,againstHero,games,hero,losses,shift,wins
0,64,10,65,1,31.455780164415454,9
1,107,10,73,1,28.662979189254322,9
2,91,10,43,0,27.344584558244538,10
3,103,15,86,2,23.967936503754768,13
4,57,12,41,2,23.379405756490286,10
5,26,10,10,2,22.772023260468664,8
6,84,10,94,1,22.762013140609874,9
7,20,11,85,2,22.58682017719025,9
8,17,11,44,2,22.07291294624117,9
9,111,25,70,6,21.76194128198864,19
10,106,10,87,1,21.56454285087387,9
11,87,29,109,6,21.22636324198765,23
12,74,14,110,3,20.87504771154673,11
13,64,10,9,2,20.434576500484805,8
14,110,12,109,2,20.16933250309852,10
15,41,13,10,2,19.73715787827288,11
16,5,10,9,2,19.535484203654345,8
17,55,12,75,2,19.50260854320923,10
18,110,12,29,2,19.248543702222978,10
19,62,13,50,3,19.202113459727393,10
20,57,18,28,3,19.08730071874414,15
21,87,10,85,2,19.06738234368307,8
22,62,12,71,1,19.043487335161075,11
23,26,11,88,3,18.785991491960523,8
24,70,15,86,4,18.5852223692848,11
25,18,10,37,2,18.374799448579125,8
26,106,12,20,4,18.3115400770612,8
27,58,11,87,2,18.229025747195355,9
28,51,11,98,3,18.11615896281521,8
29,79,12,7,3,18.096381711285993,9
30,93,13,48,2,18.07835377188638,11
31,90,11,76,4,18.031869037099202,7
32,63,13,70,3,17.959510637912526,10
33,41,10,110,1,17.607251464829996,9
34,63,13,76,2,17.535738224915978,11
35,87,17,46,5,17.514030324475865,12
36,26,11,49,4,17.344464565076983,7
37,30,22,65,5,17.16851241113137,17
38,26,13,54,5,16.939787162296547,8
39,43,14,38,5,16.915982285417527,9
40,38,12,15,3,16.880495720481196,9
41,63,13,28,3,16.83915101157232,10
42,20,10,48,2,16.747092552182814,8
43,73,16,109,4,16.722107664046135,12
44,57,13,76,3,16.719909290440036,10
45,88,14,75,3,16.698120760316787,11
46,30,13,85,3,16.384026425638844,10
47,62,13,103,4,16.29915650058687,9
48,59,11,103,3,16.266656443008632,8
49,88,18,49,4,16.108818713025215,14
50,90,12,91,4,16.09870244517902,8
51,55,16,109,4,15.902114621962271,12
52,17,15,38,4,15.678044683298907,11
53,29,12,73,3,15.669782329836798,9
54,16,10,59,4,15.561569445873221,6
55,70,13,88,3,15.445871190573252,10
56,74,11,112,3,15.445414304360204,8
57,90,11,18,3,15.206260273523736,8
58,90,17,88,5,15.203720699131468,12
59,84,14,40,5,15.139436492633187,9
60,57,15,37,4,15.06777664357477,11
61,73,14,23,4,15.067057394128556,10
62,14,10,65,2,15.014185877069247,8
63,9,10,51,3,14.933479318486382,7
64,26,24,38,7,14.873702675608984,17
65,93,11,17,3,14.792328082005673,8
66,93,25,38,8,14.706979782976548,17
67,88,14,13,6,14.636848081546898,8
68,62,19,20,5,14.58480992394943,14
69,110,11,50,3,14.53197897415603,8
70,111,30,62,9,14.365589379046474,21
71,107,25,62,8,14.352538477201135,17
72,28,10,66,4,14.329185091749263,6
73,86,12,17,3,14.311620358508238,9
74,46,11,91,3,14.304066831342244,8
75,84,10,44,3,14.273373064789187,7
76,60,10,8,3,14.262033464961124,7
77,50,12,109,4,14.261856398454315,8
78,98,11,71,3,14.175605929164412,8
79,110,16,8,4,14.095812927776766,12
80,17,13,37,5,14.003196529897798,8
81,57,20,9,5,13.952239963411909,15
82,46,14,79,5,13.9267444372902,9
83,70,12,109,3,13.90225333563024,9
84,26,33,107,8,13.8753667821026,25
85,55,22,2,7,13.871872112800904,15
86,63,10,10,3,13.847715879097754,7
87,54,26,109,8,13.824526520753498,18
88,38,16,73,6,13.771113964229546,10
89,111,16,109,5,13.722443192828687,11
90,37,10,13,3,13.71058873552403,7
91,20,18,10,5,13.692854024847371,13
92,26,13,69,4,13.665838119385654,9
93,84,17,13,6,13.61439780977119,11
94,37,12,5,3,13.59306711232449,9
95,13,15,73,5,13.471561712276628,10
96,86,16,55,6,13.429599224429374,10
97,90,10,93,4,13.383501710064953,6
98,70,12,74,3,13.332522800110302,9
99,18,13,2,4,13.317961607759768,9
100,89,12,73,4,13.292782754035763,8
101,58,10,89,3,13.242354787086834,7
102,64,16,86,5,13.126489420837816,11
103,112,10,50,3,13.007963386743393,7
104,63,15,79,5,12.990676793013687,10
105,37,13,34,4,12.94192710541144,9
106,3,11,8,3,12.917286316124732,8
107,87,11,14,3,12.902634224263675,8
108,6,14,66,4,12.900366001703455,10
109,54,13,104,4,12.823245238040403,9
110,87,13,5,4,12.788098556943213,9
111,69,10,41,4,12.78611035636453,6
112,8,13,89,4,12.710180677943102,9
113,73,11,90,3,12.699639901607059,8
114,63,11,86,3,12.694676726792153,8
115,28,28,109,9,12.602002199079491,19
116,18,16,84,5,12.53715723328448,11
117,93,22,62,7,12.439036445917953,15
118,20,18,23,5,12.419097927334018,13
119,93,12,26,4,12.342400061412192,8
120,55,21,62,8,12.326620895814228,13
121,107,26,6,8,12.32225479762014,18
122,93,17,50,6,12.303370496346973,11
123,2,20,76,7,12.29741854724382,13
124,84,17,62,6,12.2561085252652,11
125,51,15,48,4,12.237016972870071,11
126,74,20,48,7,12.23065848011944,13
127,10,23,23,9,12.202189639863423,14
128,93,20,41,5,12.152619394683914,15
129,49,10,62,4,12.115401300524669,6
130,58,11,103,3,12.09340769953573,8
131,79,11,112,3,12.08961716654424,8
132,38,15,10,4,12.029907406435381,11
133,98,15,11,5,11.975065250902475,10
134,104,16,98,6,11.933644997320592,10
135,93,10,76,3,11.923250604262599,7
136,18,13,17,5,11.905263091036248,8
137,48,17,111,5,11.902706300174234,12
138,43,14,109,5,11.866460109925432,9
139,23,15,62,4,11.828374088275886,11
140,15,10,79,3,11.756403792330076,7
141,70,13,62,5,11.719880801732707,8
142,8,17,71,6,11.702151139266475,11
143,93,15,91,5,11.673165263369297,10
144,107,14,70,5,11.658453467748313,9
145,98,17,15,6,11.628891195956701,11
146,65,16,18,5,11.593628436717696,11
147,16,18,13,6,11.568229122492738,12
148,65,16,102,6,11.56505726688695,10
149,38,22,109,7,11.561969316834688,15
150,109,15,6,5,11.553622356231042,10
151,41,31,109,7,11.540113156994366,24
152,17,20,41,5,11.462467383182345,15
153,9,10,97,4,11.373867326772807,6
154,46,18,9,7,11.371108835096305,11
155,2,22,103,6,11.358008021341286,16
156,13,13,41,5,11.285884419294256,8
157,93,14,1,4,11.222746146114874,10
158,85,16,37,4,11.183890538456167,12
159,15,10,28,3,11.17654596174133,7
160,26,13,46,5,11.17021351687407,8
161,93,19,37,6,11.135373057728067,13
162,98,12,110,4,11.026999619900323,8
163,30,21,9,6,11.009407613122827,15
164,38,14,6,4,11.00539879038108,10
165,30,10,43,3,10.958461383133033,7
166,87,17,51,6,10.954751209558497,11
167,11,10,8,3,10.874801270533917,7
168,30,11,62,4,10.859839313714287,7
169,98,48,41,18,10.835326353590226,30
170,37,13,63,5,10.805969524077799,8
171,87,27,6,9,10.79278133326798,18
172,30,25,103,8,10.7828746133779,17
173,17,16,23,5,10.781653305644493,11
174,93,37,9,12,10.753480854770821,25
175,50,10,37,4,10.74227717924088,6
176,55,20,30,8,10.741156330527382,12
177,8,13,66,4,10.737460925769158,9
178,91,10,85,5,10.70245375594107,5
179,37,14,41,5,10.694476243263008,9
180,107,16,109,6,10.668493285549749,10
181,75,16,16,5,10.668295124883432,11
182,38,13,58,4,10.642287291889893,9
183,98,37,88,11,10.639663528048942,26
184,65,10,101,4,10.616476001261294,6
185,86,12,109,5,10.607119538943422,7
186,103,14,109,4,10.579033749442827,10
187,70,15,65,5,10.573807897523746,10
188,98,32,76,12,10.566257306689165,20
189,20,17,49,6,10.413212284497668,11
190,29,10,17,3,10.395985227153455,7
191,93,12,75,5,10.37008891222569,7
192,2,11,75,4,10.36983356106975,7
193,2,16,73,6,10.299221262346565,10
194,104,20,28,6,10.280976450513146,14
195,70,22,84,8,10.221911181232901,14
196,65,12,96,5,10.190345361441295,7
197,60,10,38,4,10.186949801542642,6
198,74,17,18,6,10.16104487640857,11
199,109,14,84,5,10.149942855967595,9
200,2,31,86,10,10.07894667884976,21
201,63,18,54,7,10.075840147553764,11
202,10,18,1,6,10.049405294208217,12
203,63,13,9,5,10.036609783490738,8
204,65,14,59,6,10.03616480415964,8
205,88,11,30,5,10.02483572373662,6
206,76,17,34,6,9.994247540573085,11
207,34,14,91,5,9.987130942490122,9
208,29,10,70,3,9.974371860410164,7
209,111,24,38,9,9.966212518632446,15
210,10,17,55,7,9.955177794264817,10
211,55,46,87,15,9.941456749458233,31
212,93,11,70,4,9.92887532154977,7
213,87,13,17,5,9.92299839057506,8
214,10,14,50,5,9.907166966632534,9
215,107,30,41,12,9.88099173594234,18
216,32,22,109,8,9.8595898331429,14
217,28,10,64,4,9.85835950928987,6
218,79,31,48,12,9.853595538086752,19
219,111,20,37,8,9.840471570719457,12
220,6,34,44,13,9.768613303295997,21
221,73,21,111,8,9.713634051639158,13
222,111,42,54,15,9.68998535179476,27
223,29,32,38,11,9.681299801122258,21
224,88,11,85,4,9.656301948727865,7
225,55,23,54,7,9.648181025800827,16
226,98,26,62,10,9.641858129313672,16
227,23,22,89,8,9.57687547449059,14
228,60,21,65,8,9.571951123571157,13
229,32,14,88,4,9.505084521049724,10
230,43,16,28,5,9.500596764145225,11
231,6,11,58,4,9.489496457414946,7
232,103,11,19,4,9.481054864710426,7
233,65,17,44,7,9.4437024578389,10
234,70,10,55,4,9.436952114481349,6
235,57,11,10,4,9.432674751481889,7
236,34,16,74,6,9.430626027485216,10
237,76,14,62,7,9.422068732882325,7
238,91,20,76,7,9.390956065597496,13
239,93,14,30,5,9.378386095833305,9
240,46,16,8,6,9.37241265515055,10
241,49,17,86,8,9.343172433673244,9
242,23,15,55,6,9.335240638495888,9
243,50,17,23,7,9.300090532650527,10
244,43,14,50,5,9.274747817248809,9
245,54,37,41,13,9.187270230665861,24
246,30,20,87,7,9.180499280009721,13
247,50,15,48,6,9.13089598930205,9
248,93,29,103,11,9.099325117611029,18
249,26,12,32,5,9.097694016198698,7
250,106,13,109,5,9.062668099795834,8
251,91,16,50,5,9.0441946525026,11
252,74,35,76,12,9.021109435296273,23
253,30,19,54,7,8.941378731198723,12
254,107,20,110,8,8.933567921834614,12
255,10,11,85,5,8.81027661814343,6
256,32,17,107,5,8.731768023357223,12
257,79,16,75,5,8.729196308002644,11
258,23,23,37,8,8.700238300329014,15
259,34,18,109,7,8.66273498003357,11
260,84,27,10,10,8.646492586790986,17
261,37,40,86,16,8.60382562458516,24
262,76,36,28,14,8.544961108918416,22
263,41,18,62,7,8.537234992782366,11
264,89,10,109,4,8.517312082575355,6
265,54,23,76,10,8.51187755649848,13
266,93,31,84,11,8.46536333401638,20
267,84,26,85,12,8.437491114567164,14
268,98,21,1,7,8.436557583367698,14
269,73,21,10,7,8.419335562342066,14
270,43,17,87,6,8.417190390098332,11
271,90,11,89,4,8.39679691457017,7
272,90,19,23,7,8.394839451243376,12
273,23,23,93,10,8.38720167861792,13
274,48,12,38,4,8.376240779730193,8
275,77,12,8,4,8.373441110755335,8
276,84,20,63,8,8.347628578121027,12
277,104,11,84,4,8.339235828654411,7
278,8,10,35,4,8.33580666741078,6
279,76,18,41,7,8.284971187696899,11
280,65,12,58,6,8.279172093518053,6
281,16,24,70,8,8.272893937971958,16
282,20,33,9,11,8.272596506781891,22
283,111,14,17,6,8.239799794462416,8
284,26,10,16,4,8.231874067384087,6
285,28,13,94,5,8.222371266039175,8
286,13,19,8,7,8.198779355292585,12
287,17,29,8,11,8.17510581548791,18
288,28,20,89,8,8.171930701809194,12
289,32,24,41,10,8.170536046764163,14
290,16,65,86,24,8.160600875802443,41
291,84,42,48,17,8.151068929408758,25
292,26,44,87,17,8.146474895568339,27
293,19,14,9,6,8.117304295019105,8
294,93,32,54,10,8.106367720057325,22
295,79,28,107,10,8.088960006240738,18
296,38,19,86,6,8.08239085687564,13
297,30,15,10,5,8.08039942607508,10
298,6,12,13,5,8.074590184679876,7
299,1,11,86,4,8.004187715591293,7
300,98,58,65,22,8.00384438504987,36
301,90,15,41,6,7.9977372465156895,9
302,49,23,9,8,7.992519163965539,15
303,32,14,86,6,7.973587175462609,8
304,109,12,37,5,7.9722736641499905,7
305,55,18,76,7,7.950732428839995,11
306,65,17,68,7,7.944869327403057,10
307,54,25,37,8,7.943083932672223,17
308,49,14,13,6,7.890029815709079,8
309,74,11,12,5,7.881335923893616,6
310,93,33,87,12,7.840798177940551,21
311,17,26,9,10,7.831275179780674,16
312,76,32,37,11,7.8204975769535725,21
313,28,10,11,4,7.813271079515407,6
314,65,20,50,8,7.794013777008701,12
315,2,40,65,14,7.773153242011138,26
316,29,13,109,5,7.764821554426811,8
317,111,14,85,5,7.7293785704579765,9
318,23,11,59,4,7.703199044299861,7
319,16,23,85,9,7.69932817345713,14
320,88,40,76,17,7.693645081601591,23
321,104,12,10,5,7.685162882867629,7
322,49,22,65,9,7.648203777845677,13
323,111,26,86,11,7.599516330003596,15
324,8,49,76,19,7.599383660078011,30
325,20,33,79,12,7.546840294896304,21
326,79,17,70,8,7.531628680674285,9
327,46,15,88,5,7.530723715486486,10
328,29,20,107,7,7.52553061945499,13
329,28,53,41,23,7.494799478271725,30
330,87,33,86,13,7.461882361903253,20
331,17,14,48,6,7.444960593591365,8
332,87,31,50,12,7.429484842498567,19
333,98,14,68,4,7.4276533386231165,10
334,103,29,74,10,7.419118005067163,19
335,88,29,54,12,7.418874182686381,17
336,41,13,49,4,7.406139067429067,9
337,98,15,5,6,7.403088174401656,9
338,13,24,28,8,7.385148355874099,16
339,20,28,84,10,7.362780437625798,18
340,63,45,65,18,7.355361278305467,27
341,43,14,65,6,7.347774243596503,8
342,89,23,10,9,7.332600528276464,14
343,54,21,10,8,7.316914939103646,13
344,50,11,68,4,7.299975074722132,7
345,23,15,70,6,7.277989111704879,9
346,30,10,73,4,7.275241295919059,6
347,10,19,86,7,7.266452513785876,12
348,28,12,112,5,7.260189333899199,7
349,8,46,93,17,7.259434595610272,29
350,88,14,38,6,7.257573306252318,8
351,84,24,88,9,7.256956915758408,15
352,55,41,98,16,7.239816282699838,25
353,30,13,49,5,7.228582193886496,8
354,10,19,76,8,7.223608714939952,11
355,87,10,56,4,7.222698791088135,6
356,111,13,34,6,7.201437198359543,7
357,94,17,20,6,7.200649176708729,11
358,70,21,87,8,7.188789144484621,13
359,5,11,6,4,7.175117705775807,7
360,74,28,86,11,7.1305410605737976,17
361,86,14,20,6,7.118094837224452,8
362,16,16,89,6,7.10266421806873,10
363,104,14,62,5,7.094567188746602,9
364,30,21,86,5,7.093547407861887,16
365,87,15,34,6,7.057985714791874,9
366,74,52,65,20,7.057974081058526,32
367,109,29,9,12,7.0564874177553225,17
368,91,37,28,14,7.047707205955758,23
369,59,19,79,8,7.0352036880537785,11
370,111,20,6,8,7.018385668922465,12
371,51,10,6,3,7.0035300376142064,7
372,90,19,6,8,7.003490622158199,11
373,79,21,104,7,7.001432407845648,14
374,79,11,101,5,6.99086142593087,6
375,107,27,50,10,6.978239572703386,17
376,73,10,68,4,6.953949871021737,6
377,55,25,38,11,6.947960322969595,14
378,90,14,17,6,6.930186835428707,8
379,57,12,74,4,6.917604242425743,8
380,8,36,38,14,6.910326910265976,22
381,41,45,103,15,6.896034695840799,30
382,15,11,16,4,6.875773988595896,7
383,88,10,63,4,6.8734091426604875,6
384,87,45,79,19,6.85979977977305,26
385,30,16,70,6,6.82460555340519,10
386,32,26,79,10,6.821690929992385,16
387,88,21,6,8,6.808639243885845,13
388,91,35,41,13,6.801656465480552,22
389,93,14,43,5,6.790671371620014,9
390,55,35,20,15,6.786443158254518,20
391,26,24,109,9,6.785414157125378,15
392,87,46,28,18,6.77126457575562,28
393,46,17,54,6,6.756375555864046,11
394,98,36,50,16,6.74852588996195,20
395,73,13,93,5,6.74681570888467,8
396,111,42,41,18,6.74287931489457,24
397,65,24,32,10,6.740147619373072,14
398,2,19,34,8,6.729658072634231,11
399,111,29,32,13,6.714992004730651,16
400,89,11,74,5,6.714017548400379,6
401,79,18,62,8,6.7066833419721705,10
402,28,19,85,8,6.705663303042567,11
403,88,16,57,7,6.6984703888039245,9
404,32,23,9,9,6.67611474654004,14
405,18,24,9,10,6.6693794387353345,14
406,74,16,49,7,6.669033870592291,9
407,98,23,34,8,6.6646586704925195,15
408,17,15,49,6,6.655321673670168,9
409,8,21,57,9,6.644454597179963,12
410,86,14,85,7,6.640232602185862,7
411,23,14,18,5,6.631187531141065,9
412,34,14,65,6,6.615174326051709,8
413,107,20,76,8,6.611819543573887,12
414,16,21,18,8,6.6099594156094685,13
415,55,15,91,5,6.584228246945676,10
416,84,12,66,5,6.5780441540966335,7
417,74,23,38,10,6.562267688513879,13
418,30,14,16,5,6.557206782808545,9
419,14,18,84,5,6.539625119207458,13
420,74,26,88,9,6.515151171646329,17
421,16,68,9,25,6.511357169334913,43
422,17,13,62,5,6.51109228837904,8
423,87,25,18,9,6.50092107817753,16
424,8,35,62,14,6.490056401985651,21
425,23,11,48,5,6.485113687277618,6
426,93,26,74,9,6.479775766836977,17
427,17,10,10,4,6.479497194252815,6
428,65,32,48,13,6.477954122109948,19
429,20,16,88,6,6.450213485704795,10
430,90,10,62,4,6.4415032468905995,6
431,12,14,28,5,6.429365216940007,9
432,28,38,54,15,6.411584180634172,23
433,49,14,16,6,6.400365622536034,8
434,10,28,28,10,6.393353899415196,18
435,30,22,37,8,6.384018768768751,14
436,15,14,84,5,6.375647385580594,9
437,103,22,88,8,6.368772240906126,14
438,31,10,28,4,6.368565836830037,6
439,86,18,73,7,6.340120760849845,11
440,55,26,41,12,6.334267485528576,14
441,20,80,65,31,6.318535384282401,49
442,16,57,65,24,6.310296262259339,33
443,8,33,109,14,6.30772945688614,19
444,90,16,54,7,6.290244829620483,9
445,111,15,44,6,6.2820016152003975,9
446,87,25,76,10,6.268639154144933,15
447,73,34,9,14,6.263734230116221,20
448,23,40,8,16,6.24315320488594,24
449,75,12,9,4,6.239095019020707,8
450,2,35,41,13,6.231438093089564,22
451,16,14,34,6,6.2295567684996,8
452,2,11,66,4,6.205381429919992,7
453,28,68,9,29,6.158626932406422,39
454,111,11,56,4,6.133528731729064,7
455,73,15,88,6,6.130278796806204,9
456,111,70,65,32,6.128152820402616,38
457,49,17,6,7,6.097985660912412,10
458,107,27,2,11,6.06290925873793,16
459,63,13,98,6,6.056134732306879,7
460,1,14,107,6,6.01274894122701,8
461,98,48,91,22,6.010481139866051,26
462,49,10,77,5,6.002993751357134,5
463,16,26,6,12,5.978889658978726,14
464,74,25,6,10,5.973570320498571,15
465,17,10,34,4,5.9708638591669345,6
466,20,33,103,11,5.964316349878249,22
467,8,23,49,10,5.962799116224745,13
468,87,28,91,11,5.954439761122967,17
469,70,20,76,8,5.936463398377325,12
470,98,49,103,19,5.894528502030381,30
471,17,17,16,7,5.8683420758720235,10
472,107,10,48,4,5.8635977751046635,6
473,2,10,44,4,5.829723764491519,6
474,16,36,88,13,5.820662989223607,23
475,13,21,79,7,5.816978385717298,14
476,38,22,87,9,5.809647209419687,13
477,87,44,41,20,5.804454173879386,24
478,63,13,8,5,5.78828034754951,8
479,17,19,84,8,5.78608587231579,11
480,15,23,76,9,5.782831260117777,14
481,32,18,54,7,5.7826104895534876,11
482,51,14,79,6,5.772506691008205,8
483,75,15,28,7,5.767432508412402,8
484,38,29,9,13,5.756435186772356,16
485,90,20,37,8,5.742590617036884,12
486,54,38,6,13,5.738166771423008,25
487,89,23,65,10,5.729458742490655,13
488,18,11,51,5,5.697627847770078,6
489,43,13,9,6,5.6825351087636395,7
490,63,16,91,7,5.669548453730626,9
491,8,13,56,5,5.6620905185261305,8
492,74,18,109,8,5.655848733560989,10
493,41,45,9,17,5.643905739728352,28
494,107,41,20,18,5.643773896247953,23
495,2,16,48,8,5.635246627200352,8
496,54,16,51,7,5.634722358696404,9
497,104,12,87,4,5.633009975820393,8
498,6,25,20,12,5.631661671252286,13
499,26,22,29,8,5.630548836449716,14
500,86,11,57,5,5.628641785626695,6
501,6,33,48,14,5.618170706899612,19
502,74,35,91,15,5.5905433751155025,20
503,93,40,28,17,5.5902709007594105,23
504,9,26,88,11,5.581928928392054,15
505,28,25,17,10,5.57316967418441,15
506,49,14,48,7,5.572044813615612,7
507,49,29,98,13,5.553486162622289,16
508,28,11,97,6,5.5469707821451895,5
509,34,22,79,10,5.5447176292151426,12
510,46,10,2,4,5.541906116456136,6
511,111,36,103,15,5.530917867453249,21
512,23,40,98,16,5.52748143097881,24
513,107,16,34,7,5.514558906998726,9
514,74,21,73,9,5.496437468937686,12
515,89,10,87,4,5.494352199749725,6
516,65,15,15,7,5.4681584142167425,8
517,93,13,49,6,5.4651623752460186,7
518,90,20,87,7,5.464899068206852,13
519,54,33,38,13,5.464199343195873,20
520,14,10,9,3,5.4634394370226635,7
521,30,15,50,7,5.456889712897827,8
522,55,14,37,6,5.456618910920282,8
523,49,27,87,13,5.451792030762739,14
524,84,39,76,19,5.438513858870127,20
525,109,16,23,6,5.438260955948294,10
526,20,26,38,11,5.422962328602491,15
527,37,23,88,9,5.42033189203758,14
528,43,11,103,5,5.405634019581254,6
529,110,23,65,9,5.385061990656434,14
530,8,66,41,30,5.383353261881381,36
531,20,24,109,8,5.375774718225749,16
532,6,38,28,16,5.362669207148235,22
533,29,21,84,9,5.340667565501357,12
534,90,23,8,9,5.338168133162715,14
535,30,18,6,6,5.328184059941261,12
536,54,46,9,19,5.328004432423598,27
537,84,14,71,6,5.316384874786533,8
538,50,36,79,16,5.311051747194992,20
539,87,45,9,19,5.27696827208117,26
540,63,15,85,7,5.266282773446657,8
541,74,22,29,10,5.2608197922239635,12
542,50,12,89,5,5.253704218444127,7
543,1,10,111,5,5.2389835373250895,5
544,55,30,9,11,5.2344891272769605,19
545,30,22,8,8,5.213064512809201,14
546,55,14,18,6,5.210031069954467,8
547,9,36,86,16,5.188225565384638,20
548,111,10,57,4,5.186942618450887,6
549,8,74,79,34,5.181361620021706,40
550,107,34,9,16,5.177997873535459,18
551,16,15,57,7,5.174682414292547,8
552,26,38,20,16,5.156160372920304,22
553,98,10,52,5,5.141825899051739,5
554,20,12,32,5,5.135866792699634,7
555,54,12,17,5,5.13265067269767,7
556,41,29,89,12,5.128070897369616,17
557,103,21,18,9,5.117263308095354,12
558,9,11,1,5,5.0962387955290955,6
559,16,20,73,9,5.070658783374491,11
560,84,26,34,10,5.034519120740958,16
561,65,58,54,26,5.034371936668329,32
562,89,15,84,5,5.015269353437399,10
563,55,20,32,8,5.010948173246779,12
564,62,17,54,7,5.001633115691912,10
565,26,30,65,13,4.982618574560724,17
566,50,18,73,9,4.978313428573542,9
567,89,10,20,4,4.9764030381512026,6
568,18,23,79,11,4.97103956030986,12
569,41,20,86,9,4.96812288725616,11
570,10,10,59,5,4.967497448599426,5
571,46,11,103,5,4.93491443987304,6
572,28,23,70,11,4.906318270343948,12
573,65,11,5,5,4.90161537792141,6
574,8,46,48,20,4.828884672158708,26
575,55,29,6,10,4.803715742468641,19
576,90,11,70,4,4.801865378344786,7
577,87,22,88,8,4.796769422048848,14
578,86,11,18,5,4.795064637153176,6
579,17,11,30,5,4.793161472453947,6
580,34,10,103,3,4.790473034569175,7
581,13,12,20,4,4.788358918637377,8
582,111,10,104,4,4.785383853867566,6
583,8,13,106,6,4.770713481148754,7
584,98,17,94,7,4.761676089313329,10
585,6,12,32,5,4.741771241477241,7
586,74,18,55,9,4.738810454561628,9
587,90,30,9,13,4.717832744642906,17
588,109,19,93,8,4.710552248323456,11
589,87,35,29,15,4.710088352572669,20
590,26,16,6,6,4.685058896386026,10
591,41,53,20,21,4.6728320955774825,32
592,86,10,15,5,4.603054673648835,5
593,28,19,49,7,4.5879435578079875,12
594,2,31,6,13,4.575369715684754,18
595,46,13,37,6,4.568700097838744,7
596,9,20,89,7,4.555028073124962,13
597,87,15,57,7,4.55240997291295,8
598,2,10,51,5,4.541060117126744,5
599,26,45,8,21,4.535697997459029,24
600,74,24,23,11,4.530539923458647,13
601,65,26,109,13,4.522732343847655,13
602,91,36,9,16,4.519475424395413,20
603,111,29,93,14,4.510765206652461,15
604,38,38,28,17,4.50616017554961,21
605,9,17,59,7,4.502961051414203,10
606,29,11,62,5,4.502398822563132,6
607,111,29,91,14,4.500138929465923,15
608,29,21,93,9,4.498959392246705,12
609,111,21,29,11,4.4840296225286655,10
610,111,25,15,10,4.472513123100849,15
611,73,23,84,8,4.463513313785121,15
612,84,32,2,14,4.438454989875694,18
613,90,10,13,5,4.4350576589733715,5
614,84,36,41,14,4.40540018386779,22
615,111,38,74,17,4.395421398955389,21
616,75,11,50,4,4.392668801200933,7
617,1,14,65,6,4.384642024421805,8
618,107,15,104,6,4.384096889948014,9
619,54,13,89,5,4.375934710162817,8
620,87,11,94,5,4.3750154371421806,6
621,70,17,2,6,4.372410293055534,11
622,79,13,44,6,4.356415433762267,7
623,93,71,65,31,4.339245718156345,40
624,54,17,3,8,4.336905078418534,9
625,8,94,9,42,4.330862656922901,52
626,41,20,1,7,4.310885836842606,13
627,57,22,84,9,4.307342730462733,13
628,85,15,48,6,4.3053632687921874,9
629,103,34,28,15,4.283445470085922,19
630,79,18,106,9,4.260883343518001,9
631,58,11,9,4,4.2449574488184085,7
632,18,13,49,6,4.243576516469457,7
633,97,11,8,4,4.238412616249602,7
634,29,26,20,11,4.235090000321545,15
635,65,106,9,47,4.223360140775496,59
636,104,24,8,9,4.217796324401936,15
637,16,37,37,14,4.211147077007784,23
638,26,24,103,11,4.210605706707939,13
639,62,26,9,11,4.20006809871188,15
640,17,22,79,10,4.186747232119098,12
641,2,16,32,7,4.169077635966494,9
642,29,19,79,9,4.163523890816751,10
643,63,15,48,7,4.152796736858187,8
644,65,23,91,12,4.15010120900015,11
645,37,15,2,7,4.147220527730264,8
646,103,28,54,13,4.13111154459063,15
647,23,14,30,7,4.121797276586666,7
648,37,39,98,17,4.116775978907105,22
649,54,19,29,7,4.092788521879797,12
650,2,36,9,17,4.08389169356919,19
651,98,16,85,8,4.042048861968951,8
652,10,11,109,5,4.004247407956419,6
653,26,26,28,11,3.9790441547640567,15
654,16,29,74,12,3.9743417346866297,17
655,1,16,8,8,3.9724434837704097,8
656,91,40,8,19,3.961945852137989,21
657,93,18,10,7,3.954978874369175,11
658,23,39,84,18,3.952949843708358,21
659,6,22,73,11,3.947699618921388,11
660,79,36,74,14,3.9251156042857227,22
661,94,16,54,8,3.897800639878565,8
662,98,47,84,21,3.8908337456526523,26
663,55,11,17,5,3.884041039360635,6
664,20,10,50,4,3.8664231910700964,6
665,51,20,86,9,3.8633622170066255,11
666,38,14,49,7,3.8551286140805883,7
667,23,40,9,18,3.825851357048051,22
668,32,14,91,7,3.825310656034844,7
669,37,14,20,6,3.8240986868747346,8
670,93,15,18,7,3.800055574547406,8
671,110,12,103,5,3.7849274590311146,7
672,26,11,110,6,3.7814954576991626,5
673,79,15,73,7,3.780403758532128,8
674,98,26,18,12,3.7616966957049423,14
675,57,12,18,4,3.7525453734501895,8
676,55,31,88,12,3.7522592797043,19
677,37,37,8,17,3.7513378121907257,20
678,10,20,74,8,3.7415607204357952,12
679,87,24,37,12,3.7376369474443707,12
680,48,16,41,7,3.7233952099256946,9
681,84,22,38,9,3.721558072111382,13
682,60,10,87,5,3.716219490276849,5
683,32,14,10,5,3.709056496740236,9
684,32,35,8,16,3.704344714378886,19
685,86,40,76,19,3.6671645346353174,21
686,30,19,84,9,3.664539402131782,10
687,48,14,89,6,3.663870491648268,8
688,106,12,65,5,3.6637536933904045,7
689,57,17,65,6,3.662004607965262,11
690,88,18,93,10,3.642215672169972,8
691,10,12,18,4,3.6042571144804327,8
692,29,12,46,5,3.5756011188612917,7
693,16,34,76,16,3.5713726859790302,18
694,50,25,38,11,3.5687465201033155,14
695,73,28,8,11,3.5539511566695947,17
696,65,13,94,6,3.5056909876146616,7
697,79,41,76,17,3.500613863685398,24
698,51,10,55,4,3.478851515612335,6
699,1,14,55,6,3.4728600689370874,8
700,111,21,76,11,3.468863949107616,10
701,48,12,91,5,3.4664297594725197,7
702,23,15,26,7,3.459704667443899,8
703,51,18,8,8,3.45183106361033,10
704,5,10,91,6,3.425539811872453,4
705,86,14,93,6,3.420418426819417,8
706,98,31,10,14,3.4043551656175834,17
707,57,12,6,4,3.400016956513245,8
708,48,32,37,15,3.397336876678575,17
709,79,57,37,24,3.3937774135660415,33
710,87,51,20,23,3.393361007026731,28
711,57,14,91,5,3.387917143764689,9
712,76,14,13,7,3.383197454645706,7
713,2,14,85,7,3.3798876085075142,7
714,6,26,91,12,3.37006635937582,14
715,54,36,84,15,3.3687833567687115,21
716,29,26,8,12,3.355791507675689,14
717,28,60,16,27,3.315471872519662,33
718,104,12,76,6,3.296017349449059,6
719,10,11,46,5,3.290581679590813,6
720,32,24,98,11,3.2868277404205144,13
721,59,11,98,5,3.2664563544762375,6
722,30,21,29,10,3.2444225111341125,11
723,55,72,8,31,3.242679915951949,41
724,76,15,18,6,3.2371919896499453,9
725,49,11,85,5,3.234049059231717,6
726,23,19,86,9,3.2169168727971016,10
727,32,25,16,11,3.2091711041875497,14
728,8,75,107,35,3.203023338305832,40
729,88,17,41,8,3.1907658333962923,9
730,91,13,37,6,3.1893915884876454,7
731,87,26,48,12,3.1439283470096266,14
732,106,10,98,4,3.1299996913347945,6
733,54,27,50,11,3.1075162747982183,16
734,50,33,103,15,3.092695156166144,18
735,111,49,9,24,3.0754591947252536,25
736,26,17,43,7,3.0481873322386352,10
737,9,14,44,8,3.0418979222799782,6
738,16,59,84,27,3.031643154660335,32
739,20,33,28,13,3.0274591386657326,20
740,38,18,16,9,3.0174584469144,9
741,26,16,89,8,3.0015441091670665,8
742,46,19,76,8,2.980744453977645,11
743,8,62,16,27,2.9777798914412967,35
744,74,60,8,28,2.9442423049029234,32
745,18,18,48,8,2.918693386089228,10
746,68,10,87,5,2.918596255497213,5
747,8,24,68,11,2.9120627847170204,13
748,90,30,111,13,2.890544713054333,17
749,46,15,28,7,2.8691534505866354,8
750,55,11,13,5,2.8675322125133507,6
751,98,31,29,15,2.8666453310461546,16
752,13,27,9,11,2.8498939272778383,16
753,54,36,16,17,2.847205712046726,19
754,84,49,86,23,2.830691365897261,26
755,103,26,91,14,2.8179555042956754,12
756,38,55,65,25,2.8065899103574563,30
757,63,15,107,6,2.802147354543155,9
758,29,17,34,9,2.8011697136542666,8
759,14,12,8,5,2.800814824677635,7
760,17,30,103,13,2.7862637913294455,17
761,98,33,86,14,2.7839089247753144,19
762,41,40,23,18,2.7673807455242936,22
763,2,18,23,9,2.76700436988762,9
764,29,30,28,14,2.7417268938351826,16
765,34,21,28,9,2.7346627104082097,12
766,23,14,29,6,2.7325720738957804,8
767,79,25,89,10,2.732343278458178,15
768,26,14,30,9,2.7295268644643036,5
769,16,20,91,9,2.7214582735625528,11
770,62,25,87,11,2.7185367714166673,14
771,90,29,28,13,2.709626925847089,16
772,103,24,55,11,2.7037427493149484,13
773,46,10,18,4,2.6832650728648515,6
774,65,69,28,31,2.6612658342082547,38
775,30,25,38,13,2.6609022960305335,12
776,86,20,88,8,2.6598697754609475,12
777,15,14,8,7,2.6593953269851665,7
778,87,27,54,13,2.6518374940593397,14
779,8,42,103,17,2.6366758249260895,25
780,30,13,107,5,2.6326975250966638,8
781,70,11,50,6,2.626702900417429,5
782,111,23,50,10,2.626096528214075,13
783,9,16,94,8,2.620832608628445,8
784,29,24,9,12,2.6073964056504892,12
785,38,20,112,9,2.587558109977976,11
786,2,25,109,10,2.5641635343710663,15
787,50,12,88,6,2.559456050854571,6
788,23,11,34,6,2.530674269646428,5
789,98,52,54,26,2.52901549913828,26
790,50,19,29,8,2.5251415163545516,11
791,16,50,98,22,2.5197213230509203,28
792,48,21,55,9,2.510477788778169,12
793,16,17,62,8,2.4884740684398885,9
794,65,50,103,21,2.483568843444369,29
795,74,29,107,13,2.4812045730116723,16
796,37,15,62,7,2.4789476689639205,8
797,26,27,98,15,2.469946577348654,12
798,16,13,93,6,2.460583316835966,7
799,41,40,38,19,2.4535603181412915,21
800,111,17,46,8,2.4518689623137755,9
801,28,55,18,26,2.451529125268619,29
802,2,40,10,18,2.446660934491016,22
803,9,33,6,15,2.442634272815347,18
804,18,16,50,8,2.435107533000619,8
805,32,14,38,6,2.405973678085745,8
806,76,18,35,7,2.4023433325283117,11
807,43,22,74,10,2.399363912806923,12
808,18,18,6,8,2.39036390227397,10
809,55,12,34,5,2.374285322689373,7
810,16,21,107,10,2.371918332267288,11
811,63,14,16,7,2.3500753449010667,7
812,41,56,79,27,2.337441224056111,29
813,104,11,86,5,2.3312767847407847,6
814,65,39,29,16,2.3260339041967435,23
815,16,30,87,14,2.292110942535413,16
816,62,18,32,9,2.263686769900328,9
817,103,26,87,12,2.244435120608378,14
818,84,30,55,14,2.243237050292711,16
819,107,44,28,22,2.230559467730824,22
820,8,11,58,6,2.225895511877215,5
821,79,28,93,15,2.2181833550633514,13
822,73,15,54,7,2.2175860455428436,8
823,73,35,41,16,2.189611120966088,19
824,54,34,86,16,2.1876120177380085,18
825,44,19,28,7,2.1816767204067156,12
826,74,45,9,20,2.16700698590985,25
827,98,40,107,18,2.1579093706359758,22
828,9,11,15,5,2.157551688044861,6
829,18,10,32,5,2.1572241092213504,5
830,16,49,41,24,2.154183122999479,25
831,98,61,2,29,2.1431661416362218,32
832,111,33,26,15,2.1371335815105854,18
833,16,18,104,8,2.1264699523202086,10
834,84,11,1,5,2.1264466771262813,6
835,55,14,73,7,2.100075433191044,7
836,75,18,84,8,2.0937199255326195,10
837,107,24,88,12,2.0871354397563997,12
838,13,19,48,7,2.0777118977088533,12
839,9,16,104,7,2.074620642084024,9
840,55,31,16,14,2.074141742658653,17
841,91,11,18,5,2.068864434806542,6
842,32,19,84,8,2.0621508690380312,11
843,65,77,88,35,2.0539867836081362,42
844,91,18,10,8,2.053920396033911,10
845,30,25,98,10,2.0506203422205376,15
846,38,52,98,24,2.049865770355223,28
847,23,30,87,13,2.0171902524743803,17
848,59,14,8,7,2.010238389237951,7
849,98,55,74,27,2.008567476708278,28
850,37,10,71,4,1.989603705819686,6
851,103,13,37,6,1.9837820518429896,7
852,6,47,79,22,1.9831957209831137,25
853,79,60,111,27,1.9806558598524917,33
854,23,41,65,20,1.9794334553560258,21
855,49,11,29,4,1.979211902956338,7
856,6,47,65,25,1.9776748983278993,22
857,54,18,23,8,1.972656582258224,10
858,79,35,55,18,1.959199663076027,17
859,37,33,65,15,1.9483360284193358,18
860,87,10,13,4,1.9417659717514852,6
861,28,37,37,17,1.9409348825611632,20
862,76,24,6,12,1.937944044447951,12
863,10,13,29,6,1.9268740097605606,7
864,65,20,13,11,1.9236367618157109,9
865,87,22,73,11,1.9187809773134334,11
866,6,22,37,11,1.9187411338779705,11
867,48,35,16,17,1.9177064489155933,18
868,76,10,17,4,1.9048948605365967,6
869,84,42,111,18,1.904319508445317,24
870,41,11,61,5,1.9034780148497896,6
871,104,11,51,5,1.896724728424192,6
872,91,18,88,8,1.88786606053127,10
873,84,27,49,13,1.8786207304912836,14
874,79,57,16,26,1.8779589002013803,31
875,74,21,30,11,1.874871595565309,10
876,54,17,112,8,1.871566293788832,9
877,73,19,98,9,1.8513717297876138,10
878,6,39,98,18,1.8448936378969223,21
879,90,23,107,12,1.839992081109741,11
880,35,12,79,5,1.8379035956261849,7
881,2,30,111,14,1.8367449192872456,16
882,90,19,84,9,1.8307456952070524,10
883,8,48,18,22,1.8210825548731215,26
884,20,22,73,11,1.8197178736344521,11
885,85,13,76,5,1.800008520609701,8
886,94,10,41,5,1.7939224836809742,5
887,57,10,109,4,1.7866317267766747,6
888,14,10,28,4,1.771696362645693,6
889,111,53,28,25,1.7612142471001229,28
890,8,66,87,30,1.7501098519415272,36
891,107,35,38,17,1.7434138897292968,18
892,71,18,65,9,1.7385086790308786,9
893,32,32,28,15,1.738356190048853,17
894,16,29,103,14,1.7358551004647145,15
895,106,15,38,7,1.7348192516378895,8
896,87,13,75,7,1.7332300811803263,6
897,9,19,70,10,1.7325740605828868,9
898,76,10,45,5,1.7263356630732787,5
899,16,47,2,22,1.7122028906623956,25
900,38,11,76,5,1.6999072226365513,6
901,34,15,20,6,1.6974281353522225,9
902,30,37,28,17,1.6951481350285038,20
903,91,21,30,11,1.6670009255194451,10
904,50,32,9,15,1.656082247828397,17
905,103,26,6,11,1.6275337563735768,15
906,20,18,68,9,1.6168027641247988,9
907,17,13,50,6,1.5875425148224573,7
908,90,16,48,8,1.5828630197509423,8
909,50,18,16,9,1.5602090710005827,9
910,106,12,41,6,1.5589796315432078,6
911,50,33,2,15,1.5483452933241442,18
912,107,26,86,12,1.5423744984021208,14
913,85,12,38,6,1.5317416798467203,6
914,103,12,85,5,1.505235765059641,7
915,98,16,89,8,1.5011020579783834,8
916,55,18,43,9,1.4993353058682148,9
917,37,39,9,18,1.478823674814807,21
918,41,18,18,8,1.4488156792449216,10
919,50,36,41,18,1.4450486751473963,18
920,103,10,57,6,1.433492937470935,4
921,109,11,112,5,1.4303792106135111,6
922,62,24,28,10,1.4300815186163431,14
923,111,14,75,8,1.426535254075105,6
924,65,10,3,5,1.4258252923515962,5
925,13,11,2,4,1.4221213524937684,7
926,88,31,111,14,1.421312462080983,17
927,8,47,20,22,1.4205824356666625,25
928,2,24,38,13,1.4146987667991227,11
929,34,10,48,5,1.4123185984498856,5
930,76,30,48,14,1.4051902826993379,16
931,54,18,15,9,1.4023674366161945,9
932,50,21,86,9,1.3996923807256956,12
933,54,13,85,7,1.3987454013140737,6
934,65,34,10,16,1.3889990791790843,18
935,44,13,8,5,1.3823607495686785,8
936,16,32,10,15,1.3769942516048135,17
937,79,25,30,13,1.3756609281230907,12
938,23,14,32,8,1.362990157606229,6
939,8,58,54,28,1.3404695893424994,30
940,84,70,65,35,1.3269531130271417,35
941,98,13,57,7,1.3243405021868557,6
942,87,15,110,7,1.3076573931351636,8
943,87,43,107,19,1.307160066517201,24
944,48,27,98,13,1.2896849035906888,14
945,54,39,20,18,1.2734253946760175,21
946,87,36,84,17,1.2473160473972873,19
947,20,43,98,20,1.2404189901414067,23
948,8,53,86,25,1.234440399449158,28
949,79,11,96,6,1.2340245916617492,5
950,51,20,84,9,1.233843526123481,11
951,23,37,28,18,1.2328353573645747,19
952,74,24,46,13,1.2274275532310768,11
953,49,24,55,14,1.2120144426699917,10
954,103,10,1,6,1.178228962480735,4
955,109,23,98,11,1.1685291459099263,12
956,79,76,9,37,1.1560570797633891,39
957,50,18,34,10,1.1483521913828936,8
958,54,25,107,12,1.145063137631291,13
959,79,36,38,17,1.1399672014475537,19
960,23,22,88,10,1.1194514842315577,12
961,55,27,50,12,1.1136011471986083,15
962,88,20,62,10,1.1096322170107602,10
963,16,10,56,4,1.1063673005412125,6
964,73,16,28,9,1.1026015831683806,7
965,6,41,8,19,1.0938107771145242,22
966,91,14,62,7,1.0834634078291783,7
967,48,10,35,5,1.0695374428464177,5
968,28,29,88,13,1.0651097674029277,16
969,76,15,103,6,1.0648910249315904,9
970,79,46,86,22,1.0425261635108956,24
971,74,16,62,9,1.0383577563740094,7
972,9,28,76,14,1.034161557811222,14
973,74,44,54,23,1.03196406492569,21
974,90,20,16,10,1.0306610515551813,10
975,48,27,86,13,1.0300347247258348,14
976,107,39,65,17,1.0164693815500474,22
977,58,11,2,5,1.0060883991850518,6
978,87,31,98,14,1.0052207296323035,17
979,79,11,94,5,0.9998691980070009,6
980,87,62,65,29,0.9969072233617783,33
981,32,15,74,7,0.9878312338208317,8
982,41,16,30,8,0.9850557086879002,8
983,111,16,68,7,0.983190365703102,9
984,91,20,23,10,0.9792678927031622,10
985,103,44,9,24,0.9734466854109799,20
986,68,10,16,5,0.9723777343104946,5
987,10,11,15,6,0.9620268464624143,5
988,28,36,50,17,0.9559412289162685,19
989,93,23,107,11,0.9535678875740116,12
990,48,11,30,5,0.9383914724110479,6
991,23,35,16,17,0.937387264272772,18
992,84,71,9,32,0.9296549234939694,39
993,85,19,9,8,0.9266510351352133,11
994,13,11,74,5,0.9258529887550377,6
995,51,16,16,7,0.9254181289183423,9
996,103,12,89,5,0.9245541578032425,7
997,79,29,88,12,0.9179800734687559,17
998,60,11,9,6,0.9156618531106764,5
999,79,39,90,17,0.8969827248841573,22
1000,8,61,2,31,0.8823794512979197,30
1001,62,21,65,9,0.8755953834255747,12
1002,29,12,18,7,0.8741742779448156,5
1003,16,34,111,18,0.8706079983684193,16
1004,5,12,79,7,0.8638337222987257,5
1005,8,18,75,9,0.8583987416596391,9
1006,55,52,65,22,0.8552133427187617,30
1007,98,67,8,32,0.8537292484745942,35
1008,103,16,32,7,0.8405021181328001,9
1009,111,44,87,22,0.8376292820607008,22
1010,57,11,55,6,0.8315236951519583,5
1011,54,27,70,14,0.8260404525362524,13
1012,87,23,10,10,0.8212452099335934,13
1013,54,31,79,15,0.8204273618980665,16
1014,9,34,48,18,0.8138314912844774,16
1015,70,47,98,23,0.8130313901104012,24
1016,84,56,37,28,0.7869802805275471,28
1017,85,21,65,9,0.7821322420670093,12
1018,23,24,6,12,0.7573800729023334,12
1019,76,37,65,17,0.7568795201651484,20
1020,74,46,84,22,0.7518721095348205,24
1021,90,10,104,6,0.7461340238107392,4
1022,37,11,73,5,0.7437455399697732,6
1023,8,60,10,30,0.7407705754471634,30
1024,107,23,23,11,0.7397315330825475,12
1025,104,31,65,13,0.7351510467171632,18
1026,50,17,74,8,0.725167252731053,9
1027,87,24,32,13,0.723654834631159,11
1028,86,43,28,19,0.7167553120703369,24
1029,51,12,65,6,0.7082823610974582,6
1030,41,23,43,11,0.6921842337130567,12
1031,44,12,16,7,0.674063172823535,5
1032,90,17,10,9,0.6720080859782257,8
1033,111,44,55,23,0.6715353289992407,21
1034,91,23,86,11,0.6661452371008985,12
1035,76,13,20,7,0.6610311160325526,6
1036,88,15,48,9,0.6584132572102235,6
1037,65,79,79,40,0.6544923516921677,39
1038,32,10,30,5,0.6490824873820863,5
1039,74,39,41,21,0.6406425090111577,18
1040,16,17,1,9,0.6380538669636839,8
1041,10,21,48,11,0.631414631744242,10
1042,79,61,84,30,0.6281982301150574,31
1043,74,13,63,6,0.6231938435062125,7
1044,91,18,44,8,0.616097632961548,10
1045,55,22,29,12,0.608123085968788,10
1046,111,37,20,19,0.6068837109506124,18
1047,62,18,38,9,0.6043816495722321,9
1048,98,20,101,11,0.5948708647764208,9
1049,48,18,103,9,0.5903706399248467,9
1050,70,50,8,26,0.5792404511939316,24
1051,48,34,28,15,0.5739510260260766,19
1052,54,26,91,15,0.5702688984859549,11
1053,6,41,84,20,0.5685620720746416,21
1054,15,14,2,7,0.5683026145731193,7
1055,89,17,111,9,0.5563633904658443,8
1056,90,18,2,9,0.5540783404275267,9
1057,10,18,37,8,0.546815604170652,10
1058,2,22,62,10,0.5462872756743614,12
1059,66,13,41,7,0.534743534153634,6
1060,91,13,73,5,0.5133686150476447,8
1061,79,16,49,7,0.5123191767324973,9
1062,50,39,84,20,0.4995378615802565,19
1063,54,32,2,15,0.49725687334611157,17
1064,87,16,112,7,0.4965133955506271,9
1065,46,13,98,6,0.49490167633736465,7
1066,16,16,20,9,0.4908471999413502,7
1067,88,12,18,6,0.4864002858281218,6
1068,32,10,94,5,0.4833955664376234,5
1069,26,39,41,23,0.47541624975842567,16
1070,84,63,28,31,0.46525517642245834,32
1071,2,19,88,9,0.45627885372645166,10
1072,98,16,58,9,0.45407364718622145,7
1073,23,37,103,19,0.4333042786770564,18
1074,26,11,50,6,0.4324180875363533,5
1075,98,33,93,16,0.424948144003004,17
1076,9,41,98,18,0.42442483569339234,23
1077,109,14,79,7,0.42130275303052606,7
1078,98,66,79,35,0.40981872886822335,31
1079,93,16,55,8,0.39897461255756284,8
1080,41,13,85,6,0.3897097634286908,7
1081,44,10,50,5,0.3704918139841162,5
1082,86,19,6,9,0.36002907163375564,10
1083,49,17,91,9,0.32854883058107165,8
1084,98,31,90,16,0.3081362679703139,15
1085,19,14,41,8,0.3076861914893786,6
1086,2,23,30,12,0.29321348863964763,11
1087,65,32,86,16,0.292161429870751,16
1088,98,58,28,30,0.26969658883824965,28
1089,34,20,9,10,0.25268208409127835,10
1090,103,28,38,14,0.24815234764151997,14
1091,57,10,54,5,0.24120401170219807,5
1092,66,20,9,10,0.2394553367054245,10
1093,85,10,66,5,0.23847533791686662,5
1094,70,19,37,9,0.2315184763340002,10
1095,8,42,88,20,0.21289914554912653,22
1096,55,47,28,21,0.2032823609872518,26
1097,29,36,41,18,0.19641039337775978,18
1098,5,14,28,8,0.1909309431837826,6
1099,30,18,18,8,0.1880919802776321,10
1100,30,32,20,17,0.18006835825974649,15
1101,18,25,54,13,0.17269825689702542,12
1102,26,19,2,10,0.15549736717272822,9
1103,32,18,50,10,0.14361277931057773,8
1104,107,35,103,17,0.13970070555149214,18
1105,74,20,37,10,0.13515130121839292,10
1106,6,29,41,15,0.09412754772533743,14
1107,13,22,98,9,0.08977817869064623,13
1108,38,15,110,8,0.07451058664372237,7
1109,8,18,85,10,0.05579820159953483,8
1110,23,26,111,12,0.03864525196536135,14
1111,85,24,79,13,0.03480555903893171,11
1112,13,13,111,6,0.03396852683521152,7
1113,73,27,65,13,0.03310401758065548,14
1114,40,14,65,6,0.02213880190128984,8
1115,8,38,50,20,0.0026780543899760133,18
1116,37,15,38,8,0.001103123834968282,7
1117,38,15,37,7,-0.0011031238349704135,8
1118,65,14,40,8,-0.022138801901290386,6
1119,65,27,73,14,-0.03310401758065679,13
1120,79,50,103,24,-0.05775390300531349,26
1121,2,25,20,13,-0.061415201425745324,12
1122,110,15,38,7,-0.07451058664372263,8
1123,87,42,74,20,-0.07958529470361513,22
1124,84,47,103,22,-0.09369403051445656,25
1125,41,29,6,14,-0.09412754772533768,15
1126,43,19,20,10,-0.09655439021695482,9
1127,28,61,2,31,-0.13470852705824435,30
1128,8,23,43,12,-0.1348626033575063,11
1129,37,20,74,10,-0.13515130121839344,10
1130,8,87,65,40,-0.1421669169817261,47
1131,111,25,30,13,-0.1455874148715972,12
1132,54,25,18,12,-0.17269825689702573,13
1133,28,50,74,24,-0.17793202645056777,26
1134,20,32,30,15,-0.18006835825974682,17
1135,17,19,74,10,-0.18384205614173707,9
1136,18,18,30,10,-0.18809198027763255,8
1137,28,14,5,6,-0.19093094318378231,8
1138,88,42,8,22,-0.21289914554912737,20
1139,79,38,91,20,-0.22211474912049844,18
1140,2,30,74,16,-0.2222710450639769,14
1141,91,21,84,10,-0.2259849974893271,11
1142,37,19,70,10,-0.23151847633400094,9
1143,66,10,85,5,-0.23847533791686643,5
1144,9,20,66,10,-0.23945533670542468,10
1145,54,10,57,5,-0.24120401170219843,5
1146,38,28,103,14,-0.24815234764152064,14
1147,86,32,65,16,-0.2921614298707511,16
1148,30,23,2,11,-0.2932134886396476,12
1149,41,14,19,6,-0.30768619148937965,8
1150,91,17,49,8,-0.3285488305810701,9
1151,43,16,98,8,-0.3349193292480861,8
1152,54,21,48,12,-0.3530248887429264,9
1153,6,19,86,10,-0.3600290716337568,9
1154,50,10,44,5,-0.3704918139841169,5
1155,90,30,65,14,-0.3773068188418704,16
1156,85,13,41,7,-0.3897097634286908,6
1157,8,69,111,33,-0.3967837192963415,36
1158,55,16,93,8,-0.39897461255756195,8
1159,79,14,109,7,-0.4213027530305255,7
1160,98,41,9,23,-0.42442483569339234,18
1161,93,33,98,17,-0.42494814400300385,16
1162,28,59,79,33,-0.4362251578495623,26
1163,51,22,28,11,-0.4444684300651225,11
1164,88,19,2,10,-0.45627885372645144,9
1165,28,63,84,32,-0.46525517642245906,31
1166,94,10,32,5,-0.48339556643762405,5
1167,18,12,88,6,-0.4864002858281218,6
1168,55,25,107,12,-0.49082237211228874,13
1169,98,13,46,7,-0.4949016763373632,6
1170,112,16,87,9,-0.49651339555062735,7
1171,2,32,54,17,-0.49725687334611246,15
1172,73,13,91,8,-0.5133686150476453,5
1173,20,23,110,11,-0.5195268671329497,12
1174,84,64,8,32,-0.5227079278201219,32
1175,86,18,90,8,-0.5309843322728077,10
1176,41,13,66,6,-0.534743534153634,7
1177,49,22,107,12,-0.5403853948936628,10
1178,62,22,2,12,-0.5462872756743612,10
1179,37,18,10,10,-0.546815604170652,8
1180,111,17,89,8,-0.5563633904658417,9
1181,84,41,6,21,-0.5685620720746399,20
1182,91,26,54,11,-0.5702688984859546,15
1183,8,50,70,24,-0.5792404511939312,26
1184,103,18,48,9,-0.5903706399248498,9
1185,101,20,98,9,-0.594870864776421,11
1186,23,33,79,18,-0.5991196107820883,15
1187,38,18,62,9,-0.6043816495722321,9
1188,29,22,55,10,-0.6081230859687882,12
1189,87,32,2,17,-0.6092720590189474,15
1190,44,18,91,10,-0.6160976329615482,8
1191,63,13,74,7,-0.623193843506212,6
1192,48,21,10,10,-0.63141463174424,11
1193,41,39,74,18,-0.6406425090111568,21
1194,30,10,32,5,-0.6490824873820863,5
1195,6,19,46,9,-0.6560730930479025,10
1196,29,20,103,10,-0.657814486383537,10
1197,48,15,88,6,-0.6584132572102235,9
1198,20,13,76,6,-0.6610311160325513,7
1199,93,24,6,12,-0.6627629968980052,12
1200,86,23,91,12,-0.6661452371008979,11
1201,10,17,90,8,-0.6720080859782255,9
1202,16,12,44,5,-0.6740631728235359,7
1203,101,15,23,7,-0.6750621504160516,8
1204,8,64,84,33,-0.6829085676002634,31
1205,65,12,51,6,-0.7082823610974577,6
1206,28,43,86,24,-0.7167553120703375,19
1207,32,24,87,11,-0.7236548346311588,13
1208,74,42,87,23,-0.7245745938864449,19
1209,74,17,50,9,-0.7251672527310536,8
1210,62,18,6,8,-0.7348526325115916,10
1211,65,31,104,18,-0.735151046717163,13
1212,23,23,107,12,-0.7397315330825462,11
1213,73,11,37,6,-0.7437455399697732,5
1214,104,10,90,4,-0.7461340238107393,6
1215,84,46,74,24,-0.7518721095348192,22
1216,65,21,85,12,-0.7821322420670087,9
1217,74,17,85,9,-0.809559849760586,8
1218,98,47,70,24,-0.8130313901104019,23
1219,48,34,9,16,-0.8138314912844782,18
1220,10,23,87,13,-0.8212452099335937,10
1221,70,27,54,13,-0.8260404525362534,14
1222,55,11,57,5,-0.8315236951519567,6
1223,91,21,29,10,-0.8357535316372875,11
1224,32,17,49,9,-0.8453605230907149,8
1225,75,18,8,9,-0.8583987416596399,9
1226,38,18,91,10,-0.8605561818804551,8
1227,79,12,5,5,-0.8638337222987263,7
1228,18,12,29,5,-0.8741742779448153,7
1229,65,21,62,12,-0.8755953834255744,9
1230,29,26,6,13,-0.8939970404365927,13
1231,98,42,17,22,-0.8967649107571658,20
1232,93,30,20,17,-0.8968767950978309,13
1233,111,29,18,15,-0.9151185639276502,14
1234,9,11,60,5,-0.9156618531106767,6
1235,89,12,103,7,-0.9245541578032412,5
1236,16,16,51,9,-0.9254181289183405,7
1237,9,19,85,11,-0.9266510351352117,8
1238,8,72,28,37,-0.93689049737244,35
1239,30,11,48,6,-0.9383914724110473,5
1240,107,23,93,12,-0.9535678875740112,11
1241,50,12,6,6,-0.9593349652988957,6
1242,15,11,10,5,-0.9620268464624157,6
1243,16,10,68,5,-0.9723777343104949,5
1244,68,16,111,9,-0.9831903657031018,7
1245,30,16,41,8,-0.9850557086878995,8
1246,91,23,20,11,-0.9903622576025464,12
1247,94,11,79,6,-0.9998691980070007,5
1248,41,33,70,17,-1.0073100144887743,16
1249,41,13,75,7,-1.016068271522889,6
1250,86,27,48,14,-1.0300347247258346,13
1251,76,28,9,14,-1.034161557811219,14
1252,103,10,75,5,-1.0351884603570845,5
1253,62,16,74,7,-1.0383577563740096,9
1254,86,46,79,24,-1.0425261635108967,22
1255,2,32,87,16,-1.0461530255566567,16
1256,91,13,17,7,-1.0470112494614043,6
1257,89,13,6,6,-1.048764081963461,7
1258,79,66,98,32,-1.0629583697982095,34
1259,103,15,76,9,-1.0648910249315904,6
1260,88,29,28,16,-1.0651097674029273,13
1261,35,10,48,5,-1.069537442846417,5
1262,73,20,103,10,-1.0728746625988095,10
1263,62,14,91,7,-1.0834634078291792,7
1264,28,16,73,7,-1.1026015831683802,9
1265,56,10,16,6,-1.1063673005412127,4
1266,62,20,88,10,-1.1096322170107613,10
1267,88,22,23,12,-1.1194514842315584,10
1268,107,25,54,13,-1.1450631376312903,12
1269,34,18,50,8,-1.1483521913828936,10
1270,41,80,65,38,-1.1627117143876546,42
1271,28,72,8,37,-1.171659348885591,35
1272,111,26,10,14,-1.1728080892005104,12
1273,1,10,103,4,-1.1782289624807345,6
1274,63,10,111,5,-1.1830016075807712,5
1275,84,31,107,16,-1.1883174819228028,15
1276,111,49,98,25,-1.197194144617747,24
1277,107,36,111,18,-1.197825708062549,18
1278,55,24,49,10,-1.2120144426699921,14
1279,107,31,84,16,-1.2210869288992976,15
1280,2,49,79,26,-1.2271248327335258,23
1281,84,20,51,11,-1.2338435261234784,9
1282,96,11,79,5,-1.2340245916617498,6
1283,86,53,8,28,-1.2344403994491575,25
1284,91,28,107,14,-1.243507965011968,14
1285,84,36,87,19,-1.2473160473972869,17
1286,65,30,17,15,-1.259770189656463,15
1287,79,79,65,40,-1.2733529782356952,39
1288,98,27,48,14,-1.289684903590688,13
1289,107,18,10,10,-1.3026419982744992,8
1290,110,15,87,8,-1.3076573931351636,7
1291,74,31,20,16,-1.307808889025343,15
1292,103,47,84,26,-1.3117535282727086,21
1293,57,13,98,6,-1.3243405021868555,7
1294,65,70,84,35,-1.3269531130271408,35
1295,32,14,23,6,-1.3629901576062284,8
1296,59,16,41,9,-1.3704315284875377,7
1297,23,15,76,7,-1.3791825091008156,8
1298,8,13,44,8,-1.3823607495686774,5
1299,85,13,54,6,-1.3987454013140734,7
1300,86,21,50,12,-1.3996923807256954,9
1301,15,18,54,9,-1.402367436616194,9
1302,48,30,76,16,-1.405190282699336,14
1303,84,61,79,32,-1.4093829554241022,29
1304,111,31,88,17,-1.4213124620809834,14
1305,3,10,65,5,-1.4258252923515944,5
1306,65,80,41,44,-1.4259190406310238,36
1307,75,14,111,6,-1.4265352540751048,8
1308,107,23,18,13,-1.4296389206294293,10
1309,28,24,62,14,-1.430081518616344,10
1310,112,11,109,6,-1.4303792106135098,5
1311,57,10,103,4,-1.4334929374709364,6
1312,20,13,90,6,-1.4684862703100567,7
1313,9,39,37,21,-1.478823674814808,18
1314,89,16,98,8,-1.5011020579783834,8
1315,85,12,103,7,-1.505235765059642,5
1316,74,50,28,27,-1.5230965628089248,23
1317,38,12,85,6,-1.5317416798467203,6
1318,6,18,62,11,-1.5340589440321633,7
1319,86,26,107,14,-1.5423744984021206,12
1320,41,12,106,6,-1.5589796315432078,6
1321,8,24,34,11,-1.5596726153138445,13
1322,16,18,50,9,-1.5602090710005825,9
1323,94,11,2,6,-1.5668479197841136,5
1324,29,16,16,9,-1.5836522711306946,7
1325,79,16,57,9,-1.6225267683647044,7
1326,87,44,111,23,-1.6417891706507615,21
1327,10,50,79,29,-1.6576142605157744,21
1328,23,18,57,10,-1.6948872060166476,8
1329,28,37,30,20,-1.6951481350285025,17
1330,18,13,20,7,-1.6987680426823801,6
1331,76,11,38,6,-1.6999072226365504,5
1332,45,10,76,5,-1.7263356630732798,5
1333,16,16,29,8,-1.7271978980205145,8
1334,70,19,9,9,-1.7325740605828874,10
1335,75,13,87,6,-1.7332300811803272,7
1336,38,15,106,8,-1.7348192516378875,7
1337,103,29,16,15,-1.7358551004647156,14
1338,65,18,71,9,-1.7385086790308797,9
1339,38,35,107,18,-1.7434138897292963,17
1340,28,10,14,6,-1.7716963626456927,4
1341,13,12,107,6,-1.776140157067621,6
1342,109,10,57,6,-1.7866317267766731,4
1343,41,10,94,5,-1.7939224836809735,5
1344,76,13,85,8,-1.8000085206097012,5
1345,18,11,85,7,-1.8067340182792158,4
1346,10,26,111,13,-1.8148533802188944,13
1347,84,19,90,10,-1.8307456952070524,9
1348,79,12,35,7,-1.8379035956261862,5
1349,107,23,90,11,-1.8399920811097403,12
1350,98,19,73,10,-1.8513717297876133,9
1351,8,67,98,36,-1.8537292484745949,31
1352,112,17,54,9,-1.8715662937888333,8
1353,30,21,74,10,-1.8748715955653097,11
1354,49,27,84,14,-1.8786207304912834,13
1355,88,18,91,10,-1.88786606053127,8
1356,51,11,104,6,-1.8967247284241915,5
1357,103,14,70,8,-1.9027941936339918,6
1358,61,11,41,6,-1.9034780148497878,5
1359,111,42,84,24,-1.9043195084453177,18
1360,17,10,76,6,-1.9048948605365954,4
1361,16,35,48,18,-1.9177064489155928,17
1362,37,22,6,11,-1.9187411338779703,11
1363,73,22,87,11,-1.9187809773134357,11
1364,13,20,65,9,-1.9236367618157124,11
1365,6,24,76,12,-1.9379440444479508,12
1366,37,37,28,20,-1.9409348825611623,17
1367,13,10,87,6,-1.9417659717514852,4
1368,65,33,37,18,-1.9483360284193352,15
1369,65,87,8,49,-1.9561397360340669,38
1370,23,18,54,10,-1.9726565822582236,8
1371,29,11,49,7,-1.979211902956338,4
1372,37,13,103,7,-1.9837820518429903,6
1373,41,16,34,9,-1.984665451993842,7
1374,71,10,37,6,-1.9896037058196856,4
1375,74,55,98,28,-2.008567476708279,27
1376,9,30,10,15,-2.0135222581265255,15
1377,87,30,23,17,-2.0171902524743803,13
1378,74,17,90,9,-2.0301353599309766,8
1379,26,14,73,8,-2.0368384601286893,6
1380,98,52,38,28,-2.049865770355223,24
1381,26,30,9,17,-2.0528879968491363,13
1382,10,18,91,10,-2.0539203960339116,8
1383,34,15,6,7,-2.059469865894372,8
1384,84,19,32,11,-2.0621508690380304,8
1385,104,16,9,9,-2.074620642084023,7
1386,48,19,13,12,-2.0777118977088533,7
1387,90,17,74,9,-2.084849422931559,8
1388,84,18,75,10,-2.0937199255326187,8
1389,73,14,55,7,-2.1000754331910434,7
1390,1,11,84,6,-2.1264466771262818,5
1391,104,18,16,10,-2.1264699523202073,8
1392,46,19,6,11,-2.1320112599215366,8
1393,1,15,87,7,-2.13863269092095,8
1394,98,22,13,14,-2.1425027644706,8
1395,37,56,84,29,-2.145008221172732,27
1396,17,42,98,22,-2.156040262361809,20
1397,32,10,18,5,-2.1572241092213504,5
1398,84,39,50,20,-2.157245238611272,19
1399,15,11,9,6,-2.1575516880448595,5
1400,107,40,98,22,-2.1579093706359767,18
1401,28,19,44,12,-2.1816767204067156,7
1402,86,34,54,18,-2.187612017738008,16
1403,65,62,87,34,-2.2105235873065783,28
1404,65,30,90,17,-2.2173212695918405,13
1405,54,15,73,8,-2.217586045542845,7
1406,58,11,8,5,-2.225895511877215,6
1407,55,30,84,16,-2.2432370502927106,14
1408,20,15,17,7,-2.2513060993546468,8
1409,32,18,62,9,-2.2636867699003296,9
1410,103,37,23,19,-2.3239729626949774,18
1411,29,39,65,23,-2.3260339041967426,16
1412,86,11,104,6,-2.331276784740784,5
1413,6,21,112,11,-2.341862816288462,10
1414,16,14,63,7,-2.350075344901066,7
1415,111,69,8,39,-2.3517155925044597,30
1416,43,23,41,13,-2.365299496779167,10
1417,107,21,16,11,-2.3719183322672883,10
1418,35,18,76,11,-2.402343332528309,7
1419,57,16,79,8,-2.4270888358529503,8
1420,50,16,18,8,-2.435107533000619,8
1421,6,33,9,18,-2.442634272815348,15
1422,79,24,85,12,-2.4487159616702985,12
1423,38,40,41,21,-2.453560318141292,19
1424,93,13,16,7,-2.460583316835967,6
1425,9,44,103,21,-2.4769487250437607,23
1426,29,20,2,11,-2.477941203005174,9
1427,62,15,37,8,-2.478947668963919,7
1428,107,29,74,16,-2.4812045730116727,13
1429,62,17,16,9,-2.488474068439887,8
1430,55,21,48,12,-2.5104777887781684,9
1431,98,50,16,28,-2.519721323050921,22
1432,29,19,50,11,-2.5251415163545503,8
1433,54,52,98,26,-2.5290154991382803,26
1434,70,33,41,17,-2.5290882561404575,16
1435,34,11,23,5,-2.5306742696464295,6
1436,88,12,50,6,-2.55945605085457,6
1437,109,25,2,15,-2.564163534371066,10
1438,107,25,55,15,-2.584454892774177,10
1439,65,37,76,21,-2.5854509487365775,16
1440,112,20,38,11,-2.587558109977975,9
1441,50,11,70,5,-2.6267029004174307,6
1442,111,26,23,15,-2.6303992386646597,11
1443,107,13,30,8,-2.6326975250966638,5
1444,107,12,85,8,-2.6471438550645616,4
1445,30,25,111,13,-2.652873615194803,12
1446,65,39,107,23,-2.657495022575689,16
1447,8,14,15,7,-2.6593953269851665,7
1448,88,20,86,12,-2.6598697754609466,8
1449,98,49,111,27,-2.6617844500730894,22
1450,111,13,43,8,-2.669621436422116,5
1451,43,17,107,9,-2.6703875258201832,8
1452,9,71,84,41,-2.6774235660559245,30
1453,90,39,79,23,-2.6906940404909045,16
1454,20,39,54,22,-2.7051443867414044,17
1455,28,29,90,16,-2.7096269258470884,13
1456,50,38,8,20,-2.71668433740919,18
1457,87,25,62,14,-2.7185367714166673,11
1458,91,20,16,11,-2.721458273562552,9
1459,10,30,9,17,-2.7255115724135353,13
1460,30,14,26,5,-2.7295268644643036,9
1461,29,14,23,8,-2.7325720738957813,6
1462,28,21,34,12,-2.7346627104082093,9
1463,90,31,98,16,-2.7353689958599143,15
1464,79,49,2,26,-2.737321151823357,23
1465,28,30,29,16,-2.741726893835182,14
1466,79,50,10,24,-2.746120922049539,26
1467,87,66,8,37,-2.751858433815085,29
1468,65,52,55,32,-2.7542384607166843,20
1469,10,11,88,6,-2.758720835436875,5
1470,86,33,98,19,-2.783908924775316,14
1471,8,12,14,7,-2.800814824677635,5
1472,12,11,8,6,-2.800934387923014,5
1473,34,17,29,8,-2.8011697136542653,9
1474,107,15,63,9,-2.8021473545431546,6
1475,65,55,38,30,-2.8065899103574563,25
1476,17,30,65,17,-2.83677923729118,13
1477,16,35,23,19,-2.8430887250810795,16
1478,16,36,54,19,-2.847205712046724,17
1479,18,29,111,16,-2.8594971088993884,13
1480,65,47,6,23,-2.865509863062411,24
1481,29,31,98,16,-2.8666453310461546,15
1482,13,11,55,6,-2.8675322125133507,5
1483,28,15,46,8,-2.8691534505866363,7
1484,111,30,90,17,-2.890544713054332,13
1485,88,77,65,43,-2.8960920467660296,34
1486,20,23,91,13,-2.9131035181283305,10
1487,87,10,68,5,-2.918596255497213,5
1488,48,18,18,10,-2.918693386089228,8
1489,41,36,29,19,-2.9244119186735795,17
1490,54,44,74,22,-2.926291357510125,22
1491,107,22,49,11,-2.9383230402282323,11
1492,76,15,23,9,-2.9404074687313466,6
1493,89,16,26,8,-3.001544109167066,8
1494,16,57,79,32,-3.014693104894056,25
1495,8,11,12,6,-3.0172474302588044,5
1496,16,18,38,9,-3.0174584469144006,9
1497,54,58,8,31,-3.0346389332169545,27
1498,28,53,111,29,-3.0373034434579136,24
1499,44,14,9,6,-3.041897922279978,8
1500,10,18,107,9,-3.0501937161720885,9
1501,50,36,28,20,-3.0818186059352044,16
1502,28,34,48,20,-3.0997207494719903,14
1503,79,56,41,30,-3.107212943723593,26
1504,50,27,54,16,-3.1075162747982175,11
1505,17,15,20,9,-3.1232806552580397,6
1506,88,29,79,18,-3.1248766251928926,11
1507,8,41,6,23,-3.126747383790504,18
1508,98,10,106,6,-3.1299996913347954,4
1509,38,36,79,20,-3.1386740959807873,16
1510,48,26,87,14,-3.143928347009626,12
1511,90,10,1,5,-3.1488203588125634,5
1512,37,13,91,7,-3.1893915884876454,6
1513,41,17,88,9,-3.1907658333962923,8
1514,86,19,23,10,-3.2169168727971034,9
1515,26,37,79,21,-3.222410339322389,16
1516,85,11,49,6,-3.234049059231718,5
1517,87,15,1,9,-3.2359540636917368,6
1518,18,15,76,9,-3.237191989649945,6
1519,6,24,93,13,-3.2407027788328717,11
1520,54,21,49,10,-3.2515113788114705,11
1521,98,11,59,6,-3.2664563544762375,5
1522,85,18,8,9,-3.274345405108024,9
1523,85,17,74,9,-3.280838878179328,8
1524,46,11,10,6,-3.290581679590814,5
1525,76,12,104,6,-3.296017349449059,6
1526,79,59,28,29,-3.3058491126483527,30
1527,74,27,26,15,-3.318872656585855,12
1528,18,23,107,12,-3.3296591016307513,11
1529,84,21,91,12,-3.3334541794660995,9
1530,28,22,51,12,-3.3441861551037473,10
1531,8,26,29,14,-3.355791507675689,12
1532,23,20,91,11,-3.361881304895745,9
1533,84,36,54,21,-3.3687833567687124,15
1534,85,14,2,7,-3.3798876085075142,7
1535,13,14,76,7,-3.383197454645705,7
1536,91,14,57,9,-3.3879171437646898,5
1537,37,57,79,33,-3.3937774135660437,24
1538,28,32,32,18,-3.393781274624459,14
1539,37,32,48,17,-3.397336876678578,15
1540,6,12,57,8,-3.4000169565132445,4
1541,93,14,86,8,-3.4204184268194164,6
1542,91,10,5,4,-3.4255398118724543,6
1543,8,18,51,10,-3.451831063610331,8
1544,6,12,50,7,-3.455131926902719,5
1545,20,31,74,17,-3.4627659895235956,14
1546,91,12,48,7,-3.46642975947252,5
1547,76,21,111,10,-3.4688639491076154,11
1548,107,28,91,16,-3.470162400396322,12
1549,55,14,1,8,-3.472860068937087,6
1550,55,10,51,6,-3.478851515612335,4
1551,91,38,79,20,-3.4922631180595523,18
1552,41,49,16,26,-3.501070366837179,23
1553,10,60,8,32,-3.504088258858783,28
1554,18,55,28,30,-3.5048718464168527,25
1555,94,13,65,7,-3.5056909876146594,6
1556,26,33,111,19,-3.5276889460712026,14
1557,8,28,73,17,-3.5539511566695925,11
1558,55,35,79,18,-3.559481738507642,17
1559,38,25,50,14,-3.5687465201033155,11
1560,23,15,101,9,-3.591604516250615,6
1561,79,31,54,17,-3.598774057688572,14
1562,18,12,10,8,-3.6042571144804323,4
1563,48,21,54,10,-3.616041819529222,11
1564,10,40,2,23,-3.6379676405873065,17
1565,93,18,88,8,-3.642215672169972,10
1566,73,22,20,12,-3.652177447468763,10
1567,65,17,57,11,-3.662004607965262,6
1568,65,12,106,7,-3.663753693390405,5
1569,89,14,48,8,-3.663870491648269,6
1570,84,19,30,10,-3.6645394021317808,9
1571,10,14,32,9,-3.7090564967402346,5
1572,87,10,60,5,-3.7162194902768513,5
1573,38,22,84,13,-3.7215580721113835,9
1574,41,16,48,9,-3.7233952099256964,7
1575,37,24,87,12,-3.7376369474443716,12
1576,10,34,65,19,-3.7403807843221344,15
1577,28,69,65,39,-3.7517616974630035,30
1578,88,31,55,19,-3.7522592797042997,12
1579,18,12,57,8,-3.752545373450189,4
1580,28,47,55,28,-3.7714851181849904,19
1581,73,15,79,8,-3.7804037585321253,7
1582,110,11,26,5,-3.781495457699161,6
1583,103,12,110,7,-3.7849274590311146,5
1584,49,21,54,13,-3.7888260480165687,8
1585,18,15,93,8,-3.800055574547406,7
1586,98,16,43,9,-3.81237055891473,7
1587,49,16,79,10,-3.8231693458837075,6
1588,20,14,37,8,-3.824098686874733,6
1589,91,14,32,7,-3.8253106560348433,7
1590,29,21,91,12,-3.8408205117269745,9
1591,18,18,41,11,-3.843661029321533,7
1592,49,14,38,7,-3.855128614080587,7
1593,86,20,51,11,-3.863362217006626,9
1594,50,10,20,6,-3.8664231910700964,4
1595,17,11,55,6,-3.884041039360635,5
1596,84,47,98,26,-3.8908337456526523,21
1597,2,61,28,34,-3.897126831060739,27
1598,2,26,91,15,-3.8971597312680064,11
1599,54,16,94,8,-3.8978006398785654,8
1600,9,30,26,15,-3.917115924375873,15
1601,74,22,43,13,-3.9345782455697655,9
1602,112,10,91,5,-3.9467548682802898,5
1603,73,22,6,11,-3.9476996189213893,11
1604,111,13,13,8,-3.9528063724151234,5
1605,8,40,91,21,-3.9619458521379896,19
1606,20,20,112,10,-3.9655619093439776,10
1607,74,29,16,17,-3.9743417346866288,12
1608,26,14,55,8,-3.9805474058369086,6
1609,74,30,2,16,-4.002224854294571,14
1610,79,33,23,17,-4.005580416521509,16
1611,103,50,79,29,-4.028559233170848,21
1612,28,58,98,31,-4.030600698284188,27
1613,88,11,10,6,-4.031418867789046,5
1614,2,19,26,10,-4.0418718843206785,9
1615,85,16,98,8,-4.042048861968952,8
1616,98,23,109,13,-4.043112033025349,10
1617,10,32,16,18,-4.051397029804461,14
1618,87,30,16,17,-4.057897699416059,13
1619,9,36,2,19,-4.083891693569191,17
1620,98,39,37,22,-4.1167759789071035,17
1621,10,16,103,9,-4.145748166667439,7
1622,2,15,37,8,-4.147220527730263,7
1623,91,23,65,11,-4.15010120900015,12
1624,48,15,63,8,-4.152796736858186,7
1625,2,61,98,34,-4.158496116358835,27
1626,32,16,2,9,-4.1690776359664925,7
1627,30,25,79,13,-4.173850580469615,12
1628,9,26,62,15,-4.2000680987118795,11
1629,37,37,16,23,-4.211147077007785,14
1630,91,14,109,7,-4.213752581267598,7
1631,8,24,104,15,-4.217796324401937,9
1632,90,18,86,11,-4.223509495637678,7
1633,6,24,23,13,-4.230313442640464,11
1634,79,47,6,27,-4.237391580830745,20
1635,8,11,97,7,-4.238412616249602,4
1636,49,13,18,7,-4.243576516469458,6
1637,98,39,6,23,-4.250381101594535,16
1638,46,24,74,12,-4.250765743447535,12
1639,55,44,111,24,-4.253083069824158,20
1640,103,35,107,20,-4.274205878998454,15
1641,48,15,85,9,-4.3053632687921874,6
1642,84,22,57,13,-4.307342730462732,9
1643,41,39,26,18,-4.308213459712551,21
1644,1,20,41,13,-4.310885836842605,7
1645,90,13,20,8,-4.319530234657453,5
1646,26,27,74,15,-4.321080857814055,12
1647,3,17,54,9,-4.336905078418535,8
1648,44,13,79,7,-4.356415433762267,6
1649,2,11,57,7,-4.360321050424324,4
1650,107,43,87,26,-4.366588065151465,17
1651,94,11,87,6,-4.3750154371421806,5
1652,1,10,90,6,-4.3756010976452,4
1653,89,13,54,8,-4.375934710162816,5
1654,104,15,107,9,-4.384096889948015,6
1655,41,36,50,20,-4.391684068139686,16
1656,50,11,75,7,-4.392668801200933,4
1657,41,36,84,22,-4.405400183867788,14
1658,20,19,43,10,-4.407702920435086,9
1659,103,20,73,11,-4.408542656876497,9
1660,13,10,90,5,-4.435057658973371,5
1661,2,18,90,10,-4.440452857575476,8
1662,58,16,98,8,-4.454073647186222,8
1663,84,23,73,15,-4.463513313785123,8
1664,110,23,20,13,-4.463579786935514,10
1665,15,25,111,15,-4.472513123100849,10
1666,29,21,111,10,-4.484029622528667,11
1667,16,31,55,18,-4.485374733499428,13
1668,93,21,29,12,-4.498959392246702,9
1669,62,11,29,6,-4.502398822563132,5
1670,93,28,79,14,-4.5038976407776365,14
1671,23,40,41,23,-4.507259861409944,17
1672,93,29,111,15,-4.510765206652462,14
1673,85,11,18,5,-4.514791288537015,6
1674,74,15,32,9,-4.51940474758212,6
1675,109,26,65,13,-4.522732343847652,13
1676,23,24,74,13,-4.530539923458647,11
1677,51,10,2,5,-4.541060117126742,5
1678,98,43,20,25,-4.552220105497901,18
1679,57,15,87,8,-4.552409972912951,7
1680,89,20,9,13,-4.555028073124961,7
1681,37,13,46,7,-4.568700097838745,6
1682,8,60,74,34,-4.573820893582633,26
1683,86,49,84,27,-4.577240119007236,22
1684,49,19,28,12,-4.587943557807989,7
1685,16,60,28,34,-4.590998298731022,26
1686,15,10,86,5,-4.603054673648835,5
1687,54,27,87,15,-4.613822779482279,12
1688,9,49,111,26,-4.631532876714528,23
1689,2,20,29,11,-4.659724574406303,9
1690,9,76,79,43,-4.699969329384484,33
1691,29,35,87,20,-4.710088352572669,15
1692,93,19,109,11,-4.710552248323457,8
1693,9,30,90,17,-4.717832744642905,13
1694,106,13,8,7,-4.770713481148754,6
1695,65,41,23,23,-4.770740161452318,18
1696,28,37,23,21,-4.773448036217733,16
1697,2,61,8,33,-4.776225618469153,28
1698,104,10,111,6,-4.78538385386757,4
1699,20,12,13,8,-4.788358918637377,4
1700,103,33,50,19,-4.78996402404816,14
1701,30,11,17,6,-4.793161472453949,5
1702,18,11,86,6,-4.795064637153177,5
1703,88,22,87,14,-4.796769422048845,8
1704,48,46,8,26,-4.828884672158708,20
1705,13,13,103,7,-4.8357100666968185,6
1706,111,60,79,36,-4.845673626000183,24
1707,98,25,30,16,-4.8490813722869355,9
1708,20,30,93,15,-4.900735470483159,15
1709,5,11,65,6,-4.901615377921411,5
1710,70,23,28,12,-4.906318270343948,11
1711,20,51,87,29,-4.928957222630356,22
1712,6,15,34,9,-4.930033055320858,6
1713,103,11,46,6,-4.93491443987304,5
1714,20,37,111,20,-4.947955914179008,17
1715,111,36,107,21,-4.951406357885075,15
1716,59,10,10,5,-4.967497448599425,5
1717,86,20,41,11,-4.968122887256161,9
1718,20,10,89,6,-4.976403038151203,4
1719,54,17,62,10,-5.00163311569191,7
1720,32,20,55,12,-5.010948173246778,8
1721,84,15,89,10,-5.015269353437401,5
1722,1,17,16,9,-5.031673674933398,8
1723,43,13,111,7,-5.032790373684628,6
1724,54,58,65,32,-5.034371936668328,26
1725,73,20,16,11,-5.070658783374493,9
1726,41,16,59,9,-5.075333393683096,7
1727,49,17,32,9,-5.0842321804698765,8
1728,18,21,103,12,-5.117263308095353,9
1729,89,29,41,17,-5.128070897369616,12
1730,17,12,54,7,-5.132650672697671,5
1731,32,12,20,7,-5.135866792699634,5
1732,20,47,8,28,-5.136967124031452,19
1733,87,26,103,15,-5.138443373092134,11
1734,52,10,98,5,-5.141825899051739,5
1735,57,15,16,8,-5.174682414292547,7
1736,84,39,23,22,-5.174802875601991,17
1737,57,10,111,6,-5.186942618450885,4
1738,86,36,9,20,-5.188225565384638,16
1739,88,24,107,13,-5.199282803734947,11
1740,9,106,65,61,-5.210618625384625,45
1741,8,22,30,14,-5.213064512809201,8
1742,9,30,55,19,-5.23448912727696,11
1743,111,10,1,5,-5.2389835373250895,5
1744,65,71,93,41,-5.253531432442063,30
1745,89,12,50,7,-5.253704218444127,5
1746,85,15,63,8,-5.266282773446657,7
1747,2,33,50,20,-5.273652216296244,13
1748,9,45,87,26,-5.276968272081171,19
1749,103,30,17,18,-5.294404276815365,12
1750,16,20,90,11,-5.309705496674622,9
1751,79,36,50,20,-5.311051747194992,16
1752,71,14,84,8,-5.316384874786534,6
1753,8,23,90,14,-5.338168133162716,9
1754,84,21,29,12,-5.340667565501356,9
1755,6,13,89,8,-5.3628052160146265,5
1756,41,66,8,36,-5.383353261881383,30
1757,41,35,73,20,-5.413974250069209,15
1758,38,26,20,15,-5.42296232860249,11
1759,9,32,50,19,-5.426721633588277,13
1760,23,16,109,10,-5.438260955948293,6
1761,76,39,84,20,-5.438513858870128,19
1762,9,27,13,17,-5.440810272043138,10
1763,87,27,49,14,-5.45179203076274,13
1764,37,14,55,8,-5.456618910920279,6
1765,38,25,30,13,-5.459363326096931,12
1766,9,10,14,7,-5.463439437022663,3
1767,38,33,54,20,-5.464199343195873,13
1768,87,20,90,13,-5.46489906820685,7
1769,49,13,93,7,-5.465162375246018,6
1770,15,15,65,8,-5.468158414216743,7
1771,87,10,89,6,-5.494352199749724,4
1772,73,21,74,12,-5.496437468937686,9
1773,85,12,107,5,-5.501246863309677,7
1774,107,75,8,43,-5.502573365722739,32
1775,34,16,107,9,-5.514558906998727,7
1776,28,33,20,21,-5.5355996241516525,12
1777,2,10,46,6,-5.5419061164561345,4
1778,97,11,28,5,-5.54697078214519,6
1779,98,31,87,19,-5.56520850280109,12
1780,48,14,49,7,-5.57204481361561,7
1781,55,24,103,14,-5.588813975862997,10
1782,48,33,6,19,-5.618170706899615,14
1783,57,11,86,6,-5.628641785626694,5
1784,29,22,26,14,-5.630548836449715,8
1785,20,25,6,13,-5.631661671252285,12
1786,87,12,104,8,-5.633009975820393,4
1787,48,16,2,8,-5.635246627200354,8
1788,9,45,41,28,-5.643905739728351,17
1789,6,26,103,16,-5.659939287843902,10
1790,50,13,17,8,-5.662435030700869,5
1791,91,29,111,16,-5.664784285354981,13
1792,91,16,63,9,-5.669548453730627,7
1793,9,13,43,7,-5.6825351087636395,6
1794,51,11,18,6,-5.697627847770078,5
1795,65,23,89,13,-5.729458742490654,10
1796,55,14,26,8,-5.738748859328652,6
1797,37,20,90,12,-5.74259061703688,8
1798,9,29,38,16,-5.756435186772359,13
1799,28,15,75,8,-5.767432508412404,7
1800,79,14,51,8,-5.772506691008205,6
1801,50,27,55,17,-5.7792084950418126,10
1802,54,18,32,11,-5.782610489553487,7
1803,8,13,63,8,-5.78828034754951,5
1804,73,14,26,7,-5.793757710550322,7
1805,94,12,8,7,-5.79404543544707,5
1806,76,40,86,22,-5.806686757195038,18
1807,8,37,37,21,-5.826102721509759,16
1808,44,10,2,6,-5.829723764491519,4
1809,10,31,98,18,-5.831587893507185,13
1810,48,10,107,6,-5.863597775104665,4
1811,16,17,17,10,-5.868342075872027,7
1812,9,45,74,27,-5.903246001506488,18
1813,2,32,84,19,-5.927588372496059,13
1814,112,20,20,12,-5.928531130259162,8
1815,30,21,91,11,-5.9422253465580255,10
1816,91,28,87,17,-5.954439761122967,11
1817,48,16,90,9,-5.955034351542386,7
1818,49,23,8,13,-5.962799116224747,10
1819,34,10,17,6,-5.970863859166936,4
1820,23,18,2,10,-5.985551573396108,8
1821,77,10,49,5,-6.002993751357136,5
1822,91,18,38,10,-6.003578716041364,8
1823,2,11,94,6,-6.010461250553627,5
1824,91,48,98,26,-6.010481139866049,22
1825,98,27,26,14,-6.028495429489335,13
1826,8,72,55,44,-6.055158512520881,28
1827,98,13,63,7,-6.056134732306879,6
1828,2,27,107,16,-6.062909258737931,11
1829,89,25,79,16,-6.066359313406782,9
1830,74,38,111,22,-6.07963192527118,16
1831,76,34,16,19,-6.088457653696345,15
1832,6,17,49,10,-6.097985660912413,7
1833,56,11,111,7,-6.133528731729066,4
1834,66,11,2,7,-6.205381429919992,4
1835,34,14,16,8,-6.2295567684996,6
1836,41,35,2,22,-6.231438093089561,13
1837,9,12,75,8,-6.239095019020705,4
1838,9,34,73,20,-6.26373423011622,14
1839,76,25,87,15,-6.268639154144934,10
1840,16,25,32,15,-6.270434527094817,10
1841,50,23,111,14,-6.2704577459608215,9
1842,44,15,111,9,-6.282001615200398,6
1843,54,16,90,9,-6.290244829620483,7
1844,79,74,8,41,-6.307718388585424,33
1845,16,62,8,38,-6.324271270247479,24
1846,111,30,2,18,-6.3285907665919945,12
1847,6,26,29,15,-6.336301719273395,11
1848,9,94,8,55,-6.337620731803163,39
1849,73,18,86,11,-6.340120760849843,7
1850,28,10,31,6,-6.368565836830035,4
1851,88,22,103,14,-6.368772240906126,8
1852,37,22,30,14,-6.384018768768751,8
1853,28,28,10,18,-6.393353899415193,10
1854,54,38,28,23,-6.41158418063417,15
1855,74,36,79,23,-6.418996516558227,13
1856,28,14,12,9,-6.429365216940008,5
1857,62,10,90,6,-6.441503246890596,4
1858,88,16,20,10,-6.450213485704794,6
1859,48,32,65,19,-6.477954122109948,13
1860,48,11,23,6,-6.485113687277618,5
1861,62,35,8,21,-6.490056401985648,14
1862,8,35,32,20,-6.49474128076034,15
1863,28,34,103,20,-6.496510604338202,14
1864,18,25,87,16,-6.50092107817753,9
1865,62,13,17,8,-6.511092288379042,5
1866,88,26,74,17,-6.51515117164633,9
1867,70,14,103,7,-6.530155528635714,7
1868,57,18,23,10,-6.535348935160996,8
1869,84,18,14,13,-6.539625119207458,5
1870,16,14,30,9,-6.557206782808548,5
1871,66,12,84,7,-6.578044154096634,5
1872,79,22,17,13,-6.594638264229068,9
1873,18,48,8,29,-6.594687381789503,19
1874,18,21,16,13,-6.6099594156094685,8
1875,76,20,107,12,-6.611819543573887,8
1876,55,18,74,10,-6.615183527938437,8
1877,85,14,86,7,-6.640232602185861,7
1878,76,41,79,26,-6.641927270209361,15
1879,49,15,17,9,-6.655321673670171,6
1880,34,23,98,15,-6.6646586704925195,8
1881,49,16,74,9,-6.6690338705922905,7
1882,9,24,18,14,-6.6693794387353345,10
1883,9,23,32,14,-6.676114746540041,9
1884,2,14,15,8,-6.681223250458031,6
1885,57,16,88,9,-6.6984703888039245,7
1886,62,18,79,10,-6.70668334197217,8
1887,74,11,89,6,-6.714017548400379,5
1888,34,19,2,11,-6.72965807263423,8
1889,32,24,65,14,-6.740147619373073,10
1890,41,42,111,24,-6.742879314894573,18
1891,50,36,98,20,-6.748525889961952,16
1892,54,17,46,11,-6.756375555864044,6
1893,28,38,6,23,-6.756711383632954,15
1894,28,46,87,28,-6.771264575755614,18
1895,20,25,2,14,-6.800156386602421,11
1896,41,35,91,22,-6.801656465480554,13
1897,6,21,88,13,-6.808639243885844,8
1898,91,26,6,15,-6.823132237906983,11
1899,70,16,30,10,-6.824605553405188,6
1900,28,38,38,22,-6.868784197702509,16
1901,63,10,88,6,-6.873409142660487,4
1902,16,11,15,7,-6.875773988595895,4
1903,74,12,57,8,-6.917604242425745,4
1904,17,14,90,8,-6.930186835428706,6
1905,79,19,29,11,-6.95160824378619,8
1906,68,10,73,6,-6.953949871021737,4
1907,50,27,107,17,-6.9782395727033855,10
1908,101,11,79,6,-6.990861425930868,5
1909,104,21,79,14,-7.001432407845649,7
1910,6,19,90,11,-7.003490622158197,8
1911,6,10,51,7,-7.003530037614209,3
1912,91,26,103,13,-7.011657257024816,13
1913,6,20,111,12,-7.018385668922464,8
1914,9,40,23,24,-7.0230661313434455,16
1915,79,19,59,11,-7.0352036880537785,8
1916,34,12,55,8,-7.041774709364915,4
1917,28,37,91,23,-7.047707205955757,14
1918,9,29,109,17,-7.05648741775532,12
1919,34,15,87,9,-7.057985714791878,6
1920,86,21,30,16,-7.0935474078618865,5
1921,62,14,104,9,-7.094567188746605,5
1922,89,16,16,10,-7.102664218068732,6
1923,20,14,86,8,-7.1180948372244535,6
1924,86,28,74,17,-7.1305410605737976,11
1925,103,20,29,12,-7.147753101442866,8
1926,32,16,103,10,-7.165401001930764,6
1927,6,38,54,26,-7.169885763488394,12
1928,6,11,5,7,-7.175117705775805,4
1929,98,40,23,25,-7.180366591070178,15
1930,87,21,70,13,-7.1887891444846215,8
1931,20,17,94,11,-7.2006491767087315,6
1932,34,13,111,7,-7.201437198359542,6
1933,29,19,54,13,-7.208882798727994,6
1934,6,29,55,20,-7.216182147698296,9
1935,76,19,10,11,-7.223608714939953,8
1936,49,13,30,8,-7.2285821938864965,5
1937,73,18,50,10,-7.2419399609571045,8
1938,103,49,98,31,-7.248745608369259,18
1939,88,24,84,15,-7.256956915758408,9
1940,38,14,88,8,-7.257573306252318,6
1941,93,46,8,29,-7.259434595610272,17
1942,112,12,28,7,-7.260189333899199,5
1943,9,46,54,28,-7.266385848091391,18
1944,86,19,10,12,-7.266452513785874,7
1945,73,10,30,6,-7.275241295919059,4
1946,70,15,23,9,-7.277989111704881,6
1947,68,24,8,14,-7.280502110476539,10
1948,94,16,9,9,-7.284482029205985,7
1949,41,44,87,25,-7.307077046689722,19
1950,10,21,54,13,-7.316914939103644,8
1951,10,23,89,14,-7.332600528276464,9
1952,103,16,10,9,-7.34175922383016,7
1953,87,22,38,14,-7.344861542182534,8
1954,65,14,43,8,-7.347774243596503,6
1955,84,28,20,18,-7.362780437625795,10
1956,111,10,63,6,-7.375087282658105,4
1957,8,12,94,7,-7.380839863701188,5
1958,28,24,13,16,-7.385148355874101,8
1959,65,80,20,50,-7.401837775451881,30
1960,5,15,98,9,-7.403088174401654,6
1961,38,14,32,9,-7.40322551749003,5
1962,49,13,41,9,-7.40613906742907,4
1963,75,13,41,7,-7.416881450746815,6
1964,54,29,88,17,-7.418874182686381,12
1965,68,14,98,10,-7.427653338623117,4
1966,50,31,87,19,-7.429484842498567,12
1967,48,14,17,8,-7.444960593591367,6
1968,86,33,87,20,-7.46188236190325,13
1969,9,68,16,44,-7.4621011061615246,24
1970,8,16,1,9,-7.473060523777067,7
1971,9,34,107,19,-7.482440310595418,15
1972,79,23,18,13,-7.489902589142588,10
1973,41,53,28,30,-7.494799478271723,23
1974,38,24,2,13,-7.498014725943604,11
1975,54,28,103,16,-7.519450232339541,12
1976,34,26,84,17,-7.521080186287482,9
1977,107,20,29,13,-7.525530619454991,7
1978,70,17,79,9,-7.5316286806742845,8
1979,112,21,6,12,-7.552230223314683,9
1980,86,26,111,15,-7.599516330003595,11
1981,74,20,10,13,-7.659112863437722,7
1982,10,12,104,7,-7.685162882867629,5
1983,65,70,111,40,-7.692935034996464,30
1984,76,40,88,23,-7.693645081601592,17
1985,28,44,107,25,-7.7003074769075885,19
1986,59,11,23,7,-7.703199044299864,4
1987,85,14,111,9,-7.7293785704579765,5
1988,74,19,17,11,-7.746897696537682,8
1989,109,13,29,8,-7.764821554426809,5
1990,2,11,58,7,-7.801381373372687,4
1991,11,10,28,6,-7.813271079515405,4
1992,37,32,76,21,-7.820497576953575,11
1993,9,26,17,16,-7.8312751797806746,10
1994,38,36,8,23,-7.848513446954382,13
1995,12,11,74,6,-7.881335923893615,5
1996,13,14,49,8,-7.890029815709078,6
1997,88,36,16,24,-7.895427898542639,12
1998,37,25,54,17,-7.943083932672221,8
1999,68,17,65,10,-7.944869327403057,7
2000,76,18,55,11,-7.950732428839997,7
2001,29,13,10,8,-7.9538773066866035,5
2002,18,26,98,16,-7.97184494616587,10
2003,37,12,109,7,-7.972273664149992,5
2004,86,14,32,8,-7.97358717546261,6
2005,2,47,16,29,-7.981559053660557,18
2006,8,40,23,25,-7.983032320771592,15
2007,34,16,41,9,-7.985588983079851,7
2008,46,12,29,8,-7.9900680110629,4
2009,9,23,49,15,-7.9925191639655395,8
2010,41,15,90,9,-7.997737246515692,6
2011,86,11,1,7,-8.004187715591295,4
2012,28,40,93,24,-8.03478811627168,16
2013,79,45,87,27,-8.036990951026812,18
2014,111,34,16,19,-8.046487125961015,15
2015,74,11,13,7,-8.04867506694036,4
2016,13,12,6,7,-8.074590184679874,5
2017,10,15,30,10,-8.08039942607508,5
2018,86,19,38,13,-8.082390856875639,6
2019,54,32,93,22,-8.106367720057323,10
2020,84,59,16,36,-8.110816647171312,23
2021,9,14,19,8,-8.117304295019103,6
2022,43,23,8,14,-8.144232099403988,9
2023,106,18,79,10,-8.14725786066595,8
2024,20,16,16,9,-8.147746017528718,7
2025,48,42,84,25,-8.151068929408757,17
2026,86,65,16,41,-8.160600875802444,24
2027,8,29,17,18,-8.17510581548791,11
2028,98,29,49,17,-8.192506354783728,12
2029,8,19,13,12,-8.198779355292587,7
2030,94,13,28,8,-8.222371266039172,5
2031,16,10,26,6,-8.231874067384084,4
2032,17,14,111,8,-8.239799794462417,6
2033,9,33,20,22,-8.272596506781891,11
2034,70,24,16,16,-8.27289393797196,8
2035,58,12,65,6,-8.279172093518053,6
2036,41,18,76,11,-8.2849711876969,7
2037,65,52,74,33,-8.288743311827757,19
2038,84,19,17,12,-8.294099990413248,7
2039,59,17,9,11,-8.305936798720651,6
2040,109,33,8,20,-8.311226620633253,13
2041,103,45,41,31,-8.332714422601013,14
2042,35,10,8,6,-8.33580666741078,4
2043,9,36,91,22,-8.337030454552687,14
2044,84,11,104,7,-8.339235828654411,4
2045,107,12,13,8,-8.34538143971718,4
2046,63,20,84,12,-8.347628578121029,8
2047,65,14,1,9,-8.385347213000841,5
2048,93,23,23,13,-8.387201678617924,10
2049,23,19,90,12,-8.394839451243373,7
2050,89,11,90,7,-8.39679691457017,4
2051,87,17,43,11,-8.41719039009833,6
2052,10,21,73,14,-8.419335562342066,7
2053,1,21,98,14,-8.436557583367698,7
2054,85,26,84,14,-8.437491114567164,12
2055,88,26,9,16,-8.45468034129533,10
2056,84,31,93,20,-8.46536333401638,11
2057,56,13,8,9,-8.476650128591343,4
2058,76,23,54,13,-8.51187755649848,10
2059,109,10,89,6,-8.517312082575357,4
2060,103,24,26,14,-8.523036763842917,10
2061,62,18,41,11,-8.537234992782363,7
2062,28,36,76,22,-8.544961108918418,14
2063,10,18,93,12,-8.56386374848909,6
2064,86,40,37,24,-8.603825624585157,16
2065,109,18,34,11,-8.662734980033568,7
2066,88,23,37,15,-8.667790010971716,8
2067,20,15,34,10,-8.686931056567454,5
2068,37,23,23,15,-8.700238300329012,8
2069,75,16,79,11,-8.72919630800264,5
2070,20,35,55,21,-8.738108987978197,14
2071,91,26,2,15,-8.783750173530162,11
2072,9,24,29,14,-8.78680407934639,10
2073,20,53,41,35,-8.792551400263662,18
2074,85,11,10,6,-8.81027661814343,5
2075,79,26,32,17,-8.85913718793159,9
2076,94,17,98,11,-8.877059957058036,6
2077,76,49,8,31,-8.921707122679692,18
2078,110,20,107,12,-8.933567921834618,8
2079,54,19,30,12,-8.941378731198723,7
2080,65,40,2,27,-8.96445994810743,13
2081,107,17,43,11,-8.97149730664326,6
2082,20,10,46,5,-8.988887305938205,5
2083,76,35,74,23,-9.021109435296271,12
2084,65,57,16,35,-9.041777655106582,22
2085,50,16,91,11,-9.0441946525026,5
2086,109,13,106,8,-9.062668099795836,5
2087,46,10,20,7,-9.07799592694241,3
2088,32,12,26,7,-9.097694016198698,5
2089,57,11,2,6,-9.107338089684548,5
2090,30,14,23,8,-9.118564512919743,6
2091,91,35,74,22,-9.120669894046728,13
2092,65,58,98,37,-9.126651402593728,21
2093,48,15,50,9,-9.130895989302052,6
2094,87,20,30,13,-9.180499280009723,7
2095,6,18,30,13,-9.214935490589037,5
2096,65,45,63,28,-9.257158809469662,17
2097,50,14,43,9,-9.274747817248809,5
2098,23,17,50,10,-9.30009053265053,7
2099,32,29,111,17,-9.306159625162504,12
2100,79,22,34,13,-9.333372214384012,9
2101,55,15,23,9,-9.335240638495888,6
2102,29,22,74,13,-9.341715830488063,9
2103,86,17,49,9,-9.343172433673242,8
2104,8,16,46,10,-9.372412655150548,6
2105,8,14,59,9,-9.376826871718675,5
2106,76,20,91,13,-9.390956065597495,7
2107,62,14,76,7,-9.422068732882325,7
2108,10,11,57,7,-9.432674751481889,4
2109,55,10,70,6,-9.436952114481349,4
2110,44,17,65,10,-9.4437024578389,7
2111,34,24,8,16,-9.455603000494802,8
2112,109,24,20,17,-9.467777006169475,7
2113,19,11,103,7,-9.481054864710428,4
2114,58,11,6,7,-9.48949645741495,4
2115,28,16,43,11,-9.500596764145223,5
2116,76,23,15,15,-9.503739473265115,8
2117,88,14,32,10,-9.505084521049726,4
2118,8,45,26,27,-9.507536225083523,18
2119,17,13,91,8,-9.524679603281811,5
2120,79,21,13,15,-9.547980426671517,6
2121,65,21,60,13,-9.571951123571157,8
2122,89,22,23,14,-9.57687547449059,8
2123,68,18,20,11,-9.579258034610852,7
2124,107,28,79,19,-9.628503445575703,9
2125,18,10,46,7,-9.636942910362706,3
2126,62,26,98,16,-9.641858129313674,10
2127,54,23,55,16,-9.64818102580083,7
2128,85,11,88,7,-9.656301948727865,4
2129,38,32,29,21,-9.68129980112226,11
2130,54,42,111,27,-9.68998535179476,15
2131,2,17,70,12,-9.72121584945483,5
2132,48,10,34,6,-9.747358685821398,4
2133,103,36,111,23,-9.751404731703081,13
2134,85,19,28,12,-9.754813285313764,7
2135,103,42,8,29,-9.75520368768584,13
2136,76,19,46,13,-9.759368120687247,6
2137,44,34,6,21,-9.768613303295998,13
2138,48,31,79,19,-9.853595538086749,12
2139,64,10,28,6,-9.858359509289873,4
2140,50,14,10,9,-9.907166966632534,5
2141,17,13,87,8,-9.92299839057506,5
2142,75,10,103,6,-9.927646178593532,4
2143,70,11,93,7,-9.92887532154977,4
2144,18,14,55,9,-9.949790942140547,5
2145,55,17,10,10,-9.955177794264818,7
2146,38,24,111,15,-9.966212518632448,9
2147,70,10,29,7,-9.974371860410164,3
2148,34,17,76,11,-9.994247540573083,6
2149,30,11,88,6,-10.02483572373662,5
2150,46,17,111,11,-10.027977766283334,6
2151,9,13,63,8,-10.036609783490736,5
2152,74,26,93,18,-10.070964280509383,8
2153,54,18,63,11,-10.075840147553764,7
2154,74,29,103,20,-10.120878103689183,9
2155,50,15,30,9,-10.120991429675161,6
2156,84,14,109,9,-10.149942855967595,5
2157,65,23,110,15,-10.151511833678441,8
2158,18,17,74,11,-10.161044876408567,6
2159,38,10,60,6,-10.18694980154264,4
2160,96,12,65,7,-10.190345361441295,5
2161,6,16,26,11,-10.241752287967033,5
2162,109,14,91,9,-10.246844938152377,5
2163,9,68,28,43,-10.257395044502449,25
2164,28,20,104,14,-10.28097645051314,6
2165,73,16,2,10,-10.299221262346563,6
2166,75,11,2,7,-10.369833561069749,4
2167,75,12,93,7,-10.370088912225684,5
2168,17,10,29,7,-10.395985227153455,3
2169,88,15,73,10,-10.39694546347287,5
2170,49,17,20,11,-10.413212284497668,6
2171,76,20,70,13,-10.440720709029366,7
2172,9,20,34,13,-10.453225144992842,7
2173,79,37,26,23,-10.48182801922156,14
2174,76,32,98,20,-10.566257306689165,12
2175,32,12,6,8,-10.571898387448906,4
2176,65,15,70,10,-10.573807897523746,5
2177,109,14,103,10,-10.579033749442829,4
2178,109,12,86,7,-10.607119538943417,5
2179,101,10,65,6,-10.616476001261294,4
2180,88,37,98,26,-10.639663528048944,11
2181,58,13,38,9,-10.642287291889895,4
2182,109,18,74,11,-10.643610558105998,7
2183,16,16,75,11,-10.668295124883432,5
2184,109,16,107,10,-10.668493285549749,6
2185,6,26,16,16,-10.690827392878644,10
2186,41,14,37,9,-10.69447624326301,5
2187,103,50,65,34,-10.698432421307977,16
2188,85,10,91,5,-10.70245375594107,5
2189,41,26,55,16,-10.703172393729929,10
2190,85,23,16,15,-10.72266636367359,8
2191,66,13,8,9,-10.73746092576916,4
2192,30,20,55,12,-10.741156330527383,8
2193,37,10,50,6,-10.742277179240878,4
2194,18,14,23,10,-10.76931964993769,4
2195,23,16,17,11,-10.781653305644493,5
2196,103,25,30,17,-10.7828746133779,8
2197,6,27,87,18,-10.792781333267982,9
2198,68,11,50,8,-10.798306988405816,3
2199,87,33,93,22,-10.803849348258458,11
2200,63,13,37,8,-10.805969524077799,5
2201,41,48,98,30,-10.835326353590226,18
2202,51,16,54,10,-10.844122413303602,6
2203,62,11,30,7,-10.859839313714286,4
2204,8,10,11,7,-10.874801270533913,3
2205,65,30,26,19,-10.898269254189747,11
2206,20,38,26,25,-10.946036152479264,13
2207,2,11,13,8,-10.953261699605447,3
2208,51,17,87,11,-10.954751209558495,6
2209,43,10,30,7,-10.958461383133034,3
2210,56,10,87,7,-10.975444937841756,3
2211,6,14,38,10,-11.00539879038108,4
2212,9,21,30,15,-11.009407613122827,6
2213,50,20,65,13,-11.026543162219182,7
2214,110,12,98,8,-11.026999619900325,4
2215,103,13,13,8,-11.05495221756605,5
2216,6,25,74,17,-11.078169532223486,8
2217,37,19,93,13,-11.135373057728069,6
2218,46,13,26,8,-11.17021351687407,5
2219,28,10,15,7,-11.17654596174133,3
2220,37,16,85,12,-11.183890538456167,4
2221,1,14,93,10,-11.222746146114872,4
2222,50,18,32,11,-11.22509689213064,7
2223,29,21,30,13,-11.231145218657776,8
2224,65,14,34,9,-11.233073447780965,5
2225,103,22,2,16,-11.358008021341286,6
2226,9,18,46,11,-11.371108835096305,7
2227,97,10,9,6,-11.373867326772805,4
2228,10,27,84,18,-11.412845799216361,9
2229,41,20,17,15,-11.462467383182346,5
2230,79,33,20,23,-11.52637500903139,10
2231,109,22,38,15,-11.56196931683469,7
2232,102,16,65,10,-11.56505726688695,6
2233,91,15,55,11,-11.567443094683275,4
2234,13,18,16,12,-11.568229122492733,6
2235,18,16,65,11,-11.593628436717697,5
2236,18,11,91,7,-11.60000478191822,4
2237,15,17,98,11,-11.628891195956703,6
2238,70,14,107,9,-11.658453467748311,5
2239,93,13,73,9,-11.669892631961593,4
2240,91,15,93,10,-11.673165263369297,5
2241,20,13,18,8,-11.715025972179696,5
2242,20,41,107,26,-11.716667295780281,15
2243,62,13,70,8,-11.719880801732707,5
2244,26,15,23,10,-11.729655071897731,5
2245,79,10,15,7,-11.756403792330076,3
2246,107,14,1,9,-11.758251767033556,5
2247,88,15,46,11,-11.797390382153155,4
2248,103,29,93,19,-11.801085216233046,10
2249,9,11,58,8,-11.822266619156148,3
2250,41,37,54,25,-11.82264476558168,12
2251,62,15,23,11,-11.828374088275885,4
2252,109,14,43,9,-11.86646010992543,5
2253,87,44,26,29,-11.8713861461171,15
2254,1,11,9,7,-11.88637849875502,4
2255,111,17,48,12,-11.902706300174234,5
2256,17,13,18,8,-11.905263091036248,5
2257,76,10,93,7,-11.923250604262597,3
2258,98,16,104,10,-11.933644997320592,6
2259,98,24,32,16,-11.959293567844908,8
2260,65,22,49,14,-11.960634834980652,8
2261,11,15,98,10,-11.975065250902475,5
2262,87,46,55,32,-12.067123893381947,14
2263,6,18,18,12,-12.078104024118803,6
2264,112,11,79,8,-12.089617166544242,3
2265,103,11,58,8,-12.093407699535733,3
2266,62,10,49,6,-12.115401300524669,4
2267,41,20,93,15,-12.152619394683914,5
2268,109,11,10,7,-12.166039484484616,4
2269,48,20,74,13,-12.23065848011944,7
2270,48,15,51,11,-12.237016972870073,4
2271,62,17,84,11,-12.2561085252652,6
2272,41,24,32,15,-12.295470101415006,9
2273,50,17,93,11,-12.303370496346973,6
2274,89,20,28,13,-12.339450745494947,7
2275,26,12,93,8,-12.342400061412192,4
2276,23,18,20,13,-12.419097927334018,5
2277,62,22,93,15,-12.439036445917946,7
2278,84,14,15,10,-12.488568021465506,4
2279,84,16,18,11,-12.537157233284482,5
2280,70,11,90,8,-12.581946187652854,3
2281,98,41,55,29,-12.606268888418896,12
2282,103,33,20,24,-12.666531668869958,9
2283,86,11,63,8,-12.694676726792155,3
2284,90,11,73,8,-12.699639901607064,3
2285,89,13,8,9,-12.710180677943102,4
2286,111,21,73,14,-12.761253099258205,7
2287,5,13,87,9,-12.788098556943213,4
2288,104,13,54,9,-12.823245238040403,4
2289,86,31,2,22,-12.839620514410688,9
2290,9,37,93,26,-12.871076607744834,11
2291,14,11,87,8,-12.902634224263672,3
2292,8,11,3,8,-12.917286316124734,3
2293,34,13,37,9,-12.94192710541144,4
2294,79,15,63,10,-12.990676793013687,5
2295,50,10,112,7,-13.007963386743393,3
2296,43,18,55,12,-13.012921035450159,6
2297,86,16,64,11,-13.126489420837814,5
2298,41,30,107,19,-13.15459356629732,11
2299,103,11,43,7,-13.185714828889324,4
2300,17,25,28,18,-13.189393025867657,7
2301,107,17,32,13,-13.233625998220854,4
2302,89,10,58,7,-13.242354787086828,3
2303,109,24,26,17,-13.28104412568642,7
2304,73,12,89,8,-13.292782754035763,4
2305,74,12,70,9,-13.332522800110302,3
2306,109,22,32,15,-13.338298268264793,7
2307,91,10,112,7,-13.348872894391056,3
2308,93,10,90,6,-13.383501710064953,4
2309,55,16,86,10,-13.429599224429374,6
2310,73,15,13,10,-13.47156171227663,5
2311,38,23,74,15,-13.507243955925757,8
2312,37,20,111,13,-13.57504840749372,7
2313,5,12,37,9,-13.59306711232449,3
2314,43,17,26,13,-13.599337683555719,4
2315,13,17,84,11,-13.61439780977119,6
2316,57,21,8,14,-13.698942718189372,7
2317,13,10,37,7,-13.710588735524027,3
2318,73,16,38,10,-13.771113964229546,6
2319,8,12,77,9,-13.77292858304554,3
2320,43,14,93,10,-13.775006273083648,4
2321,109,26,54,18,-13.824526520753498,8
2322,50,11,26,8,-13.838338669086026,3
2323,2,22,55,15,-13.871872112800908,7
2324,38,25,55,17,-13.895599618213826,8
2325,109,12,70,9,-13.90225333563024,3
2326,79,14,46,9,-13.926744437290198,5
2327,9,20,57,15,-13.952239963411909,5
2328,37,13,17,8,-14.0031965298978,5
2329,8,16,110,12,-14.095812927776766,4
2330,71,11,98,8,-14.175605929164412,3
2331,38,12,48,9,-14.205802555452118,3
2332,109,12,50,8,-14.261856398454315,4
2333,8,10,60,7,-14.262033464961124,3
2334,62,21,55,14,-14.271402247137447,7
2335,44,10,84,7,-14.273373064789189,3
2336,84,22,70,15,-14.297191605156168,7
2337,91,11,46,8,-14.304066831342245,3
2338,17,12,86,9,-14.311620358508236,3
2339,66,10,28,6,-14.329185091749263,4
2340,62,25,107,17,-14.352538477201138,8
2341,23,23,10,15,-14.368201832765772,8
2342,20,26,29,18,-14.478890408494557,8
2343,50,11,110,8,-14.53197897415603,3
2344,20,19,62,14,-14.58480992394943,5
2345,13,14,88,8,-14.636848081546894,6
2346,74,16,34,11,-14.640026082092414,5
2347,59,14,65,9,-14.654063925888897,5
2348,38,25,93,17,-14.706979782976548,8
2349,17,11,93,8,-14.792328082005673,3
2350,41,13,13,9,-14.878152444409174,4
2351,51,10,9,7,-14.933479318486377,3
2352,65,10,14,8,-15.014185877069247,2
2353,37,15,57,11,-15.06777664357477,4
2354,40,14,84,9,-15.139436492633186,5
2355,107,33,26,26,-15.181646063962573,7
2356,88,17,90,12,-15.203720699131468,5
2357,18,11,90,8,-15.206260273523736,3
2358,28,26,26,19,-15.21129576490937,7
2359,6,31,2,22,-15.303923962237267,9
2360,88,13,70,10,-15.445871190573252,3
2361,76,20,2,14,-15.537111030617941,6
2362,59,10,16,6,-15.561569445873218,4
2363,73,12,29,9,-15.669782329836794,3
2364,38,15,17,11,-15.678044683298909,4
2365,62,30,111,22,-15.726936324972732,8
2366,30,14,93,10,-15.791222727391174,4
2367,66,14,6,11,-15.817538028688281,3
2368,109,16,55,12,-15.902114621962275,4
2369,91,12,90,8,-16.09870244517901,4
2370,6,26,107,19,-16.09948767879897,7
2371,49,18,88,14,-16.108818713025215,4
2372,103,11,59,8,-16.26665644300863,3
2373,103,13,62,9,-16.299156500586875,4
2374,16,14,49,10,-16.362303182466885,4
2375,85,13,30,10,-16.384026425638844,3
2376,69,13,26,10,-16.62596512327185,3
2377,41,10,69,7,-16.634275461416586,3
2378,75,14,88,11,-16.698120760316787,3
2379,76,13,57,10,-16.719909290440036,3
2380,109,16,73,12,-16.722107664046135,4
2381,71,17,8,12,-16.73632107470111,5
2382,48,10,20,8,-16.747092552182814,2
2383,28,13,63,10,-16.83915101157232,3
2384,109,31,41,26,-16.84086997358482,5
2385,15,12,38,9,-16.8804957204812,3
2386,54,13,26,8,-16.939787162296547,5
2387,65,22,30,17,-17.16851241113137,5
2388,91,14,34,10,-17.47588407236358,4
2389,76,13,63,11,-17.535738224915978,2
2390,110,10,41,9,-17.60725146483,1
2391,70,13,63,10,-17.95951063791253,3
2392,10,15,38,12,-18.015221595889397,3
2393,76,11,90,7,-18.031869037099202,4
2394,48,13,93,11,-18.07835377188638,2
2395,7,12,79,9,-18.096381711285996,3
2396,98,11,51,8,-18.116158962815206,3
2397,87,11,58,9,-18.229025747195358,2
2398,20,12,106,8,-18.3115400770612,4
2399,37,10,18,8,-18.374799448579118,2
2400,1,18,10,14,-18.37916925532281,4
2401,6,15,109,11,-18.56848342127744,4
2402,86,15,70,11,-18.585222369284804,4
2403,38,24,26,18,-18.614524044017745,6
2404,2,13,18,10,-18.66694455968119,3
2405,109,28,28,21,-18.761679918134746,7
2406,88,11,26,8,-18.78599149196052,3
2407,109,16,111,12,-18.82454889767414,4
2408,71,12,62,11,-19.04348733516107,1
2409,85,10,87,8,-19.06738234368307,2
2410,28,18,57,15,-19.08730071874414,3
2411,50,13,62,10,-19.202113459727396,3
2412,29,12,110,10,-19.248543702222975,2
2413,38,14,43,10,-19.328461951187712,4
2414,75,12,55,10,-19.502608543209227,2
2415,9,10,5,8,-19.535484203654345,2
2416,23,14,73,11,-19.63848596555713,3
2417,10,13,41,11,-19.73715787827288,2
2418,103,10,34,9,-19.87880862427677,1
2419,109,12,110,10,-20.16933250309852,2
2420,10,10,17,8,-20.222695302818998,2
2421,9,10,64,8,-20.43457650048481,2
2422,46,17,87,13,-20.824880493627077,4
2423,110,14,74,11,-20.87504771154673,3
2424,109,29,87,23,-21.226363241987656,6
2425,87,10,106,9,-21.564542850873874,1
2426,70,25,111,19,-21.761941281988644,6
2427,44,11,17,9,-22.07291294624117,2
2428,10,10,63,8,-22.40580476933663,2
2429,85,11,20,9,-22.586820177190248,2
2430,10,18,20,15,-22.627581995234397,3
2431,94,10,84,9,-22.762013140609874,1
2432,10,10,26,8,-22.77202326046866,2
2433,41,12,57,10,-23.379405756490282,2
2434,86,15,103,13,-23.96793650375476,2
2435,112,11,74,9,-24.423385588541223,2
2436,49,11,26,8,-26.831812890773925,3
2437,43,10,91,10,-27.34458455824453,0
2438,73,10,107,9,-28.662979189254315,1
2439,65,10,64,9,-31.45578016441545,1
