,againstHero,games,hero,losses,shift,wins
0,95,10,37,0,33.05724191683926,10
1,88,13,37,1,28.252272733952857,12
2,30,11,54,1,25.713620235434703,10
3,25,13,106,3,25.179665157562322,10
4,48,10,35,1,25.155197930838906,9
5,76,14,35,3,24.65568308296192,11
6,34,10,51,1,22.213174768846972,9
7,50,18,55,4,21.384042844031153,14
8,5,14,98,3,21.043629991929123,11
9,30,12,107,2,21.034566601211726,10
10,65,10,104,1,20.258723268915208,9
11,107,10,66,2,20.152222817707916,8
12,2,13,54,2,19.759970484752476,11
13,38,10,97,1,19.67073344994079,9
14,104,13,2,3,19.626967622722084,10
15,28,14,112,3,19.249826897720943,11
16,107,11,32,2,19.05312990423956,9
17,50,10,70,3,18.66920839814296,7
18,88,14,109,2,18.52791141944204,12
19,63,17,91,4,18.120595699414864,13
20,93,10,50,2,18.03384687661146,8
21,104,11,102,3,17.918506819753233,8
22,90,23,28,5,17.842079516061677,18
23,11,14,25,3,17.774778708310116,11
24,93,14,96,3,17.771004816118815,11
25,41,13,86,2,17.568343007541294,11
26,114,12,106,3,17.530744904632478,9
27,34,11,87,3,17.338115350277818,8
28,35,10,106,3,17.319051156851785,7
29,114,13,109,2,16.934502621040732,11
30,90,12,63,3,16.840668609829066,9
31,95,12,88,3,16.53166628937119,9
32,104,12,46,3,16.40484204464055,9
33,11,13,70,3,16.32604658673946,10
34,104,10,100,2,16.26193989930638,8
35,48,11,9,3,15.643745764186933,8
36,11,13,98,4,15.616050281557111,9
37,34,13,28,3,15.421948286719395,10
38,93,10,11,2,15.321419061771829,8
39,74,24,28,6,15.31519507992004,18
40,2,16,70,5,15.20234077608459,11
41,73,14,90,4,15.181297397438652,10
42,91,12,96,3,15.083901067533665,9
43,100,14,54,4,14.930697835147345,10
44,80,12,50,2,14.926124931290452,10
45,91,13,20,4,14.874187006920964,9
46,102,15,5,5,14.700985080882875,10
47,16,15,46,4,14.63177135505341,11
48,80,11,35,3,14.578551377058158,8
49,63,33,84,10,14.557123158417967,23
50,73,12,37,4,14.533349572792922,8
51,14,11,63,4,14.53302527333945,7
52,107,14,35,3,14.477847243885739,11
53,16,23,74,6,14.22296330279235,17
54,88,25,46,6,14.199181147964373,19
55,73,10,87,2,14.104045620374126,8
56,90,10,48,3,14.062301149493257,7
57,106,11,23,4,13.977666138674254,7
58,73,11,54,3,13.856140526530867,8
59,8,12,98,3,13.758631370873724,9
60,75,10,5,3,13.751440551521483,7
61,87,15,70,5,13.709203230326096,10
62,50,10,25,3,13.663219852775494,7
63,51,12,74,3,13.519826421822684,9
64,86,18,73,6,13.498917483420346,12
65,104,12,50,3,13.423441976007842,9
66,20,11,98,2,13.40692814740014,9
67,69,11,28,4,13.38734226962898,7
68,63,14,109,4,13.371852687868843,10
69,34,10,8,3,13.309346330253714,7
70,8,15,114,4,13.19160663168953,11
71,86,11,39,4,13.181031933377376,7
72,90,11,97,4,13.178561240127799,7
73,76,11,55,2,13.17189682864644,9
74,97,10,84,2,13.1315313075884,8
75,48,19,54,6,13.122325082638987,13
76,16,30,106,8,13.120750145694194,22
77,80,10,14,4,13.097202558791373,6
78,17,10,107,3,13.095515887019284,7
79,102,11,87,3,13.031920315209861,8
80,95,10,11,3,12.962395970965867,7
81,78,10,96,3,12.899686199305037,7
82,17,14,37,5,12.777771600020978,9
83,98,10,87,3,12.766560909926934,7
84,37,27,54,9,12.577195310341338,18
85,73,17,107,6,12.476279417058619,11
86,63,39,54,12,12.439421659836578,27
87,11,38,96,12,12.43376452627604,26
88,25,13,46,4,12.405977888292135,9
89,16,12,70,3,12.328970589486453,9
90,20,18,25,6,12.230511176411236,12
91,46,17,96,7,12.129227204168036,10
92,16,35,87,12,12.102704314622608,23
93,38,10,106,4,12.053515342420265,6
94,30,10,5,2,12.011638874309803,8
95,30,10,87,3,11.954020606538128,7
96,88,12,104,4,11.911529882206118,8
97,73,15,5,5,11.910694863368755,10
98,16,12,98,4,11.817599398499155,8
99,75,16,8,4,11.794220762958481,12
100,86,20,109,5,11.786893718585258,15
101,83,14,5,4,11.757143877932299,10
102,80,15,107,3,11.678062977381895,12
103,55,27,11,7,11.616496674178505,20
104,91,10,98,3,11.6111736728835,7
105,71,15,8,5,11.554874198552197,10
106,11,19,84,6,11.373729994467022,13
107,90,20,106,6,11.319121838741873,14
108,50,11,109,3,11.21767101593788,8
109,8,12,65,4,11.180766905333911,8
110,97,16,5,5,11.001465278853818,11
111,30,13,16,4,10.882729052195028,9
112,97,10,114,4,10.862239910215562,6
113,86,10,33,3,10.827935889094654,7
114,87,15,93,5,10.798658757671168,10
115,50,11,98,3,10.6914012264267,8
116,50,28,20,10,10.558524754395552,18
117,16,20,55,6,10.518672310475319,14
118,28,20,25,6,10.43668370179945,14
119,48,22,96,7,10.412031756955415,15
120,11,19,37,6,10.335627850347763,13
121,16,38,96,11,10.237680582890102,27
122,16,24,107,7,10.150129279172639,17
123,55,12,70,4,10.141434019068976,8
124,106,14,75,7,10.013304733371458,7
125,86,20,76,7,9.940010233613187,13
126,95,12,107,4,9.937496129371693,8
127,51,17,96,6,9.90017056684033,11
128,102,11,88,3,9.888500122769269,8
129,86,23,79,8,9.865377107457421,15
130,98,24,96,9,9.85522726903532,15
131,20,22,84,6,9.790302500691975,16
132,74,16,70,7,9.770873759550817,9
133,98,14,106,5,9.701360201061402,9
134,88,12,57,5,9.696740487129196,7
135,8,10,32,4,9.695711025914951,6
136,50,25,5,10,9.615141407944584,15
137,50,28,107,10,9.593575141846495,18
138,79,12,87,3,9.532024747647966,9
139,114,19,20,6,9.456323838229798,13
140,88,24,28,8,9.449291017909664,16
141,90,17,50,6,9.438413402091001,11
142,96,16,104,6,9.433481460132812,10
143,87,13,2,5,9.430732046556473,8
144,63,18,2,7,9.424323722958958,11
145,50,16,102,7,9.414224162201034,9
146,2,25,107,8,9.34845410579801,17
147,90,13,80,4,9.306752684001106,9
148,108,14,63,5,9.298531248541144,9
149,2,11,65,3,9.274625860779652,8
150,97,14,8,5,9.2569642199044,9
151,20,14,46,4,9.238657962224787,10
152,76,14,50,4,9.228465475536328,10
153,2,10,16,3,9.214178381730257,7
154,30,15,8,5,9.185211827951935,10
155,30,11,28,4,9.144215115290798,7
156,23,10,87,4,9.096524698327546,6
157,50,26,96,9,9.051096363617635,17
158,63,38,28,13,9.045203898145056,25
159,57,12,107,5,8.988403130065704,7
160,32,10,11,3,8.939422844172492,7
161,102,20,86,6,8.876334285027802,14
162,28,20,114,9,8.84184705741822,11
163,84,11,76,4,8.826925911567171,7
164,37,16,46,5,8.822890347017472,11
165,7,11,96,3,8.775501150402919,8
166,8,12,67,4,8.77235690116511,8
167,86,27,51,11,8.740860643352912,16
168,73,10,98,3,8.72433500141915,7
169,106,12,91,3,8.70066752710923,9
170,28,12,18,5,8.658858567038083,7
171,57,11,5,4,8.610734603358434,7
172,90,22,5,7,8.559685419611386,15
173,8,13,100,4,8.54112762254678,9
174,106,21,70,8,8.519014816449403,13
175,63,27,20,11,8.518828390562923,16
176,50,17,88,7,8.503859481033004,10
177,5,22,84,8,8.484507375916772,14
178,32,10,5,3,8.444026138330045,7
179,86,26,70,11,8.431070575550432,15
180,50,13,114,5,8.388183657848247,8
181,98,17,63,7,8.359697866117658,10
182,69,13,86,5,8.329501489122975,8
183,89,11,37,5,8.260841827542206,6
184,11,20,20,6,8.234400855107406,14
185,20,11,44,4,8.212958514210372,7
186,8,43,87,16,8.206684755768935,27
187,86,12,108,5,8.204205290543774,7
188,74,17,93,7,8.19338693451652,10
189,20,11,95,4,8.18646759603118,7
190,46,15,84,5,8.129936367388796,10
191,80,14,65,5,8.117894882236026,9
192,63,20,88,8,8.087843670572429,12
193,16,17,104,7,8.057707930282643,10
194,16,14,48,6,8.053586068768567,8
195,73,20,74,7,8.01522036427702,13
196,28,18,91,7,8.01457036803685,11
197,102,19,96,7,7.9956311609664965,12
198,97,18,37,7,7.973109918201967,11
199,76,17,107,6,7.961856909329562,11
200,102,11,37,4,7.9525351673088975,7
201,96,12,34,4,7.949755484984076,8
202,80,24,106,9,7.948937081453317,15
203,88,13,70,5,7.915858076944355,8
204,114,14,96,5,7.889762565328155,9
205,2,15,106,6,7.778481190743794,9
206,48,20,79,8,7.777732866617034,12
207,16,13,91,4,7.754521449385596,9
208,46,23,28,7,7.7505833090146155,16
209,79,10,106,4,7.723339908977314,6
210,8,22,25,8,7.717252659656066,14
211,76,14,70,5,7.7067801731883225,9
212,48,18,87,7,7.681552221415861,11
213,55,10,108,4,7.660382487173957,6
214,96,22,80,8,7.6325568595370585,14
215,5,11,2,4,7.630524777935994,7
216,2,14,97,5,7.627801324727646,9
217,63,12,46,4,7.600674717701955,8
218,85,10,107,4,7.595499375056901,6
219,102,13,16,6,7.55516594118759,7
220,28,19,70,8,7.544208909658004,11
221,76,16,5,6,7.518744663128346,10
222,30,10,84,3,7.509917010745374,7
223,20,17,51,8,7.493698730314256,9
224,8,15,91,6,7.483090394261753,9
225,37,27,106,12,7.475043034461925,15
226,16,17,84,7,7.47114031170461,10
227,88,12,25,5,7.434876792293262,7
228,74,26,46,9,7.428235200256028,17
229,63,11,25,4,7.385187766970543,7
230,48,22,107,9,7.330278865374194,13
231,88,13,114,5,7.320732624891944,8
232,63,18,76,6,7.244525780520105,12
233,28,19,75,8,7.2257676072063814,11
234,63,28,48,10,7.208356975606329,18
235,28,12,17,5,7.176420733706949,7
236,11,15,109,6,7.174727842093128,9
237,50,11,17,4,7.150648662679504,7
238,63,12,79,4,7.1114844508040305,8
239,86,21,80,9,7.071945289109106,12
240,50,11,48,4,7.05821121395096,7
241,97,16,25,7,6.959301134276737,9
242,44,17,86,7,6.949446042817986,10
243,54,22,90,9,6.925522493440474,13
244,93,12,86,4,6.922029970425321,8
245,37,39,86,16,6.893488734465293,23
246,80,22,63,8,6.843518885460648,14
247,11,11,80,4,6.802148460786961,7
248,51,12,63,5,6.799312029973926,7
249,48,10,108,3,6.749808304712147,7
250,96,22,70,11,6.734945499709392,11
251,5,21,11,9,6.692287385746945,12
252,46,10,2,4,6.670222065576344,6
253,37,21,63,8,6.667064334500574,13
254,54,14,51,6,6.622588079460444,8
255,85,12,96,4,6.610954135702339,8
256,54,11,76,4,6.60321190549357,7
257,93,15,28,5,6.588443137697581,10
258,106,18,104,7,6.586828379052246,11
259,88,27,107,10,6.5675514861634845,17
260,38,16,86,7,6.564447252990193,9
261,74,27,84,12,6.529493156115414,15
262,86,21,104,9,6.468213518700146,12
263,14,17,28,6,6.462988674713604,11
264,50,10,18,5,6.440154509710169,5
265,109,15,8,7,6.403030229228608,8
266,37,27,104,11,6.397100518327712,16
267,74,36,96,14,6.391187863501184,22
268,34,11,106,4,6.348877012003049,7
269,86,76,96,30,6.329796370249291,46
270,87,33,37,13,6.328985291620954,20
271,86,12,14,5,6.306786470454386,7
272,86,23,48,9,6.215181955253339,14
273,65,13,93,6,6.214442146672824,7
274,20,12,97,5,6.196901748083682,7
275,102,19,25,7,6.161400465362891,12
276,46,12,106,5,6.1479645161124665,7
277,71,13,107,5,6.143176064124285,8
278,37,17,84,7,6.135362755463087,10
279,86,17,82,6,6.124344607685837,11
280,55,10,79,4,6.105260957218084,6
281,63,15,39,6,6.098512313477008,9
282,5,29,87,13,6.079041134915277,16
283,37,24,25,11,6.0405874199244165,13
284,86,24,75,11,6.040483815268099,13
285,95,15,8,6,6.03386134830471,9
286,51,15,107,5,6.010709658258433,10
287,20,14,90,6,6.004646856364408,8
288,28,22,102,10,6.002196336125346,12
289,87,12,46,5,5.996729580761838,7
290,28,15,98,5,5.973059566412094,10
291,109,10,76,5,5.969855218128681,5
292,102,17,114,6,5.9425198657476965,11
293,54,39,70,17,5.888091541631836,22
294,33,10,11,5,5.887923901561769,5
295,106,11,93,5,5.8657901820682214,6
296,108,11,50,4,5.8529749166500435,7
297,5,17,70,7,5.831365434421651,10
298,30,12,96,5,5.827709187189812,7
299,39,14,11,4,5.821131817679595,10
300,28,28,109,11,5.815001302128313,17
301,16,12,108,5,5.770631208900039,7
302,104,25,28,9,5.749142721940425,16
303,5,25,54,9,5.741523774218408,16
304,84,14,39,6,5.735188058057851,8
305,84,12,9,5,5.723245457590759,7
306,102,10,106,5,5.6912957732881875,5
307,57,10,28,4,5.6869622567132065,6
308,107,42,37,17,5.68503339380379,25
309,8,42,63,18,5.649560038871754,24
310,114,10,70,4,5.636681816492889,6
311,38,11,84,5,5.627456024192355,6
312,73,22,8,9,5.596510667207429,13
313,9,12,50,4,5.578106204160814,8
314,50,44,54,19,5.529996409038496,25
315,107,16,108,6,5.5146494473296634,10
316,91,20,107,8,5.505802548817647,12
317,93,20,8,9,5.491132662741163,11
318,2,11,88,4,5.477658376983315,7
319,54,27,88,12,5.434189753382354,15
320,63,34,96,13,5.39321635342965,21
321,109,12,102,5,5.392570444511439,7
322,88,11,97,4,5.351571329720364,7
323,90,18,37,7,5.349002601490299,11
324,54,14,104,5,5.334409503258775,9
325,16,16,51,8,5.285051160663565,8
326,50,54,28,23,5.279941331032883,31
327,109,16,5,7,5.27605958784894,9
328,34,12,74,4,5.2395412452934975,8
329,20,14,70,6,5.220897363934602,8
330,28,43,84,18,5.219221803540028,25
331,75,20,37,6,5.205769951831414,14
332,25,11,54,5,5.180889000134092,6
333,28,25,65,11,5.172274670876916,14
334,50,30,86,14,5.118847118423948,16
335,96,12,73,6,5.035390942293943,6
336,86,13,35,6,4.963361102394037,7
337,8,26,104,12,4.911621506512686,14
338,74,13,108,6,4.9091054802012675,7
339,96,21,90,8,4.8646011169770125,13
340,84,32,106,15,4.851744201560306,17
341,97,27,96,12,4.847267990402032,15
342,114,11,65,5,4.8392105326122365,6
343,28,22,2,9,4.837290355461167,13
344,85,13,86,6,4.833314993475176,7
345,114,34,107,14,4.829411961485131,20
346,98,15,37,7,4.814565641664851,8
347,107,19,25,8,4.802339370319195,11
348,96,22,25,10,4.793774224103586,12
349,74,12,62,5,4.762498174936739,7
350,16,13,79,6,4.716412220610577,7
351,95,12,106,5,4.699195682867778,7
352,114,28,5,12,4.694432433116341,16
353,102,17,54,7,4.6916495776952525,10
354,55,11,9,5,4.690967100580704,6
355,46,13,75,5,4.683703940633833,8
356,8,14,57,5,4.683699755799594,9
357,20,19,35,8,4.681781057889634,11
358,20,23,74,9,4.672235592214688,14
359,104,10,98,5,4.672200096826949,5
360,83,13,86,7,4.598477964081231,6
361,97,19,107,9,4.579839642750204,10
362,34,10,84,5,4.577710307306147,5
363,65,14,37,6,4.574583590431901,8
364,14,20,8,8,4.574516362462752,12
365,8,19,46,9,4.571464349413289,10
366,25,28,114,14,4.5658645828256015,14
367,62,13,86,6,4.563398493117805,7
368,98,24,86,11,4.56301016412544,13
369,95,12,96,5,4.548367780459664,7
370,79,12,8,4,4.5233682313953745,8
371,87,10,91,4,4.489603676814871,6
372,33,10,96,6,4.401522257584364,4
373,107,42,20,19,4.400812570612914,23
374,74,10,109,4,4.381848852561214,6
375,76,10,98,5,4.379545503881031,5
376,87,24,74,10,4.3427999466192215,14
377,65,10,11,4,4.281072376862914,6
378,63,17,70,8,4.20425277286591,9
379,84,22,70,9,4.182188769343139,13
380,74,11,55,5,4.181300299067086,6
381,20,13,73,5,4.146065391689569,8
382,86,34,90,14,4.124931636943059,20
383,65,30,86,13,4.119813593278432,17
384,84,16,90,7,4.100528600599519,9
385,54,16,95,7,4.0788113560066686,9
386,8,19,51,10,4.05944709438689,9
387,76,27,106,9,4.058349989135632,18
388,11,13,79,7,4.047561716338114,6
389,63,37,106,16,4.042568329293669,21
390,28,14,95,6,4.040550234811001,8
391,8,53,74,22,4.010168343975992,31
392,74,41,5,19,3.952743749218005,22
393,76,18,28,7,3.937083310529341,11
394,50,13,65,7,3.932064446598149,6
395,37,21,96,10,3.919945326141697,11
396,93,13,84,5,3.9158680410000715,8
397,65,25,107,10,3.884732871922416,15
398,80,13,55,7,3.844743684805329,6
399,63,21,55,9,3.838857697931918,12
400,86,24,97,11,3.801856449037873,13
401,102,17,8,7,3.7943727477668925,10
402,46,21,107,8,3.7858000639811684,13
403,86,57,107,27,3.7647946280812086,30
404,90,19,87,9,3.7262927176583673,10
405,50,34,11,14,3.701800884418704,20
406,75,13,71,5,3.6847064190257015,8
407,37,10,32,5,3.674911859501992,5
408,8,25,84,10,3.6608734975068677,15
409,87,16,65,7,3.6538862860446715,9
410,11,23,54,11,3.5626284863355506,12
411,86,23,46,10,3.5373084660977905,13
412,84,19,48,8,3.5357038968611265,11
413,51,13,104,6,3.5072770164972575,7
414,91,15,84,7,3.506943767095505,8
415,97,17,106,8,3.504320080557486,9
416,57,10,37,4,3.4895001536829016,6
417,23,10,107,4,3.4694839628849055,6
418,8,32,5,15,3.419692044575382,17
419,37,15,55,7,3.413809572719784,8
420,9,14,8,5,3.40854125083978,9
421,76,18,87,8,3.3882858472826842,10
422,55,20,28,7,3.3574009350442156,13
423,20,10,9,4,3.353443346624384,6
424,54,30,106,14,3.348177634825245,16
425,63,61,86,25,3.3220512619028564,36
426,51,22,28,9,3.3101205733455643,13
427,5,22,106,11,3.3051198302733824,11
428,28,26,97,11,3.3032475352202004,15
429,51,17,84,7,3.2832731192578755,10
430,65,20,96,9,3.2670140800116543,11
431,86,62,84,30,3.2556113214049702,32
432,17,12,54,6,3.244378643466575,6
433,74,11,76,6,3.229790236578266,5
434,109,16,84,7,3.226616392220337,9
435,87,12,95,5,3.2220270612599204,7
436,114,12,16,6,3.2095139798841816,6
437,93,15,5,6,3.2084119507242597,9
438,37,22,114,9,3.202781514461955,13
439,54,24,87,12,3.1999308912200175,12
440,74,52,86,24,3.1923569433787127,28
441,86,14,91,6,3.1812690370906767,8
442,90,14,74,5,3.1680613510289204,9
443,84,21,54,9,3.1584774492637115,12
444,75,15,50,6,3.1567636841259676,9
445,76,13,20,5,3.130007006131113,8
446,5,13,95,5,3.122925129209137,8
447,87,18,55,7,3.1228779611285558,11
448,8,20,48,8,3.119996469210726,12
449,55,22,84,10,3.089338762612198,12
450,2,17,37,8,3.08113164671896,9
451,8,49,54,24,3.072459467582149,25
452,76,11,88,6,3.063986784297211,5
453,63,31,5,12,3.06254528735993,19
454,8,50,96,22,3.0457764045352866,28
455,38,13,96,6,3.0422152322461717,7
456,90,10,65,5,3.027765344735429,5
457,88,11,90,5,3.0263742827452007,6
458,96,24,88,12,2.98577720327048,12
459,33,13,28,7,2.9473995278098504,6
460,28,46,54,20,2.9438119853556044,26
461,76,19,8,9,2.941917329794885,10
462,20,38,37,18,2.9380141770666848,20
463,55,10,20,4,2.907783221025639,6
464,86,11,9,6,2.904091823827273,5
465,37,11,67,5,2.896292127222718,6
466,114,15,90,7,2.866922984708622,8
467,65,13,88,6,2.8256435057944165,7
468,87,10,80,4,2.824759591911268,6
469,96,31,55,14,2.8188234933181313,17
470,65,27,20,11,2.818099115974001,16
471,28,12,89,5,2.801605415078669,7
472,57,10,87,5,2.8009386872691002,5
473,79,15,50,6,2.7998338113931376,9
474,63,16,75,8,2.7969405195200974,8
475,84,53,107,25,2.756070497755699,28
476,14,16,84,7,2.744202009506242,9
477,5,15,91,6,2.71766014432503,9
478,86,58,54,28,2.714028566095165,30
479,23,12,86,5,2.6913953048637516,7
480,98,17,54,8,2.6894762284984193,9
481,93,10,20,4,2.681687159073302,6
482,97,11,76,6,2.6606949198631935,5
483,88,15,11,7,2.660306622848361,8
484,46,18,5,8,2.660282144837708,10
485,75,17,96,6,2.629915777332828,11
486,20,33,96,15,2.6060385861975357,18
487,65,17,106,7,2.568493594459923,10
488,96,12,108,6,2.55336363887327,6
489,74,14,50,6,2.5242109778775914,8
490,39,11,50,4,2.5147259903046506,7
491,8,46,106,22,2.5079635996452634,24
492,46,10,97,4,2.4856935637597237,6
493,74,16,80,8,2.4851777101640504,8
494,96,50,54,25,2.4432934029688895,25
495,39,10,54,5,2.4307020889287747,5
496,88,11,75,5,2.4011311958613604,6
497,65,15,84,7,2.3729866166848383,8
498,8,22,50,8,2.358466045837438,14
499,65,20,74,10,2.3418899736021284,10
500,11,42,86,20,2.320673202336343,22
501,20,16,2,7,2.315728907836497,9
502,104,26,5,12,2.312081990367855,14
503,106,36,96,16,2.2984565902488905,20
504,11,13,35,6,2.2776751536044095,7
505,88,20,55,9,2.26494688861935,11
506,86,11,32,5,2.2612651114762348,6
507,16,23,5,9,2.249976675103156,14
508,97,15,55,7,2.195224664138417,8
509,96,11,14,5,2.19268862994012,6
510,107,13,38,6,2.179372128477191,7
511,5,29,107,14,2.174315189774514,15
512,86,41,55,19,2.1685890701244097,22
513,87,25,28,11,2.1378875510596975,14
514,35,12,37,6,2.089032815390569,6
515,54,19,65,9,2.0809072527497627,10
516,106,11,51,6,2.064732142648737,5
517,28,64,96,30,2.0558086605309875,34
518,8,37,16,17,2.039066649438008,20
519,63,11,38,5,2.0377552699599373,6
520,16,30,54,15,2.030734300537762,15
521,8,15,39,8,2.0305096269970417,7
522,51,18,37,7,2.0229700276706106,11
523,84,10,35,5,1.9965083140622215,5
524,55,12,90,7,1.9940592194265985,5
525,54,21,109,9,1.9827715886635058,12
526,98,17,107,8,1.9696484412943798,9
527,11,20,74,9,1.9548228575807027,11
528,87,41,107,19,1.9301722661331329,22
529,46,32,54,14,1.923818091292869,18
530,95,19,86,8,1.9115319097125791,11
531,62,10,28,5,1.893815032183228,5
532,74,20,25,9,1.8910924957233424,11
533,8,34,70,16,1.8843474596478074,18
534,51,17,87,8,1.8833490464670963,9
535,106,37,11,16,1.8759983600353716,21
536,107,12,34,6,1.8698580351185214,6
537,28,50,106,23,1.8491729543106743,27
538,2,26,50,13,1.8461136978514234,13
539,28,15,73,7,1.8127976206407082,8
540,17,10,65,6,1.8006374195790151,4
541,106,13,14,7,1.779477658135787,6
542,97,15,54,7,1.7788146482197413,8
543,86,73,28,34,1.7655146936915704,39
544,16,13,75,6,1.7465772324516469,7
545,20,27,106,12,1.727429826058266,15
546,8,12,80,5,1.7222815544039995,7
547,88,26,86,10,1.7220665197329303,16
548,85,13,54,6,1.7196059703411017,7
549,87,10,14,5,1.715650278366312,5
550,93,16,107,7,1.6955126217730305,9
551,48,12,55,5,1.6914768408443575,7
552,5,17,55,8,1.6826220381986683,9
553,87,30,20,15,1.6750220040723263,15
554,11,32,87,17,1.6577944333232217,15
555,55,21,54,10,1.6195393460702778,11
556,20,10,13,5,1.6012518493962211,5
557,84,18,80,8,1.570942028221592,10
558,86,59,20,28,1.5556128192080652,31
559,9,12,63,5,1.5537368197949128,7
560,91,12,37,6,1.5047753560040007,6
561,63,25,50,11,1.494996890500293,14
562,20,20,16,9,1.4827356605490611,11
563,106,27,50,12,1.4779046660890947,15
564,16,44,28,22,1.477883439041638,22
565,5,43,96,20,1.4607691712217459,23
566,28,42,5,21,1.4599426144439278,21
567,74,38,106,18,1.4263966612706762,20
568,86,63,5,29,1.414214654756442,34
569,106,25,55,12,1.4065571326303348,13
570,20,38,28,17,1.377543749179071,21
571,60,18,90,9,1.377207088583531,9
572,80,23,28,11,1.3633599598332944,12
573,75,10,54,5,1.3596486355164763,5
574,106,27,107,12,1.3516781039731263,15
575,28,30,37,15,1.347532788949099,15
576,79,17,28,8,1.3443965025775713,9
577,16,16,90,9,1.3115727036907034,7
578,106,16,48,8,1.2966873109190276,8
579,5,24,25,12,1.295589150150006,12
580,87,32,63,16,1.2889484863013154,16
581,33,12,20,6,1.286127202835982,6
582,84,37,96,19,1.2684027154450666,18
583,54,26,74,13,1.2592496514062275,13
584,8,34,20,16,1.252810472216638,18
585,75,17,74,7,1.2518654913136213,10
586,75,11,84,5,1.2484479349865476,6
587,76,27,96,12,1.2472960439721177,15
588,109,11,87,6,1.2284964497151856,5
589,2,19,86,8,1.2277524355686495,11
590,50,10,89,4,1.225073132431477,6
591,54,18,80,8,1.2235928560664608,10
592,86,21,30,10,1.2204804157391769,11
593,50,10,34,5,1.2099513767481038,5
594,82,11,28,6,1.1949949841809344,5
595,88,20,16,9,1.1914510987995774,11
596,86,35,16,18,1.1895001610717795,17
597,10,10,84,4,1.186679886136357,6
598,114,18,104,10,1.180355563843464,8
599,55,13,104,7,1.1790245057142883,6
600,109,12,96,6,1.1785332086119338,6
601,20,15,109,6,1.159846603781428,9
602,107,25,104,11,1.1516991064210802,14
603,5,39,37,17,1.1478252571734857,22
604,86,60,87,31,1.1327161641325862,29
605,8,53,28,24,1.1273193466024871,29
606,84,12,2,6,1.108389759283692,6
607,106,36,87,17,1.1042232432862973,19
608,63,16,104,8,1.0989587807584251,8
609,74,24,37,12,1.080219048236992,12
610,97,12,70,5,1.0662872633837654,7
611,63,37,107,17,1.0308376478711636,20
612,73,12,109,5,1.0224778207967047,7
613,70,20,107,10,1.0170699004269221,10
614,54,16,114,9,1.011032343903596,7
615,5,25,20,13,1.004187407566928,12
616,51,14,55,7,0.9973662961454701,7
617,28,11,39,6,0.9894043657226432,5
618,55,39,8,19,0.9859143320620694,20
619,95,16,74,7,0.9851522200954939,9
620,100,14,28,7,0.9692991305888411,7
621,88,20,87,9,0.9684998419166344,11
622,65,20,63,9,0.9622572852504735,11
623,63,22,97,11,0.9555568256913428,11
624,70,10,25,5,0.9515534852775879,5
625,11,28,63,15,0.942119129711844,13
626,107,14,102,7,0.9168684547097737,7
627,70,17,65,8,0.9099362463379622,9
628,87,27,84,13,0.8933576292022856,14
629,86,13,17,7,0.8741885349342235,6
630,74,17,2,9,0.8667525886050844,8
631,96,51,107,24,0.8072369681591718,27
632,11,42,28,21,0.80002515389246,21
633,71,11,28,6,0.7906121882474628,5
634,37,18,76,10,0.7903669685641044,8
635,50,23,87,11,0.7797054275713596,12
636,8,42,37,20,0.7689536473216465,22
637,8,32,90,15,0.7632563127671124,17
638,54,42,107,20,0.7580278594476431,22
639,65,16,55,7,0.7579567813833229,9
640,88,24,84,12,0.7568947749815388,12
641,28,27,48,13,0.7484805696104432,14
642,10,14,8,6,0.7361591080743034,8
643,107,22,55,11,0.6732864832670306,11
644,11,35,8,18,0.6717989227937821,17
645,11,19,48,9,0.6653817416079896,10
646,74,16,114,7,0.6603693995469326,9
647,8,31,88,16,0.6268290349547475,15
648,104,22,74,10,0.5866137400431932,12
649,74,10,91,5,0.5863595626570582,5
650,2,17,96,8,0.5793042045284421,9
651,104,13,76,6,0.5791952933362301,7
652,75,10,2,5,0.5581802915267957,5
653,50,19,16,10,0.5337635900243206,9
654,114,13,73,7,0.5332127342521746,6
655,70,21,37,11,0.5328679186303419,10
656,100,10,5,5,0.5286580931004543,5
657,16,27,11,14,0.5076788856733216,13
658,88,23,5,11,0.5053358119310012,12
659,37,15,38,7,0.4922159473383237,8
660,13,10,86,5,0.4284750679076108,5
661,65,20,16,9,0.4261404500025613,11
662,63,27,16,13,0.42109162793691096,14
663,84,14,79,8,0.41419542722796737,6
664,86,30,25,16,0.40625630030123455,14
665,37,31,50,15,0.3809470290104885,16
666,107,42,74,20,0.37250168626875535,22
667,25,11,90,6,0.35163036444831747,5
668,104,14,87,6,0.3134948185289212,8
669,54,48,20,22,0.3031885074380545,26
670,55,13,75,8,0.2901701128736263,5
671,9,17,28,7,0.28857106564612295,10
672,100,12,86,7,0.28409428109562196,5
673,63,23,74,11,0.28387790330250756,12
674,107,31,11,15,0.27128435777580023,16
675,8,28,2,14,0.24768095122823727,14
676,25,11,104,5,0.24565462151022127,6
677,11,21,46,11,0.24361069109025463,10
678,80,22,20,11,0.23432520359835018,11
679,50,25,84,12,0.2279160089784446,13
680,86,21,114,11,0.2223474219805456,10
681,107,60,8,29,0.20894288024861443,31
682,106,64,86,33,0.20101162217339585,31
683,8,11,38,6,0.19165867130515385,5
684,107,53,28,25,0.18420900903117746,28
685,96,41,87,21,0.18114836506824772,20
686,106,27,88,12,0.17435430078847314,15
687,48,13,20,7,0.17288062748629193,6
688,97,18,74,9,0.17023728727496903,9
689,20,11,30,6,0.16828840917584162,5
690,93,19,54,9,0.16287755756373165,10
691,90,24,107,11,0.15572257401909476,13
692,76,15,11,7,0.1376774645288651,8
693,80,14,37,7,0.08688615194951728,7
694,37,18,16,9,0.08671451909913487,9
695,8,50,86,24,0.08276067205969362,26
696,11,11,51,6,0.07978822497443648,5
697,109,13,48,7,0.0675018600088535,6
698,106,12,73,6,0.03447044123380808,6
699,75,21,107,9,0.033919501607410495,12
700,35,12,28,6,0.0265085475018972,6
701,28,12,35,6,-0.02650854750189661,6
702,107,21,75,12,-0.033919501607409565,9
703,73,12,106,6,-0.0344704412338069,6
704,48,13,109,6,-0.0675018600088535,7
705,51,11,11,5,-0.07978822497443616,6
706,86,50,8,26,-0.08276067205969408,24
707,16,18,37,9,-0.08671451909913526,9
708,37,14,80,7,-0.08688615194951765,7
709,54,19,93,10,-0.1628775575637335,9
710,74,18,97,9,-0.17023728727496965,9
711,20,13,48,6,-0.17288062748629165,7
712,88,27,106,15,-0.17435430078847286,12
713,87,41,96,20,-0.1811483650682465,21
714,28,53,107,28,-0.18420900903117787,25
715,38,11,8,5,-0.19165867130515354,6
716,8,60,107,31,-0.20894288024861413,29
717,114,21,86,10,-0.22234742198054458,11
718,84,25,50,13,-0.22791600897844702,12
719,20,22,80,11,-0.23432520359835107,11
720,46,21,11,10,-0.24361069109025346,11
721,104,11,25,6,-0.24565462151022063,5
722,2,28,8,14,-0.24768095122823564,14
723,74,23,63,12,-0.28387790330250773,11
724,86,12,100,5,-0.28409428109562046,7
725,28,17,9,10,-0.2885710656461217,7
726,75,13,55,5,-0.2901701128736252,8
727,20,48,54,26,-0.30318850743805464,22
728,87,14,104,8,-0.31349481852892197,6
729,90,11,25,5,-0.3516303644483168,6
730,50,31,37,16,-0.380947029010488,15
731,25,30,86,14,-0.40625630030123433,16
732,79,14,84,6,-0.414195427227968,8
733,16,27,63,14,-0.4210916279369104,13
734,16,20,65,11,-0.4261404500025613,9
735,86,10,13,5,-0.4284750679076105,5
736,38,15,37,8,-0.4922159473383237,7
737,5,23,88,12,-0.5053358119310019,11
738,5,10,100,5,-0.5286580931004561,5
739,37,21,70,10,-0.5328679186303411,11
740,73,13,114,6,-0.5332127342521755,7
741,16,19,50,9,-0.5337635900243203,10
742,2,10,75,5,-0.5581802915267943,5
743,76,13,104,7,-0.5791952933362308,6
744,96,17,2,9,-0.5793042045284422,8
745,91,10,74,5,-0.5863595626570579,5
746,74,22,104,12,-0.5866137400431928,10
747,88,31,8,15,-0.6268290349547463,16
748,114,16,74,9,-0.6603693995469326,7
749,8,35,11,17,-0.6717989227937827,18
750,55,22,107,11,-0.6732864832670304,11
751,8,14,10,8,-0.7361591080743034,6
752,48,27,28,14,-0.7484805696104441,13
753,84,24,88,12,-0.7568947749815388,12
754,55,16,65,9,-0.7579567813833243,7
755,107,42,54,22,-0.7580278594476416,20
756,90,32,8,17,-0.7632563127671115,15
757,37,42,8,22,-0.768953647321648,20
758,87,23,50,12,-0.7797054275713593,11
759,76,18,37,8,-0.7903669685641046,10
760,28,11,71,5,-0.7906121882474615,6
761,28,42,11,21,-0.80002515389246,21
762,107,51,96,27,-0.8072369681591716,24
763,2,17,74,8,-0.8667525886050853,9
764,17,13,86,6,-0.8741885349342239,7
765,84,27,87,14,-0.8933576292022849,13
766,65,17,70,9,-0.9099362463379616,8
767,63,28,11,13,-0.9421191297118439,15
768,25,10,70,5,-0.9515534852775879,5
769,97,22,63,11,-0.9555568256913415,11
770,63,20,65,11,-0.9622572852504726,9
771,87,20,88,11,-0.9684998419166352,9
772,28,14,100,7,-0.9692991305888405,7
773,74,16,95,9,-0.9851522200954943,7
774,8,39,55,20,-0.9859143320620694,19
775,39,11,28,5,-0.9894043657226448,6
776,55,14,51,7,-0.9973662961454703,7
777,20,25,5,12,-1.0041874075669264,13
778,114,16,54,7,-1.011032343903596,9
779,107,20,70,10,-1.017069900426923,10
780,109,12,73,7,-1.0224778207967002,5
781,107,37,63,20,-1.0308376478711645,17
782,70,12,97,7,-1.0662872633837661,5
783,37,24,74,12,-1.0802190482369913,12
784,104,16,63,8,-1.0989587807584247,8
785,87,36,106,19,-1.1042232432862964,17
786,2,12,84,6,-1.1083897592836933,6
787,28,53,8,29,-1.127319346602486,24
788,37,39,5,22,-1.1478252571734857,17
789,104,25,107,14,-1.1516991064210809,11
790,109,15,20,9,-1.1598466037814272,6
791,96,12,109,6,-1.1785332086119353,6
792,104,13,55,6,-1.179024505714288,7
793,104,18,114,8,-1.1803555638434642,10
794,84,10,10,6,-1.186679886136357,4
795,16,35,86,17,-1.1895001610717801,18
796,16,20,88,11,-1.1914510987995772,9
797,28,11,82,5,-1.1949949841809342,6
798,86,64,106,32,-1.2094877770467394,32
799,34,10,50,5,-1.2099513767481056,5
800,30,21,86,11,-1.2204804157391766,10
801,80,18,54,10,-1.2235928560664604,8
802,89,10,50,6,-1.2250731324314763,4
803,86,19,2,11,-1.2277524355686478,8
804,87,11,109,5,-1.2284964497151856,6
805,96,27,76,15,-1.2472960439721181,12
806,84,11,75,6,-1.2484479349865476,5
807,74,17,75,10,-1.2518654913136231,7
808,20,34,8,18,-1.252810472216638,16
809,74,26,54,13,-1.259249651406227,13
810,96,37,84,18,-1.2684027154450674,19
811,20,12,33,6,-1.286127202835983,6
812,63,32,87,16,-1.2889484863013152,16
813,25,24,5,12,-1.2955891501500059,12
814,20,22,88,10,-1.2971586949466378,12
815,90,16,16,7,-1.3115727036907021,9
816,28,17,79,9,-1.3443965025775715,8
817,37,30,28,15,-1.3475327889490984,15
818,54,10,75,5,-1.3596486355164779,5
819,28,23,80,12,-1.3633599598332946,11
820,90,18,60,9,-1.3772070885835308,9
821,28,38,20,21,-1.3775437491790712,17
822,55,25,106,13,-1.4065571326303354,12
823,5,63,86,34,-1.4142146547564407,29
824,106,38,74,20,-1.426396661270676,18
825,5,42,28,21,-1.459942614443929,21
826,96,43,5,23,-1.4607691712217454,20
827,28,44,16,22,-1.477883439041638,22
828,50,27,106,15,-1.4779046660890947,12
829,16,20,20,11,-1.482735660549062,9
830,50,25,63,14,-1.4949968905002942,11
831,37,12,91,6,-1.5047753560039994,6
832,63,12,9,7,-1.5537368197949135,5
833,20,59,86,31,-1.5556128192080652,28
834,80,18,84,10,-1.5709420282215925,8
835,13,10,20,5,-1.6012518493962198,5
836,54,21,55,11,-1.6195393460702765,10
837,87,32,11,15,-1.6577944333232226,17
838,20,30,87,15,-1.6750220040723263,15
839,55,17,5,9,-1.6826220381986678,8
840,55,12,48,7,-1.6914768408443577,5
841,14,10,87,5,-1.7156502783663115,5
842,54,13,85,7,-1.719605970341104,6
843,86,26,88,16,-1.7220665197329301,10
844,80,12,8,7,-1.7222815544039987,5
845,106,27,20,15,-1.727429826058265,12
846,75,13,16,7,-1.7465772324516466,6
847,28,73,86,39,-1.7655146936915704,34
848,54,15,97,8,-1.778814648219741,7
849,14,13,106,6,-1.7794776581357872,7
850,65,10,17,4,-1.8006374195790151,6
851,73,15,28,8,-1.8127976206407088,7
852,102,13,74,7,-1.8394444113925652,6
853,50,26,2,13,-1.846113697851424,13
854,106,50,28,27,-1.8491729543106743,23
855,34,12,107,6,-1.869858035118521,6
856,11,37,106,21,-1.8759983600353736,16
857,87,17,51,9,-1.8833490464670963,8
858,70,34,8,18,-1.8843474596478085,16
859,25,20,74,11,-1.8910924957233415,9
860,28,10,62,5,-1.893815032183228,5
861,86,19,95,11,-1.9115319097125787,8
862,54,32,46,18,-1.92381809129287,14
863,74,20,11,11,-1.954822857580702,9
864,107,17,98,9,-1.96964844129438,8
865,109,21,54,12,-1.9827715886635051,9
866,90,12,55,5,-1.9940592194265978,7
867,35,10,84,5,-1.996508314062219,5
868,37,18,51,11,-2.0229700276706115,7
869,39,15,8,7,-2.0305096269970417,8
870,54,30,16,15,-2.0307343005377616,15
871,38,11,63,6,-2.0377552699599373,5
872,16,37,8,20,-2.0390666494380083,17
873,96,64,28,34,-2.055808660530986,30
874,51,11,106,5,-2.0647321426487375,6
875,65,19,54,10,-2.080907252749764,9
876,37,12,35,6,-2.0890328153905666,6
877,28,25,87,14,-2.1378875510596966,11
878,55,41,86,22,-2.1685890701244097,19
879,107,29,5,15,-2.1743151897745134,14
880,38,13,107,7,-2.1793721284771914,6
881,14,11,96,6,-2.19268862994012,5
882,55,15,97,8,-2.1952246641384163,7
883,87,60,86,30,-2.208424062664152,30
884,5,23,16,14,-2.2499766751031545,9
885,32,11,86,6,-2.2612651114762348,5
886,55,20,88,11,-2.2649468886193502,9
887,35,13,11,7,-2.277675153604409,6
888,96,36,106,20,-2.2984565902488896,16
889,5,26,104,14,-2.312081990367854,12
890,2,16,20,9,-2.3157289078364967,7
891,74,42,107,23,-2.333671068233484,19
892,74,20,65,10,-2.341889973602131,10
893,11,31,107,17,-2.3532996452562522,14
894,50,22,8,14,-2.358466045837439,8
895,84,15,65,8,-2.3729866166848383,7
896,75,11,88,6,-2.4011311958613617,5
897,54,10,39,5,-2.4307020889287743,5
898,54,50,96,25,-2.4432934029688886,25
899,88,22,20,13,-2.4468919433496605,9
900,80,16,74,8,-2.4851777101640518,8
901,97,10,46,6,-2.4856935637597224,4
902,106,46,8,24,-2.507963599645265,22
903,50,11,39,7,-2.5147259903046506,4
904,50,14,74,8,-2.524210977877591,6
905,108,12,96,6,-2.5533636388732703,6
906,106,17,65,10,-2.568493594459923,7
907,96,33,20,18,-2.6060385861975353,15
908,96,17,75,11,-2.629915777332827,6
909,5,18,46,10,-2.6602821448377076,8
910,11,15,88,8,-2.660306622848362,7
911,76,11,97,5,-2.6606949198631926,6
912,54,17,98,9,-2.6894762284984184,8
913,86,12,23,7,-2.6913953048637516,5
914,54,58,86,30,-2.7140285660951644,28
915,91,15,5,9,-2.71766014432503,6
916,84,16,14,9,-2.744202009506241,7
917,14,12,107,6,-2.752826564735613,6
918,107,53,84,28,-2.7560704977557,25
919,75,16,63,8,-2.7969405195200965,8
920,50,15,79,9,-2.7998338113931363,6
921,87,10,57,5,-2.8009386872691002,5
922,89,12,28,7,-2.801605415078669,5
923,20,27,65,16,-2.818099115974002,11
924,55,31,96,17,-2.8188234933181313,14
925,80,10,87,6,-2.824759591911268,4
926,88,13,65,7,-2.825643505794417,6
927,90,15,114,8,-2.866922984708621,7
928,67,11,37,6,-2.896292127222718,5
929,11,27,16,14,-2.8981408824101362,13
930,9,11,86,5,-2.9040918238272733,6
931,20,10,55,6,-2.907783221025638,4
932,37,38,20,20,-2.9380141770666843,18
933,8,19,76,10,-2.941917329794886,9
934,54,46,28,26,-2.943811985355604,20
935,28,13,33,6,-2.947399527809851,7
936,88,24,96,12,-2.985777203270479,12
937,90,11,88,6,-3.026374282745202,5
938,65,10,90,5,-3.027765344735429,5
939,96,13,38,7,-3.0422152322461713,6
940,96,50,8,28,-3.045776404535286,22
941,5,31,63,19,-3.062545287359932,12
942,88,11,76,5,-3.063986784297211,6
943,54,49,8,25,-3.0724594675821497,24
944,37,17,2,9,-3.08113164671896,8
945,84,22,55,12,-3.089338762612198,10
946,107,12,14,7,-3.1146710636183896,5
947,48,20,8,12,-3.119996469210726,8
948,55,18,87,11,-3.1228779611285558,7
949,95,13,5,8,-3.122925129209137,5
950,20,13,76,8,-3.130007006131113,5
951,50,15,75,9,-3.1567636841259703,6
952,54,21,84,12,-3.1584774492637115,9
953,74,14,90,9,-3.168061351028922,5
954,91,14,86,8,-3.1812690370906784,6
955,86,52,74,28,-3.1923569433787113,24
956,87,24,54,12,-3.199930891220017,12
957,114,22,37,13,-3.2027815144619565,9
958,5,15,93,9,-3.2084119507242614,6
959,16,12,114,6,-3.209513979884182,6
960,95,12,87,7,-3.2220270612599187,5
961,84,16,109,9,-3.226616392220337,7
962,76,11,74,5,-3.229790236578266,6
963,54,12,17,6,-3.2443786434665753,6
964,84,62,86,32,-3.2556113214049716,30
965,96,20,65,11,-3.2670140800116547,9
966,84,17,51,10,-3.283273119257878,7
967,97,26,28,15,-3.303247535220201,11
968,106,22,5,11,-3.3051198302733824,11
969,28,22,51,13,-3.310120573345564,9
970,86,61,63,36,-3.3220512619028586,25
971,106,30,54,16,-3.348177634825244,14
972,9,10,20,6,-3.353443346624384,4
973,28,20,55,13,-3.3574009350442124,7
974,8,14,9,9,-3.4085412508397837,5
975,55,15,37,8,-3.4138095727197832,7
976,5,32,8,17,-3.419692044575383,15
977,107,10,23,6,-3.4694839628849055,4
978,37,10,57,6,-3.489500153682902,4
979,106,17,97,9,-3.5043200805574863,8
980,107,41,87,23,-3.504378946911036,18
981,84,15,91,8,-3.5069437670955055,7
982,104,13,51,7,-3.507277016497256,6
983,48,19,84,11,-3.535703896861128,8
984,46,23,86,13,-3.53730846609779,10
985,54,23,11,12,-3.5626284863355515,11
986,107,24,90,14,-3.587768992457369,10
987,65,16,87,9,-3.6538862860446715,7
988,84,25,8,15,-3.6608734975068673,10
989,32,10,37,5,-3.674911859501994,5
990,71,13,75,8,-3.6847064190257015,5
991,11,34,50,20,-3.7018008844187023,14
992,87,19,90,10,-3.7262927176583673,9
993,107,57,86,30,-3.764794628081207,27
994,107,21,46,13,-3.7858000639811693,8
995,8,17,102,10,-3.7943727477668934,7
996,97,24,86,13,-3.801856449037874,11
997,107,27,106,16,-3.83408094673828,11
998,55,21,63,12,-3.8388576979319176,9
999,55,13,80,6,-3.8447436848053296,7
1000,86,42,11,23,-3.857398771667153,19
1001,107,25,65,15,-3.8847328719224157,10
1002,84,13,93,8,-3.91586804100007,5
1003,96,21,37,11,-3.919945326141697,10
1004,65,13,50,6,-3.9320644465981482,7
1005,28,18,76,11,-3.937083310529341,7
1006,5,41,74,22,-3.9527437492180035,19
1007,74,53,8,31,-4.010168343975989,22
1008,95,14,28,8,-4.040550234811,6
1009,106,37,63,21,-4.042568329293666,16
1010,79,13,11,6,-4.047561716338114,7
1011,51,19,8,9,-4.05944709438689,10
1012,48,19,11,11,-4.0623540527603055,8
1013,95,16,54,9,-4.078811356006668,7
1014,90,16,84,9,-4.100528600599519,7
1015,86,30,65,17,-4.119813593278432,13
1016,90,34,86,20,-4.124931636943059,14
1017,73,13,20,8,-4.146065391689571,5
1018,55,11,74,6,-4.181300299067087,5
1019,70,22,84,13,-4.182188769343141,9
1020,70,17,63,9,-4.20425277286591,8
1021,11,10,65,6,-4.281072376862916,4
1022,74,24,87,14,-4.342799946619222,10
1023,98,10,76,5,-4.379545503881031,5
1024,20,42,107,23,-4.400812570612912,19
1025,96,10,33,4,-4.401522257584364,6
1026,11,15,76,9,-4.440509058655133,6
1027,91,10,87,6,-4.4896036768148715,4
1028,74,13,102,7,-4.496641284185785,6
1029,8,12,79,8,-4.523368231395376,4
1030,96,12,95,7,-4.548367780459663,5
1031,86,24,98,13,-4.5630101641254415,11
1032,86,13,62,7,-4.563398493117803,6
1033,114,28,25,14,-4.5658645828256,14
1034,46,19,8,10,-4.571464349413289,9
1035,8,20,14,12,-4.5745163624627505,8
1036,37,14,65,8,-4.574583590431904,6
1037,84,10,34,5,-4.5777103073061465,5
1038,107,19,97,10,-4.579839642750203,9
1039,86,13,83,6,-4.59847796408123,7
1040,98,10,104,5,-4.672200096826948,5
1041,35,19,20,11,-4.681781057889634,8
1042,57,14,8,9,-4.683699755799596,5
1043,75,13,46,8,-4.683703940633832,5
1044,9,11,55,6,-4.690967100580704,5
1045,54,17,102,10,-4.6916495776952525,7
1046,5,28,114,16,-4.694432433116341,12
1047,106,12,95,7,-4.699195682867778,5
1048,79,13,16,7,-4.716412220610577,6
1049,62,12,74,7,-4.762498174936739,5
1050,25,22,96,12,-4.7937742241035854,10
1051,25,19,107,11,-4.802339370319193,8
1052,37,15,98,8,-4.814565641664852,7
1053,107,34,114,20,-4.829411961485131,14
1054,86,13,85,7,-4.833314993475175,6
1055,2,22,28,13,-4.837290355461167,9
1056,65,11,114,6,-4.839210532612239,5
1057,96,27,97,15,-4.847267990402032,12
1058,106,32,84,17,-4.851744201560307,15
1059,90,21,96,13,-4.864601116977013,8
1060,108,13,74,7,-4.90910548020127,6
1061,104,26,8,14,-4.911621506512688,12
1062,35,13,86,7,-4.963361102394038,6
1063,73,12,96,6,-5.035390942293941,6
1064,86,30,50,16,-5.118847118423947,14
1065,65,25,28,14,-5.172274670876916,11
1066,54,11,25,6,-5.180889000134091,5
1067,37,20,75,14,-5.205769951831413,6
1068,84,43,28,25,-5.219221803540025,18
1069,70,14,20,8,-5.220897363934605,6
1070,74,12,34,8,-5.239541245293498,4
1071,5,16,109,9,-5.276059587848939,7
1072,28,54,50,31,-5.279941331032883,23
1073,51,16,16,8,-5.285051160663567,8
1074,48,16,106,9,-5.330591930412405,7
1075,104,14,54,9,-5.334409503258776,5
1076,37,18,90,11,-5.349002601490298,7
1077,97,11,88,7,-5.351571329720363,4
1078,102,12,109,7,-5.392570444511439,5
1079,96,34,63,21,-5.39321635342965,13
1080,88,27,54,15,-5.434189753382354,12
1081,88,11,2,7,-5.477658376983314,4
1082,8,20,93,11,-5.491132662741161,9
1083,107,20,91,12,-5.505802548817647,8
1084,108,16,107,10,-5.514649447329664,6
1085,102,14,107,8,-5.527045162702203,6
1086,54,44,50,25,-5.5299964090385,19
1087,50,12,9,8,-5.578106204160814,4
1088,8,22,73,13,-5.596510667207431,9
1089,84,11,38,6,-5.627456024192355,5
1090,70,10,114,6,-5.636681816492889,4
1091,63,42,8,24,-5.64956003887175,18
1092,37,42,107,25,-5.6850333938037885,17
1093,28,10,57,6,-5.686962256713207,4
1094,106,10,102,5,-5.6912957732881875,5
1095,9,12,84,7,-5.723245457590759,5
1096,39,14,84,8,-5.735188058057851,6
1097,54,25,5,16,-5.741523774218407,9
1098,28,25,104,16,-5.749142721940425,9
1099,108,12,16,7,-5.770631208900042,5
1100,109,28,28,17,-5.815001302128311,11
1101,11,14,39,10,-5.821131817679595,4
1102,96,12,30,7,-5.827709187189811,5
1103,70,17,5,10,-5.831365434421651,7
1104,50,11,108,7,-5.852974916650042,4
1105,93,11,106,6,-5.8657901820682214,5
1106,11,10,33,5,-5.887923901561768,5
1107,70,39,54,22,-5.888091541631834,17
1108,114,17,102,11,-5.942519865747698,6
1109,76,10,109,5,-5.969855218128682,5
1110,98,15,28,10,-5.973059566412095,5
1111,46,12,87,7,-5.996729580761838,5
1112,102,22,28,12,-6.002196336125345,10
1113,107,15,51,10,-6.010709658258435,5
1114,8,15,95,9,-6.0338613483047085,6
1115,75,24,86,13,-6.0404838152681,11
1116,25,24,37,13,-6.0405874199244165,11
1117,87,29,5,16,-6.079041134915277,13
1118,39,15,63,9,-6.098512313477011,6
1119,79,10,55,6,-6.105260957218082,4
1120,82,17,86,11,-6.124344607685839,6
1121,84,17,37,10,-6.135362755463087,7
1122,107,13,71,8,-6.143176064124285,5
1123,106,12,46,7,-6.1479645161124665,5
1124,25,19,102,12,-6.161400465362891,7
1125,97,12,20,7,-6.196901748083682,5
1126,93,13,65,7,-6.214442146672824,6
1127,48,23,86,14,-6.215181955253337,9
1128,37,33,87,20,-6.328985291620955,13
1129,96,76,86,46,-6.3297963702492925,30
1130,106,11,34,7,-6.348877012003049,4
1131,96,36,74,22,-6.391187863501184,14
1132,104,27,37,16,-6.397100518327712,11
1133,8,15,109,8,-6.403030229228608,7
1134,18,10,50,5,-6.440154509710172,5
1135,106,27,76,19,-6.448811985872448,8
1136,28,17,14,11,-6.462988674713606,6
1137,104,21,86,12,-6.468213518700147,9
1138,84,27,74,15,-6.529493156115414,12
1139,86,16,38,9,-6.564447252990193,7
1140,104,18,106,11,-6.586828379052247,7
1141,28,15,93,10,-6.588443137697581,5
1142,76,11,54,7,-6.60321190549357,4
1143,96,12,85,8,-6.610954135702339,4
1144,51,14,54,8,-6.622588079460445,6
1145,63,21,37,13,-6.667064334500574,8
1146,2,10,46,6,-6.670222065576342,4
1147,11,21,5,12,-6.692287385746942,9
1148,70,22,96,11,-6.734945499709392,11
1149,108,10,48,7,-6.749808304712144,3
1150,63,12,51,7,-6.799312029973925,5
1151,80,11,11,7,-6.802148460786961,4
1152,63,22,80,14,-6.84351888546065,8
1153,107,16,93,10,-6.84358224943044,6
1154,86,39,37,23,-6.893488734465289,16
1155,86,12,93,8,-6.922029970425322,4
1156,90,22,54,13,-6.925522493440474,9
1157,86,17,44,10,-6.949446042817987,7
1158,25,16,97,9,-6.959301134276736,7
1159,87,18,76,11,-6.973978842387907,7
1160,48,11,50,7,-7.058211213950958,4
1161,80,21,86,12,-7.071945289109108,9
1162,79,12,63,8,-7.1114844508040305,4
1163,17,11,50,7,-7.1506486626795,4
1164,109,15,11,9,-7.174727842093128,6
1165,17,12,28,7,-7.1764207337069505,5
1166,48,28,63,18,-7.208356975606329,10
1167,75,19,28,11,-7.22576760720638,8
1168,76,18,63,12,-7.244525780520105,6
1169,114,13,88,8,-7.320732624891944,5
1170,107,22,48,13,-7.3302788653741935,9
1171,25,11,63,7,-7.385187766970543,4
1172,46,26,74,17,-7.428235200256031,9
1173,25,12,88,7,-7.434876792293262,5
1174,84,17,16,10,-7.471140311704607,7
1175,106,27,37,15,-7.475043034461926,12
1176,91,15,8,9,-7.483090394261755,6
1177,51,17,20,9,-7.493698730314256,8
1178,84,10,30,7,-7.509917010745373,3
1179,5,16,76,10,-7.518744663128344,6
1180,70,19,28,11,-7.544208909658003,8
1181,107,10,85,6,-7.595499375056905,4
1182,46,12,63,8,-7.600674717701954,4
1183,97,14,2,9,-7.627801324727646,5
1184,2,11,5,7,-7.6305247779359915,4
1185,80,22,96,14,-7.6325568595370585,8
1186,30,11,20,6,-7.656389685768439,5
1187,108,10,55,6,-7.6603824871739565,4
1188,70,14,76,9,-7.7067801731883225,5
1189,25,22,8,14,-7.717252659656068,8
1190,106,10,79,6,-7.723339908977311,4
1191,28,23,46,16,-7.750583309014615,7
1192,91,13,16,9,-7.754521449385596,4
1193,79,20,48,12,-7.7777328666170344,8
1194,106,15,2,9,-7.7784811907437925,6
1195,96,14,114,9,-7.889762565328155,5
1196,70,13,88,8,-7.915858076944355,5
1197,106,24,80,15,-7.94893708145332,9
1198,34,12,96,8,-7.949755484984076,4
1199,37,11,102,7,-7.952535167308898,4
1200,107,17,76,11,-7.96185690932956,6
1201,37,18,97,11,-7.973109918201967,7
1202,96,19,102,12,-7.995631160966494,7
1203,91,18,28,11,-8.014570368036852,7
1204,74,20,73,13,-8.015220364277019,7
1205,48,14,16,8,-8.053586068768565,6
1206,104,17,16,10,-8.057707930282644,7
1207,88,20,63,12,-8.08784367057243,8
1208,65,14,80,9,-8.117894882236024,5
1209,84,15,46,10,-8.1299363673888,5
1210,95,11,20,7,-8.186467596031179,4
1211,93,17,74,10,-8.19338693451652,7
1212,108,12,86,7,-8.204205290543772,5
1213,87,43,8,27,-8.206684755768938,16
1214,44,11,20,7,-8.212958514210372,4
1215,20,20,11,14,-8.234400855107406,6
1216,74,23,20,15,-8.253501420150274,8
1217,37,11,89,6,-8.260841827542206,5
1218,86,13,69,8,-8.329501489122974,5
1219,63,17,98,10,-8.359697866117662,7
1220,114,13,50,8,-8.388183657848245,5
1221,70,26,86,15,-8.43107057555043,11
1222,5,10,32,7,-8.444026138330047,3
1223,84,22,5,14,-8.484507375916774,8
1224,88,17,50,10,-8.503859481033006,7
1225,20,27,63,16,-8.518828390562922,11
1226,70,21,106,13,-8.519014816449403,8
1227,100,13,8,9,-8.541127622546782,4
1228,5,22,90,15,-8.559685419611386,7
1229,5,11,57,7,-8.61073460335844,4
1230,18,12,28,7,-8.658858567038083,5
1231,91,12,106,9,-8.70066752710923,3
1232,98,10,73,7,-8.72433500141915,3
1233,51,27,86,16,-8.740860643352914,11
1234,67,12,8,8,-8.77235690116511,4
1235,96,11,7,8,-8.775501150402919,3
1236,46,16,37,11,-8.822890347017472,5
1237,76,11,84,7,-8.826925911567171,4
1238,114,20,28,11,-8.84184705741822,9
1239,11,10,32,7,-8.93942284417249,3
1240,107,12,57,7,-8.988403130065704,5
1241,28,38,63,25,-9.045203898145056,13
1242,96,26,50,17,-9.051096363617633,9
1243,87,10,23,6,-9.096524698327546,4
1244,28,11,30,7,-9.144215115290798,4
1245,8,15,30,10,-9.185211827951933,5
1246,16,10,2,7,-9.214178381730255,3
1247,50,14,76,10,-9.228465475536328,4
1248,46,14,20,10,-9.238657962224787,4
1249,8,14,97,9,-9.2569642199044,5
1250,65,11,2,8,-9.274625860779656,3
1251,63,14,108,9,-9.298531248541147,5
1252,80,13,90,9,-9.30675268400111,4
1253,107,25,2,17,-9.348454105798005,8
1254,102,16,50,9,-9.414224162201034,7
1255,2,18,63,11,-9.42432372295896,7
1256,2,13,87,8,-9.430732046556471,5
1257,104,16,96,10,-9.433481460132812,6
1258,50,17,90,11,-9.438413402091001,6
1259,28,24,88,16,-9.449291017909664,8
1260,20,19,114,13,-9.4563238382298,6
1261,87,12,79,9,-9.532024747647966,3
1262,107,28,50,18,-9.593575141846495,10
1263,5,25,50,15,-9.615141407944582,10
1264,107,27,88,18,-9.61825941366417,9
1265,32,10,8,6,-9.695711025914951,4
1266,57,12,88,7,-9.696740487129196,5
1267,106,14,98,9,-9.701360201061403,5
1268,70,16,74,9,-9.770873759550815,7
1269,84,22,20,16,-9.790302500691977,6
1270,96,24,98,15,-9.85522726903532,9
1271,79,23,86,15,-9.865377107457421,8
1272,96,17,51,11,-9.900170566840332,6
1273,107,12,95,8,-9.937496129371693,4
1274,76,20,86,13,-9.940010233613185,7
1275,75,14,106,7,-10.013304733371458,7
1276,70,12,55,8,-10.141434019068976,4
1277,107,24,16,17,-10.150129279172639,7
1278,96,38,16,27,-10.237680582890105,11
1279,37,19,11,13,-10.335627850347763,6
1280,96,22,48,15,-10.412031756955415,7
1281,25,20,28,14,-10.436683701799446,6
1282,55,20,16,14,-10.518672310475317,6
1283,20,28,50,18,-10.55852475439555,10
1284,98,11,50,8,-10.691401226426704,3
1285,93,15,87,10,-10.798658757671168,5
1286,33,10,86,7,-10.827935889094652,3
1287,114,10,97,6,-10.862239910215562,4
1288,16,13,30,9,-10.88272905219503,4
1289,20,10,93,7,-10.918598563325158,3
1290,5,16,97,11,-11.001465278853818,5
1291,65,12,8,8,-11.180766905333911,4
1292,109,11,50,8,-11.21767101593788,3
1293,87,18,48,12,-11.267245216521085,6
1294,106,20,90,14,-11.319121838741875,6
1295,84,19,11,13,-11.37372999446702,6
1296,8,15,71,10,-11.554874198552197,5
1297,98,10,91,7,-11.6111736728835,3
1298,11,27,55,20,-11.6164966741785,7
1299,107,15,80,12,-11.678062977381893,3
1300,14,12,86,8,-11.685325963112222,4
1301,5,14,83,10,-11.757143877932297,4
1302,109,20,86,15,-11.786893718585256,5
1303,8,16,75,12,-11.79422076295848,4
1304,98,12,16,8,-11.817599398499153,4
1305,90,14,20,9,-11.888155002258594,5
1306,5,15,73,10,-11.910694863368754,5
1307,104,12,88,8,-11.911529882206116,4
1308,87,10,30,7,-11.954020606538128,3
1309,5,10,30,8,-12.011638874309805,2
1310,106,10,38,6,-12.053515342420265,4
1311,86,20,102,15,-12.1034579806225,5
1312,96,17,46,10,-12.129227204168037,7
1313,25,18,20,12,-12.230511176411236,6
1314,70,12,16,9,-12.32897058948645,3
1315,46,13,25,9,-12.405977888292133,4
1316,96,38,11,26,-12.433764526276038,12
1317,54,39,63,27,-12.439421659836581,12
1318,107,17,73,11,-12.476279417058619,6
1319,16,13,102,8,-12.5199716267179,5
1320,54,27,37,18,-12.577195310341336,9
1321,109,10,74,7,-12.618760256813067,3
1322,87,10,98,7,-12.766560909926936,3
1323,37,14,17,9,-12.777771600020978,5
1324,96,10,78,7,-12.899686199305037,3
1325,11,10,95,7,-12.962395970965863,3
1326,87,11,102,8,-13.031920315209861,3
1327,107,10,17,7,-13.095515887019285,3
1328,14,10,80,6,-13.097202558791372,4
1329,54,19,48,13,-13.122325082638987,6
1330,84,10,97,8,-13.131531307588403,2
1331,55,11,76,9,-13.17189682864644,2
1332,97,11,90,7,-13.1785612401278,4
1333,39,11,86,7,-13.181031933377376,4
1334,114,15,8,11,-13.19160663168953,4
1335,8,10,34,7,-13.309346330253714,3
1336,109,14,63,10,-13.37185268786884,4
1337,28,11,69,7,-13.387342269628983,4
1338,98,11,20,9,-13.406928147400139,2
1339,50,12,104,9,-13.423441976007842,3
1340,73,18,86,12,-13.498917483420348,6
1341,74,12,51,9,-13.51982642182268,3
1342,25,10,50,7,-13.663219852775494,3
1343,70,15,87,10,-13.709203230326098,5
1344,5,10,75,7,-13.751440551521483,3
1345,98,12,8,9,-13.75863137087373,3
1346,54,11,73,8,-13.856140526530867,3
1347,87,35,16,24,-13.946774997819576,11
1348,23,11,106,7,-13.97766613867425,4
1349,48,10,90,7,-14.062301149493257,3
1350,87,10,73,8,-14.104045620374126,2
1351,46,25,88,19,-14.19918114796437,6
1352,74,23,16,17,-14.22296330279235,6
1353,35,14,107,11,-14.477847243885742,3
1354,63,11,14,7,-14.53302527333945,4
1355,37,12,73,8,-14.533349572792924,4
1356,84,33,63,23,-14.557123158417973,10
1357,35,11,80,8,-14.578551377058158,3
1358,46,15,16,11,-14.631771355053408,4
1359,5,15,102,10,-14.700985080882877,5
1360,20,13,91,9,-14.874187006920964,4
1361,50,12,80,10,-14.926124931290454,2
1362,54,14,100,10,-14.930697835147344,4
1363,96,12,91,9,-15.083901067533665,3
1364,90,14,73,10,-15.18129739743865,4
1365,70,16,2,11,-15.20234077608459,5
1366,106,30,16,23,-15.27216594275733,7
1367,28,24,74,18,-15.315195079920043,6
1368,11,10,93,8,-15.321419061771829,2
1369,28,13,34,10,-15.421948286719397,3
1370,98,13,11,9,-15.616050281557111,4
1371,9,11,48,8,-15.643745764186933,3
1372,100,10,104,8,-16.261939899306377,2
1373,70,13,11,10,-16.32604658673946,3
1374,46,12,104,9,-16.404842044640546,3
1375,88,12,95,9,-16.531666289371188,3
1376,63,12,90,9,-16.840668609829063,3
1377,109,13,114,11,-16.93450262104073,2
1378,106,10,35,7,-17.319051156851785,3
1379,87,11,34,8,-17.33811535027782,3
1380,88,11,102,9,-17.376601399361864,2
1381,106,12,114,9,-17.530744904632478,3
1382,86,13,41,11,-17.568343007541298,2
1383,96,14,93,11,-17.771004816118815,3
1384,25,14,11,11,-17.774778708310116,3
1385,28,23,90,18,-17.842079516061677,5
1386,102,11,104,8,-17.918506819753233,3
1387,50,10,93,8,-18.033846876611463,2
1388,91,17,63,13,-18.120595699414864,4
1389,70,10,50,7,-18.669208398142956,3
1390,32,11,107,9,-19.05312990423956,2
1391,112,14,28,11,-19.249826897720947,3
1392,2,13,104,10,-19.626967622722084,3
1393,97,10,38,9,-19.67073344994079,1
1394,54,13,2,11,-19.75997048475248,2
1395,66,10,107,8,-20.152222817707916,2
1396,104,10,65,9,-20.258723268915208,1
1397,98,14,5,11,-21.043629991929123,3
1398,55,18,50,14,-21.38404284403115,4
1399,51,10,34,9,-22.213174768846976,1
1400,109,14,88,13,-24.411419565336224,1
1401,35,14,76,11,-24.655683082961918,3
1402,35,10,48,9,-25.15519793083891,1
1403,106,13,25,10,-25.179665157562322,3
1404,54,11,30,10,-25.713620235434703,1
1405,107,12,30,11,-27.89865943808827,1
1406,37,13,88,12,-28.252272733952864,1
1407,37,10,95,10,-33.05724191683926,0
