,againstHero,games,hero,losses,shift,wins
0,64,11,65,2,27.727149312498728,9
1,91,10,43,0,27.34458455824453,10
2,46,11,30,2,24.436531907478123,9
3,55,11,89,2,24.169792122479972,9
4,103,15,86,2,23.967936503754764,13
5,65,10,97,3,23.53209680517744,7
6,6,10,12,3,23.4207865353791,7
7,57,13,41,2,23.15616213187528,11
8,26,10,10,2,22.77202326046866,8
9,84,10,94,1,22.762013140609877,9
10,20,11,85,2,22.58682017719025,9
11,107,11,73,2,22.13453383862815,9
12,17,11,44,2,22.072912946241175,9
13,111,25,70,6,21.76194128198864,19
14,74,14,110,3,20.875047711546735,11
15,37,10,104,2,20.681486856575926,8
16,28,10,71,1,20.618030954774138,9
17,87,13,85,2,20.571580164340972,11
18,18,11,37,2,20.49673353679967,9
19,110,12,109,2,20.16933250309851,10
20,51,12,98,3,20.0679948728163,9
21,90,12,76,4,19.849308288721737,8
22,5,11,9,2,19.80151383215592,9
23,41,13,10,2,19.737157878272868,11
24,87,19,46,5,19.57398065475983,14
25,87,30,109,7,19.45596890113392,23
26,62,14,50,3,19.293193829496534,11
27,110,12,29,2,19.248543702222978,10
28,63,15,28,3,19.065782846243966,12
29,62,12,71,1,19.04348733516107,11
30,26,11,88,3,18.785991491960512,8
31,88,15,75,3,18.461574020804573,12
32,79,13,7,3,18.404801500191937,10
33,58,12,87,2,18.330309566002583,10
34,63,17,86,3,17.9646938905751,14
35,64,11,9,3,17.707873254379976,8
36,63,16,70,4,17.68149233309164,12
37,41,10,110,1,17.607251464829996,9
38,57,19,28,4,17.559820084625652,15
39,88,19,49,4,17.532034552741443,15
40,37,10,89,2,17.418835616565147,8
41,26,11,49,4,17.344464565076983,7
42,26,13,54,5,16.93978716229654,8
43,43,14,38,5,16.91598228541753,9
44,38,12,15,3,16.880495720481193,9
45,70,18,86,5,16.806348175717314,13
46,73,16,109,4,16.722107664046142,12
47,63,11,10,3,16.316509167938314,8
48,62,13,103,4,16.29915650058687,9
49,59,11,103,3,16.266656443008642,8
50,55,14,75,3,16.265128193907934,11
51,17,14,37,5,16.224073122382876,9
52,30,25,65,6,16.220777761486314,19
53,90,18,88,5,16.196945416210344,13
54,90,12,91,4,16.098702445179015,8
55,46,15,79,5,15.695062063539163,10
56,17,15,38,4,15.678044683298898,11
57,29,12,73,3,15.669782329836798,9
58,46,10,107,2,15.65139707745225,8
59,16,10,59,4,15.561569445873218,6
60,39,11,54,3,15.528226686771601,8
61,106,19,87,4,15.497991654896767,15
62,70,13,88,3,15.44587119057327,10
63,74,11,112,3,15.445414304360199,8
64,63,16,76,3,15.315183161564981,13
65,90,11,18,3,15.206260273523743,8
66,84,14,40,5,15.139436492633184,9
67,57,15,37,4,15.067776643574769,11
68,73,14,23,4,15.06705739412856,10
69,55,13,85,4,14.980602580320598,9
70,26,24,38,7,14.873702675608982,17
71,93,11,17,3,14.792328082005683,8
72,93,25,38,8,14.706979782976543,17
73,49,11,62,4,14.691411076024671,7
74,90,11,93,4,14.682520064465667,7
75,88,14,13,6,14.6368480815469,8
76,62,19,20,5,14.584809923949425,14
77,55,15,11,4,14.552741756285249,11
78,111,31,62,9,14.463263378850396,22
79,104,10,50,3,14.369017199502489,7
80,28,10,66,4,14.329185091749263,6
81,46,11,91,3,14.304066831342244,8
82,60,10,8,3,14.262033464961128,7
83,50,12,109,4,14.261856398454313,8
84,57,14,76,4,14.156354151485953,10
85,30,14,85,4,14.008346410378739,10
86,57,20,9,5,13.952239963411898,15
87,30,27,54,8,13.923397923845725,19
88,70,12,109,3,13.902253335630233,9
89,55,22,2,7,13.871872112800908,15
90,38,16,73,6,13.771113964229547,10
91,111,16,109,5,13.722443192828694,11
92,37,10,13,3,13.710588735524032,7
93,26,13,69,4,13.66583811938565,9
94,84,17,13,6,13.614397809771186,11
95,106,13,20,5,13.604914514810027,8
96,37,12,5,3,13.593067112324485,9
97,28,29,109,9,13.560226410906258,20
98,107,27,62,9,13.491527071908125,18
99,13,15,73,5,13.471561712276639,10
100,10,24,23,9,13.345513564331808,15
101,30,12,62,4,13.325811773490166,8
102,18,13,2,4,13.31796160775977,9
103,89,12,73,4,13.292782754035754,8
104,58,10,89,3,13.242354787086834,7
105,55,17,109,5,13.091080409868951,12
106,30,24,9,7,13.086601208658116,17
107,107,15,70,5,13.053888487638648,10
108,3,11,8,3,12.917286316124727,8
109,6,14,66,4,12.900366001703459,10
110,86,14,17,4,12.845058614378047,10
111,2,21,76,7,12.801773404860658,14
112,69,10,41,4,12.786110356364535,6
113,26,35,107,9,12.719830578595298,26
114,73,11,90,3,12.699639901607053,8
115,46,21,9,8,12.65253338448702,13
116,86,13,109,5,12.564742847433584,8
117,13,10,86,3,12.514933779078898,7
118,51,16,48,4,12.491719199285038,12
119,107,10,66,3,12.465793182898505,7
120,93,22,62,7,12.439036445917942,15
121,20,18,23,5,12.419097927334024,13
122,9,11,97,4,12.349501112253755,7
123,93,12,26,4,12.342400061412198,8
124,93,17,50,6,12.303370496346986,11
125,63,16,9,6,12.275723948784513,10
126,8,14,66,4,12.246420589176186,10
127,93,20,41,5,12.152619394683915,15
128,54,27,109,9,12.131563798369136,18
129,58,11,103,3,12.093407699535737,8
130,79,11,112,3,12.089617166544242,8
131,104,11,48,3,12.069826525059822,8
132,63,20,79,7,12.045237433446486,13
133,29,11,70,3,12.030336124564109,8
134,38,15,10,4,12.029907406435383,11
135,14,11,65,3,11.952914938466222,8
136,93,10,76,3,11.9232506042626,7
137,18,13,17,5,11.905263091036245,8
138,43,14,109,5,11.866460109925438,9
139,85,17,37,4,11.836833776252563,13
140,23,15,62,4,11.828374088275869,11
141,50,11,37,4,11.791517943036679,7
142,37,14,63,5,11.788951691627307,9
143,26,14,46,5,11.785571142877396,9
144,104,18,98,7,11.758094591275455,11
145,15,10,79,3,11.756403792330063,7
146,93,15,48,4,11.743861625157336,11
147,70,13,62,5,11.719880801732709,8
148,46,11,86,3,11.702567693743317,8
149,93,13,75,5,11.701725422413729,8
150,10,18,55,7,11.634204977110192,11
151,98,17,15,6,11.628891195956703,11
152,30,26,103,8,11.5945127814643,18
153,65,16,18,5,11.593628436717697,11
154,74,22,48,8,11.585683993127107,14
155,16,18,13,6,11.568229122492738,12
156,65,16,102,6,11.565057266886955,10
157,38,22,109,7,11.561969316834697,15
158,107,10,7,3,11.56115244063066,7
159,109,15,6,5,11.553622356231047,10
160,16,28,70,8,11.544275868635912,20
161,41,31,109,7,11.540113156994366,24
162,43,17,28,5,11.503038032270851,12
163,17,20,41,5,11.462467383182338,15
164,34,15,91,5,11.445515293888622,10
165,87,15,5,5,11.40194095276914,10
166,2,22,103,6,11.358008021341288,16
167,39,10,2,4,11.302944205280658,6
168,13,13,41,5,11.285884419294261,8
169,98,12,71,4,11.256798740703502,8
170,93,14,1,4,11.222746146114876,10
171,65,18,44,7,11.219859746185271,11
172,15,10,28,3,11.176545961741331,7
173,93,19,37,6,11.135373057728058,13
174,74,10,104,3,11.124138818031259,7
175,106,14,86,4,11.08802587245307,10
176,98,12,110,4,11.026999619900328,8
177,49,17,16,6,11.010920636133424,11
178,20,19,10,6,11.010427213733353,13
179,38,14,6,4,11.005398790381081,10
180,30,10,43,3,10.958461383133036,7
181,55,23,62,9,10.947383871127185,14
182,98,48,41,18,10.835326353590219,30
183,98,17,11,6,10.82732686511273,11
184,17,16,23,5,10.781653305644484,11
185,63,25,54,9,10.767569219567786,16
186,93,37,9,12,10.753480854770812,25
187,87,29,6,10,10.703931695338108,19
188,91,10,85,5,10.702453755941072,5
189,37,14,41,5,10.694476243263011,9
190,6,35,44,13,10.67278245600393,22
191,107,16,109,6,10.668493285549742,10
192,38,13,58,4,10.642287291889902,9
193,98,37,88,11,10.639663528048942,26
194,54,15,104,5,10.631063301403962,10
195,65,10,101,4,10.616476001261294,6
196,110,17,8,5,10.493443474648158,12
197,14,10,54,3,10.443430113517227,7
198,64,17,86,6,10.437285409841268,11
199,70,19,65,6,10.41844263586608,13
200,29,10,17,3,10.395985227153457,7
201,2,11,75,4,10.369833561069749,7
202,8,14,89,5,10.313019177206716,9
203,2,16,73,6,10.299221262346556,10
204,30,19,16,6,10.19849835634007,13
205,2,32,86,10,10.192867967955026,22
206,60,10,38,4,10.186949801542621,6
207,10,18,1,6,10.049405294208206,12
208,37,14,34,5,10.040882054419713,9
209,65,14,59,6,10.036164804159641,8
210,88,11,30,5,10.02483572373662,6
211,76,17,34,6,9.994247540573088,11
212,90,20,23,7,9.967154481509692,13
213,111,24,38,9,9.966212518632439,15
214,93,11,70,4,9.928875321549775,7
215,87,13,17,5,9.922998390575081,8
216,16,11,108,4,9.921562283850516,7
217,10,14,50,5,9.907166966632534,9
218,107,30,41,12,9.880991735942342,18
219,32,22,109,8,9.859589833142886,14
220,17,28,9,10,9.851089499965493,18
221,111,20,37,8,9.840471570719451,12
222,54,25,76,10,9.821966207421672,15
223,70,13,74,4,9.800022679632328,9
224,93,17,91,6,9.794639196057782,11
225,11,12,54,4,9.747794227973566,8
226,73,21,111,8,9.713634051639158,13
227,29,32,38,11,9.681299801122258,21
228,88,11,85,4,9.65630194872786,7
229,98,26,62,10,9.641858129313677,16
230,13,21,8,7,9.615323131026955,14
231,8,12,35,5,9.605315474711038,7
232,30,18,70,6,9.585226013483615,12
233,93,35,54,10,9.580586312783264,25
234,23,22,89,8,9.576875474490599,14
235,60,21,65,8,9.571951123571171,13
236,32,14,88,4,9.505084521049728,10
237,6,11,58,4,9.489496457414935,7
238,103,11,19,4,9.481054864710421,7
239,18,17,84,6,9.48013150601899,11
240,8,20,71,8,9.460862953446574,12
241,30,27,87,9,9.441306317195094,18
242,57,11,10,4,9.43267475148189,7
243,34,16,74,6,9.430626027485216,10
244,46,17,8,6,9.405496106583277,11
245,55,22,30,9,9.385734127086305,13
246,49,17,86,8,9.34317243367324,9
247,79,19,75,6,9.342561498216153,13
248,28,13,112,5,9.317343463958052,8
249,50,17,23,7,9.300090532650529,10
250,20,34,9,11,9.290302263411942,23
251,38,20,86,6,9.280969369301586,14
252,43,14,50,5,9.27474781724881,9
253,110,12,50,4,9.252517401752682,8
254,111,46,54,17,9.235401744617302,29
255,55,16,37,6,9.183747537097531,10
256,13,26,28,8,9.183739107543797,18
257,84,28,85,12,9.160197369727126,16
258,84,25,63,9,9.157819288318452,16
259,20,12,48,4,9.143509340718829,8
260,93,29,103,11,9.099325117611023,18
261,26,12,32,5,9.09769401619869,7
262,106,13,109,5,9.062668099795829,8
263,15,12,16,4,9.059606623425509,8
264,91,16,50,5,9.044194652502608,11
265,74,35,76,12,9.02110943529627,23
266,84,11,44,4,9.017421120510091,7
267,41,19,62,7,9.00335332858162,12
268,37,41,86,16,8.9832167055326,25
269,74,19,18,7,8.9712615057984,12
270,65,14,96,6,8.945535735868065,8
271,48,18,111,6,8.93792122942067,12
272,107,20,110,8,8.933567921834609,12
273,10,20,86,7,8.92570532964782,13
274,112,11,50,4,8.921235906620762,7
275,11,14,86,6,8.91695456811855,8
276,79,10,80,4,8.90853030883555,6
277,8,23,57,9,8.905396375956737,14
278,16,14,106,5,8.877977313206348,9
279,10,11,85,5,8.810276618143424,6
280,29,10,76,3,8.806443209825622,7
281,23,24,93,10,8.804783518097919,14
282,48,16,35,6,8.750506609295915,10
283,30,24,37,8,8.742074606758964,16
284,32,17,107,5,8.731768023357226,12
285,55,31,54,10,8.716015508186064,21
286,76,16,62,8,8.710475893988358,8
287,48,11,75,3,8.67281534666425,8
288,34,18,109,7,8.662734980033562,11
289,65,26,32,10,8.65722618752934,16
290,84,14,66,5,8.616861190106436,9
291,107,29,50,10,8.583068473313558,19
292,11,10,76,4,8.560443995014507,6
293,32,25,9,9,8.53109215537152,16
294,84,29,10,11,8.510842712738034,18
295,98,60,65,22,8.49413981702294,38
296,93,31,84,11,8.465363334016377,20
297,98,21,1,7,8.436557583367685,14
298,73,21,10,7,8.419335562342072,14
299,90,11,89,4,8.396796914570167,7
300,48,12,38,4,8.376240779730173,8
301,20,10,70,3,8.374580328727138,7
302,77,12,8,4,8.373441110755328,8
303,30,17,50,7,8.363042610972485,10
304,84,26,88,9,8.338765030439282,17
305,11,10,48,4,8.287859925157544,6
306,76,18,41,7,8.284971187696902,11
307,65,12,58,6,8.279172093518044,6
308,76,11,109,3,8.273966572487598,8
309,17,30,8,11,8.267140148743708,19
310,51,11,37,4,8.265197669915755,7
311,111,14,17,6,8.239799794462428,8
312,26,10,16,4,8.231874067384071,6
313,28,13,94,5,8.222371266039163,8
314,11,11,9,4,8.198586667223204,7
315,32,24,41,10,8.170536046764159,14
316,26,44,87,17,8.146474895568335,27
317,55,36,9,12,8.11977265059526,24
318,19,14,9,6,8.117304295019109,8
319,54,39,41,14,8.096759700478561,25
320,30,15,10,5,8.08039942607508,10
321,6,12,13,5,8.074590184679876,7
322,1,11,86,4,8.004187715591307,7
323,55,50,87,18,8.001636513353814,32
324,90,15,41,6,7.997737246515682,9
325,109,12,37,5,7.972273664149992,7
326,71,10,9,4,7.971373091011489,6
327,111,27,86,11,7.962255850113393,16
328,2,41,65,14,7.9589934151571535,27
329,107,29,6,11,7.905082416130331,18
330,74,27,88,9,7.895683127849934,18
331,49,14,13,6,7.890029815709072,8
332,109,30,9,12,7.889736540676636,18
333,74,11,12,5,7.8813359238936185,6
334,20,18,49,7,7.854535242795636,11
335,76,32,37,11,7.820497576953577,21
336,30,15,49,6,7.795814319272768,9
337,29,13,109,5,7.7648215544268036,8
338,50,17,48,7,7.751737687672278,10
339,103,15,109,5,7.74806703390503,10
340,55,26,38,11,7.745065833950479,15
341,111,14,85,5,7.729378570457984,9
342,30,26,86,7,7.726335622844074,19
343,23,11,59,4,7.703199044299857,7
344,65,24,50,9,7.669757652755209,15
345,84,19,62,8,7.65619075053016,11
346,49,22,65,9,7.648203777845676,13
347,74,29,86,11,7.646930643556198,18
348,87,16,34,6,7.640142491832506,10
349,91,21,76,8,7.53854735511653,13
350,29,20,107,7,7.525530619454996,13
351,34,10,38,4,7.513274255260262,6
352,54,27,37,9,7.469706742796568,18
353,111,30,32,13,7.463790988299924,17
354,104,10,23,4,7.459802178175596,6
355,10,29,28,10,7.458178088618777,19
356,23,24,37,9,7.440544332640973,15
357,88,17,57,7,7.432081698575297,10
358,98,14,68,4,7.427653338623123,10
359,75,13,9,4,7.420012168869883,9
360,103,29,74,10,7.419118005067162,19
361,65,34,48,13,7.410700295202606,21
362,41,13,49,4,7.406139067429071,9
363,98,15,5,6,7.40308817440165,9
364,20,11,50,4,7.37029217669463,7
365,73,35,9,14,7.317625242616718,21
366,54,21,10,8,7.316914939103651,13
367,50,11,68,4,7.299975074722132,7
368,13,13,20,4,7.287197108459041,9
369,41,22,86,9,7.286274520016925,13
370,23,15,70,6,7.277989111704888,9
371,30,10,73,4,7.27524129591905,6
372,88,14,38,6,7.257573306252311,8
373,74,19,109,8,7.255868408074382,11
374,55,41,98,16,7.2398162826998345,25
375,10,19,76,8,7.223608714939963,11
376,87,10,56,4,7.222698791088141,6
377,84,48,48,20,7.209403276697926,28
378,111,13,34,6,7.201437198359541,7
379,5,11,6,4,7.175117705775805,7
380,90,12,70,4,7.158523730695325,8
381,63,17,91,7,7.145656838756393,10
382,98,35,76,14,7.116562365346761,21
383,16,16,89,6,7.102664218068734,10
384,104,25,28,9,7.094797317145894,16
385,88,32,54,13,7.090162220607111,19
386,10,10,13,5,7.081545477709261,5
387,98,24,34,8,7.0691518153654185,16
388,91,37,28,14,7.047707205955762,23
389,87,34,50,13,7.043252292270627,21
390,59,19,79,8,7.0352036880537865,11
391,8,56,76,22,7.029702728241303,34
392,111,20,6,8,7.01838566892247,12
393,8,48,93,18,7.017566439579715,30
394,51,10,6,3,7.003530037614207,7
395,90,19,6,8,7.0034906221582,11
396,79,11,101,5,6.9908614259308735,6
397,73,10,68,4,6.95394987102174,6
398,20,18,88,7,6.938480603467199,11
399,90,14,17,6,6.930186835428711,8
400,57,12,74,4,6.9176042424257504,8
401,34,16,65,7,6.912804970312552,9
402,8,36,38,14,6.910326910265974,22
403,41,45,103,15,6.896034695840802,30
404,65,18,68,8,6.89592459737167,10
405,89,11,87,4,6.890327484533061,7
406,17,20,84,8,6.874361487047255,12
407,55,11,106,4,6.858732619650541,7
408,90,24,8,9,6.838297347223881,15
409,16,71,9,26,6.825766832468779,45
410,28,11,64,5,6.82253762472366,6
411,32,26,79,10,6.821690929992381,16
412,43,18,87,7,6.811944333065353,11
413,88,21,6,8,6.808639243885847,13
414,76,39,28,16,6.804995058327358,23
415,91,35,41,13,6.801656465480552,22
416,28,73,9,31,6.79339527606444,42
417,16,25,85,10,6.790728536327192,15
418,93,14,43,5,6.79067137162001,9
419,55,35,20,15,6.786443158254519,20
420,87,50,28,20,6.785536302011417,30
421,26,24,109,9,6.785414157125367,15
422,73,13,93,5,6.746815708884676,8
423,111,42,41,18,6.742879314894578,24
424,2,19,34,8,6.729658072634226,11
425,18,24,79,11,6.727434004130173,13
426,89,11,74,5,6.7140175484003635,6
427,73,16,88,6,6.709173893318198,10
428,79,18,62,8,6.70668334197217,10
429,20,34,79,13,6.674702669544552,21
430,18,24,9,10,6.669379438735331,14
431,74,16,49,7,6.669033870592301,9
432,86,14,85,7,6.640232602185862,7
433,87,21,51,9,6.638885465379,12
434,23,14,18,5,6.63118753114106,9
435,55,19,76,8,6.61682633400798,11
436,107,20,76,8,6.611819543573891,12
437,74,23,38,10,6.562267688513878,13
438,28,54,41,24,6.549671741224454,30
439,16,40,88,14,6.547604687657639,26
440,79,18,70,9,6.541994947083337,9
441,74,15,106,7,6.5362197915338545,8
442,16,79,86,31,6.517762010081222,48
443,17,13,62,5,6.51109228837904,8
444,87,25,18,9,6.500921078177537,16
445,23,11,48,5,6.485113687277626,6
446,17,10,10,4,6.479497194252798,6
447,32,16,86,7,6.471177759830174,9
448,90,10,62,4,6.441503246890602,6
449,12,14,28,5,6.429365216940004,9
450,90,12,50,5,6.3963545792520575,7
451,15,14,84,5,6.375647385580588,9
452,103,22,88,8,6.368772240906124,14
453,31,10,28,4,6.368565836830035,6
454,86,18,73,7,6.340120760849839,11
455,88,41,76,18,6.323191299261618,23
456,62,19,54,7,6.312055934230411,12
457,8,33,109,14,6.3077294568861335,19
458,90,16,54,7,6.290244829620479,9
459,79,23,106,10,6.288631840986401,13
460,6,40,28,16,6.2836176921265,24
461,111,15,44,6,6.282001615200402,9
462,6,11,106,5,6.262787648448941,6
463,2,17,48,8,6.245081234312723,9
464,2,35,41,13,6.231438093089566,22
465,16,14,34,6,6.229556768499603,8
466,2,11,66,4,6.205381429919993,7
467,87,44,86,17,6.156705143028481,27
468,87,23,88,8,6.146478682205598,15
469,8,52,48,21,6.14228344797818,31
470,74,53,65,21,6.137709015019595,32
471,111,11,56,4,6.133528731729061,7
472,87,45,41,20,6.130516050826405,25
473,30,14,76,5,6.105099986395528,9
474,70,21,76,8,6.104247467977058,13
475,28,25,89,11,6.088973901063954,14
476,51,23,86,9,6.086561001211847,14
477,93,15,30,6,6.056393100709427,9
478,54,49,9,20,6.050802275785849,29
479,79,32,107,12,6.039727207849199,20
480,1,14,107,6,6.012748941227003,8
481,84,41,76,19,6.0122133251855985,22
482,98,48,91,22,6.010481139866045,26
483,49,10,77,5,6.002993751357126,5
484,74,25,6,10,5.973570320498578,15
485,17,10,34,4,5.97086385916694,6
486,20,33,103,11,5.96431634987825,22
487,8,23,49,10,5.962799116224744,13
488,89,25,10,10,5.961935346068015,15
489,87,28,91,11,5.954439761122977,17
490,49,30,98,13,5.930886416801632,17
491,16,13,96,5,5.918742950992743,8
492,111,71,65,33,5.901383737891229,38
493,98,49,103,19,5.894528502030377,30
494,17,17,16,7,5.868342075872022,10
495,49,28,87,13,5.837138934523044,15
496,104,12,84,5,5.83583289734061,7
497,46,14,37,6,5.834073346635607,8
498,2,10,44,4,5.82972376449153,6
499,2,11,51,5,5.82458141989376,6
500,96,10,28,4,5.817657099477481,6
501,13,21,79,7,5.816978385717296,14
502,23,16,55,7,5.806506460340061,9
503,93,35,87,14,5.801672416811602,21
504,63,14,87,6,5.794939568846776,8
505,63,11,20,4,5.791453238708792,7
506,15,23,76,9,5.782831260117769,14
507,32,18,54,7,5.782610489553489,11
508,51,14,79,6,5.7725066910082035,8
509,49,24,9,9,5.76893486693949,15
510,75,15,28,7,5.767432508412387,8
511,38,29,9,13,5.756435186772363,16
512,90,20,37,8,5.742590617036877,12
513,87,49,9,21,5.735371827832201,28
514,89,23,65,10,5.729458742490648,13
515,18,11,51,5,5.697627847770078,6
516,43,13,9,6,5.682535108763634,7
517,8,13,56,5,5.662090518526135,8
518,63,50,65,21,5.6463970088136985,29
519,41,45,9,17,5.6439057397283525,28
520,26,22,29,8,5.630548836449718,14
521,86,23,88,9,5.601729846556069,14
522,84,28,34,10,5.6010410890491125,18
523,74,35,91,15,5.590543375115505,20
524,28,25,17,10,5.573169674184406,15
525,9,12,51,5,5.566013437140973,7
526,28,11,97,6,5.54697078214519,5
527,6,35,48,15,5.544547995709246,20
528,46,10,2,4,5.541906116456113,6
529,63,15,98,7,5.5319776999855375,8
530,23,41,8,17,5.530959099012352,24
531,111,36,103,15,5.530917867453256,21
532,28,46,54,19,5.5206143371290795,27
533,34,10,51,4,5.497172152397963,6
534,74,21,73,9,5.496437468937688,12
535,54,35,38,14,5.47856504565386,21
536,93,28,74,10,5.4705081639253095,18
537,87,16,57,7,5.466000765538215,9
538,90,20,87,7,5.46489906820686,13
539,14,10,9,3,5.463439437022661,7
540,109,16,23,6,5.438260955948294,10
541,94,18,20,7,5.424401699040207,11
542,20,26,38,11,5.422962328602487,15
543,55,27,41,13,5.421661683278699,14
544,98,37,50,17,5.407228229606667,20
545,43,11,103,5,5.4056340195812504,6
546,19,10,28,4,5.405282356849322,6
547,6,27,20,13,5.3915163015983865,14
548,110,23,65,9,5.3850619906564345,14
549,8,66,41,30,5.38335326188138,36
550,54,11,71,4,5.354693946074447,7
551,50,24,86,9,5.328218131490922,15
552,20,84,65,34,5.311994770706184,50
553,104,14,76,6,5.288345369680406,8
554,64,10,84,5,5.285274543011926,5
555,17,23,79,10,5.280486878224028,13
556,63,15,85,7,5.266282773446653,8
557,74,22,29,10,5.260819792223967,12
558,28,20,85,9,5.2561838588407,11
559,18,19,48,8,5.245315113768612,11
560,1,10,111,5,5.238983537325087,5
561,55,14,18,6,5.21003106995447,8
562,111,10,57,4,5.186942618450884,6
563,104,15,62,6,5.186101581217904,9
564,26,38,20,16,5.156160372920298,22
565,98,10,52,5,5.141825899051737,5
566,41,29,89,12,5.128070897369617,17
567,20,31,84,12,5.125132779135493,19
568,103,21,18,9,5.1172633080953505,12
569,87,27,76,11,5.116388437491941,16
570,70,10,48,4,5.103393723771425,6
571,107,28,2,12,5.101731059055636,16
572,9,11,1,5,5.096238795529086,6
573,29,25,84,11,5.094046057364016,14
574,16,20,73,9,5.070658783374491,11
575,109,16,84,7,5.067243867891083,9
576,63,14,88,6,5.029062789658772,8
577,48,14,96,6,5.024611756936058,8
578,89,15,84,5,5.015269353437395,10
579,107,19,104,7,4.998347958456829,12
580,93,42,28,18,4.991965722669563,24
581,26,30,65,13,4.98261857456072,17
582,50,18,73,9,4.9783134285735455,9
583,89,10,20,4,4.976403038151212,6
584,46,10,70,4,4.972558334053198,6
585,10,10,59,5,4.967497448599417,5
586,1,17,8,8,4.943313786871868,9
587,46,11,103,5,4.9349144398730305,6
588,65,11,5,5,4.90161537792141,6
589,62,27,9,11,4.876428914210389,16
590,28,17,11,7,4.863784981994055,10
591,38,24,87,10,4.849210013950484,14
592,8,83,79,39,4.838502142156572,44
593,39,11,63,5,4.830077117168623,6
594,89,11,109,5,4.829014520032646,6
595,8,100,9,45,4.808253906976541,55
596,11,12,87,5,4.803797400963365,7
597,55,29,6,10,4.803715742468646,19
598,86,11,18,5,4.795064637153174,6
599,34,10,103,3,4.7904730345691835,7
600,79,42,48,19,4.785956113625244,23
601,111,10,104,4,4.785383853867563,6
602,46,23,54,9,4.7761943840724514,14
603,46,19,28,8,4.773210022871566,11
604,98,17,94,7,4.761676089313327,10
605,65,66,54,30,4.757496898509859,36
606,107,36,9,18,4.756936242672488,18
607,6,12,32,5,4.741771241477238,7
608,76,21,35,8,4.725447690057796,13
609,90,30,9,13,4.71783274464291,17
610,87,14,14,6,4.712999134730352,8
611,109,19,93,8,4.710552248323453,11
612,50,39,79,18,4.700291458157237,21
613,26,16,6,6,4.685058896386023,10
614,41,53,20,21,4.672832095577478,32
615,96,12,55,5,4.672271940431312,7
616,8,21,106,10,4.667623942868986,11
617,68,11,87,5,4.6261419910984936,6
618,79,25,104,9,4.621702045304475,16
619,86,10,15,5,4.60305467364883,5
620,8,38,62,17,4.586265631219048,21
621,2,31,6,13,4.57536971568475,18
622,16,38,87,17,4.575207384729779,21
623,17,15,48,7,4.57243158960934,8
624,2,37,9,17,4.570200756721712,20
625,55,22,32,9,4.561305856484579,13
626,9,20,89,7,4.555028073124964,13
627,74,24,23,11,4.530539923458648,13
628,65,26,109,13,4.522732343847645,13
629,91,36,9,16,4.519475424395421,20
630,111,29,93,14,4.510765206652466,15
631,38,38,28,17,4.506160175549613,21
632,34,24,79,12,4.503244435504136,12
633,9,17,59,7,4.5029610514141964,10
634,29,11,62,5,4.502398822563124,6
635,111,29,91,14,4.500138929465921,15
636,29,21,93,9,4.4989593922467,12
637,74,31,107,13,4.496848852346025,18
638,111,21,29,11,4.484029622528672,10
639,87,53,79,25,4.482441737512029,28
640,111,25,15,10,4.472513123100842,15
641,73,23,84,8,4.463513313785126,15
642,16,64,65,29,4.4549887746296175,35
643,35,12,86,4,4.454208680307122,8
644,107,45,20,20,4.447199946249051,25
645,84,32,2,14,4.438454989875698,18
646,90,10,13,5,4.435057658973358,5
647,16,24,91,10,4.4213987794735585,14
648,84,36,41,14,4.405400183867787,22
649,111,38,74,17,4.395421398955392,21
650,29,29,8,13,4.3862864415616,16
651,1,14,65,6,4.384642024421804,8
652,86,20,20,9,4.380135140550649,11
653,54,13,89,5,4.375934710162813,8
654,87,11,94,5,4.375015437142173,6
655,79,13,44,6,4.35641543376227,7
656,75,19,16,8,4.325958452336133,11
657,84,11,106,6,4.3181557746419115,5
658,87,37,29,16,4.317833214151956,21
659,41,20,1,7,4.310885836842606,13
660,30,16,107,6,4.31051675338316,10
661,85,15,48,6,4.3053632687921874,9
662,55,14,34,5,4.304037025765173,9
663,32,25,98,11,4.297859841525708,14
664,46,21,76,8,4.290697960762892,13
665,103,34,28,15,4.283445470085917,19
666,63,21,16,10,4.279009624505893,11
667,37,24,88,10,4.265987830661223,14
668,65,108,9,48,4.259267083972893,60
669,55,16,91,6,4.250002044063523,10
670,58,11,9,4,4.244957448818405,7
671,18,13,49,6,4.243576516469453,7
672,23,41,98,17,4.243286610418413,24
673,51,19,16,7,4.242679291932901,12
674,9,38,86,17,4.240091175183199,21
675,97,11,8,4,4.238412616249588,7
676,29,26,20,11,4.235090000321542,15
677,50,34,103,15,4.223445001067976,19
678,93,73,65,32,4.214075863061876,41
679,26,24,103,11,4.2106057067079385,13
680,9,28,88,12,4.191886886127067,16
681,51,24,8,10,4.1878112962147656,14
682,2,16,32,7,4.169077635966495,9
683,16,22,18,9,4.167483705263703,13
684,16,27,6,13,4.159304128363459,14
685,30,28,8,11,4.155265384733845,17
686,65,23,91,12,4.150101209000142,11
687,16,11,35,5,4.150016684827545,6
688,37,15,2,7,4.147220527730259,8
689,103,28,54,13,4.131111544590628,15
690,37,39,98,17,4.116775978907109,22
691,48,33,54,13,4.10362086951445,20
692,106,16,65,7,4.0921186691282205,9
693,32,15,38,6,4.090422340111541,9
694,16,25,107,11,4.07846703304185,14
695,90,12,104,6,4.064341220930972,6
696,65,10,75,4,4.061741964132056,6
697,84,15,71,7,4.0469973544528735,8
698,52,10,65,4,4.03382642115339,6
699,10,11,109,5,4.004247407956422,6
700,87,26,37,13,3.9965570187790034,13
701,73,29,8,11,3.9924196449780625,18
702,107,18,34,8,3.9868137021950045,10
703,104,13,10,6,3.98234198179897,7
704,26,26,28,11,3.9790441547640487,15
705,16,29,74,12,3.974341734686631,17
706,91,40,8,19,3.961945852137986,21
707,23,32,87,13,3.9566444001518777,19
708,93,18,10,7,3.9549788743691674,11
709,23,39,84,18,3.9529498437083554,21
710,6,22,73,11,3.947699618921396,11
711,94,16,54,8,3.8978006398785645,8
712,98,47,84,21,3.890833745652655,26
713,87,52,20,23,3.8857958203893874,29
714,20,25,109,9,3.878585285280937,16
715,38,14,49,7,3.855128614080598,7
716,23,12,34,6,3.853881899354071,6
717,8,20,75,9,3.8505131421822583,11
718,37,10,75,4,3.844326750652962,6
719,54,19,51,9,3.840546896941151,10
720,17,16,49,7,3.8354352643495573,9
721,8,69,16,29,3.830024698724433,40
722,23,40,9,18,3.825851357048053,22
723,32,14,91,7,3.8253106560348464,7
724,93,15,18,7,3.8000555745474087,8
725,110,12,103,5,3.7849274590311146,7
726,26,11,110,6,3.7814954576991564,5
727,79,15,73,7,3.7804037585321275,8
728,86,43,76,20,3.770551952832362,23
729,74,19,55,10,3.7670610658889934,9
730,16,16,11,6,3.764288435187581,10
731,28,22,49,9,3.761707702389012,13
732,57,12,18,4,3.7525453734501917,8
733,10,20,74,8,3.741560720435788,12
734,48,16,41,7,3.7233952099256955,9
735,84,22,38,9,3.7215580721113755,13
736,60,10,87,5,3.716219490276845,5
737,32,14,10,5,3.709056496740225,9
738,91,15,62,7,3.7079997693755615,8
739,32,35,8,16,3.704344714378896,19
740,90,18,48,8,3.702031262726638,10
741,16,18,20,9,3.701780437410533,9
742,54,34,70,16,3.700162543327729,18
743,90,33,28,14,3.692345711046821,19
744,26,46,8,22,3.689219062321196,24
745,57,17,65,6,3.66200460796526,11
746,16,38,37,15,3.653813418657004,23
747,46,17,88,7,3.642829227288957,10
748,87,31,54,14,3.6386388579102245,17
749,98,10,112,5,3.634369737429613,5
750,10,12,18,4,3.6042571144804363,8
751,87,14,75,7,3.5866681857153266,7
752,54,41,6,16,3.576182334552821,25
753,29,12,46,5,3.5756011188612877,7
754,16,16,57,8,3.5714373486183058,8
755,50,25,38,11,3.5687465201033057,14
756,13,28,9,11,3.550319505488332,17
757,70,26,87,11,3.5345174393475727,15
758,76,32,48,14,3.5258970581860236,18
759,14,14,28,5,3.520697506583677,9
760,65,13,94,6,3.5056909876146594,7
761,55,34,88,13,3.4984778706231707,21
762,98,32,29,15,3.4944771315816667,17
763,1,14,55,6,3.472860068937084,8
764,48,12,91,5,3.4664297594725237,7
765,23,15,26,7,3.459704667443896,8
766,86,12,57,6,3.4531517504498637,6
767,107,10,37,4,3.444420525023787,6
768,84,57,86,25,3.4420272868673756,32
769,5,10,91,6,3.4255398118724356,4
770,98,31,10,14,3.404355165617583,17
771,32,20,84,8,3.403700726822617,12
772,37,40,8,18,3.4036571085144507,22
773,57,12,6,4,3.4000169565132325,8
774,65,16,15,8,3.3963132917863037,8
775,70,14,50,7,3.3858944797818467,7
776,76,14,13,7,3.383197454645703,7
777,2,14,85,7,3.3798876085075156,7
778,6,26,91,12,3.3700663593758144,14
779,49,18,6,8,3.361990920437635,10
780,55,79,8,33,3.3433762407278653,46
781,55,13,57,5,3.3276700776213226,8
782,111,51,9,25,3.320225202022207,26
783,16,18,62,8,3.3165301409136885,10
784,2,26,109,10,3.295965627936023,16
785,57,23,84,10,3.2865946702288213,13
786,59,11,98,5,3.2664563544762513,6
787,73,30,65,13,3.2644989461981972,17
788,74,61,8,28,3.2583668403481756,33
789,51,13,55,5,3.250762185768764,8
790,30,21,29,10,3.244422511134119,11
791,76,15,18,6,3.2371919896499475,9
792,49,11,85,5,3.2340490592317157,6
793,23,19,86,9,3.2169168727971016,10
794,70,28,84,13,3.2115322566926667,15
795,91,13,37,6,3.1893915884876662,7
796,104,25,8,10,3.1877877944585085,15
797,111,15,75,8,3.1768571401147816,7
798,18,13,88,6,3.1759771370815293,7
799,48,43,9,18,3.1751195832174797,25
800,50,19,16,9,3.1594632722429505,10
801,23,23,88,10,3.1441600025036927,13
802,13,14,111,6,3.137242431792204,8
803,16,67,84,31,3.088053247550798,36
804,106,14,28,5,3.086797036091732,9
805,43,16,65,8,3.0818646979565365,8
806,70,15,55,7,3.055120987205429,8
807,62,28,87,12,3.0525441320022706,16
808,26,17,43,7,3.0481873322386313,10
809,9,14,44,8,3.0418979222799787,6
810,48,17,89,8,3.030683667814096,9
811,38,18,16,9,3.0174584469144032,9
812,51,15,65,7,3.002433018856541,8
813,26,16,89,8,3.0015441091670585,8
814,79,58,37,25,2.964015442225525,33
815,65,72,28,32,2.95741614475882,40
816,16,15,93,7,2.9086793764389984,8
817,2,41,10,18,2.8955248222440733,23
818,90,30,111,13,2.8905447130543305,17
819,30,19,6,7,2.8896247906630976,12
820,111,22,76,12,2.8888180973130932,10
821,74,14,63,6,2.8546011556463164,8
822,75,10,86,5,2.853654010473079,5
823,63,20,107,8,2.8489994132116685,12
824,79,37,74,15,2.8445388974316312,22
825,98,55,54,27,2.835866843669563,28
826,103,26,91,14,2.81795550429567,12
827,104,12,55,6,2.817049603991469,6
828,8,85,107,41,2.8168131208732516,44
829,98,17,85,9,2.811605176676512,8
830,93,25,107,11,2.8066980710044707,14
831,38,55,65,25,2.8065899103574585,30
832,17,30,103,13,2.786263791329437,17
833,79,29,93,15,2.7764930954452365,14
834,104,15,87,6,2.773139485298443,9
835,70,18,2,7,2.768805537158304,11
836,50,15,89,7,2.7678854176457244,8
837,41,40,23,18,2.767380745524291,22
838,2,18,23,9,2.7670043698876174,9
839,48,19,103,9,2.74551902113029,10
840,34,21,28,9,2.734662710408205,12
841,23,14,29,6,2.7325720738957853,8
842,79,25,89,10,2.7323432784581803,15
843,98,40,86,17,2.7301970918095324,23
844,26,14,30,9,2.729526864464305,5
845,103,24,55,11,2.703742749314949,13
846,46,10,18,4,2.6832650728648453,6
847,6,21,86,10,2.6797895540068417,11
848,37,16,20,7,2.6697969055897994,9
849,30,25,38,13,2.6609022960305304,12
850,15,14,8,7,2.659395326985167,7
851,106,11,9,5,2.6544531376629674,6
852,30,24,84,11,2.649950052405462,13
853,48,33,37,16,2.6418897918039517,17
854,8,42,103,17,2.6366758249260935,25
855,111,23,50,10,2.6260965282140734,13
856,8,74,87,33,2.6221580810087284,41
857,9,16,94,8,2.620832608628453,8
858,30,40,28,18,2.6105936366755755,22
859,38,20,112,9,2.5875581099779743,11
860,90,21,16,10,2.556904125602615,11
861,30,10,11,4,2.556482524063204,6
862,8,71,54,34,2.5509010277943966,37
863,8,56,86,25,2.5454892932378956,31
864,49,15,48,8,2.5444991556032637,7
865,63,10,49,5,2.5291147398136253,5
866,50,19,29,8,2.5251415163545525,11
867,28,27,70,14,2.5100244330478434,13
868,65,36,86,17,2.5084949662200606,19
869,98,41,107,18,2.504606560314171,23
870,75,12,50,5,2.4925159155893497,7
871,65,50,103,21,2.4835688434443703,29
872,37,15,62,7,2.478947668963917,8
873,26,27,98,15,2.4699465773486544,12
874,86,25,55,13,2.464697480344813,12
875,8,46,88,21,2.4622937925313138,25
876,41,40,38,19,2.4535603181412866,21
877,63,22,48,10,2.4502218283603603,12
878,86,17,93,8,2.4398685074463295,9
879,18,16,50,8,2.435107533000617,8
880,55,13,90,6,2.423005519398733,7
881,50,36,9,17,2.4068423828458214,19
882,55,38,16,17,2.4019689679738265,21
883,43,22,74,10,2.3993639128069244,12
884,20,36,28,15,2.396150185468307,21
885,18,18,6,8,2.3903639022739704,10
886,16,22,104,10,2.3846505018781015,12
887,51,10,107,4,2.364406054363658,6
888,8,25,68,12,2.35813484080187,13
889,10,22,48,11,2.352652144057524,11
890,41,56,79,27,2.337441224056112,29
891,41,11,94,5,2.327533953224649,6
892,28,57,18,27,2.325443992999963,30
893,65,10,39,5,2.3211966169516858,5
894,28,39,37,18,2.3108067440306623,21
895,79,33,88,13,2.303396520773149,20
896,74,48,84,22,2.2830224549509466,26
897,20,13,32,6,2.2751108005385445,7
898,84,78,9,34,2.274353058782541,44
899,62,25,28,10,2.271350662558558,15
900,62,18,32,9,2.263686769900323,9
901,37,40,9,18,2.2628015576501816,22
902,62,10,106,5,2.25172428368668,5
903,20,44,98,20,2.2445302838681975,24
904,103,26,87,12,2.244435120608379,14
905,8,11,58,6,2.225895511877211,5
906,54,12,57,5,2.224387822283533,7
907,14,14,8,6,2.218960260374273,8
908,73,15,54,7,2.217586045542856,8
909,8,18,11,8,2.2144208281589424,10
910,86,31,48,14,2.208595393524404,17
911,73,35,41,16,2.1896111209660925,19
912,44,19,28,7,2.1816767204067147,12
913,89,18,98,8,2.1800794132028996,10
914,28,52,86,26,2.1700095013032863,26
915,74,45,9,20,2.167006985909848,25
916,111,19,46,9,2.165349951686943,10
917,111,54,28,25,2.1618622413747612,29
918,90,24,107,12,2.161624044674691,12
919,28,68,16,32,2.159924574696866,36
920,9,11,15,5,2.1575516880448644,6
921,18,10,32,5,2.157224109221358,5
922,29,21,79,10,2.154722811821747,11
923,16,49,41,24,2.1541831229994863,25
924,16,51,98,23,2.1492857255902784,28
925,84,44,111,19,2.142252654485593,25
926,16,37,76,18,2.1381270128695977,19
927,111,33,26,15,2.137133581510591,18
928,54,18,3,9,2.135806802832069,9
929,98,63,2,30,2.135100922237145,33
930,65,81,88,37,2.119863485318386,44
931,75,18,84,8,2.093719925532618,10
932,54,33,50,14,2.086951916582851,19
933,13,19,48,7,2.077711897708858,12
934,9,17,104,7,2.074620642084027,10
935,91,11,18,5,2.068864434806556,6
936,85,22,65,9,2.0630480183814526,13
937,91,18,10,8,2.053920396033922,10
938,30,25,98,10,2.050620342220537,15
939,38,52,98,24,2.0498657703552294,28
940,84,72,65,35,2.037917633089768,37
941,8,14,96,7,2.0352117697299548,7
942,88,20,93,12,2.03337259421067,8
943,87,66,65,30,2.0306725693730434,36
944,32,26,16,12,2.021073617693015,14
945,59,14,8,7,2.010238389237962,7
946,98,55,74,27,2.0085674767082775,28
947,80,10,65,4,1.9897653118429468,6
948,37,10,71,4,1.989603705819686,6
949,55,10,97,5,1.9884220470048688,5
950,103,13,37,6,1.9837820518429876,7
951,6,47,79,22,1.9831957209831137,25
952,49,11,29,4,1.9792119029563418,7
953,63,19,8,8,1.9640537669425608,11
954,76,24,6,12,1.937944044447951,12
955,62,10,48,4,1.9270832455013291,6
956,10,13,29,6,1.9268740097605626,7
957,65,20,13,11,1.923636761815708,9
958,6,22,37,11,1.9187411338779805,11
959,96,16,84,8,1.915527358947278,8
960,76,10,17,4,1.904894860536603,6
961,41,11,61,5,1.903478014849791,6
962,5,18,28,9,1.8930799000381913,9
963,54,20,29,8,1.8852461336565378,12
964,98,27,18,13,1.877022513938192,14
965,34,10,90,5,1.875212395692607,5
966,54,17,112,8,1.871566293788823,9
967,49,25,55,14,1.8646594153921858,11
968,73,19,98,9,1.8513717297876215,10
969,6,39,98,18,1.8448936378969205,21
970,2,30,111,14,1.8367449192872438,16
971,90,19,84,9,1.8307456952070562,10
972,8,48,18,22,1.8210825548731258,26
973,20,22,73,11,1.8197178736344486,11
974,14,20,84,7,1.8141100794725653,13
975,87,25,32,13,1.8019631830327207,12
976,85,13,76,5,1.8000085206097032,8
977,2,21,88,9,1.7993488805723392,12
978,57,10,109,4,1.7866317267766754,6
979,15,20,54,9,1.7760257646065063,11
980,84,32,55,15,1.7463159686665124,17
981,107,35,38,17,1.7434138897292857,18
982,71,18,65,9,1.7385086790308775,9
983,32,32,28,15,1.7383561900488511,17
984,17,12,30,6,1.7366091011141076,6
985,16,29,103,14,1.7358551004647216,15
986,76,10,45,5,1.7263356630732685,5
987,38,11,76,5,1.699907222636557,6
988,34,15,20,6,1.6974281353522305,9
989,54,27,91,15,1.6885326799927167,12
990,16,49,2,23,1.6778156958659614,26
991,6,49,65,26,1.6288389900978633,23
992,103,26,6,11,1.6275337563735748,15
993,10,18,90,8,1.612631742744166,10
994,70,56,8,28,1.5940338293248182,28
995,30,17,48,8,1.59066657704961,9
996,34,12,48,6,1.5875475207565521,6
997,17,13,50,6,1.587542514822458,7
998,76,10,14,5,1.56343838736732,5
999,104,13,86,6,1.5590713730616257,7
1000,106,14,41,7,1.55653648871753,7
1001,84,11,46,5,1.5536654797415743,6
1002,50,33,2,15,1.5483452933241444,18
1003,6,21,46,9,1.5348461201360555,12
1004,85,12,38,6,1.5317416798467223,6
1005,74,18,50,9,1.5058020463222817,9
1006,103,12,85,5,1.5052357650596415,7
1007,55,18,43,9,1.4993353058682126,9
1008,41,18,18,8,1.4488156792449156,10
1009,79,62,111,28,1.4456912335304024,34
1010,50,36,41,18,1.4450486751473977,18
1011,16,44,54,21,1.4396923883896255,23
1012,103,10,57,6,1.4334929374709406,4
1013,109,11,112,5,1.4303792106135154,6
1014,65,10,3,5,1.425825292351592,5
1015,13,11,2,4,1.4221213524937664,7
1016,88,31,111,14,1.4213124620809892,17
1017,8,47,20,22,1.420582435666663,25
1018,2,24,38,13,1.4146987667991204,11
1019,8,40,50,20,1.4130020441022069,20
1020,107,49,28,25,1.3956461262525064,24
1021,51,26,84,11,1.3946044446619845,15
1022,65,34,10,16,1.3889990791790807,18
1023,54,20,23,9,1.3830605566363516,11
1024,44,13,8,5,1.382360749568672,8
1025,54,17,85,9,1.3789825215785754,8
1026,16,32,10,15,1.3769942516048166,17
1027,23,14,32,8,1.36299015760623,6
1028,111,47,55,24,1.3611225123553383,23
1029,29,18,34,10,1.3490741689669339,8
1030,76,30,9,14,1.3464329670764867,16
1031,48,32,98,16,1.346038192120595,16
1032,84,41,87,20,1.3385938795219072,21
1033,79,61,16,28,1.3376507869334486,33
1034,98,13,57,7,1.3243405021868635,6
1035,37,35,65,16,1.3173393657012906,19
1036,54,43,84,20,1.3144548521624781,23
1037,38,17,106,8,1.3101869215810398,9
1038,87,15,110,7,1.3076573931351647,8
1039,86,12,62,8,1.3029764877822878,4
1040,55,12,17,6,1.2644044388351476,6
1041,50,10,63,4,1.2561234705003208,6
1042,8,24,43,12,1.2491635720553627,12
1043,23,42,65,21,1.2395198214726815,21
1044,2,36,87,16,1.230956912786467,20
1045,74,24,46,13,1.2274275532310792,11
1046,17,14,54,7,1.2121687634663056,7
1047,8,19,85,10,1.1861465554197632,9
1048,103,10,1,6,1.178228962480731,4
1049,109,23,98,11,1.1685291459099245,12
1050,9,34,6,16,1.164779086663607,18
1051,79,76,9,37,1.156057079763386,39
1052,79,36,38,17,1.1399672014475488,19
1053,98,69,8,33,1.112214433038039,36
1054,16,10,56,4,1.1063673005412145,6
1055,73,16,28,9,1.102601583168376,7
1056,6,42,84,20,1.1025381642551553,22
1057,84,66,28,32,1.0932884901587276,34
1058,65,41,29,18,1.0863542275741345,23
1059,86,52,79,26,1.077124646168825,26
1060,76,15,103,6,1.064891024931597,9
1061,11,10,93,6,1.0550285886343462,4
1062,34,23,9,12,1.0530539128922707,11
1063,98,11,106,6,1.0522359380778141,5
1064,74,16,62,9,1.038357756374001,7
1065,13,23,98,9,1.0334282765850014,14
1066,74,44,54,23,1.0319640649256887,21
1067,48,21,88,9,1.022088854727801,12
1068,107,36,103,17,1.0215275466090674,19
1069,107,32,54,16,1.0097458724362607,16
1070,58,11,2,5,1.0060883991850635,6
1071,79,11,94,5,0.999869198006996,6
1072,8,12,5,7,0.9947252871595059,5
1073,32,15,74,7,0.9878312338208298,8
1074,41,16,30,8,0.9850557086879019,8
1075,111,16,68,7,0.9831903657030904,9
1076,91,20,23,10,0.9792678927031672,10
1077,103,44,9,24,0.9734466854109779,20
1078,68,10,16,5,0.9723777343104946,5
1079,54,44,20,20,0.965531605512796,24
1080,62,21,88,10,0.9626827472726068,11
1081,10,11,15,6,0.9620268464624092,5
1082,79,14,96,7,0.9587839220541053,7
1083,84,28,49,14,0.9573548536710029,14
1084,20,19,68,10,0.9561217863728688,9
1085,57,15,91,6,0.9462820674582961,9
1086,30,30,79,14,0.9459285919663998,16
1087,54,34,79,17,0.93397106002864,17
1088,85,19,9,8,0.9266510351352133,11
1089,13,11,74,5,0.9258529887550367,6
1090,103,12,89,5,0.9245541578032253,7
1091,60,11,9,6,0.9156618531106675,5
1092,93,15,49,8,0.9146738839447187,7
1093,79,39,90,17,0.8969827248841548,22
1094,62,21,65,9,0.8755953834255741,12
1095,29,12,18,7,0.8741742779448103,5
1096,5,12,79,7,0.8638337222987199,5
1097,20,33,30,15,0.8624210657658014,18
1098,103,16,32,7,0.8405021181328091,9
1099,111,44,87,22,0.837629282060696,22
1100,2,34,54,17,0.8033910108899872,17
1101,49,25,54,13,0.7952964242907768,12
1102,29,25,9,13,0.7771037627191238,12
1103,107,45,65,20,0.7750649968921992,25
1104,70,49,98,24,0.7703441864474497,25
1105,112,17,87,9,0.7591685884445001,8
1106,23,24,6,12,0.757380072902326,12
1107,55,12,13,6,0.7567536850396058,6
1108,37,11,73,5,0.7437455399697707,6
1109,46,12,10,6,0.7362386600396065,6
1110,8,91,65,41,0.7286756190519219,50
1111,87,48,107,22,0.7220336856386385,26
1112,79,70,84,34,0.7045123518634121,36
1113,16,36,111,19,0.7024109034978862,17
1114,50,15,88,8,0.6966849372246732,7
1115,41,23,43,11,0.6921842337130496,12
1116,44,12,16,7,0.6740631728235357,5
1117,91,23,86,11,0.6661452371009022,12
1118,76,13,20,7,0.6610311160325412,6
1119,65,33,104,18,0.6526567218920184,15
1120,32,10,30,5,0.6490824873820774,5
1121,28,43,50,21,0.6427350235475658,22
1122,74,39,41,21,0.6406425090111565,18
1123,16,17,1,9,0.638053866963686,8
1124,48,46,16,23,0.6372929392635934,23
1125,91,18,44,8,0.6160976329615543,10
1126,11,11,79,7,0.6107232313792162,4
1127,55,22,29,12,0.608123085968795,10
1128,111,37,20,19,0.6068837109506102,18
1129,73,15,55,7,0.6065055891974576,8
1130,79,18,49,8,0.6053065369071557,10
1131,62,18,38,9,0.6043816495722358,9
1132,6,43,8,20,0.5988016059813149,23
1133,98,20,101,11,0.594870864776421,9
1134,75,10,23,5,0.5879055997029298,5
1135,15,14,2,7,0.5683026145731128,7
1136,107,17,48,8,0.557090283563172,9
1137,89,17,111,9,0.5563633904658294,8
1138,90,18,2,9,0.5540783404275302,9
1139,79,41,55,22,0.550687264714179,19
1140,10,18,37,8,0.5468156041706492,10
1141,2,22,62,10,0.5462872756743675,12
1142,98,67,79,35,0.5423907596369391,32
1143,54,48,86,23,0.5393131038468973,25
1144,66,13,41,7,0.534743534153649,6
1145,48,24,55,11,0.5337677992724043,13
1146,104,14,51,7,0.5303101352697448,7
1147,91,13,73,5,0.5133686150476426,8
1148,46,13,98,6,0.4949016763373522,7
1149,23,16,30,9,0.4884824633855258,7
1150,73,24,87,11,0.4865857809474523,13
1151,32,10,94,5,0.48339556643762405,5
1152,26,39,41,23,0.4754162497584248,16
1153,29,32,28,16,0.47285680343469233,16
1154,10,24,87,13,0.4726888100769076,11
1155,28,32,88,15,0.4686798041952342,17
1156,98,16,58,9,0.4540736471862188,7
1157,48,33,87,16,0.4418438090502057,17
1158,88,18,41,9,0.44177382423880074,9
1159,23,37,103,19,0.4333042786770578,18
1160,26,11,50,6,0.4324180875363617,5
1161,98,33,93,16,0.4249481440030074,17
1162,9,41,98,18,0.424424835693392,23
1163,109,14,79,7,0.42130275303052095,7
1164,23,26,107,13,0.40709415642669183,13
1165,93,16,55,8,0.39897461255756417,8
1166,41,13,85,6,0.3897097634286919,7
1167,55,50,28,22,0.3864978397570932,28
1168,44,10,50,5,0.37049181398411835,5
1169,70,22,9,10,0.35783800642150543,12
1170,107,29,55,16,0.34674543537917646,13
1171,55,54,65,24,0.33480129578262635,30
1172,49,17,91,9,0.3285488305810779,8
1173,74,10,75,5,0.3162987227122439,5
1174,19,14,41,8,0.30768619148938015,6
1175,2,23,30,12,0.29321348863964647,11
1176,98,58,28,30,0.2696965888382482,28
1177,37,22,70,11,0.26541516331841886,11
1178,35,13,79,6,0.2611575923038565,7
1179,103,28,38,14,0.2481523476415201,14
1180,18,27,54,14,0.24449076708154974,13
1181,84,12,1,6,0.2428062343244942,6
1182,2,31,74,16,0.2426189207787665,15
1183,55,29,50,13,0.24146107891644247,16
1184,66,20,9,10,0.23945533670543603,10
1185,85,10,66,5,0.23847533791686767,5
1186,84,58,37,30,0.2306892845057094,28
1187,87,11,71,6,0.21156446783375316,5
1188,30,22,74,10,0.20088773846185115,12
1189,29,36,41,18,0.19641039337775912,18
1190,30,18,18,8,0.18809198027763627,10
1191,79,45,76,21,0.17513970918172436,24
1192,26,19,2,10,0.15549736717273138,9
1193,23,38,28,19,0.15194126752419734,19
1194,6,23,112,11,0.14608972875934934,12
1195,32,18,50,10,0.14361277931057495,8
1196,34,19,50,8,0.14032687609608874,11
1197,86,29,107,15,0.1399161722852584,14
1198,74,20,37,10,0.1351513012183972,10
1199,13,11,87,6,0.13022005589559751,5
1200,91,19,88,9,0.11151015137343248,10
1201,6,29,41,15,0.0941275477253323,14
1202,38,15,110,8,0.07451058664372948,7
1203,8,64,2,34,0.0602818425873517,30
1204,85,24,79,13,0.034805559038930234,11
1205,84,39,107,19,0.023472071078477742,20
1206,40,14,65,6,0.022138801901295854,8
1207,86,13,96,7,0.020233588159525286,6
1208,37,15,38,8,0.0011031238349569132,7
1209,38,15,37,7,-0.0011031238349578606,8
1210,28,61,79,34,-0.008836982918016517,27
1211,96,13,86,6,-0.020233588159524193,7
1212,65,14,40,8,-0.022138801901296672,6
1213,13,13,107,6,-0.03566165788038671,7
1214,65,81,79,42,-0.04424467295364335,39
1215,76,38,65,18,-0.05184006466891194,20
1216,79,50,103,24,-0.05775390300531491,26
1217,2,25,20,13,-0.06141520142574363,12
1218,110,15,38,7,-0.07451058664372871,8
1219,87,42,74,20,-0.07958529470361445,22
1220,84,47,103,22,-0.09369403051445593,25
1221,41,29,6,14,-0.09412754772533327,15
1222,43,19,20,10,-0.09655439021695145,9
1223,88,19,91,10,-0.11151015137343323,9
1224,17,17,20,9,-0.12665014758012894,8
1225,87,11,13,5,-0.13022005589559688,6
1226,37,20,74,10,-0.135151301218397,10
1227,91,29,107,14,-0.13982179383331866,15
1228,107,29,86,14,-0.13991617228525743,15
1229,50,19,34,11,-0.14032687609608985,8
1230,111,25,30,13,-0.14558741487159338,12
1231,87,34,98,16,-0.1724338468755451,18
1232,28,50,74,24,-0.17793202645056747,26
1233,17,19,74,10,-0.18384205614173943,9
1234,18,18,30,10,-0.18809198027763716,8
1235,74,22,30,12,-0.20088773846185182,10
1236,71,11,87,5,-0.21156446783375446,6
1237,10,12,88,6,-0.22505216329234803,6
1238,66,10,85,5,-0.23847533791686928,5
1239,9,20,66,10,-0.23945533670543603,10
1240,1,12,84,6,-0.24280623432449092,6
1241,54,27,18,13,-0.24449076708155026,14
1242,38,28,103,14,-0.24815234764151944,14
1243,79,13,35,7,-0.26115759230385677,6
1244,70,22,37,11,-0.2654151633184179,11
1245,30,23,2,11,-0.29321348863964564,12
1246,28,37,48,20,-0.3045575028463844,17
1247,41,14,19,6,-0.30768619148938214,8
1248,10,27,111,13,-0.3114645815059003,14
1249,75,10,74,5,-0.3162987227122439,5
1250,91,17,49,8,-0.32854883058107764,9
1251,43,16,98,8,-0.334919329248079,8
1252,84,45,50,22,-0.341940991423321,23
1253,28,64,2,33,-0.34518024809502945,31
1254,9,22,70,12,-0.3578380064215045,10
1255,50,10,44,5,-0.37049181398411835,5
1256,84,67,8,33,-0.3729158728731228,34
1257,90,30,65,14,-0.37730681884186645,16
1258,8,62,10,32,-0.38632082928330636,30
1259,85,13,41,7,-0.3897097634286919,6
1260,55,16,93,8,-0.3989746125575646,8
1261,107,26,23,13,-0.4070941564266929,13
1262,65,32,17,16,-0.4089458448973926,16
1263,79,14,109,7,-0.42130275303052045,7
1264,98,41,9,23,-0.42442483569339234,18
1265,93,33,98,17,-0.42494814400300696,16
1266,41,18,88,9,-0.4417738242388016,9
1267,87,33,48,17,-0.44184380905020415,16
1268,88,32,28,17,-0.4686798041952336,15
1269,87,24,10,11,-0.4726888100769076,13
1270,28,32,29,16,-0.47285680343469205,16
1271,94,10,32,5,-0.4833955664376234,5
1272,87,24,73,13,-0.4865857809474514,11
1273,91,41,79,20,-0.4867348746757923,21
1274,98,13,46,7,-0.494901676337354,6
1275,73,13,91,8,-0.5133686150476421,5
1276,20,23,110,11,-0.5195268671329448,12
1277,51,14,104,7,-0.5303101352697429,7
1278,55,24,48,13,-0.5337677992724031,11
1279,41,13,66,6,-0.5347435341536495,7
1280,86,48,54,25,-0.5393131038468956,23
1281,62,22,2,12,-0.5462872756743683,10
1282,37,18,10,10,-0.5468156041706485,8
1283,111,17,89,8,-0.556363390465831,9
1284,48,17,107,9,-0.5570902835631725,8
1285,79,81,65,40,-0.5589485959558708,41
1286,23,10,75,5,-0.5879055997029312,5
1287,16,37,23,19,-0.5884301363027267,18
1288,101,20,98,9,-0.5948708647764195,11
1289,39,10,87,5,-0.5972214062189816,5
1290,23,33,79,18,-0.5991196107820859,15
1291,38,18,62,9,-0.6043816495722345,9
1292,55,15,73,8,-0.6065055891974562,7
1293,29,22,55,10,-0.6081230859687949,12
1294,79,11,11,4,-0.6107232313792149,7
1295,44,18,91,10,-0.6160976329615553,8
1296,16,46,48,23,-0.6372929392635932,23
1297,41,39,74,18,-0.640642509011156,21
1298,6,19,62,11,-0.6431821395568814,8
1299,30,10,32,5,-0.6490824873820789,5
1300,104,33,65,15,-0.6526567218920186,18
1301,29,20,103,10,-0.6578144863835312,10
1302,20,13,76,6,-0.6610311160325401,7
1303,86,23,91,12,-0.6661452371009026,11
1304,16,12,44,5,-0.6740631728235359,7
1305,101,15,23,7,-0.6750621504160544,8
1306,88,15,50,7,-0.6966849372246742,8
1307,74,42,87,23,-0.7245745938864455,19
1308,10,12,46,6,-0.7362386600396065,6
1309,73,11,37,6,-0.7437455399697719,5
1310,13,12,55,6,-0.7567536850396056,6
1311,87,17,112,8,-0.7591685884445006,9
1312,98,49,70,25,-0.770344186447448,24
1313,8,67,84,35,-0.7770567842970908,32
1314,54,34,2,17,-0.8033910108899884,17
1315,74,17,85,9,-0.8095598497605868,8
1316,91,21,29,10,-0.8357535316372816,11
1317,10,51,79,29,-0.8544891772527285,22
1318,38,18,91,10,-0.8605561818804589,8
1319,30,33,20,18,-0.8624210657658024,15
1320,79,12,5,5,-0.8638337222987221,7
1321,18,12,29,5,-0.8741742779448094,7
1322,65,21,62,12,-0.8755953834255741,9
1323,93,30,20,17,-0.8968767950978295,13
1324,49,15,93,7,-0.9146738839447184,8
1325,111,29,18,15,-0.9151185639276579,14
1326,9,11,60,5,-0.9156618531106686,6
1327,89,12,103,7,-0.9245541578032253,5
1328,28,78,8,40,-0.9254529528643421,38
1329,9,19,85,11,-0.9266510351352133,8
1330,91,15,57,9,-0.9462820674582971,6
1331,8,70,111,34,-0.9571051337572238,36
1332,49,28,84,14,-0.9573548536710035,14
1333,96,14,79,7,-0.9587839220541056,7
1334,15,11,10,5,-0.9620268464624092,6
1335,88,21,62,11,-0.9626827472726072,10
1336,16,10,68,5,-0.9723777343104946,5
1337,68,16,111,9,-0.9831903657030906,7
1338,30,16,41,8,-0.9850557086879017,8
1339,91,23,20,11,-0.9903622576025491,12
1340,5,12,8,5,-0.9947252871595057,7
1341,94,11,79,6,-0.9998691980069959,5
1342,41,33,70,17,-1.0073100144887814,16
1343,54,32,107,16,-1.0097458724362598,16
1344,41,13,75,7,-1.0160682715228835,6
1345,8,78,28,40,-1.0187943079709858,38
1346,88,21,48,12,-1.022088854727801,9
1347,98,32,90,17,-1.0267736789331345,15
1348,103,10,75,5,-1.035188460357086,5
1349,112,10,8,5,-1.0357746876565699,5
1350,62,16,74,7,-1.0383577563740003,9
1351,111,27,23,15,-1.048513117845392,12
1352,89,13,6,6,-1.0487640819634654,7
1353,106,11,98,5,-1.0522359380778148,6
1354,93,10,11,4,-1.0550285886343462,6
1355,103,15,76,9,-1.0648910249315973,6
1356,51,24,28,12,-1.0697876821134717,12
1357,73,20,103,10,-1.0728746625988024,10
1358,79,52,86,26,-1.0771246461688242,26
1359,107,23,49,11,-1.0783463838457161,12
1360,29,41,65,23,-1.0863542275741362,18
1361,28,66,84,34,-1.093288490158726,32
1362,50,45,84,24,-1.0947387353368896,21
1363,84,42,6,22,-1.1025381642551555,20
1364,28,16,73,7,-1.102601583168377,9
1365,56,10,16,6,-1.1063673005412131,4
1366,88,27,107,13,-1.1333373612451967,14
1367,91,23,30,13,-1.146326244872261,10
1368,65,81,41,44,-1.1521295696669458,37
1369,6,34,9,18,-1.1647790866636063,16
1370,1,10,103,4,-1.178228962480731,6
1371,79,67,98,33,-1.185782047717224,34
1372,111,49,98,25,-1.1971941446177512,24
1373,107,36,111,18,-1.1978257080625474,18
1374,23,37,16,19,-1.2113990211273438,18
1375,54,14,17,7,-1.212168763466305,7
1376,2,51,79,27,-1.2385569143211732,24
1377,63,10,50,6,-1.2561234705003208,4
1378,17,12,55,6,-1.2644044388351479,6
1379,107,18,10,10,-1.302641998274499,8
1380,62,12,86,4,-1.3029764877822885,8
1381,110,15,87,8,-1.307657393135164,7
1382,106,17,38,9,-1.3101869215810407,8
1383,103,47,84,26,-1.3117535282727075,21
1384,84,43,54,23,-1.3144548521624781,20
1385,65,35,37,19,-1.3173393657012917,16
1386,57,13,98,6,-1.3243405021868624,7
1387,90,32,98,16,-1.3246080262099156,16
1388,91,15,109,7,-1.3373257862259469,8
1389,87,41,84,21,-1.3385938795219061,20
1390,98,32,48,16,-1.3460381921205946,16
1391,9,30,76,16,-1.3464329670764872,14
1392,34,18,29,8,-1.3490741689669334,10
1393,74,33,20,17,-1.353456899126018,16
1394,32,14,23,6,-1.3629901576062295,8
1395,59,16,41,9,-1.3704315284875221,7
1396,85,17,54,8,-1.3789825215785738,9
1397,23,15,76,7,-1.3791825091008199,8
1398,8,13,44,8,-1.3823607495686732,5
1399,23,20,54,11,-1.3830605566363494,9
1400,84,70,79,37,-1.3852590410612948,33
1401,84,26,51,15,-1.3946044446619839,11
1402,41,81,65,39,-1.4041433009139985,42
1403,111,31,88,17,-1.4213124620809878,14
1404,3,10,65,5,-1.425825292351591,5
1405,107,23,18,13,-1.4296389206294247,10
1406,112,11,109,6,-1.4303792106135154,5
1407,57,10,103,4,-1.43349293747094,6
1408,54,44,16,23,-1.439692388389625,21
1409,23,27,111,13,-1.4435580232116272,14
1410,17,43,98,22,-1.4651649500523514,21
1411,20,13,90,6,-1.4684862703100507,7
1412,85,12,103,7,-1.505235765059642,5
1413,50,18,74,9,-1.5058020463222825,9
1414,62,19,6,9,-1.506313038221411,10
1415,98,43,17,23,-1.5166447539243209,20
1416,6,14,50,8,-1.5219443856325081,6
1417,74,50,28,27,-1.5230965628089277,23
1418,38,12,85,6,-1.5317416798467212,6
1419,37,58,84,29,-1.5410671219703609,29
1420,46,11,84,6,-1.553665479741575,5
1421,41,14,106,7,-1.5565364887175293,7
1422,86,13,104,7,-1.559071373061625,6
1423,14,10,76,5,-1.56343838736732,5
1424,94,11,2,6,-1.566847919784111,5
1425,29,16,16,9,-1.5836522711307057,7
1426,48,17,30,9,-1.5906665770496091,8
1427,8,56,70,28,-1.594033829324818,28
1428,90,18,10,10,-1.612631742744166,8
1429,91,22,84,11,-1.6140489066565649,11
1430,79,16,57,9,-1.6225267683647033,7
1431,107,27,88,15,-1.6330158511801816,12
1432,87,44,111,23,-1.641789170650758,21
1433,91,27,54,12,-1.688532679992717,15
1434,23,18,57,10,-1.6948872060166507,8
1435,18,13,20,7,-1.69876804268239,6
1436,76,11,38,6,-1.6999072226365548,5
1437,65,38,76,21,-1.7259377131088651,17
1438,45,10,76,5,-1.7263356630732685,5
1439,16,16,29,8,-1.7271978980205005,8
1440,103,29,16,15,-1.735855100464721,14
1441,30,12,17,6,-1.736609101114107,6
1442,65,18,71,9,-1.7385086790308772,9
1443,38,35,107,18,-1.7434138897292857,17
1444,55,32,84,17,-1.7463159686665113,15
1445,111,70,8,39,-1.7509750705170983,31
1446,54,20,15,11,-1.7760257646065063,9
1447,84,22,91,12,-1.7835975804372517,10
1448,109,10,57,6,-1.7866317267766754,4
1449,88,21,2,12,-1.7993488805723394,9
1450,76,13,85,8,-1.8000085206097036,5
1451,32,25,87,12,-1.8019631830327214,13
1452,93,25,6,13,-1.8024437751588966,12
1453,18,11,85,7,-1.8067340182792189,4
1454,84,20,14,13,-1.8141100794725638,7
1455,84,19,90,10,-1.8307456952070555,9
1456,98,19,73,10,-1.851371729787623,9
1457,55,25,49,11,-1.8646594153921843,14
1458,112,17,54,9,-1.8715662937888236,8
1459,90,10,34,5,-1.8752123956926063,5
1460,28,18,5,9,-1.8930799000381917,9
1461,103,14,70,8,-1.9027941936339994,6
1462,61,11,41,6,-1.9034780148497894,5
1463,90,19,86,11,-1.9043174139425585,8
1464,17,10,76,6,-1.9048948605366014,4
1465,84,16,96,8,-1.9155273589472777,8
1466,55,41,79,20,-1.9167817193509258,21
1467,37,22,6,11,-1.9187411338779805,11
1468,13,20,65,9,-1.9236367618157104,11
1469,48,10,62,6,-1.9270832455013296,4
1470,6,24,76,12,-1.937944044447951,12
1471,6,25,93,13,-1.9383775932498641,12
1472,107,39,84,21,-1.9386396796806626,18
1473,8,19,63,11,-1.9640537669425608,8
1474,29,11,49,7,-1.9792119029563418,4
1475,37,13,103,7,-1.9837820518429876,6
1476,41,16,34,9,-1.9846654519938336,7
1477,97,10,55,5,-1.9884220470048688,5
1478,71,10,37,6,-1.9896037058196856,4
1479,65,10,80,6,-1.9897653118429464,4
1480,74,55,98,28,-2.008567476708278,27
1481,48,37,28,18,-2.0107314103123723,19
1482,9,30,10,15,-2.0135222581265264,15
1483,74,17,90,9,-2.030135359930969,8
1484,93,20,88,8,-2.033372594210669,12
1485,96,14,8,7,-2.0352117697299557,7
1486,26,14,73,8,-2.0368384601286986,6
1487,65,72,84,37,-2.0379176330897706,35
1488,98,52,38,28,-2.0498657703552294,24
1489,26,30,9,17,-2.052887996849143,13
1490,10,18,91,10,-2.0539203960339205,8
1491,74,28,26,15,-2.062380911226794,13
1492,65,22,85,13,-2.0630480183814526,9
1493,104,17,9,10,-2.0746206420840276,7
1494,48,19,13,12,-2.0777118977088573,7
1495,8,69,98,37,-2.081911402735009,32
1496,90,17,74,9,-2.0848494229315673,8
1497,50,33,54,19,-2.0869519165828496,14
1498,84,18,75,10,-2.0937199255326187,8
1499,3,18,54,9,-2.1358068028320694,9
1500,1,15,87,7,-2.138632690920939,8
1501,111,44,84,25,-2.1422526544855915,19
1502,98,51,16,28,-2.149285725590278,23
1503,32,10,18,5,-2.1572241092213575,5
1504,15,11,9,6,-2.1575516880448644,5
1505,107,24,90,12,-2.161624044674689,12
1506,65,54,55,32,-2.1621650885730803,22
1507,86,52,28,26,-2.1700095013032836,26
1508,98,18,89,10,-2.180079413202899,8
1509,28,19,44,12,-2.1816767204067156,7
1510,65,45,107,26,-2.197287219114421,19
1511,48,31,86,17,-2.208595393524403,14
1512,11,18,8,10,-2.214420828158943,8
1513,65,30,90,17,-2.2173212695918445,13
1514,54,15,73,8,-2.217586045542855,7
1515,8,14,14,8,-2.2189602603742733,6
1516,57,12,54,7,-2.224387822283533,5
1517,58,11,8,5,-2.2258955118772117,6
1518,20,44,54,25,-2.2268078604275408,19
1519,49,23,107,13,-2.2491138584447943,10
1520,106,10,62,5,-2.251724283686679,5
1521,50,14,6,7,-2.2618843791117285,7
1522,9,40,37,22,-2.262801557650182,18
1523,32,18,62,9,-2.2636867699003225,9
1524,28,25,62,15,-2.271350662558558,10
1525,32,13,20,7,-2.2751108005385445,6
1526,84,48,74,26,-2.2830224549509457,22
1527,10,62,8,32,-2.284886264681262,30
1528,37,39,28,21,-2.310806744030662,18
1529,103,37,23,19,-2.3239729626949814,18
1530,94,11,41,6,-2.3275339532246493,5
1531,48,22,10,11,-2.3526521440575237,11
1532,107,10,51,6,-2.364406054363658,4
1533,43,23,41,13,-2.3652994967791563,10
1534,104,22,16,12,-2.3846505018780997,10
1535,16,61,79,34,-2.3998450437774235,27
1536,28,24,51,13,-2.4031456876246624,11
1537,50,43,28,23,-2.422539339191327,20
1538,57,16,79,8,-2.4270888358529543,8
1539,50,16,18,8,-2.4351075330006164,8
1540,93,17,86,9,-2.439868507446329,8
1541,79,24,85,12,-2.448715961670296,12
1542,48,22,63,12,-2.4502218283603607,10
1543,38,40,41,21,-2.4535603181412866,19
1544,29,27,6,14,-2.45903121181426,13
1545,88,46,8,25,-2.4622937925313138,21
1546,55,25,86,12,-2.464697480344814,13
1547,9,44,103,21,-2.4769487250437585,23
1548,29,20,2,11,-2.477941203005181,9
1549,62,15,37,8,-2.4789476689639174,7
1550,65,49,6,24,-2.47968083130177,25
1551,50,12,75,7,-2.4925159155893497,5
1552,107,41,98,23,-2.504606560314172,18
1553,86,36,65,19,-2.5084949662200597,17
1554,70,27,28,13,-2.510024433047842,14
1555,29,19,50,11,-2.525141516354553,8
1556,70,33,41,17,-2.5290882561404504,16
1557,49,10,63,5,-2.5291147398136253,5
1558,8,43,6,24,-2.5371830216491102,19
1559,48,15,49,7,-2.544499155603262,8
1560,86,56,8,31,-2.5454892932378956,25
1561,11,10,30,6,-2.5564825240632034,4
1562,111,27,10,15,-2.561286831397376,12
1563,79,51,2,27,-2.570420600253088,24
1564,112,20,38,11,-2.5875581099779774,9
1565,8,25,34,12,-2.599349637379093,13
1566,86,19,90,9,-2.5999398967094858,10
1567,28,40,30,22,-2.6105936366755755,18
1568,37,33,48,17,-2.6418897918039517,16
1569,107,12,85,8,-2.6471438550645616,4
1570,84,24,30,13,-2.649950052405462,11
1571,30,25,111,13,-2.6528736151948067,12
1572,9,11,106,6,-2.6544531376629665,5
1573,63,11,111,6,-2.656681768070538,5
1574,8,14,15,7,-2.6593953269851673,7
1575,98,49,111,27,-2.661784450073085,22
1576,111,13,43,8,-2.669621436422116,5
1577,20,16,37,9,-2.669796905589799,7
1578,43,17,107,9,-2.670387525820163,8
1579,86,21,6,11,-2.6797895540068413,10
1580,49,18,32,9,-2.688514142434056,9
1581,90,39,79,23,-2.6906940404909006,16
1582,87,36,2,21,-2.7024458768536723,15
1583,10,30,9,17,-2.725511572413539,13
1584,30,14,26,5,-2.7295268644643054,9
1585,86,40,98,23,-2.7301970918095306,17
1586,29,14,23,8,-2.732572073895786,6
1587,65,91,8,52,-2.7337241986003473,39
1588,28,21,34,12,-2.734662710408204,9
1589,103,19,48,10,-2.7455190211302885,9
1590,30,23,91,11,-2.757139530858619,12
1591,89,15,50,8,-2.767885417645722,7
1592,87,15,104,9,-2.773139485298443,6
1593,12,11,8,6,-2.8009343879230215,5
1594,65,55,38,30,-2.806589910357459,25
1595,107,25,93,14,-2.806698071004472,11
1596,85,17,98,8,-2.811605176676513,9
1597,55,12,104,6,-2.817049603991468,6
1598,54,55,98,28,-2.835866843669563,27
1599,107,20,63,12,-2.8489994132116676,8
1600,86,10,75,5,-2.8536540104730803,5
1601,63,14,74,8,-2.8546011556463156,6
1602,18,29,111,16,-2.859497108899379,13
1603,76,22,111,10,-2.8888180973130924,12
1604,111,30,90,17,-2.89054471305433,13
1605,32,18,49,10,-2.892278990328854,8
1606,34,16,6,8,-2.8927905205883553,8
1607,93,15,16,8,-2.9086793764389984,7
1608,20,23,91,13,-2.91310351812833,10
1609,88,81,65,45,-2.919863485318388,36
1610,41,36,29,19,-2.9244119186735795,17
1611,54,44,74,22,-2.926291357510124,22
1612,76,15,23,9,-2.940407468731348,6
1613,79,41,91,23,-2.9490646524657533,18
1614,37,58,79,33,-2.9640154422255227,25
1615,98,23,13,15,-2.9928471993749595,8
1616,55,29,107,15,-2.997846525798543,14
1617,89,16,26,8,-3.0015441091670585,8
1618,65,15,51,8,-3.0024330188565416,7
1619,8,11,12,6,-3.0172474302587955,5
1620,16,18,38,9,-3.0174584469144037,9
1621,89,17,48,9,-3.030683667814096,8
1622,76,45,79,26,-3.037225257348003,19
1623,44,14,9,6,-3.0418979222799787,8
1624,10,18,107,9,-3.050193716172087,9
1625,87,28,62,16,-3.05254413200227,12
1626,55,15,70,8,-3.0551209872054277,7
1627,65,16,43,8,-3.0818646979565365,8
1628,28,14,106,9,-3.0867970360917325,5
1629,79,56,41,30,-3.1072129437235954,26
1630,20,33,74,18,-3.1279922292078326,15
1631,38,36,79,20,-3.1386740959807797,16
1632,88,23,23,13,-3.1441600025036935,10
1633,90,10,1,5,-3.14882035881255,5
1634,16,19,50,10,-3.1594632722429505,9
1635,91,14,17,8,-3.16960980301192,6
1636,65,66,87,37,-3.1707364264120983,29
1637,9,43,48,25,-3.1751195832174797,18
1638,88,13,18,7,-3.1759771370815284,6
1639,75,15,111,7,-3.17685714011478,8
1640,8,25,104,15,-3.1877877944585076,10
1641,37,13,91,7,-3.1893915884876662,6
1642,86,19,23,10,-3.216916872797102,9
1643,26,37,79,21,-3.2224103393223973,16
1644,85,11,49,6,-3.234049059231714,5
1645,87,15,1,9,-3.235954063691745,6
1646,18,15,76,9,-3.237191989649946,6
1647,55,13,51,8,-3.2507621857687634,5
1648,65,30,73,17,-3.264498946198197,13
1649,98,11,59,6,-3.2664563544762517,5
1650,85,17,74,9,-3.280838878179328,8
1651,16,68,28,37,-3.2853890684127722,31
1652,84,23,57,13,-3.2865946702288213,10
1653,109,26,2,16,-3.2959656279360225,10
1654,62,18,16,10,-3.3165301409136863,8
1655,57,13,55,8,-3.327670077621321,5
1656,18,23,107,12,-3.3296591016307526,11
1657,18,57,28,31,-3.341827320423698,26
1658,79,30,30,17,-3.3581610508858177,13
1659,23,20,91,11,-3.3618813048957485,9
1660,6,18,49,10,-3.361990920437636,8
1661,85,14,2,7,-3.3798876085075156,7
1662,13,14,76,7,-3.383197454645703,7
1663,50,14,70,7,-3.3858944797818475,7
1664,28,32,32,18,-3.3937812746244553,14
1665,15,16,65,8,-3.396313291786303,8
1666,6,12,57,8,-3.4000169565132334,4
1667,84,20,32,12,-3.403700726822616,8
1668,28,54,111,30,-3.413874283084288,24
1669,91,10,5,4,-3.4255398118724374,6
1670,17,32,65,18,-3.431569242866022,14
1671,37,10,107,6,-3.444420525023787,4
1672,57,12,86,6,-3.4531517504498637,6
1673,79,34,54,18,-3.4597407834745564,16
1674,79,51,10,25,-3.461171301661281,26
1675,107,48,87,28,-3.462771267748502,20
1676,91,12,48,7,-3.4664297594725237,5
1677,55,14,1,8,-3.472860068937083,6
1678,29,32,98,17,-3.494477131581665,15
1679,2,64,28,35,-3.494662950113527,29
1680,88,34,55,21,-3.4984778706231747,13
1681,41,49,16,26,-3.501070366837183,23
1682,94,13,65,7,-3.505690987614661,6
1683,87,74,8,42,-3.5156095188959546,32
1684,28,14,14,9,-3.520697506583676,5
1685,16,11,46,6,-3.5247066219075394,5
1686,48,32,76,18,-3.525897058186025,14
1687,26,33,111,19,-3.5276889460712058,14
1688,87,26,70,15,-3.5345174393475727,11
1689,49,18,79,11,-3.5482844650415624,7
1690,38,25,50,14,-3.5687465201033057,11
1691,57,16,16,8,-3.5714373486183053,8
1692,75,14,87,7,-3.5866681857153258,7
1693,23,15,101,9,-3.591604516250614,6
1694,28,38,23,21,-3.599379928512799,17
1695,18,12,10,8,-3.6042571144804363,4
1696,79,61,28,30,-3.610546327891444,31
1697,112,10,98,5,-3.634369737429611,5
1698,73,22,20,12,-3.6521774474687554,10
1699,37,38,16,23,-3.6538134186570033,15
1700,6,16,34,9,-3.6598684680509215,7
1701,65,17,57,11,-3.66200460796526,6
1702,28,33,90,19,-3.6923457110468223,14
1703,70,34,54,18,-3.70016254332773,16
1704,62,15,91,8,-3.707999769375562,7
1705,10,14,32,9,-3.709056496740224,5
1706,87,10,60,5,-3.716219490276847,5
1707,38,22,84,13,-3.721558072111377,9
1708,41,16,48,9,-3.723395209925695,7
1709,28,50,55,30,-3.7362392036570076,20
1710,10,34,65,19,-3.7403807843221304,15
1711,18,12,57,8,-3.7525453734501912,4
1712,49,22,28,13,-3.761707702389012,9
1713,11,16,16,10,-3.7642884351875816,6
1714,2,64,8,33,-3.771603970672433,31
1715,73,15,79,8,-3.780403758532128,7
1716,110,11,26,5,-3.781495457699158,6
1717,103,12,110,7,-3.784927459031115,5
1718,18,15,93,8,-3.8000555745474087,7
1719,98,16,43,9,-3.8123705589147328,7
1720,91,14,32,7,-3.8253106560348464,7
1721,49,16,17,9,-3.8354352643495577,7
1722,29,21,91,12,-3.840820511726981,9
1723,18,18,41,11,-3.84366102932153,7
1724,75,10,37,6,-3.8443267506529617,4
1725,75,20,8,11,-3.850513142182257,9
1726,34,12,23,6,-3.85388189935407,6
1727,49,14,38,7,-3.8551286140805963,7
1728,9,78,84,46,-3.8632336429297727,32
1729,84,47,98,26,-3.8908337456526567,21
1730,2,26,91,15,-3.8971597312680113,11
1731,54,16,94,8,-3.897800639878564,8
1732,9,30,26,15,-3.917115924375875,15
1733,54,71,8,38,-3.9258790460113477,33
1734,74,22,43,13,-3.9345782455697673,9
1735,112,10,91,5,-3.946754868280294,5
1736,73,22,6,11,-3.9476996189213933,11
1737,87,32,23,19,-3.956644400151879,13
1738,8,40,91,21,-3.961945852137986,19
1739,65,42,23,23,-3.9627458762007683,19
1740,20,20,112,10,-3.9655619093439842,10
1741,74,29,16,17,-3.974341734686631,12
1742,26,14,55,8,-3.9805474058369166,6
1743,10,13,104,7,-3.982341981798969,6
1744,98,34,87,20,-3.9852020639548185,14
1745,34,18,107,10,-3.9868137021950045,8
1746,50,40,8,22,-3.9913080129704546,18
1747,8,29,73,18,-3.9924196449780625,11
1748,37,26,87,13,-3.9965570187790043,13
1749,28,72,65,41,-4.002474680377952,31
1750,79,33,23,17,-4.005580416521516,16
1751,103,50,79,29,-4.028559233170849,21
1752,28,58,98,31,-4.030600698284184,27
1753,65,10,52,6,-4.033826421153391,4
1754,2,19,26,10,-4.041871884320681,9
1755,98,23,109,13,-4.0431120330253485,10
1756,71,15,84,8,-4.046997354452872,7
1757,10,32,16,18,-4.051397029804468,14
1758,46,21,6,13,-4.0573986299655465,8
1759,10,41,2,24,-4.057775267216063,17
1760,75,10,65,6,-4.061741964132054,4
1761,104,12,90,6,-4.064341220930973,6
1762,107,25,16,14,-4.078467033041849,11
1763,2,63,98,35,-4.0864521676034835,28
1764,65,16,106,9,-4.0921186691282205,7
1765,98,39,37,22,-4.11677597890711,17
1766,10,16,103,9,-4.145748166667432,7
1767,2,15,37,8,-4.14722052773026,7
1768,35,11,16,6,-4.150016684827543,5
1769,91,23,65,11,-4.15010120900014,12
1770,8,28,30,17,-4.155265384733847,11
1771,18,22,16,13,-4.167483705263702,9
1772,32,16,2,9,-4.169077635966493,7
1773,8,24,51,14,-4.187811296214764,10
1774,111,62,79,37,-4.218289071737846,25
1775,6,24,23,13,-4.230313442640459,11
1776,85,19,8,10,-4.235296537690964,9
1777,79,47,6,27,-4.237391580830745,20
1778,8,11,97,7,-4.238412616249588,4
1779,86,38,9,21,-4.2400911751832,17
1780,16,19,51,12,-4.2426792919329,7
1781,88,33,79,21,-4.242790460167086,12
1782,49,13,18,7,-4.243576516469454,6
1783,98,39,6,23,-4.250381101594533,16
1784,46,24,74,12,-4.250765743447537,12
1785,16,21,63,11,-4.279009624505892,10
1786,48,15,85,9,-4.305363268792187,6
1787,41,39,26,18,-4.308213459712551,21
1788,107,16,30,10,-4.310516753383161,6
1789,1,20,41,13,-4.310885836842604,7
1790,29,37,87,21,-4.317833214151955,16
1791,106,11,84,5,-4.3181557746419115,6
1792,90,13,20,8,-4.319530234657456,5
1793,16,19,75,11,-4.325958452336133,8
1794,74,31,2,17,-4.326298290158694,14
1795,44,13,79,7,-4.356415433762269,6
1796,2,11,57,7,-4.360321050424336,4
1797,16,38,55,22,-4.369027460501823,16
1798,94,11,87,6,-4.375015437142172,5
1799,1,10,90,6,-4.375601097645208,4
1800,89,13,54,8,-4.375934710162814,5
1801,20,20,86,11,-4.3801351405506495,9
1802,8,29,29,16,-4.386286441561601,13
1803,41,36,50,20,-4.39168406813968,16
1804,41,36,84,22,-4.405400183867785,14
1805,20,19,43,10,-4.407702920435093,9
1806,103,20,73,11,-4.408542656876506,9
1807,107,29,91,17,-4.411308214147099,12
1808,91,24,16,14,-4.421398779473557,10
1809,13,10,90,5,-4.435057658973358,5
1810,2,18,90,10,-4.440452857575481,8
1811,76,37,16,20,-4.451124010231458,17
1812,58,16,98,8,-4.454073647186219,8
1813,86,12,35,8,-4.454208680307121,4
1814,84,23,73,15,-4.463513313785124,8
1815,110,23,20,13,-4.46357978693552,10
1816,15,25,111,15,-4.472513123100842,10
1817,29,21,111,10,-4.484029622528673,11
1818,107,31,74,18,-4.49684885234603,13
1819,93,21,29,12,-4.498959392246701,9
1820,62,11,29,6,-4.502398822563125,5
1821,6,27,29,15,-4.503478704943507,12
1822,23,40,41,23,-4.507259861409941,17
1823,93,29,111,15,-4.510765206652467,14
1824,85,11,18,5,-4.514791288537011,6
1825,74,15,32,9,-4.519404747582117,6
1826,109,26,65,13,-4.522732343847644,13
1827,23,24,74,13,-4.530539923458647,11
1828,89,20,9,13,-4.555028073124964,7
1829,32,22,55,13,-4.5613058564845765,9
1830,9,37,2,20,-4.570200756721712,17
1831,48,15,17,8,-4.57243158960934,7
1832,20,17,17,9,-4.57611326270597,8
1833,50,29,55,18,-4.585302402770459,11
1834,62,38,8,21,-4.586265631219047,17
1835,15,10,86,5,-4.603054673648832,5
1836,104,25,79,16,-4.621702045304473,9
1837,87,11,68,6,-4.626141991098492,5
1838,2,20,29,11,-4.659724574406296,9
1839,106,21,8,11,-4.667623942868985,10
1840,55,12,96,7,-4.672271940431311,5
1841,28,36,20,22,-4.676277899546413,14
1842,79,21,29,12,-4.677275321651237,9
1843,55,47,111,26,-4.698473816305829,21
1844,9,76,79,43,-4.699969329384482,33
1845,79,39,50,21,-4.700291458157238,18
1846,93,19,109,11,-4.710552248323455,8
1847,14,14,87,8,-4.712999134730353,6
1848,9,30,90,17,-4.717832744642908,13
1849,35,21,76,13,-4.725447690057797,8
1850,54,66,65,36,-4.75749689850986,30
1851,28,19,46,11,-4.7732100228715675,8
1852,54,23,46,14,-4.7761943840724514,9
1853,104,10,111,6,-4.78538385386756,4
1854,48,42,79,23,-4.785956113625242,19
1855,18,11,86,6,-4.795064637153174,5
1856,87,12,11,7,-4.803797400963364,5
1857,9,51,111,27,-4.814055936731913,24
1858,29,20,54,13,-4.828224061790944,7
1859,109,11,89,6,-4.829014520032646,5
1860,63,11,39,6,-4.830077117168623,5
1861,13,13,103,7,-4.835710066696813,6
1862,107,85,8,47,-4.84582785094699,38
1863,98,25,30,16,-4.849081372286935,9
1864,30,16,23,8,-4.860653795176971,8
1865,8,61,74,35,-4.861231025934779,26
1866,11,17,28,10,-4.863784981994054,7
1867,9,27,62,16,-4.876428914210389,11
1868,6,41,54,26,-4.900522402213304,15
1869,20,30,93,15,-4.900735470483163,15
1870,5,11,65,6,-4.901615377921411,5
1871,103,11,46,6,-4.934914439873031,5
1872,86,57,84,33,-4.943446390418057,24
1873,20,37,111,20,-4.9479559141790075,17
1874,111,36,107,21,-4.95140635788508,15
1875,16,26,32,15,-4.9645961397192355,11
1876,59,10,10,5,-4.967497448599415,5
1877,20,10,89,6,-4.97640303815121,4
1878,93,29,79,15,-4.983389647169374,14
1879,104,19,107,12,-4.99834795845683,7
1880,84,15,89,10,-5.0152693534373975,5
1881,96,14,48,8,-5.024611756936056,6
1882,88,14,63,8,-5.029062789658771,6
1883,1,17,16,9,-5.031673674933401,8
1884,43,13,111,7,-5.0327903736846205,6
1885,103,36,107,21,-5.041185354126945,15
1886,84,16,109,9,-5.067243867891082,7
1887,73,20,16,11,-5.0706587833744905,9
1888,41,16,59,9,-5.075333393683101,7
1889,84,25,29,14,-5.0940460573640145,11
1890,2,28,107,16,-5.101731059055636,12
1891,65,73,93,42,-5.102964751950764,31
1892,48,10,70,6,-5.103393723771427,4
1893,76,27,87,16,-5.11638843749194,11
1894,18,21,103,12,-5.117263308095348,9
1895,111,11,63,6,-5.123399041237538,5
1896,84,31,20,19,-5.125132779135495,12
1897,89,29,41,17,-5.128070897369619,12
1898,20,47,8,28,-5.13696712403145,19
1899,87,26,103,15,-5.13844337309213,11
1900,52,10,98,5,-5.141825899051739,5
1901,84,39,23,22,-5.174802875601986,17
1902,62,15,104,9,-5.186101581217904,6
1903,57,10,111,6,-5.186942618450885,4
1904,9,108,65,62,-5.228072138963157,46
1905,111,10,1,5,-5.238983537325088,5
1906,48,19,18,11,-5.245315113768614,8
1907,85,15,63,8,-5.266282773446651,7
1908,74,37,79,23,-5.271017622885964,14
1909,2,33,50,20,-5.273652216296242,13
1910,76,14,104,8,-5.288345369680408,6
1911,103,30,17,18,-5.294404276815358,12
1912,26,28,74,16,-5.30471712051598,12
1913,8,40,37,23,-5.3188247171166365,17
1914,86,24,50,15,-5.328218131490922,9
1915,54,31,87,18,-5.347464751665686,13
1916,71,11,54,7,-5.354693946074446,4
1917,6,13,89,8,-5.362805216014631,5
1918,41,66,8,36,-5.383353261881381,30
1919,20,52,87,30,-5.390680111680939,22
1920,20,27,6,14,-5.391516301598387,13
1921,28,10,19,6,-5.405282356849322,4
1922,50,37,98,20,-5.4072282296066625,17
1923,41,35,73,20,-5.413974250069213,15
1924,38,26,20,15,-5.422962328602488,11
1925,20,18,94,11,-5.424401699040208,7
1926,23,16,109,10,-5.438260955948294,6
1927,38,25,30,13,-5.45936332609693,12
1928,9,10,14,7,-5.463439437022661,3
1929,87,20,90,13,-5.4648990682068606,7
1930,57,16,87,9,-5.466000765538215,7
1931,98,44,20,26,-5.475555762264778,18
1932,38,35,54,21,-5.478565045653858,14
1933,79,53,87,29,-5.481943675368997,24
1934,73,21,74,12,-5.49643746893769,9
1935,85,12,107,5,-5.501246863309672,7
1936,54,46,28,27,-5.5206143371290795,19
1937,98,15,63,8,-5.531977699985538,7
1938,2,10,46,6,-5.541906116456114,4
1939,48,35,6,20,-5.544547995709246,15
1940,55,19,74,10,-5.544677661719653,9
1941,97,11,28,5,-5.54697078214519,6
1942,51,12,9,7,-5.566013437140973,5
1943,55,24,103,14,-5.588813975862993,10
1944,88,23,86,14,-5.601729846556069,9
1945,29,22,26,14,-5.630548836449718,8
1946,9,45,41,28,-5.6439057397283525,17
1947,6,26,103,16,-5.659939287843899,10
1948,50,13,17,8,-5.662435030700867,5
1949,91,29,111,16,-5.664784285354977,13
1950,9,13,43,7,-5.682535108763632,6
1951,51,11,18,6,-5.697627847770079,5
1952,65,23,89,13,-5.729458742490648,10
1953,9,49,87,28,-5.7353718278322,21
1954,55,14,26,8,-5.738748859328644,6
1955,37,20,90,12,-5.742590617036875,8
1956,9,29,38,16,-5.756435186772364,13
1957,9,36,50,21,-5.758521836854601,15
1958,76,43,86,24,-5.7608051831204765,19
1959,28,15,75,8,-5.767432508412389,7
1960,9,24,49,15,-5.768934866939488,9
1961,79,14,51,8,-5.772506691008202,6
1962,54,18,32,11,-5.782610489553489,7
1963,20,11,63,7,-5.791453238708793,4
1964,73,14,26,7,-5.793757710550314,7
1965,94,12,8,7,-5.79404543544707,5
1966,87,14,63,8,-5.794939568846778,6
1967,55,16,23,9,-5.806506460340061,7
1968,28,10,96,6,-5.817657099477481,4
1969,51,11,2,6,-5.82458141989376,5
1970,44,10,2,6,-5.829723764491529,4
1971,10,31,98,18,-5.831587893507183,13
1972,37,14,46,8,-5.834073346635607,6
1973,84,12,104,7,-5.8358328973406115,5
1974,87,28,49,15,-5.837138934523044,13
1975,79,83,8,45,-5.842723839430253,38
1976,98,41,23,25,-5.855857498312431,16
1977,16,17,17,10,-5.868342075872026,7
1978,103,34,50,20,-5.870794196365225,14
1979,8,79,55,49,-5.900174964881441,30
1980,9,45,74,27,-5.903246001506488,18
1981,96,13,16,8,-5.918742950992745,5
1982,20,11,46,5,-5.919838640633247,6
1983,2,32,84,19,-5.92758837249606,13
1984,112,20,20,12,-5.92853113025916,8
1985,18,27,98,16,-5.93123934771538,11
1986,91,28,87,17,-5.954439761122977,11
1987,10,25,89,15,-5.961935346068012,10
1988,49,23,8,13,-5.962799116224744,10
1989,87,38,16,22,-5.9692495612144985,16
1990,34,10,17,6,-5.970863859166942,4
1991,23,18,2,10,-5.985551573396107,8
1992,88,12,10,7,-5.999242564664751,5
1993,77,10,49,5,-6.002993751357126,5
1994,91,18,38,10,-6.003578716041363,8
1995,2,11,94,6,-6.010461250553638,5
1996,91,48,98,26,-6.010481139866049,22
1997,76,41,84,22,-6.0122133251855985,19
1998,98,27,26,14,-6.028495429489334,13
1999,9,28,13,18,-6.048703123654873,10
2000,89,25,79,16,-6.066359313406789,9
2001,74,38,111,22,-6.079631925271179,16
2002,86,23,51,14,-6.08656100121185,9
2003,76,14,30,9,-6.105099986395525,5
2004,56,11,111,7,-6.133528731729063,4
2005,48,52,8,31,-6.142283447978181,21
2006,88,23,87,15,-6.146478682205597,8
2007,86,44,87,27,-6.15670514302848,17
2008,66,11,2,7,-6.205381429919995,4
2009,34,14,16,8,-6.229556768499603,6
2010,41,35,2,22,-6.231438093089563,13
2011,48,17,2,9,-6.245081234312723,8
2012,87,24,38,15,-6.25648981898309,9
2013,106,11,6,6,-6.262787648448941,5
2014,50,23,111,14,-6.270457745960824,9
2015,44,15,111,9,-6.2820016152004,6
2016,54,16,90,9,-6.290244829620479,7
2017,28,49,107,27,-6.307256583472456,22
2018,54,19,62,12,-6.312055934230411,7
2019,76,41,88,23,-6.323191299261617,18
2020,111,30,2,18,-6.328590766591992,12
2021,73,18,86,11,-6.340120760849839,7
2022,65,84,20,51,-6.343089817722918,33
2023,28,10,31,6,-6.368565836830035,4
2024,88,22,103,14,-6.368772240906126,8
2025,84,28,70,16,-6.381194808632994,12
2026,50,12,90,7,-6.396354579252059,5
2027,39,10,65,6,-6.40523745473044,4
2028,28,14,12,9,-6.429365216940005,5
2029,8,10,112,6,-6.439047583949824,4
2030,62,10,90,6,-6.4415032468905995,4
2031,86,16,32,9,-6.471177759830176,7
2032,48,11,23,6,-6.485113687277626,5
2033,8,35,32,20,-6.494741280760348,15
2034,28,34,103,20,-6.496510604338202,14
2035,18,25,87,16,-6.500921078177539,9
2036,62,13,17,8,-6.51109228837904,5
2037,86,79,16,48,-6.517762010081229,31
2038,70,14,103,7,-6.530155528635705,7
2039,57,18,23,10,-6.535348935161005,8
2040,106,15,74,8,-6.5362197915338545,7
2041,70,18,79,9,-6.541994947083339,9
2042,41,54,28,30,-6.549671741224456,24
2043,68,25,8,14,-6.551836593531009,11
2044,6,19,30,13,-6.571810356539939,6
2045,18,48,8,29,-6.594687381789504,19
2046,76,20,107,12,-6.61181954357389,8
2047,76,19,55,11,-6.616826334007979,8
2048,54,33,48,21,-6.6293905929603625,12
2049,16,21,90,12,-6.632184549525892,9
2050,51,21,87,12,-6.638885465379,9
2051,85,14,86,7,-6.640232602185863,7
2052,17,14,91,8,-6.646960274535358,6
2053,49,16,74,9,-6.6690338705923,7
2054,9,24,18,14,-6.669379438735331,10
2055,2,14,15,8,-6.68122325045803,6
2056,9,100,8,58,-6.694606497363985,42
2057,62,18,79,10,-6.706683341972167,8
2058,54,25,49,14,-6.709179862826327,11
2059,9,25,29,14,-6.70933512946719,11
2060,74,11,89,6,-6.714017548400364,5
2061,111,14,13,9,-6.729510456907126,5
2062,34,19,2,11,-6.729658072634228,8
2063,41,42,111,24,-6.742879314894576,18
2064,28,50,87,30,-6.785536302011417,20
2065,20,25,2,14,-6.800156386602417,11
2066,41,35,91,22,-6.801656465480553,13
2067,28,39,76,23,-6.80499505832736,16
2068,6,21,88,13,-6.808639243885848,8
2069,87,18,43,11,-6.811944333065352,7
2070,64,11,28,6,-6.82253762472366,5
2071,91,26,6,15,-6.823132237906975,11
2072,16,69,8,43,-6.832024317947625,26
2073,8,24,90,15,-6.838297347223882,9
2074,106,11,55,7,-6.85873261965054,4
2075,88,28,9,17,-6.859441769537254,11
2076,28,38,38,22,-6.8687841977025155,16
2077,65,64,16,37,-6.878077106994111,27
2078,87,11,89,7,-6.89032748453306,4
2079,68,18,65,10,-6.895924597371667,8
2080,74,12,57,8,-6.91760424242575,4
2081,17,14,90,8,-6.930186835428714,6
2082,88,18,20,11,-6.938480603467197,7
2083,68,10,73,6,-6.95394987102174,4
2084,101,11,79,6,-6.990861425930873,5
2085,9,36,107,19,-6.995537467245023,17
2086,6,19,90,11,-7.0034906221582,8
2087,6,10,51,7,-7.0035300376142064,3
2088,91,26,103,13,-7.011657257024809,13
2089,93,48,8,30,-7.0175664395797135,18
2090,6,20,111,12,-7.01838566892247,8
2091,9,40,23,24,-7.023066131343451,16
2092,79,19,59,11,-7.0352036880537865,8
2093,50,34,87,21,-7.043252292270627,13
2094,28,37,91,23,-7.04770720595576,14
2095,34,24,98,16,-7.069151815365415,8
2096,13,10,10,5,-7.08154547770926,5
2097,54,32,88,19,-7.0901622206071115,13
2098,28,25,104,16,-7.094797317145898,9
2099,89,16,16,10,-7.102664218068734,6
2100,76,35,98,21,-7.11656236534676,14
2101,91,17,63,10,-7.145656838756392,7
2102,103,20,29,12,-7.147753101442872,8
2103,32,16,103,10,-7.165401001930772,6
2104,6,11,5,7,-7.175117705775805,4
2105,34,13,111,7,-7.201437198359538,6
2106,48,48,84,28,-7.209403276697929,20
2107,6,29,55,20,-7.216182147698299,9
2108,76,19,10,11,-7.223608714939963,8
2109,8,41,23,25,-7.226225929875295,16
2110,73,18,50,10,-7.241939960957099,8
2111,103,49,98,31,-7.248745608369252,18
2112,38,14,88,8,-7.257573306252311,6
2113,73,10,30,6,-7.2752412959190496,4
2114,70,15,23,9,-7.277989111704888,6
2115,94,16,9,9,-7.284482029205993,7
2116,86,22,41,13,-7.286274520016925,9
2117,20,13,13,9,-7.287197108459042,4
2118,10,21,54,13,-7.316914939103655,8
2119,9,35,73,21,-7.31762524261672,14
2120,28,42,93,25,-7.320077356490772,17
2121,103,16,10,9,-7.341759223830171,7
2122,65,53,74,33,-7.345256184830916,20
2123,65,50,63,30,-7.358014786861475,20
2124,50,11,20,7,-7.37029217669463,4
2125,88,24,37,15,-7.378135194639771,9
2126,8,12,94,7,-7.380839863701195,5
2127,5,15,98,9,-7.40308817440165,6
2128,49,13,41,9,-7.40613906742907,4
2129,88,17,46,11,-7.407535109641899,6
2130,48,34,65,21,-7.410700295202604,13
2131,75,13,41,7,-7.41688145074682,6
2132,9,13,75,9,-7.420012168869883,4
2133,68,14,98,10,-7.427653338623123,4
2134,107,32,79,21,-7.430282572409814,11
2135,57,17,88,10,-7.432081698575297,7
2136,37,24,23,15,-7.440544332640971,9
2137,65,71,111,40,-7.44315444932928,31
2138,28,29,10,19,-7.458178088618773,10
2139,23,10,104,6,-7.459802178175598,4
2140,111,36,16,20,-7.468239795228054,16
2141,37,27,54,18,-7.469706742796568,9
2142,38,24,2,13,-7.498014725943601,11
2143,38,10,34,6,-7.513274255260262,4
2144,54,28,103,16,-7.519450232339535,12
2145,107,20,29,13,-7.525530619454991,7
2146,76,21,91,13,-7.538547355116531,8
2147,84,67,16,40,-7.560758263344042,27
2148,79,23,17,14,-7.583686995894435,9
2149,48,18,90,11,-7.588405779874588,7
2150,41,45,87,26,-7.5997473042409585,19
2151,28,40,6,25,-7.6079577597869825,15
2152,34,16,87,10,-7.640142491832505,6
2153,86,29,74,18,-7.646930643556196,11
2154,62,19,84,11,-7.65619075053016,8
2155,74,20,10,13,-7.659112863437717,7
2156,2,49,16,30,-7.691279770578487,19
2157,59,11,23,7,-7.703199044299859,4
2158,86,26,30,19,-7.726335622844075,7
2159,85,14,111,9,-7.729378570457982,5
2160,9,71,16,46,-7.73633849027455,25
2161,74,19,17,11,-7.746897696537681,8
2162,109,15,103,10,-7.74806703390503,5
2163,48,17,50,10,-7.751737687672279,7
2164,109,13,29,8,-7.7648215544268036,5
2165,49,15,30,9,-7.795814319272768,6
2166,2,11,58,7,-7.801381373372695,4
2167,2,18,70,12,-7.802975472592941,6
2168,90,13,55,8,-7.804139466218974,5
2169,109,25,20,17,-7.80690748170692,8
2170,37,32,76,21,-7.820497576953574,11
2171,38,36,8,23,-7.848513446954377,13
2172,49,18,20,11,-7.854535242795636,7
2173,9,49,54,30,-7.862767512170962,19
2174,12,11,74,6,-7.881335923893619,5
2175,9,30,109,18,-7.889736540676633,12
2176,13,14,49,8,-7.890029815709072,6
2177,88,27,74,18,-7.895683127849934,9
2178,34,28,84,19,-7.909990649913739,9
2179,29,13,10,8,-7.953877306686606,5
2180,86,27,111,16,-7.962255850113394,11
2181,9,10,71,6,-7.971373091011489,4
2182,37,12,109,7,-7.972273664149992,5
2183,34,25,8,16,-7.975314953797204,9
2184,34,16,41,9,-7.985588983079854,7
2185,46,12,29,8,-7.990068011062898,4
2186,41,15,90,9,-7.997737246515682,6
2187,86,11,1,7,-8.004187715591307,4
2188,74,11,13,7,-8.04867506694036,4
2189,13,12,6,7,-8.074590184679874,5
2190,10,15,30,10,-8.08039942607508,5
2191,9,14,19,8,-8.117304295019109,6
2192,9,36,55,24,-8.119772650595259,12
2193,79,24,34,13,-8.127174908274364,11
2194,85,20,28,12,-8.15287634199834,8
2195,76,56,8,35,-8.186735758017774,21
2196,9,11,11,7,-8.198586667223204,4
2197,94,13,28,8,-8.222371266039165,5
2198,51,19,54,11,-8.227410100820899,8
2199,16,10,26,6,-8.231874067384071,4
2200,8,17,1,10,-8.238012177466368,7
2201,17,14,111,8,-8.239799794462428,6
2202,37,11,51,7,-8.265197669915755,4
2203,8,30,17,19,-8.267140148743708,11
2204,109,11,76,8,-8.273966572487595,3
2205,58,12,65,6,-8.279172093518044,6
2206,41,18,76,11,-8.284971187696902,7
2207,48,10,11,6,-8.287859925157548,4
2208,34,14,55,10,-8.304742214344207,4
2209,59,17,9,11,-8.305936798720639,6
2210,109,33,8,20,-8.311226620633244,13
2211,103,45,41,31,-8.332714422601015,14
2212,9,36,91,22,-8.337030454552696,14
2213,88,26,84,17,-8.338765030439285,9
2214,70,10,20,7,-8.374580328727138,3
2215,65,14,1,9,-8.38534721300084,5
2216,89,11,90,7,-8.396796914570167,4
2217,88,40,16,27,-8.414893106044769,13
2218,10,21,73,14,-8.419335562342074,7
2219,1,21,98,14,-8.436557583367687,7
2220,84,31,93,20,-8.465363334016377,11
2221,56,13,8,9,-8.47665012859135,4
2222,98,30,49,18,-8.481939269224359,12
2223,68,19,20,11,-8.49950046367544,8
2224,103,24,26,14,-8.523036763842914,10
2225,9,25,32,16,-8.53109215537152,9
2226,48,12,34,7,-8.533414260232822,5
2227,8,46,26,27,-8.545433145117217,19
2228,76,10,11,6,-8.56044399501451,4
2229,10,18,93,12,-8.563863748489084,6
2230,50,29,107,19,-8.583068473313562,10
2231,87,35,93,22,-8.595406377397056,13
2232,66,14,84,9,-8.616861190106436,5
2233,32,26,65,16,-8.65722618752934,10
2234,109,18,34,11,-8.66273498003356,7
2235,75,11,48,8,-8.672815346664251,3
2236,20,15,34,10,-8.68693105656746,5
2237,46,11,16,7,-8.68716865467983,4
2238,6,27,16,16,-8.696725649896711,11
2239,62,16,76,8,-8.710475893988356,8
2240,54,31,55,21,-8.716015508186064,10
2241,20,35,55,21,-8.738108987978196,14
2242,37,24,30,16,-8.742074606758964,8
2243,35,16,48,10,-8.750506609295915,6
2244,38,15,32,10,-8.75452405688887,5
2245,91,26,2,15,-8.783750173530157,11
2246,20,53,41,35,-8.79255140026366,18
2247,74,28,93,19,-8.795682713621986,9
2248,93,24,23,14,-8.804783518097919,10
2249,76,10,29,7,-8.806443209825622,3
2250,85,11,10,6,-8.810276618143424,5
2251,79,26,32,17,-8.859137187931584,9
2252,94,17,98,11,-8.877059957058028,6
2253,106,14,16,9,-8.877977313206351,5
2254,80,10,79,6,-8.908530308835552,4
2255,86,14,11,8,-8.916954568118552,6
2256,50,11,112,7,-8.921235906620762,4
2257,91,16,55,11,-8.921765963817519,5
2258,86,20,10,13,-8.925705329647823,7
2259,110,20,107,12,-8.933567921834605,8
2260,111,18,48,12,-8.93792122942067,6
2261,46,19,111,12,-8.943973618396548,7
2262,96,14,65,8,-8.945535735868065,6
2263,18,19,74,12,-8.971261505798399,7
2264,107,17,43,11,-8.971497306643272,6
2265,86,41,37,25,-8.9832167055326,16
2266,62,19,41,12,-9.00335332858162,7
2267,44,11,84,7,-9.017421120510093,4
2268,76,35,74,23,-9.021109435296268,12
2269,50,16,91,11,-9.044194652502608,5
2270,16,12,15,8,-9.05960662342551,4
2271,109,13,106,8,-9.06266809979583,5
2272,32,12,26,7,-9.09769401619869,5
2273,112,23,6,14,-9.097888193162195,9
2274,57,11,2,6,-9.107338089684553,5
2275,91,35,74,22,-9.120669894046731,13
2276,65,41,2,28,-9.121243860129145,13
2277,79,24,18,14,-9.141344406761542,10
2278,48,12,20,8,-9.14350934071883,4
2279,63,25,84,16,-9.157819288318455,9
2280,85,28,84,16,-9.160197369727129,12
2281,43,24,8,15,-9.183295995535126,9
2282,28,26,13,18,-9.183739107543797,8
2283,37,16,55,10,-9.183747537097535,6
2284,54,46,111,29,-9.235401744617302,17
2285,50,12,110,8,-9.25251740175268,4
2286,84,20,17,13,-9.25697489923984,7
2287,50,14,43,9,-9.27474781724881,5
2288,86,20,38,14,-9.280969369301586,6
2289,9,34,20,23,-9.290302263411943,11
2290,23,17,50,10,-9.300090532650529,7
2291,107,13,13,9,-9.307281354536356,4
2292,112,13,28,8,-9.317343463958052,5
2293,106,23,79,14,-9.330142332667407,9
2294,29,22,74,13,-9.341715830488068,9
2295,75,19,79,13,-9.342561498216151,6
2296,86,17,49,9,-9.343172433673239,8
2297,8,14,59,9,-9.376826871718674,5
2298,30,22,55,13,-9.385734127086305,9
2299,8,17,46,11,-9.405496106583279,6
2300,89,25,28,15,-9.422989936012565,10
2301,10,11,57,7,-9.432674751481889,4
2302,87,27,30,18,-9.441306317195094,9
2303,84,17,18,11,-9.480131506018989,6
2304,19,11,103,7,-9.481054864710421,4
2305,58,11,6,7,-9.489496457414932,4
2306,76,23,15,15,-9.503739473265108,8
2307,88,14,32,10,-9.505084521049728,4
2308,79,21,13,15,-9.547980426671515,6
2309,65,21,60,13,-9.571951123571171,8
2310,85,25,16,16,-9.572199671326333,9
2311,89,22,23,14,-9.576875474490599,8
2312,65,60,98,39,-9.578885579734806,21
2313,54,35,93,25,-9.580586312783261,10
2314,70,18,30,12,-9.585226013483616,6
2315,35,12,8,7,-9.605315474711036,5
2316,8,21,13,14,-9.615323131026955,7
2317,41,27,55,16,-9.622531787318458,11
2318,18,10,46,7,-9.6369429103627,3
2319,62,26,98,16,-9.641858129313675,10
2320,85,11,88,7,-9.656301948727862,4
2321,38,32,29,21,-9.681299801122256,11
2322,54,12,11,8,-9.747794227973568,4
2323,103,36,111,23,-9.751404731703087,13
2324,103,42,8,29,-9.755203687685839,13
2325,91,17,93,11,-9.794639196057782,6
2326,74,13,70,9,-9.800022679632324,4
2327,76,25,54,15,-9.82196620742167,10
2328,9,28,17,18,-9.851089499965493,10
2329,50,14,10,9,-9.907166966632534,5
2330,108,11,16,7,-9.921562283850518,4
2331,17,13,87,8,-9.92299839057508,5
2332,75,10,103,6,-9.92764617859353,4
2333,70,11,93,7,-9.928875321549777,4
2334,18,14,55,9,-9.949790942140542,5
2335,87,50,55,33,-9.957250285763632,17
2336,32,30,111,18,-9.962416908002066,12
2337,38,24,111,15,-9.966212518632437,9
2338,23,20,90,13,-9.96715448150969,7
2339,20,45,107,28,-9.968012127642075,17
2340,34,17,76,11,-9.994247540573088,6
2341,30,11,88,6,-10.024835723736619,5
2342,34,14,37,9,-10.040882054419711,5
2343,74,29,103,20,-10.120878103689181,9
2344,65,23,110,15,-10.151511833678441,8
2345,38,10,60,6,-10.186949801542625,4
2346,16,19,30,13,-10.198498356340071,6
2347,6,16,26,11,-10.241752287967037,5
2348,87,10,39,6,-10.267299551613329,4
2349,73,16,2,10,-10.299221262346556,6
2350,89,14,8,9,-10.313019177206712,5
2351,9,23,34,14,-10.326274877348238,9
2352,46,11,20,8,-10.3403562689593,3
2353,50,24,65,16,-10.363532140430609,8
2354,75,11,2,7,-10.369833561069749,4
2355,76,21,70,14,-10.3832919130965,7
2356,17,10,29,7,-10.39598522715346,3
2357,65,19,70,13,-10.418442635866082,6
2358,76,21,46,15,-10.423738421119205,6
2359,86,17,64,11,-10.437285409841268,6
2360,54,10,14,7,-10.443430113517227,3
2361,79,37,26,23,-10.48182801922156,14
2362,8,17,110,12,-10.493443474648162,5
2363,20,18,16,11,-10.507912719710413,7
2364,79,34,20,23,-10.53719224502861,11
2365,32,12,6,8,-10.5718983874489,4
2366,41,39,54,26,-10.593430312504074,13
2367,9,73,28,46,-10.611425846236083,27
2368,101,10,65,6,-10.616476001261296,4
2369,104,15,54,10,-10.631063301403966,5
2370,88,37,98,26,-10.63966352804894,11
2371,58,13,38,9,-10.642287291889899,4
2372,109,16,107,10,-10.668493285549742,6
2373,44,35,6,22,-10.67278245600393,13
2374,41,14,37,9,-10.69447624326301,5
2375,103,50,65,34,-10.69843242130798,16
2376,85,10,91,5,-10.702453755941068,5
2377,6,29,87,19,-10.703931695338108,10
2378,88,16,73,11,-10.709173893318198,5
2379,54,25,63,16,-10.767569219567788,9
2380,18,14,23,10,-10.769319649937687,4
2381,23,16,17,11,-10.781653305644483,5
2382,68,11,50,8,-10.798306988405807,3
2383,11,17,98,11,-10.827326865112727,6
2384,41,48,98,30,-10.835326353590224,18
2385,65,30,26,19,-10.898269254189744,11
2386,20,38,26,25,-10.94603615247926,13
2387,2,11,13,8,-10.953261699605443,3
2388,65,16,34,10,-10.953466701825645,6
2389,43,10,30,7,-10.958461383133036,3
2390,56,10,87,7,-10.97544493784176,3
2391,6,14,38,10,-11.005398790381081,4
2392,110,12,98,8,-11.026999619900332,4
2393,103,13,13,8,-11.054952217566056,5
2394,6,25,74,17,-11.078169532223491,8
2395,10,29,84,19,-11.086412944996143,10
2396,86,14,106,10,-11.088025872453063,4
2397,104,10,74,7,-11.124138818031259,3
2398,37,19,93,13,-11.13537305772806,6
2399,28,10,15,7,-11.176545961741331,3
2400,44,18,65,11,-11.219859746185271,7
2401,1,14,93,10,-11.222746146114872,4
2402,50,18,32,11,-11.225096892130631,7
2403,29,21,30,13,-11.231145218657787,8
2404,71,12,98,8,-11.256798740703502,4
2405,6,29,107,19,-11.291567068221694,10
2406,2,10,39,6,-11.302944205280658,4
2407,103,22,2,16,-11.358008021341288,6
2408,5,15,87,10,-11.401940952769143,5
2409,41,20,17,15,-11.462467383182341,5
2410,28,17,43,12,-11.503038032270851,5
2411,70,28,16,20,-11.54427586863591,8
2412,7,10,107,7,-11.561152440630659,3
2413,109,22,38,15,-11.561969316834697,7
2414,102,16,65,10,-11.565057266886953,6
2415,13,18,16,12,-11.568229122492735,6
2416,48,22,74,14,-11.585683993127107,8
2417,18,16,65,11,-11.593628436717696,5
2418,103,26,30,18,-11.594512781464298,8
2419,18,11,91,7,-11.600004781918232,4
2420,15,17,98,11,-11.628891195956705,6
2421,55,18,10,11,-11.634204977110194,7
2422,93,13,73,9,-11.6698926319616,4
2423,75,13,93,8,-11.701725422413729,5
2424,86,11,46,8,-11.702567693743317,3
2425,20,13,18,8,-11.715025972179685,5
2426,62,13,70,8,-11.719880801732709,5
2427,26,15,23,10,-11.729655071897735,5
2428,48,15,93,11,-11.743861625157338,4
2429,79,10,15,7,-11.756403792330063,3
2430,98,18,104,11,-11.758094591275455,7
2431,107,14,1,9,-11.758251767033554,5
2432,46,14,26,9,-11.785571142877396,5
2433,63,14,37,9,-11.788951691627307,5
2434,37,11,50,7,-11.791517943036679,4
2435,103,29,93,19,-11.801085216233043,10
2436,9,11,58,8,-11.82226661915616,3
2437,62,15,23,11,-11.828374088275872,4
2438,37,17,85,13,-11.836833776252561,4
2439,109,14,43,9,-11.866460109925436,5
2440,87,44,26,29,-11.871386146117102,15
2441,1,11,9,7,-11.88637849875501,4
2442,17,13,18,8,-11.905263091036245,5
2443,76,10,93,7,-11.923250604262599,3
2444,65,11,14,8,-11.952914938466222,3
2445,65,22,49,14,-11.960634834980652,8
2446,109,19,74,12,-11.981116452380181,7
2447,70,11,29,8,-12.030336124564109,3
2448,30,15,93,10,-12.041707290163442,5
2449,79,20,63,13,-12.045237433446484,7
2450,48,11,104,8,-12.069826525059817,3
2451,6,18,18,12,-12.078104024118801,6
2452,112,11,79,8,-12.089617166544242,3
2453,109,15,91,10,-12.09037191037832,5
2454,103,11,58,8,-12.093407699535737,3
2455,109,27,54,18,-12.131563798369134,9
2456,41,20,93,15,-12.152619394683914,5
2457,109,11,10,7,-12.166039484484626,4
2458,66,14,8,10,-12.246420589176186,4
2459,9,16,63,10,-12.275723948784513,6
2460,41,24,32,15,-12.295470101415006,9
2461,50,17,93,11,-12.303370496346982,6
2462,26,12,93,8,-12.342400061412198,4
2463,97,11,9,7,-12.349501112253755,4
2464,23,18,20,13,-12.419097927334022,5
2465,62,22,93,15,-12.439036445917942,7
2466,66,10,107,7,-12.465793182898503,3
2467,50,17,30,11,-12.478426478717187,6
2468,84,14,15,10,-12.488568021465507,4
2469,48,16,51,12,-12.491719199285036,4
2470,86,10,13,7,-12.514933779078893,3
2471,109,13,86,8,-12.564742847433582,5
2472,98,41,55,29,-12.606268888418896,12
2473,98,25,32,17,-12.60897292614075,8
2474,9,21,46,13,-12.652533384487015,8
2475,103,33,20,24,-12.666531668869954,9
2476,90,11,73,8,-12.699639901607055,3
2477,62,23,55,15,-12.723053800596206,8
2478,111,21,73,14,-12.761253099258202,7
2479,17,14,86,10,-12.845058614378045,4
2480,86,32,2,23,-12.867270746154679,9
2481,9,37,93,26,-12.871076607744827,11
2482,8,11,3,8,-12.917286316124729,3
2483,43,18,55,12,-13.012921035450152,6
2484,70,15,107,10,-13.053888487638648,5
2485,9,24,30,17,-13.086601208658113,7
2486,109,17,55,12,-13.091080409868953,5
2487,41,30,107,19,-13.154593566297324,11
2488,103,11,43,7,-13.18571482888933,4
2489,17,25,28,18,-13.189393025867652,7
2490,107,17,32,13,-13.233625998220862,4
2491,89,10,58,7,-13.242354787086834,3
2492,109,24,26,17,-13.281044125686407,7
2493,73,12,89,8,-13.292782754035754,4
2494,62,12,30,8,-13.325811773490164,4
2495,109,22,32,15,-13.338298268264783,7
2496,91,10,112,7,-13.34887289439105,3
2497,73,15,13,10,-13.471561712276635,5
2498,62,27,107,18,-13.491527071908129,9
2499,38,23,74,15,-13.50724395592576,8
2500,37,20,111,13,-13.57504840749371,7
2501,5,12,37,9,-13.593067112324485,3
2502,43,17,26,13,-13.59933768355571,4
2503,20,13,106,8,-13.604914514810028,5
2504,13,17,84,11,-13.614397809771184,6
2505,13,10,37,7,-13.71058873552403,3
2506,71,20,8,13,-13.739907398566018,7
2507,73,16,38,10,-13.771113964229546,6
2508,8,12,77,9,-13.772928583045534,3
2509,43,14,93,10,-13.775006273083642,4
2510,51,10,34,7,-13.832212239769484,3
2511,50,11,26,8,-13.83833866908602,3
2512,84,10,64,6,-13.843363433250811,4
2513,2,22,55,15,-13.871872112800904,7
2514,109,12,70,9,-13.902253335630233,3
2515,54,27,30,19,-13.923397923845725,8
2516,107,35,26,27,-13.95146533006327,8
2517,9,20,57,15,-13.952239963411907,5
2518,85,14,30,10,-14.008346410378737,4
2519,76,14,57,10,-14.156354151485946,4
2520,38,12,48,9,-14.205802555452095,3
2521,109,12,50,8,-14.261856398454313,4
2522,8,10,60,7,-14.262033464961128,3
2523,70,12,90,9,-14.290264472561063,3
2524,91,11,46,8,-14.304066831342237,3
2525,66,10,28,6,-14.329185091749263,4
2526,50,10,104,7,-14.369017199502489,3
2527,38,26,55,18,-14.425488233223774,8
2528,20,26,29,18,-14.478890408494554,8
2529,11,15,55,11,-14.552741756285249,4
2530,20,19,62,14,-14.584809923949425,5
2531,13,14,88,8,-14.636848081546901,6
2532,74,16,34,11,-14.640026082092419,5
2533,59,14,65,9,-14.654063925888893,5
2534,93,11,90,7,-14.682520064465665,4
2535,62,11,49,7,-14.691411076024673,4
2536,38,25,93,17,-14.706979782976546,8
2537,17,11,93,8,-14.792328082005685,3
2538,41,13,13,9,-14.878152444409187,4
2539,37,15,57,11,-15.067776643574774,4
2540,40,14,84,9,-15.139436492633186,5
2541,18,11,90,8,-15.206260273523743,3
2542,28,26,26,19,-15.211295764909368,7
2543,6,31,2,22,-15.303923962237263,9
2544,76,16,63,13,-15.315183161564981,3
2545,57,23,8,16,-15.346450747313162,7
2546,23,24,10,16,-15.417351314064488,8
2547,88,13,70,10,-15.445871190573264,3
2548,87,19,106,15,-15.497991654896767,4
2549,54,11,39,8,-15.528226686771598,3
2550,59,10,16,6,-15.561569445873218,4
2551,107,10,46,8,-15.65139707745225,2
2552,73,12,29,9,-15.669782329836792,3
2553,38,15,17,11,-15.678044683298898,4
2554,79,15,46,10,-15.695062063539162,5
2555,62,31,111,23,-15.780695907166118,8
2556,66,14,6,11,-15.817538028688281,3
2557,76,21,2,15,-15.887194817597921,6
2558,91,12,90,8,-16.09870244517901,4
2559,88,18,90,13,-16.196945416210344,5
2560,65,25,30,19,-16.220777761486307,6
2561,37,14,17,9,-16.224073122382876,5
2562,75,14,55,11,-16.26512819390793,3
2563,103,11,59,8,-16.266656443008642,3
2564,103,13,62,9,-16.299156500586875,4
2565,69,13,26,10,-16.625965123271836,3
2566,41,10,69,7,-16.634275461416582,3
2567,109,16,73,12,-16.722107664046142,4
2568,86,18,70,13,-16.806348175717314,5
2569,109,31,41,26,-16.84086997358483,5
2570,15,12,38,9,-16.880495720481193,3
2571,54,13,26,8,-16.93978716229654,5
2572,70,10,46,7,-17.153485710664995,3
2573,89,10,37,8,-17.418835616565143,2
2574,49,19,88,15,-17.53203455274144,4
2575,28,19,57,15,-17.55982008462565,4
2576,110,10,41,9,-17.607251464829996,1
2577,70,16,63,12,-17.68149233309164,4
2578,9,11,64,8,-17.70787325437998,3
2579,86,17,63,14,-17.9646938905751,3
2580,10,15,38,12,-18.015221595889397,3
2581,87,12,58,10,-18.33030956600258,2
2582,1,18,10,14,-18.3791692553228,4
2583,7,13,79,10,-18.40480150019194,3
2584,91,15,34,11,-18.43501821510385,4
2585,75,15,88,12,-18.46157402080457,3
2586,6,15,109,11,-18.568483421277442,4
2587,38,24,26,18,-18.614524044017738,6
2588,2,13,18,10,-18.666944559681195,3
2589,88,11,26,8,-18.785991491960512,3
2590,109,16,111,12,-18.82454889767414,4
2591,71,12,62,11,-19.04348733516107,1
2592,28,15,63,12,-19.065782846243966,3
2593,16,17,49,13,-19.10499490357724,4
2594,29,12,110,10,-19.248543702222975,2
2595,50,14,62,11,-19.293193829496534,3
2596,38,14,43,10,-19.328461951187712,4
2597,109,30,87,23,-19.45596890113393,7
2598,10,19,20,15,-19.474906343573682,4
2599,109,29,28,22,-19.49991563999526,7
2600,23,14,73,11,-19.638485965557127,3
2601,10,13,41,11,-19.737157878272868,2
2602,9,11,5,9,-19.801513832155916,2
2603,76,12,90,8,-19.849308288721737,4
2604,103,10,34,9,-19.87880862427678,1
2605,98,12,51,9,-20.0679948728163,3
2606,109,12,110,10,-20.16933250309851,2
2607,10,10,17,8,-20.222695302818984,2
2608,37,11,18,9,-20.496733536799674,2
2609,85,13,87,11,-20.571580164340965,2
2610,71,10,28,9,-20.618030954774138,1
2611,104,10,37,8,-20.681486856575923,2
2612,110,14,74,11,-20.875047711546735,3
2613,70,25,111,19,-21.761941281988644,6
2614,44,11,17,9,-22.072912946241182,2
2615,73,11,107,9,-22.13453383862815,2
2616,85,13,55,10,-22.50219401266605,3
2617,46,19,87,15,-22.516958582894237,4
2618,85,11,20,9,-22.58682017719025,2
2619,94,10,84,9,-22.762013140609877,1
2620,10,10,26,8,-22.77202326046866,2
2621,41,13,57,11,-23.156162131875274,2
2622,12,10,6,7,-23.420786535379097,3
2623,97,10,65,7,-23.53209680517744,3
2624,86,15,103,13,-23.967936503754764,2
2625,10,11,63,9,-24.09658997724639,2
2626,89,11,55,9,-24.169792122479972,2
2627,112,11,74,9,-24.423385588541223,2
2628,30,11,46,9,-24.436531907478123,2
2629,49,11,26,8,-26.831812890773925,3
2630,43,10,91,10,-27.34458455824453,0
2631,65,11,64,9,-27.72714931249874,2
