,againstHero,games,hero,losses,shift,wins
0,90,11,23,1,28.300961743533684,10
1,44,10,37,0,28.253477074224726,10
2,75,16,77,2,26.228267199136482,14
3,49,10,112,1,24.460078908180627,9
4,78,19,112,3,24.293257718319964,16
5,19,10,107,0,24.226623453768696,10
6,73,12,97,3,24.10757303293757,9
7,34,11,97,2,24.058676404388496,9
8,27,22,9,4,24.023674987501078,18
9,27,11,69,2,23.96512545131146,9
10,4,11,8,1,23.177905083651492,10
11,10,10,28,1,23.03135332069283,9
12,75,15,3,2,22.90290040082441,13
13,100,25,65,3,22.417652768002984,22
14,91,12,97,2,22.175648770183788,10
15,78,10,69,2,22.058413120869446,8
16,62,12,31,3,21.79094106777599,9
17,41,15,4,5,21.480590173913868,10
18,25,13,4,2,21.42004260246313,11
19,90,19,51,2,21.39328709298296,17
20,2,16,51,4,21.322170492802822,12
21,104,16,91,1,21.319718278752113,15
22,98,10,77,2,21.266559747636286,8
23,7,10,84,2,21.17364400986741,8
24,55,11,38,2,20.87506721402826,9
25,30,10,79,2,20.824119521738705,8
26,49,12,81,3,20.596347227570796,9
27,48,11,35,2,20.438098241934792,9
28,64,10,5,2,20.375787318305825,8
29,111,11,75,3,20.02641187481709,8
30,100,15,68,4,19.919601065708385,11
31,95,12,32,2,19.760326388824463,10
32,90,10,68,2,19.75244962865367,8
33,28,10,72,2,19.667105139612282,8
34,101,10,51,2,19.538804927619935,8
35,86,17,58,4,19.50459908880172,13
36,16,16,77,3,19.494965112936953,13
37,27,11,12,2,19.43334632488541,9
38,30,19,36,2,19.30529767168729,17
39,99,14,18,3,19.290873438644514,11
40,4,16,54,2,19.2440876038421,14
41,31,10,57,3,19.217116599721326,7
42,100,10,2,3,19.14350422886928,7
43,92,10,106,2,19.041690772468705,8
44,112,19,68,5,18.940096365856384,14
45,87,13,112,3,18.936535119389838,10
46,98,13,4,2,18.936498509144613,11
47,2,10,11,2,18.923084797888755,8
48,71,13,112,3,18.866115742328507,10
49,55,11,47,3,18.857554518412744,8
50,99,17,28,4,18.754584808369174,13
51,50,14,68,4,18.562076689620618,10
52,106,15,31,4,18.52908676481624,11
53,65,14,33,3,18.51276218041885,11
54,5,10,18,2,18.464269170029823,8
55,109,10,103,3,18.37872283171988,7
56,55,18,33,4,17.969879843551904,14
57,95,21,68,3,17.962668451083438,18
58,55,16,43,2,17.887669395914717,14
59,78,21,51,6,17.85552935241669,15
60,111,11,114,3,17.846918134233796,8
61,38,10,57,3,17.84660478771764,7
62,32,17,88,4,17.82459413467382,13
63,69,10,8,2,17.824588271872045,8
64,30,18,5,3,17.81053305502534,15
65,44,12,55,3,17.77184716319356,9
66,30,14,69,4,17.765258614983445,10
67,5,11,3,4,17.694163901939547,7
68,90,27,28,6,17.576354024280796,21
69,110,11,83,2,17.575104905290946,9
70,23,14,18,4,17.468338798211544,10
71,55,11,19,3,17.435802328445057,8
72,45,10,43,3,17.339723268429022,7
73,45,10,39,3,17.32115834390289,7
74,35,10,106,3,17.319051156851785,7
75,63,12,35,3,17.190706154289504,9
76,27,22,5,6,17.18696709990766,16
77,49,14,69,4,17.144708838601282,10
78,15,15,9,4,17.12648608718579,11
79,51,13,10,3,17.10096027286803,10
80,104,13,79,4,17.056081750892357,9
81,34,12,87,3,16.987810368259346,9
82,77,16,50,3,16.97319460562341,13
83,38,10,31,4,16.97274158238424,6
84,47,13,112,4,16.87246054147755,9
85,38,14,97,3,16.838290194315167,11
86,95,14,30,4,16.836817117204568,10
87,1,10,76,3,16.815372977495876,7
88,95,15,71,5,16.72675418994599,10
89,39,11,85,4,16.691830444179974,7
90,60,10,20,3,16.689435106346487,7
91,30,12,41,4,16.67014747818193,8
92,15,12,55,2,16.63699492471769,10
93,101,10,36,2,16.6279467044195,8
94,14,15,55,3,16.464885141480416,12
95,11,25,25,5,16.429746187224733,20
96,61,16,7,5,16.42696802044795,11
97,43,13,91,3,16.255864059996064,10
98,53,21,69,6,16.247322250303586,15
99,65,18,58,5,16.230092308358206,13
100,23,12,83,3,16.123810814063006,9
101,28,17,112,4,16.09923214780967,13
102,41,18,5,6,16.05037708250146,12
103,98,16,31,5,16.004000710168853,11
104,14,13,63,4,15.961958621197992,9
105,80,13,70,2,15.901333417895936,11
106,53,30,9,8,15.894615033798411,22
107,34,18,8,5,15.876296726362224,13
108,76,11,91,2,15.872477419459232,9
109,41,15,12,4,15.852631956602023,11
110,99,18,39,4,15.84878961626863,14
111,16,45,31,12,15.837412153743443,33
112,48,10,70,3,15.796496446665468,7
113,8,16,77,4,15.792942369486319,12
114,75,12,12,4,15.785867542761377,8
115,15,10,37,2,15.78269510258246,8
116,87,16,81,6,15.759058609918437,10
117,75,10,35,2,15.755761764469415,8
118,93,16,96,4,15.733194627661211,12
119,37,14,77,4,15.73169378416834,10
120,80,12,35,3,15.72406211872363,9
121,75,13,80,3,15.718052052365534,10
122,8,13,1,3,15.702434313684373,10
123,34,12,51,3,15.6894891289244,9
124,80,16,88,5,15.676196886577953,11
125,90,13,97,4,15.621888085765939,9
126,106,11,85,3,15.60573196351404,8
127,4,14,45,4,15.600891470448106,10
128,23,20,5,5,15.563915929412016,15
129,104,12,31,4,15.561592201078605,8
130,25,11,14,2,15.536643242754739,9
131,89,10,106,4,15.508251121091039,6
132,104,18,2,6,15.503443707499333,12
133,69,15,31,5,15.502962092044205,10
134,100,13,60,3,15.468043250681323,10
135,81,16,94,6,15.463781780556559,10
136,73,25,107,8,15.460672720698525,17
137,49,14,25,4,15.43786379260084,10
138,11,10,71,3,15.386871545741162,7
139,98,12,46,4,15.381140721878971,8
140,18,13,37,3,15.368965567811566,10
141,107,18,99,5,15.347683777553831,13
142,20,18,112,4,15.347636279185814,14
143,61,15,68,4,15.24709195978541,11
144,88,18,29,5,15.200290125021418,13
145,41,17,71,4,15.16238863659133,13
146,27,11,35,3,15.129282720135883,8
147,84,13,29,4,15.120150931852738,9
148,48,12,9,3,15.097519161061681,9
149,72,10,54,3,15.080610884546303,7
150,63,17,3,3,15.071396371833838,14
151,25,18,99,5,15.014737107768298,13
152,45,10,75,2,15.003649946946844,8
153,95,21,17,5,14.970865650802967,16
154,41,25,9,7,14.929419745005406,18
155,9,16,104,5,14.915937256999364,11
156,55,10,112,2,14.907032679929213,8
157,8,10,108,2,14.883275708091887,8
158,69,12,57,3,14.86920981303713,9
159,30,17,91,4,14.854653528597783,13
160,55,11,85,3,14.836765173492136,8
161,18,13,1,3,14.814066225099424,10
162,57,10,2,3,14.75670329182861,7
163,114,26,109,6,14.744077219906968,20
164,32,14,106,3,14.741977351969275,11
165,114,19,83,5,14.712530964906872,14
166,78,14,8,3,14.668119505967436,11
167,14,11,97,2,14.634263785488013,9
168,30,10,102,3,14.616177341977675,7
169,50,12,99,4,14.581629542155014,8
170,73,12,37,4,14.533349572792922,8
171,13,12,2,4,14.516038794033767,8
172,45,18,51,5,14.493324057948724,13
173,34,12,25,3,14.468789684868277,9
174,73,10,2,3,14.457830254043136,7
175,44,12,5,3,14.447481002517355,9
176,80,15,13,5,14.445550827997446,10
177,80,11,14,4,14.435345395194508,7
178,51,22,81,8,14.413069140354857,14
179,60,16,112,4,14.375050795639753,12
180,40,10,83,2,14.347262135245902,8
181,77,22,51,7,14.34162590555927,15
182,7,27,77,8,14.33556677589385,19
183,80,18,50,4,14.309192739594003,14
184,46,11,102,3,14.30749471315205,8
185,34,12,37,3,14.30057126443514,9
186,30,11,11,3,14.29951613613078,8
187,74,21,60,7,14.268042080973931,14
188,16,21,94,6,14.265495530226408,15
189,30,15,77,4,14.240898393688356,11
190,91,28,60,9,14.219487017087326,19
191,63,11,66,3,14.209916362631539,8
192,41,11,80,3,14.18671629223256,8
193,71,18,54,6,14.183245475418028,12
194,40,29,77,8,14.048771071022596,21
195,15,25,39,6,14.010931018079322,19
196,40,24,71,7,13.948125771645659,17
197,75,19,69,5,13.942304484906579,14
198,34,11,57,3,13.937862830072245,8
199,2,16,54,4,13.913344645570438,12
200,53,19,50,6,13.883151416746285,13
201,30,23,13,8,13.875626061777945,15
202,11,13,83,3,13.863860744018647,10
203,86,19,52,5,13.851910838120485,14
204,97,11,112,2,13.794615799527321,9
205,63,14,33,4,13.733555706081617,10
206,63,25,31,7,13.714594813504092,18
207,104,14,44,4,13.703910249073422,10
208,7,19,57,7,13.697105013999773,12
209,92,16,86,5,13.67676060817369,11
210,93,12,46,3,13.65474091099076,9
211,64,18,104,5,13.54129056151704,13
212,27,26,60,6,13.540065663312776,20
213,37,10,10,4,13.538762623915124,6
214,74,11,103,3,13.53565105452587,8
215,104,15,38,5,13.530669032796665,10
216,7,11,66,4,13.514093541012448,7
217,78,10,1,3,13.511302040012387,7
218,34,10,70,3,13.500624883981928,7
219,108,14,39,5,13.481039273987522,9
220,15,16,51,5,13.474823536409176,11
221,93,10,90,3,13.452391800759148,7
222,102,17,55,5,13.448934349992445,12
223,36,15,35,4,13.440272285829963,11
224,25,12,32,5,13.427877456338663,7
225,75,15,53,5,13.423496737137006,10
226,74,18,62,5,13.411803700884374,13
227,104,12,35,4,13.369677424437178,8
228,55,11,32,4,13.36363963009391,7
229,16,18,83,5,13.351235477213141,13
230,15,11,3,4,13.349088796326875,7
231,100,12,112,4,13.302851040311163,8
232,64,19,106,6,13.295192075566398,13
233,7,12,99,4,13.274517260788409,8
234,102,31,5,10,13.269431869962297,21
235,95,23,11,6,13.26328800508424,17
236,11,39,96,12,13.25258237771624,27
237,95,36,88,11,13.24512473637818,25
238,8,16,41,4,13.244566662838952,12
239,102,11,17,3,13.231752901126407,8
240,108,13,60,4,13.225499906177388,9
241,50,16,46,6,13.220197801431311,10
242,48,26,54,8,13.218100464174018,18
243,36,18,54,6,13.217744798273172,12
244,41,13,28,4,13.19117071449606,9
245,79,14,87,3,13.17533484699995,11
246,97,12,35,3,13.159538935863281,9
247,95,28,37,7,13.149042342745604,21
248,53,15,77,5,13.125923769197524,10
249,83,10,70,4,13.118339150755117,6
250,71,12,38,3,13.11375866950239,9
251,2,10,38,4,13.106587736027677,6
252,104,38,46,12,13.083570903140268,26
253,6,11,9,4,13.029614696230583,7
254,27,12,114,4,13.009570993376595,8
255,13,72,31,23,12.993302649386727,49
256,74,33,28,10,12.957271538108257,23
257,23,16,17,5,12.920452187354222,11
258,98,12,75,4,12.900340980932176,8
259,2,21,65,5,12.890027578518202,16
260,87,11,35,4,12.88940090296237,7
261,23,14,45,4,12.875487654765548,10
262,27,19,109,7,12.854514856980066,12
263,108,10,9,4,12.825707088631287,6
264,49,20,104,6,12.812277987885736,14
265,104,20,27,5,12.796343894614777,15
266,54,12,81,4,12.757047966098476,8
267,95,10,36,3,12.746346244298937,7
268,33,14,106,4,12.736963404825662,10
269,46,24,106,9,12.725492516069492,15
270,80,16,51,5,12.713909479894406,11
271,111,16,88,4,12.710530076381987,12
272,30,11,52,3,12.667026316194523,8
273,48,14,5,4,12.657719903594751,10
274,75,33,54,11,12.657132724468571,22
275,64,24,112,6,12.576658543796354,18
276,80,34,63,10,12.572385685987726,24
277,57,27,5,8,12.572003913811171,19
278,54,14,58,5,12.535089602873327,9
279,75,27,5,10,12.535083552437033,17
280,53,40,88,12,12.503961998215976,28
281,111,14,51,4,12.456032818979448,10
282,36,17,50,7,12.423703215189779,10
283,43,16,53,4,12.41343484704957,12
284,37,10,112,3,12.392005916673293,7
285,67,12,97,3,12.35346782744064,9
286,49,20,60,6,12.352144520803872,14
287,87,13,33,4,12.350753088118475,9
288,100,22,54,7,12.349967715760691,15
289,87,12,19,4,12.34527153536319,8
290,78,10,20,3,12.337947782230119,7
291,18,11,46,3,12.326844972781839,8
292,28,10,108,4,12.299856976610261,6
293,107,23,35,6,12.292793992800663,17
294,87,27,114,10,12.28642258906464,17
295,32,10,39,3,12.25900875776762,7
296,91,23,39,7,12.232573714352018,16
297,11,21,70,6,12.22505126846703,15
298,78,11,106,3,12.210243252742755,8
299,7,18,76,7,12.19661731578168,11
300,2,22,70,8,12.153236389251056,14
301,92,12,63,5,12.136993324985582,7
302,34,14,20,4,12.080633416209027,10
303,34,21,28,6,12.064560123194633,15
304,98,28,96,9,12.0522531035848,19
305,1,12,104,4,12.020108292717422,8
306,53,10,54,3,11.951994898142782,7
307,95,27,18,9,11.951490678023532,18
308,62,18,63,6,11.898616241132697,12
309,90,18,104,6,11.89837391797068,12
310,78,10,47,4,11.843066191666676,6
311,83,10,17,4,11.812775268760372,6
312,53,10,91,3,11.811611902058761,7
313,8,21,40,6,11.791921402372775,15
314,44,10,54,3,11.791894285038754,7
315,91,12,65,4,11.784658313781675,8
316,104,19,71,7,11.784281392964672,12
317,70,20,57,8,11.777168573797624,12
318,55,37,1,11,11.76903355576794,26
319,16,11,67,3,11.761532223804268,8
320,16,27,69,9,11.757721074864538,18
321,108,23,70,7,11.716508786473797,16
322,7,20,19,5,11.707331952559509,15
323,91,13,96,4,11.692854193124042,9
324,30,30,39,10,11.676641348162722,20
325,78,17,107,5,11.64562231980435,12
326,55,11,103,3,11.639657223031874,8
327,7,14,10,5,11.631959119868696,9
328,13,65,88,21,11.593746975603075,44
329,15,21,18,6,11.590119158022436,15
330,90,15,39,5,11.57797650142359,10
331,33,15,50,5,11.568332857311571,10
332,36,16,104,6,11.564722196156039,10
333,111,10,71,3,11.563837134119533,7
334,49,10,15,3,11.54727068179138,7
335,74,15,76,6,11.544600382799558,9
336,49,12,27,4,11.521519655834481,8
337,69,10,91,4,11.501202941557144,6
338,65,12,57,4,11.482165332996512,8
339,47,14,81,4,11.445134927289029,10
340,100,33,51,14,11.434832550293002,19
341,86,19,72,6,11.423615729846855,13
342,114,39,106,13,11.417874917507987,26
343,26,21,86,6,11.412432841806387,15
344,29,10,95,3,11.401888238693152,7
345,76,23,35,8,11.396918545348738,15
346,4,11,38,3,11.395009854616484,8
347,11,18,57,7,11.361151811212741,11
348,100,15,43,6,11.350388483589276,9
349,69,12,18,4,11.324568934723304,8
350,47,23,60,7,11.313305625779169,16
351,63,46,28,14,11.30701920844641,32
352,80,10,79,4,11.30670069299901,6
353,30,15,70,6,11.30291408800561,9
354,7,25,96,7,11.300422106484014,18
355,80,10,5,3,11.295210617596885,7
356,29,10,86,3,11.288307199014056,7
357,2,14,55,5,11.276816159574059,9
358,64,10,20,2,11.273683916826545,8
359,65,23,29,9,11.272698873119092,14
360,86,14,103,5,11.266539954551964,9
361,78,12,16,4,11.259161752967472,8
362,90,12,48,4,11.252381363492233,8
363,87,29,70,11,11.250414739740135,18
364,107,16,83,5,11.249585120390279,11
365,40,13,81,4,11.249205674756393,9
366,95,28,51,8,11.244919045567018,20
367,75,17,109,5,11.242273446455997,12
368,46,20,96,8,11.223825219116966,12
369,73,13,51,4,11.219804453521853,9
370,98,18,106,6,11.217270403208776,12
371,28,21,68,6,11.213633194972727,15
372,89,11,1,4,11.209011069389932,7
373,114,45,65,16,11.207925536927627,29
374,13,22,83,7,11.207026527024825,15
375,6,12,61,4,11.200388242698187,8
376,91,10,109,3,11.192740070217315,7
377,58,15,13,4,11.187681570256991,11
378,30,15,46,5,11.187097177578687,10
379,43,16,4,6,11.162760468553993,10
380,74,13,32,4,11.101664191982366,9
381,58,16,68,5,11.098600977228575,11
382,85,10,50,3,11.098189393682755,7
383,78,13,80,4,11.097915766170063,9
384,12,10,87,3,11.056786464431308,7
385,99,11,11,4,11.04788337752713,7
386,32,12,114,4,11.045874107216177,8
387,98,11,88,3,11.027639102171307,8
388,45,12,68,4,11.024019728389067,8
389,41,14,92,5,11.016394202336144,9
390,98,10,68,3,11.014423279510455,7
391,15,13,71,4,11.00914391321026,9
392,56,13,107,5,11.000292497508868,8
393,58,16,69,6,10.99341396878222,10
394,75,18,43,5,10.989434810711296,13
395,50,37,88,13,10.986958086725295,24
396,9,15,47,5,10.968614103246173,10
397,15,10,53,3,10.953947902365101,7
398,15,19,107,5,10.951282290046715,14
399,89,10,13,4,10.939542022741618,6
400,27,14,64,4,10.925557497140753,10
401,78,10,31,4,10.912809716780329,6
402,73,17,5,6,10.907383059794872,11
403,100,11,46,4,10.904685887838546,7
404,102,10,35,4,10.903207987031468,6
405,63,41,88,12,10.89220871689106,29
406,111,21,41,8,10.875724405637953,13
407,17,11,78,4,10.875549356054371,7
408,71,16,77,5,10.872072685026803,11
409,30,25,54,8,10.869653792907938,17
410,20,18,9,6,10.865484007949272,12
411,27,30,65,10,10.85658782517334,20
412,98,25,87,8,10.830753925226269,17
413,109,34,8,13,10.819891467814772,21
414,106,17,81,7,10.816681182916202,10
415,104,27,77,9,10.795670361212093,18
416,55,25,91,7,10.791612827626562,18
417,47,11,15,4,10.775485769989336,7
418,59,11,7,3,10.771239818059199,8
419,27,27,31,11,10.758919665279384,16
420,23,20,39,7,10.742827162036496,13
421,37,15,60,6,10.721994289598655,9
422,53,18,17,6,10.719913358297381,12
423,54,11,111,3,10.714143810197228,8
424,114,13,81,5,10.713660949239014,8
425,43,13,36,5,10.713552025008548,8
426,47,14,18,4,10.710476641545714,10
427,51,25,74,7,10.704030149650722,18
428,40,23,17,7,10.673939896309559,16
429,5,25,98,9,10.66291868554062,16
430,30,20,64,7,10.642272986004784,13
431,98,18,71,6,10.627953776602759,12
432,16,12,101,4,10.622717697482882,8
433,7,31,91,9,10.609100286101588,22
434,75,15,38,4,10.597530026810052,11
435,75,51,7,17,10.587695481592943,34
436,69,18,28,7,10.575983527327304,11
437,95,15,9,6,10.569002592922953,9
438,11,24,84,8,10.563882323195871,16
439,37,45,54,15,10.551214199845806,30
440,86,16,56,5,10.543126647721753,11
441,71,19,97,6,10.5235339621969,13
442,27,27,36,10,10.523349599331352,17
443,89,14,37,6,10.519274673853001,8
444,114,12,12,5,10.50495457801322,7
445,50,37,20,12,10.501577095705528,25
446,75,14,102,4,10.47886729381523,10
447,75,35,8,11,10.477015226263449,24
448,23,12,77,4,10.472073733658851,8
449,6,10,31,4,10.459894630543896,6
450,49,10,62,3,10.4539945527009,7
451,34,11,60,3,10.444545857082172,8
452,44,16,39,6,10.434810009571377,10
453,95,19,114,7,10.422604339796184,12
454,110,11,7,5,10.422576579231729,6
455,106,16,93,6,10.37915501513517,10
456,16,24,1,6,10.362823173840477,18
457,3,11,18,3,10.36192093091692,8
458,104,13,81,6,10.361322759461329,7
459,94,10,7,3,10.355621654064773,7
460,1,17,63,7,10.344681903521664,10
461,37,13,1,5,10.342164269053148,8
462,7,14,81,6,10.32158298772756,8
463,57,18,63,7,10.314939985261887,11
464,40,13,78,3,10.282455211399137,10
465,71,10,84,3,10.279461085413814,7
466,34,12,104,4,10.27427919250402,8
467,77,12,99,3,10.252199704478638,9
468,67,16,106,6,10.252161434234207,10
469,7,43,25,14,10.249875265637385,29
470,30,17,31,7,10.214096274935343,10
471,25,24,68,8,10.211790433098953,16
472,11,36,37,12,10.20717474941383,24
473,48,24,96,8,10.200121519345739,16
474,98,15,2,6,10.198603389321667,9
475,71,13,33,4,10.195530501937561,9
476,97,41,37,14,10.190687502541845,27
477,89,13,104,5,10.17868688184359,8
478,64,24,9,7,10.178655144521006,17
479,40,11,69,3,10.175676528085834,8
480,58,13,39,4,10.147489402696785,9
481,96,11,23,4,10.143008283174426,7
482,53,37,31,14,10.136338371296793,23
483,92,10,109,3,10.132066653367776,7
484,46,14,70,5,10.128652016947743,9
485,8,20,15,8,10.121581558030638,12
486,8,10,35,3,10.118762046100299,7
487,50,20,102,8,10.118106239071224,12
488,53,36,36,11,10.114732824687987,25
489,18,24,8,7,10.103008591242306,17
490,89,11,74,4,10.093150392265771,7
491,28,14,94,4,10.089052267433145,10
492,79,12,106,4,10.079963228120917,8
493,110,10,28,4,10.06674072061994,6
494,91,11,71,4,10.058832289642849,7
495,44,10,38,3,10.048373138060269,7
496,70,12,29,5,10.037060199943541,7
497,11,14,18,5,10.031989827572826,9
498,20,12,3,4,10.029309207648437,8
499,60,15,29,6,10.014518053593553,9
500,43,13,9,5,10.011482215577137,8
501,54,15,43,6,10.003127798418703,9
502,75,12,57,4,10.001839571130395,8
503,95,25,65,9,9.987438820754939,16
504,34,11,48,4,9.987399142382838,7
505,107,13,10,5,9.987353405179212,8
506,87,13,52,5,9.984852518055051,8
507,73,18,88,6,9.974203425238965,12
508,38,10,17,4,9.957251396991316,6
509,95,10,2,3,9.920312629990502,7
510,25,14,3,5,9.907996037168818,9
511,18,39,39,13,9.885046818102031,26
512,17,15,71,6,9.874078720771614,9
513,63,34,91,11,9.863803572303501,23
514,76,12,18,4,9.847622493503502,8
515,30,16,63,6,9.842696842263113,10
516,86,26,79,9,9.841357831333449,17
517,53,10,98,4,9.839111782848335,6
518,54,13,57,3,9.824315369895016,10
519,104,25,75,9,9.822163907084754,16
520,48,27,107,10,9.812988008703408,17
521,104,15,84,6,9.801640239199907,9
522,62,10,93,4,9.798162399200404,6
523,37,24,83,9,9.783726366978417,15
524,6,10,51,4,9.769920787003374,6
525,100,12,62,5,9.768885934940618,7
526,38,10,28,4,9.755543154623547,6
527,16,42,18,14,9.75454627994462,28
528,89,13,16,5,9.733195931265595,8
529,16,16,32,6,9.72172092201369,10
530,78,13,57,5,9.706642642705255,8
531,100,19,87,8,9.686243494464469,11
532,30,13,84,4,9.677396996952378,9
533,17,17,109,6,9.672922776879656,11
534,53,12,38,4,9.664145468055217,8
535,35,14,45,6,9.663816215290334,8
536,53,19,108,8,9.662757254259093,11
537,100,12,71,4,9.66068752031631,8
538,87,30,9,12,9.657202776782617,18
539,111,16,63,6,9.656549842780759,10
540,41,15,17,5,9.654478177971624,10
541,22,10,114,5,9.649313306364819,5
542,93,10,104,4,9.637966581885273,6
543,57,28,107,10,9.636004223648037,18
544,41,23,53,8,9.631953807885303,15
545,100,17,63,7,9.628829836647935,10
546,70,17,109,6,9.623350653501726,11
547,76,16,9,5,9.621504571842449,11
548,99,14,8,6,9.61106559286031,8
549,83,18,84,7,9.609473734372159,11
550,8,13,53,4,9.596286006275326,9
551,80,14,39,5,9.589468521855673,9
552,73,20,7,8,9.582485903794176,12
553,39,32,20,13,9.57757827371138,19
554,64,44,60,14,9.569439655645416,30
555,13,24,97,9,9.567486234498416,15
556,92,15,68,5,9.538113226799515,10
557,106,13,108,4,9.535201707134298,9
558,1,22,31,9,9.525804060927038,13
559,20,32,25,11,9.520523686179052,21
560,60,25,69,11,9.516572001635845,14
561,8,17,36,6,9.51236026695053,11
562,90,14,80,4,9.509239360264802,10
563,114,13,2,5,9.509158562417847,8
564,37,22,99,7,9.502759058160713,15
565,37,29,7,11,9.500511382222342,18
566,107,17,66,6,9.469730190602778,11
567,112,10,29,4,9.468799644939955,6
568,76,28,68,7,9.459920139276978,21
569,51,18,110,6,9.452475656462822,12
570,86,14,94,5,9.44487953345369,9
571,32,11,63,4,9.44232166344675,7
572,78,12,53,5,9.436495389192622,7
573,64,14,92,7,9.432471863302014,7
574,15,10,1,3,9.421594860471428,7
575,38,11,112,3,9.41394016209822,8
576,65,35,93,14,9.411885467293352,21
577,86,37,76,13,9.404159373470087,24
578,63,25,109,10,9.392892060380623,15
579,109,11,36,3,9.390936468630548,8
580,29,11,51,4,9.382792177373643,7
581,76,17,39,5,9.374915521858481,12
582,28,15,111,5,9.365771514395545,10
583,15,15,87,6,9.356894108440963,9
584,109,16,39,4,9.356347251836707,12
585,23,12,50,3,9.354699302165745,9
586,18,25,9,8,9.349773872691086,17
587,98,10,48,3,9.346073134818257,7
588,16,46,96,14,9.342765312407817,32
589,109,10,29,5,9.339951738191694,5
590,60,16,58,6,9.319426070200468,10
591,50,17,70,7,9.316243790355681,10
592,110,12,107,4,9.307853181235298,8
593,86,15,67,6,9.30654184494345,9
594,109,11,22,4,9.30323095736105,7
595,63,19,77,6,9.291814452323939,13
596,75,13,93,5,9.279825087560205,8
597,65,13,66,4,9.24629898792323,9
598,15,10,76,4,9.241288842836553,6
599,2,31,107,11,9.235597195463594,20
600,64,15,37,5,9.227089681457187,10
601,64,11,81,4,9.217681779438383,7
602,27,15,4,6,9.214915067697104,9
603,54,15,76,5,9.21434337052745,10
604,2,12,40,4,9.204153353273352,8
605,73,17,40,6,9.199997222971483,11
606,17,16,9,6,9.184055414811954,10
607,15,30,88,9,9.176202112652083,21
608,41,39,86,13,9.172157333193887,26
609,41,15,49,6,9.171912615870818,9
610,40,15,102,6,9.171373555966685,9
611,92,15,40,5,9.168940871834318,10
612,16,63,106,21,9.160803291418002,42
613,27,12,30,5,9.159316291712274,7
614,39,27,43,11,9.158740133364713,16
615,50,43,5,17,9.156049369840707,26
616,13,42,18,16,9.15021879704067,26
617,86,25,1,9,9.12482621931439,16
618,104,18,17,7,9.118260519592532,11
619,92,11,17,4,9.114563540800457,7
620,109,15,31,5,9.11388757240418,10
621,48,11,51,5,9.079697327016948,6
622,95,34,8,13,9.079209474058969,21
623,74,23,39,9,9.075238839119182,14
624,44,29,86,10,9.073857704921485,19
625,28,34,75,12,9.068390514566694,22
626,39,18,112,7,9.062101008825092,11
627,58,10,112,4,9.041979275484929,6
628,48,23,87,8,9.021568034700334,15
629,5,15,36,6,9.008614310253613,9
630,62,10,69,4,9.007065239439928,6
631,17,17,60,6,8.995312545980157,11
632,47,20,114,8,8.969382880850322,12
633,28,11,32,4,8.963821007682872,7
634,11,13,80,5,8.941133144462878,8
635,73,12,31,4,8.938919570135752,8
636,30,38,107,14,8.938338387407445,24
637,11,10,91,3,8.923724837318142,7
638,16,101,88,35,8.918867116206172,66
639,110,19,25,6,8.917701672558222,13
640,89,15,107,5,8.908975430626485,10
641,7,20,109,7,8.9080321410632,13
642,69,12,97,4,8.888377862411462,8
643,87,26,91,9,8.88711273267609,17
644,28,16,40,7,8.877350715587877,9
645,28,30,114,12,8.875783073761175,18
646,23,16,12,6,8.872217683410865,10
647,107,29,43,10,8.857175926154707,19
648,112,12,84,4,8.85414320771021,8
649,102,16,51,6,8.84826485855953,10
650,53,17,3,6,8.84518913908164,11
651,32,15,87,5,8.84415502943487,10
652,49,13,77,4,8.842593838828115,9
653,51,47,63,19,8.825173206487683,28
654,63,19,36,7,8.822881427312195,12
655,63,28,76,9,8.821395394022662,19
656,36,18,47,6,8.810892372607714,12
657,106,10,42,3,8.802546839644418,7
658,107,28,31,13,8.798674063671836,15
659,97,22,51,7,8.785196874414883,15
660,106,23,18,8,8.778191080978742,15
661,100,21,39,8,8.754145947004435,13
662,38,14,106,7,8.74501943352997,7
663,104,23,11,8,8.742484307216115,15
664,39,35,88,13,8.74018182363142,22
665,4,22,17,7,8.727735068009611,15
666,58,10,45,4,8.721721801464442,6
667,63,15,102,6,8.710165699989911,9
668,63,35,20,14,8.705248065274409,21
669,30,10,2,4,8.704387763563812,6
670,110,14,39,4,8.694421097429624,10
671,76,15,60,4,8.678706996102921,11
672,77,16,88,6,8.678317130754186,10
673,9,31,31,11,8.678153869820548,20
674,51,14,112,5,8.662465094799597,9
675,102,32,86,11,8.651776846078937,21
676,41,19,97,7,8.638943706099205,12
677,23,34,60,12,8.608807282411219,22
678,90,22,50,8,8.598522697494,14
679,40,15,49,6,8.588514005098899,9
680,95,23,55,8,8.575006509864881,15
681,78,19,7,8,8.565348954184037,11
682,86,86,51,35,8.557465951431581,51
683,63,42,84,17,8.556534866486706,25
684,78,11,36,4,8.552435160203329,7
685,114,13,62,5,8.54955618000272,8
686,84,14,3,6,8.535145143847831,8
687,18,12,20,4,8.532272478061662,8
688,12,13,106,4,8.530975907772834,9
689,86,28,48,10,8.527783865058886,18
690,62,23,88,9,8.512625127129992,14
691,63,17,69,5,8.506537399631053,12
692,91,10,45,4,8.504304930616431,6
693,20,20,41,8,8.499902151857665,12
694,64,28,40,10,8.496071624321134,18
695,94,10,37,3,8.495177713557318,7
696,75,16,1,5,8.487454866261048,11
697,75,56,68,19,8.48370722934506,37
698,85,10,16,3,8.463981088255792,7
699,95,14,96,5,8.45037398259218,9
700,80,30,107,10,8.450019757222567,20
701,8,32,114,11,8.446067232393613,21
702,52,12,20,4,8.437421503459811,8
703,96,24,70,11,8.437417991026262,13
704,55,20,114,7,8.432483182241098,13
705,47,31,13,12,8.428277126431585,19
706,90,20,13,7,8.424919065495569,13
707,73,19,90,7,8.424101991862472,12
708,48,21,79,8,8.423308200700252,13
709,64,20,8,7,8.418575329228204,13
710,68,24,91,10,8.412577437061728,14
711,30,10,38,3,8.411592281207323,7
712,91,19,20,8,8.407006886407046,11
713,67,10,104,4,8.393331116483226,6
714,28,14,52,6,8.38312541721312,8
715,45,21,107,8,8.374668953212842,13
716,11,11,9,4,8.359525570926444,7
717,7,22,5,8,8.357081514884824,14
718,13,18,98,6,8.341994513785483,12
719,76,39,51,13,8.339242903099507,26
720,28,11,29,4,8.329043879308335,7
721,76,25,50,8,8.328303760573554,17
722,102,17,88,5,8.307899790454732,12
723,18,22,97,8,8.29806548281246,14
724,90,31,106,10,8.283845461248372,21
725,41,18,91,6,8.276671952774393,12
726,100,15,55,7,8.275270908208638,8
727,75,12,76,5,8.269580351796622,7
728,50,34,55,14,8.268886532039616,20
729,20,28,84,9,8.268193588498612,19
730,37,12,14,5,8.266467835075433,7
731,40,49,55,18,8.264830770768937,31
732,94,10,2,4,8.235738884159371,6
733,69,21,106,8,8.230262561693124,13
734,102,10,39,4,8.224547128845817,6
735,41,28,104,12,8.222150207467429,16
736,40,24,3,8,8.21009163331203,16
737,8,25,57,9,8.20914757769532,16
738,11,24,109,8,8.196422948591085,16
739,19,13,13,5,8.194839200536869,8
740,13,10,35,4,8.193263635625328,6
741,107,10,61,4,8.19056957850756,6
742,104,35,60,10,8.183651908443375,25
743,108,13,98,5,8.179403178791242,8
744,16,19,47,7,8.178952833737183,12
745,68,11,33,4,8.166895131198165,7
746,4,10,112,4,8.145974306589784,6
747,75,12,29,5,8.144839094845086,7
748,81,15,16,5,8.120114808218235,10
749,100,19,88,7,8.116464062015535,12
750,114,14,57,5,8.115945976762234,9
751,45,31,7,12,8.099756768827417,19
752,60,30,50,13,8.087484578525554,17
753,29,11,37,4,8.087342118064884,7
754,8,61,5,24,8.080732178020162,37
755,110,16,97,6,8.077466293642946,10
756,16,72,39,28,8.067394918609539,44
757,16,18,14,7,8.06483217295593,11
758,53,13,46,5,8.064750592390656,8
759,43,24,86,8,8.063012454340049,16
760,51,15,91,5,8.060157448942936,10
761,9,11,12,4,8.058955245687951,7
762,37,16,27,6,8.030406858059436,10
763,75,41,50,14,8.02466935745211,27
764,35,11,9,5,8.012816785902409,6
765,48,12,25,5,8.01244102921806,7
766,43,18,31,10,8.011472574516002,8
767,86,51,39,21,8.000320040451781,30
768,102,19,96,7,7.9956311609664965,12
769,13,16,70,6,7.990308468406848,10
770,5,28,84,11,7.986435375626319,17
771,12,12,4,4,7.976222296376225,8
772,81,30,13,11,7.974436586188656,19
773,65,25,5,10,7.967561696591304,15
774,89,12,53,5,7.9499730264780055,7
775,73,17,87,5,7.942207150258419,12
776,27,13,77,5,7.939137496569419,8
777,18,10,34,3,7.934073113605032,7
778,77,12,64,6,7.9282827223690555,6
779,33,16,20,6,7.928062438364485,10
780,54,22,18,9,7.917650548154775,13
781,88,10,82,4,7.912578083642496,6
782,16,23,76,11,7.906950340887347,12
783,76,11,108,4,7.890267325318871,7
784,70,15,69,5,7.8892362038055985,10
785,103,14,16,5,7.884424733518567,9
786,15,17,104,6,7.875168892784026,11
787,84,13,60,3,7.874921397384912,10
788,55,17,23,8,7.871570609888838,9
789,114,25,90,10,7.8701656835045455,15
790,44,12,35,5,7.859665557157517,7
791,106,26,91,9,7.859341034872018,17
792,114,41,13,18,7.855529583445475,23
793,53,19,109,7,7.841205358929896,12
794,7,11,2,4,7.836909370766421,7
795,63,57,54,21,7.834983225160246,36
796,8,17,98,6,7.8322640771965775,11
797,25,46,46,19,7.8204011950255445,27
798,60,23,81,9,7.817127893520488,14
799,75,21,49,8,7.802050873504809,13
800,114,12,110,4,7.80031681097971,8
801,50,15,48,5,7.798532000224024,10
802,68,28,18,11,7.775566947501909,17
803,92,14,114,4,7.774797164908212,10
804,41,15,81,5,7.770221546669875,10
805,10,14,86,6,7.764445720347282,8
806,53,11,73,4,7.756297558195456,7
807,37,49,25,20,7.755599308877524,29
808,46,11,1,5,7.752232750476011,6
809,73,13,54,5,7.746921178252216,8
810,44,11,84,5,7.741464370739849,6
811,63,10,52,4,7.736846011905835,6
812,86,28,112,11,7.733542128760624,17
813,28,28,2,10,7.726967938716942,18
814,57,19,102,8,7.725209435984633,11
815,68,44,87,17,7.713445601645926,27
816,46,13,64,5,7.701785189637151,8
817,41,15,77,5,7.700447698799743,10
818,40,39,104,14,7.699889638025223,25
819,64,11,11,3,7.699861982788657,8
820,111,25,7,10,7.69032342577198,15
821,5,32,11,12,7.687442157533876,20
822,37,24,96,10,7.665844925696509,14
823,33,13,31,6,7.647223417443057,7
824,70,11,60,4,7.6464357490262,7
825,16,35,9,12,7.644783932906991,23
826,108,20,88,7,7.642505031143237,13
827,53,27,30,11,7.642346295513209,16
828,97,29,5,10,7.639418302115124,19
829,96,22,80,8,7.6325568595370585,14
830,23,13,91,6,7.630492751883036,7
831,16,63,63,25,7.62690807086149,38
832,38,16,84,7,7.623292346759984,9
833,87,27,41,10,7.608960513510675,17
834,18,20,36,8,7.5949028785012285,12
835,20,15,90,6,7.5926874674698235,9
836,58,18,88,7,7.5880987725104365,11
837,72,10,36,4,7.585561627806539,6
838,46,12,77,5,7.574271980014295,7
839,34,14,5,4,7.5706698448560905,10
840,12,16,107,5,7.554377135078079,11
841,51,20,33,6,7.54115209621082,14
842,64,31,51,12,7.527516454843379,19
843,6,11,55,3,7.526848268362216,8
844,55,18,77,7,7.520653437888106,11
845,65,11,52,3,7.51122589655402,8
846,41,11,96,3,7.480521636982391,8
847,48,10,89,3,7.476757612743907,7
848,70,14,36,6,7.476080415111229,8
849,108,15,63,6,7.475559971035058,9
850,64,37,31,14,7.4738922265185375,23
851,45,12,53,5,7.463487107897495,7
852,40,64,68,23,7.460123554388273,41
853,37,21,110,9,7.457046552670356,12
854,86,53,97,21,7.453774682156136,32
855,75,17,100,8,7.449782688238093,9
856,46,30,75,12,7.449361290092638,18
857,70,13,71,6,7.447387393345601,7
858,8,28,84,10,7.447150756775401,18
859,64,17,43,7,7.43896725456377,10
860,84,26,39,10,7.428032986604076,16
861,63,23,18,8,7.424434558796218,15
862,54,44,109,16,7.42149631612999,28
863,8,19,91,7,7.416456742894205,12
864,36,34,41,16,7.412500474371832,18
865,13,27,69,10,7.410798113719347,17
866,16,65,55,23,7.4088914596986175,42
867,37,41,46,14,7.398384968299374,27
868,1,10,5,4,7.391988711274886,6
869,73,10,71,4,7.37323406519455,6
870,34,15,74,5,7.367415754617591,10
871,25,16,33,5,7.36592627296452,11
872,77,10,114,4,7.3654772203978025,6
873,49,12,64,5,7.364918196286091,7
874,53,18,61,6,7.3640960284192225,12
875,49,13,23,5,7.360298065336568,8
876,73,25,8,10,7.35879002547718,15
877,58,25,107,9,7.327155673902655,16
878,70,42,5,17,7.323141246130927,25
879,1,23,65,10,7.319832649719675,13
880,109,26,55,12,7.3182997081126135,14
881,39,24,106,10,7.31226919998241,14
882,16,41,91,14,7.309347152714904,27
883,97,17,36,7,7.301788222671786,10
884,93,14,11,4,7.294440502359943,10
885,44,19,13,7,7.286242475868136,12
886,2,24,106,10,7.283295399336633,14
887,91,16,54,7,7.27744302438935,9
888,65,42,20,15,7.275621933808215,27
889,55,20,68,7,7.273979151335479,13
890,106,13,57,6,7.272492874678534,7
891,62,10,96,3,7.268496266352443,7
892,110,16,70,6,7.267896542251015,10
893,20,17,98,6,7.267496359610282,11
894,41,31,31,12,7.267301725174954,19
895,75,19,81,7,7.259552889264539,12
896,38,11,54,4,7.25460278530091,7
897,98,12,93,5,7.2513528092711335,7
898,46,13,90,5,7.250761878801304,8
899,31,14,5,5,7.246607645789562,9
900,54,32,40,13,7.243609732204195,19
901,20,10,75,4,7.241047227766171,6
902,13,60,106,23,7.22482230869508,37
903,35,20,40,7,7.2238461178978355,13
904,41,12,3,3,7.218526234783575,9
905,27,20,63,9,7.19472225275396,11
906,23,12,47,4,7.180906240191946,8
907,36,16,112,6,7.175574629533441,10
908,87,23,93,9,7.164798687762667,14
909,5,17,60,6,7.144002600647477,11
910,18,39,75,16,7.143872456900073,23
911,75,57,107,18,7.131800392099847,39
912,63,32,48,12,7.1299692009467925,20
913,88,11,67,3,7.127393540580368,8
914,88,23,3,9,7.12663205785296,14
915,50,21,18,9,7.12662202019937,12
916,67,12,107,4,7.124134838046416,8
917,86,28,83,9,7.1046405351353314,19
918,36,20,3,7,7.093052097907007,13
919,63,11,85,5,7.079874969572199,6
920,28,35,70,14,7.078735797739843,21
921,107,19,102,8,7.0774996579991125,11
922,102,14,98,6,7.075813129571894,8
923,63,21,38,7,7.07127755522525,14
924,50,14,49,6,7.064134383315743,8
925,100,21,25,9,7.062312436550092,12
926,44,13,64,5,7.05920038211248,8
927,30,39,65,15,7.0585708403802245,24
928,65,16,73,6,7.056062739811479,10
929,94,14,43,5,7.04208807677441,9
930,37,28,38,11,7.0413163805665135,17
931,41,15,112,6,7.039515078376401,9
932,62,15,51,6,7.028758985101916,9
933,100,16,18,7,7.026565168419708,9
934,95,15,40,6,7.026458120737083,9
935,87,27,53,12,7.022639512769477,15
936,91,30,98,12,7.005781194364029,18
937,45,14,86,6,7.001591160951405,8
938,80,13,48,4,6.99747900943173,9
939,62,15,5,6,6.992708759597391,9
940,114,19,1,7,6.990089974683044,12
941,111,23,13,10,6.988942249892523,13
942,17,20,55,9,6.987444025974705,11
943,46,23,39,11,6.9816941894182785,12
944,8,17,33,6,6.975602243001775,11
945,53,18,12,8,6.969479938527376,10
946,16,34,36,13,6.9623095532486845,21
947,32,18,104,6,6.95922508638955,12
948,15,11,50,4,6.950752908185209,7
949,19,13,39,6,6.948417519072789,7
950,99,12,88,5,6.93913123202866,7
951,20,29,51,13,6.932399765519158,16
952,68,15,19,7,6.924559442631492,8
953,75,19,30,8,6.923427737676235,11
954,16,38,46,15,6.9206390826160336,23
955,104,36,55,14,6.909075624793388,22
956,49,10,53,4,6.907813000954768,6
957,76,16,88,7,6.891817282335726,9
958,90,22,65,10,6.887045978873851,12
959,114,47,5,19,6.885144276646171,28
960,106,15,99,5,6.882359612487447,10
961,84,13,78,5,6.8775899451817635,8
962,7,48,87,18,6.866073104845454,30
963,60,43,4,19,6.864343045215706,24
964,75,17,11,7,6.860129083231025,10
965,114,19,96,7,6.8573207383282995,12
966,13,29,95,12,6.852052215706936,17
967,7,99,51,37,6.849475435937799,62
968,86,80,96,31,6.839782165020975,49
969,78,14,96,5,6.830515928543477,9
970,95,25,106,9,6.830338155584792,16
971,7,20,46,7,6.829366067671735,13
972,89,10,68,4,6.826893879643049,6
973,68,69,31,28,6.821634358561019,41
974,30,22,104,10,6.820606807560422,12
975,56,13,4,6,6.816273515879696,7
976,25,14,9,5,6.810304163725227,9
977,51,20,96,8,6.809158319794973,12
978,39,22,38,9,6.807429116943057,13
979,100,16,114,6,6.806713890734189,10
980,60,18,45,8,6.8022482279138705,10
981,108,25,13,9,6.801707995205209,16
982,49,10,71,4,6.800377692667283,6
983,55,10,31,4,6.798197972656263,6
984,39,14,29,6,6.7842531834204545,8
985,6,14,27,6,6.780540737481572,8
986,81,10,108,4,6.778588424753946,6
987,33,23,107,10,6.763493299081546,13
988,13,43,23,19,6.759962036733638,24
989,53,13,90,5,6.752088210585151,8
990,30,19,18,8,6.749976540021853,11
991,94,10,71,4,6.748460655059317,6
992,74,38,96,14,6.731828732252355,24
993,14,13,95,5,6.731405281187272,8
994,27,11,98,5,6.722224921815259,6
995,100,11,95,5,6.722166987268522,6
996,65,10,32,4,6.718474357729474,6
997,28,35,97,13,6.716635909782017,22
998,60,21,12,11,6.704537300087493,10
999,83,15,74,7,6.703298030488857,8
1000,15,12,91,6,6.697476716978323,6
1001,111,11,106,3,6.697425895741327,8
1002,7,21,38,9,6.693287820142804,12
1003,107,20,47,8,6.679988416533418,12
1004,49,14,70,6,6.672966411521808,8
1005,27,36,88,16,6.672694825026893,20
1006,14,13,13,4,6.663851771345142,9
1007,83,11,71,5,6.656205380333864,6
1008,54,74,88,30,6.654867228993362,44
1009,71,19,37,8,6.653996053488669,11
1010,76,15,114,5,6.6539119931134865,10
1011,32,26,5,10,6.647447060451906,16
1012,16,28,64,10,6.6466026985544655,18
1013,4,30,65,12,6.6356003955737535,18
1014,25,48,5,19,6.626414170343125,29
1015,39,20,37,8,6.620813501609792,12
1016,97,25,68,10,6.6196959499026775,15
1017,16,30,100,11,6.617449381235235,19
1018,71,18,81,7,6.61709770119633,11
1019,39,75,51,31,6.615588090433578,44
1020,34,16,30,6,6.601140375094157,10
1021,80,18,37,7,6.595363149795721,11
1022,65,28,96,12,6.593487230396348,16
1023,13,40,43,18,6.584602401444723,22
1024,40,26,1,10,6.58137324665705,16
1025,53,26,114,11,6.571088082289226,15
1026,104,37,25,16,6.567754121461538,21
1027,107,44,53,17,6.556157644451656,27
1028,16,29,27,11,6.548968077490892,18
1029,77,21,18,7,6.545250800191177,14
1030,49,10,55,4,6.541972088163769,6
1031,35,15,28,7,6.525585250622975,8
1032,90,10,102,5,6.502237322589002,5
1033,1,20,54,8,6.493394551110143,12
1034,48,10,104,4,6.493358473776671,6
1035,70,20,9,7,6.477071321597407,13
1036,90,25,87,10,6.4548524533916245,15
1037,27,30,86,11,6.453315924089684,19
1038,6,10,28,4,6.452419128804086,6
1039,4,20,87,7,6.445923142452618,13
1040,75,49,16,20,6.443913435512626,29
1041,41,20,109,7,6.432688342356182,13
1042,40,16,33,5,6.427211772717694,11
1043,28,13,53,5,6.426853986137571,8
1044,100,30,86,14,6.417275816064882,16
1045,107,19,77,8,6.416947048354687,11
1046,65,57,88,21,6.408593036147459,36
1047,106,13,77,6,6.407119934187455,7
1048,74,13,77,5,6.38427445953612,8
1049,50,27,71,11,6.379934345675859,16
1050,74,32,84,15,6.379678119893638,17
1051,7,21,56,9,6.361794853449644,12
1052,28,12,44,6,6.357970575228094,6
1053,92,13,27,6,6.356396578041118,7
1054,11,20,98,9,6.338677652860182,11
1055,13,18,94,7,6.333471224988879,11
1056,54,14,112,5,6.3267118256224935,9
1057,80,12,60,5,6.326591453694461,7
1058,76,11,57,4,6.324386635638288,7
1059,29,13,55,5,6.301089833667023,8
1060,39,16,83,6,6.297771796270439,10
1061,23,17,114,6,6.291790840234864,11
1062,87,26,57,10,6.2897492965158115,16
1063,70,16,64,5,6.286009204558742,11
1064,16,12,92,3,6.284475222709882,9
1065,41,11,102,4,6.282861273718874,7
1066,86,21,4,8,6.2794844995496994,13
1067,20,45,5,17,6.270373633442785,28
1068,16,28,43,10,6.26554728557569,18
1069,15,12,95,5,6.265255655621163,7
1070,92,22,39,10,6.263991845659126,12
1071,43,17,5,7,6.250727481432205,10
1072,54,15,62,6,6.240490314200175,9
1073,28,32,9,14,6.237351159402921,18
1074,104,41,50,16,6.230364171354915,25
1075,13,17,6,7,6.226729543003945,10
1076,80,31,55,14,6.225846961531592,17
1077,38,21,65,10,6.225284615552252,11
1078,86,18,34,7,6.204793306210544,11
1079,74,28,70,13,6.203999405338755,15
1080,63,28,2,12,6.200018491851485,16
1081,55,14,35,6,6.181710197353361,8
1082,28,54,84,22,6.1786789402149065,32
1083,97,23,76,10,6.171425808149794,13
1084,54,28,60,11,6.171029746511066,17
1085,13,47,36,18,6.167141158071529,29
1086,63,10,89,3,6.159771716986653,7
1087,16,13,58,5,6.156802466115244,8
1088,31,15,112,5,6.149641402394961,10
1089,40,48,39,19,6.1478732659202615,29
1090,28,23,17,9,6.144271685607964,14
1091,78,16,63,8,6.142144937717797,8
1092,109,14,46,6,6.137839688733693,8
1093,23,10,48,4,6.136507124451633,6
1094,31,13,80,4,6.13276887148396,9
1095,55,24,97,9,6.128965912516967,15
1096,25,35,88,12,6.123879676950231,23
1097,81,13,31,4,6.117159791325403,9
1098,90,12,7,5,6.108519045195328,7
1099,102,12,60,5,6.102540677846686,7
1100,23,40,88,14,6.098802854801483,26
1101,98,39,86,17,6.096402500191193,22
1102,111,23,107,11,6.08814286411973,12
1103,79,10,108,3,6.083927302918588,7
1104,74,14,48,7,6.068043245358376,7
1105,23,27,41,11,6.068042449918637,16
1106,23,18,28,8,6.06620277166243,10
1107,69,19,68,8,6.057902735707317,11
1108,90,19,63,8,6.053395439788756,11
1109,16,48,68,18,6.053036366464971,30
1110,8,16,32,7,6.041444852098721,9
1111,7,24,98,9,6.0336860037819795,15
1112,75,31,31,14,6.033482134287373,17
1113,64,38,86,16,6.030765339147399,22
1114,64,30,65,13,6.029400567070289,17
1115,91,17,50,6,6.027790824025911,11
1116,95,20,46,8,6.027785407812038,12
1117,30,31,71,13,6.024215205048038,18
1118,99,10,17,4,6.0116233289389776,6
1119,54,57,70,23,6.000249372764343,34
1120,87,20,97,7,5.9946622011567,13
1121,114,25,31,11,5.991876520395493,14
1122,74,12,27,6,5.991317096712259,6
1123,64,20,18,8,5.974775055211904,12
1124,112,19,76,9,5.969192222728869,10
1125,97,18,40,7,5.966918416140386,11
1126,68,52,53,21,5.964244334939563,31
1127,97,12,10,6,5.950831581917705,6
1128,39,12,14,5,5.947548147792332,7
1129,33,15,7,7,5.9471342175078945,8
1130,16,40,71,15,5.938571238576761,25
1131,37,45,63,18,5.933785173114154,27
1132,73,20,114,8,5.924435121305103,12
1133,93,10,63,4,5.9175632502755855,6
1134,41,15,45,5,5.9144627061547626,10
1135,100,33,107,16,5.907266287901798,17
1136,93,16,25,7,5.904464695396421,9
1137,109,19,34,8,5.8910600256239505,11
1138,46,12,36,5,5.882094180819339,7
1139,54,53,106,24,5.881114693459095,29
1140,104,49,28,21,5.869912935195163,28
1141,86,27,81,9,5.867982727130613,18
1142,62,17,9,7,5.86600144742425,10
1143,54,36,95,16,5.865979569344106,20
1144,51,52,65,20,5.865717524678075,32
1145,34,17,7,7,5.863504951401833,10
1146,7,20,112,8,5.8633899504874805,12
1147,85,12,84,4,5.86323385034251,8
1148,74,37,46,14,5.850135921281393,23
1149,58,13,87,5,5.8383296210552,8
1150,40,16,5,7,5.820527251695649,9
1151,100,10,49,5,5.813425744151518,5
1152,80,28,106,11,5.812470547213421,17
1153,79,13,20,5,5.810117746469002,8
1154,86,84,88,35,5.809179862821953,49
1155,27,32,51,12,5.804553521558318,20
1156,7,45,64,20,5.801061458968774,25
1157,74,28,55,12,5.797157459674129,16
1158,98,26,63,11,5.795644107915217,15
1159,16,17,35,6,5.790753866714489,11
1160,11,19,35,8,5.768399159544,11
1161,64,30,71,11,5.764884814228726,19
1162,58,13,53,7,5.756559382638666,6
1163,36,12,77,5,5.751140829309578,7
1164,107,44,9,19,5.739717930392418,25
1165,25,42,106,16,5.73768822242091,26
1166,13,48,25,22,5.729332953997915,26
1167,45,14,9,5,5.727853500458987,9
1168,25,26,51,11,5.72613511284895,15
1169,98,13,17,6,5.723425305113809,7
1170,41,18,37,7,5.716493275276269,11
1171,23,10,102,4,5.7160538226538815,6
1172,114,26,40,9,5.715670519906256,17
1173,29,11,54,5,5.709851331879876,6
1174,51,26,69,10,5.708510695737555,16
1175,74,22,109,8,5.703058853572775,14
1176,28,10,85,4,5.696401332147329,6
1177,70,10,32,5,5.692479372096213,5
1178,23,10,43,4,5.689859175567734,6
1179,106,46,5,18,5.689619439430471,28
1180,30,25,55,10,5.686463879094618,15
1181,102,10,95,4,5.685319962340818,6
1182,47,18,68,7,5.681623794437403,11
1183,94,10,25,5,5.671887186214519,5
1184,75,39,37,14,5.670197882049105,25
1185,16,31,99,13,5.665818337043021,18
1186,16,48,37,20,5.664774565241773,28
1187,54,11,82,4,5.664278302313932,7
1188,43,12,68,5,5.6614021510813615,7
1189,18,13,112,4,5.661004110361593,9
1190,9,13,61,5,5.652969843590383,8
1191,4,10,97,4,5.649870700339136,6
1192,39,13,97,5,5.649731064357227,8
1193,73,23,74,9,5.649045009007229,14
1194,109,11,77,5,5.645459503468274,6
1195,78,16,54,6,5.62884902035499,10
1196,86,28,73,13,5.62531345595925,15
1197,5,21,17,7,5.625033929201379,14
1198,95,26,50,11,5.619957219349123,15
1199,16,48,50,20,5.617696720442929,28
1200,114,22,3,8,5.616945915532873,14
1201,6,10,50,4,5.6169206992817635,6
1202,30,14,90,6,5.614315415339312,8
1203,100,15,50,6,5.612526049660052,9
1204,27,14,43,7,5.609839390205427,7
1205,38,13,18,6,5.608114426083465,7
1206,70,17,98,6,5.604121247592221,11
1207,99,11,63,5,5.595807733799709,6
1208,87,32,25,14,5.592843725263717,18
1209,62,21,68,9,5.591004045591886,12
1210,7,14,79,6,5.580594560810972,8
1211,39,54,68,24,5.5781138607757725,30
1212,12,17,71,7,5.57619075244912,10
1213,42,11,69,5,5.570250078296481,6
1214,11,31,54,13,5.5650490652973295,18
1215,37,60,104,24,5.563475261062019,36
1216,63,11,10,4,5.56040496031845,7
1217,31,10,95,4,5.5581891593402775,6
1218,76,14,102,6,5.556814882908007,8
1219,46,11,4,5,5.55622187464566,6
1220,8,41,25,16,5.550067480025434,25
1221,36,53,31,23,5.548564460468652,30
1222,25,18,84,7,5.5466876181289715,11
1223,86,51,75,23,5.544222274149607,28
1224,75,16,84,7,5.542746956131477,9
1225,28,36,18,16,5.538955354420103,20
1226,106,31,23,15,5.535479536227778,16
1227,54,30,68,12,5.529360876289248,18
1228,114,45,68,19,5.528966703625285,26
1229,30,23,88,11,5.525413582454542,12
1230,33,14,102,6,5.525239013163607,8
1231,88,24,57,11,5.524909922819241,13
1232,28,33,7,13,5.522079859732702,20
1233,62,10,20,4,5.517288163699186,6
1234,87,59,37,24,5.516733087496062,35
1235,95,19,83,7,5.510188596504647,12
1236,32,13,109,6,5.5080518973086185,7
1237,67,10,102,4,5.49724656177184,6
1238,62,20,40,10,5.493314127309687,10
1239,18,10,62,4,5.493140482819633,6
1240,15,20,54,9,5.4915266593547525,11
1241,65,49,40,21,5.488110460552834,28
1242,114,23,70,9,5.484820175107314,14
1243,14,10,75,4,5.479308338136782,6
1244,99,17,36,6,5.4766719172319,11
1245,69,30,86,13,5.472935342008731,17
1246,80,11,68,4,5.466227321340817,7
1247,49,17,30,7,5.458460770772241,10
1248,75,43,71,16,5.454468163058883,27
1249,97,18,57,8,5.45235309786646,10
1250,91,18,18,7,5.437015235679076,11
1251,49,11,37,5,5.40579366661915,6
1252,4,11,58,4,5.405037105567146,7
1253,9,11,66,5,5.404825557202403,6
1254,54,31,90,13,5.397442007333916,18
1255,93,24,54,9,5.392828840599427,15
1256,100,24,7,10,5.390746304293862,14
1257,107,24,109,9,5.374789076628488,15
1258,75,30,63,13,5.362343223381901,17
1259,7,35,97,16,5.356987360153851,19
1260,62,18,65,8,5.34575502328806,10
1261,97,14,102,5,5.335160623731844,9
1262,61,15,60,7,5.316729344745585,8
1263,87,62,65,25,5.311793490232524,37
1264,111,25,55,10,5.307717141421055,15
1265,30,11,35,5,5.293385259461386,6
1266,14,19,28,7,5.288795345484194,12
1267,56,11,88,5,5.280224334897691,6
1268,50,17,30,7,5.272543611954233,10
1269,28,11,92,4,5.26619903758234,7
1270,25,26,40,11,5.242222631716463,15
1271,16,19,79,8,5.241758370421846,11
1272,98,15,40,7,5.239271076053035,8
1273,65,15,14,7,5.239230657167624,8
1274,91,21,25,9,5.236778929543691,12
1275,71,47,13,21,5.235216499316668,26
1276,88,17,112,7,5.231027938888666,10
1277,35,11,5,5,5.226534281744142,6
1278,40,22,37,10,5.2189812618502875,12
1279,67,11,84,4,5.218285236173895,7
1280,33,12,91,6,5.213867650447791,6
1281,34,18,55,8,5.202160532736089,10
1282,41,15,89,6,5.196780511481055,9
1283,40,13,113,5,5.193726392686624,8
1284,44,20,6,7,5.189449523361068,13
1285,84,24,48,9,5.188857256683019,15
1286,107,30,38,12,5.1863355550449874,18
1287,4,24,51,9,5.183921696313047,15
1288,75,17,97,7,5.183439015487436,10
1289,75,26,47,9,5.17693162231529,17
1290,2,40,50,17,5.160264368077373,23
1291,91,11,56,5,5.1601828143932735,6
1292,67,12,5,5,5.159840528973067,7
1293,111,14,39,6,5.158992286191915,8
1294,8,54,63,24,5.156454172512435,30
1295,87,46,50,21,5.1516202521080965,25
1296,63,13,79,5,5.150156389678723,8
1297,106,24,9,10,5.150083731218861,14
1298,44,15,88,7,5.148664566159752,8
1299,107,58,20,25,5.1376242090423085,33
1300,109,12,4,5,5.135069245647407,7
1301,40,30,58,14,5.133397385337812,16
1302,75,18,4,7,5.112428644465592,11
1303,55,23,70,10,5.1032220329288345,13
1304,53,25,104,11,5.0942603831986055,14
1305,87,11,110,4,5.0925904586002675,7
1306,60,24,95,10,5.089480392621887,14
1307,107,61,104,25,5.0845878069653105,36
1308,7,17,62,7,5.083532766636536,10
1309,32,10,20,3,5.082163415292109,7
1310,90,13,33,5,5.072843762888294,8
1311,16,90,107,34,5.0705236105975295,56
1312,46,17,65,6,5.066104910854949,11
1313,11,64,86,28,5.058819946444532,36
1314,55,29,63,13,5.056066807562624,16
1315,81,14,63,6,5.016441825370756,8
1316,93,26,5,10,5.004460526821323,16
1317,7,41,106,20,5.003800212982272,21
1318,32,12,68,4,4.994599728673895,8
1319,104,30,63,13,4.993963037729944,17
1320,74,15,71,7,4.993812181109021,8
1321,27,25,39,12,4.989393098929608,13
1322,23,17,15,7,4.9841342107101605,10
1323,14,18,51,6,4.969794868699566,12
1324,1,15,87,7,4.968031301569397,8
1325,40,49,107,19,4.964616090179718,30
1326,109,16,38,6,4.964461961570972,10
1327,62,12,8,4,4.9642207369004785,8
1328,96,23,90,9,4.963939687748078,14
1329,39,18,77,8,4.961640817784317,10
1330,20,36,96,15,4.958331873160826,21
1331,57,20,39,9,4.958056164867145,11
1332,13,32,8,13,4.955794878282507,19
1333,56,19,68,9,4.94813216675333,10
1334,86,33,17,16,4.947496305270282,17
1335,76,12,49,5,4.943121216792114,7
1336,77,14,87,6,4.942401920251487,8
1337,37,11,108,5,4.94147061612662,6
1338,20,21,55,9,4.931554548881413,12
1339,114,22,9,7,4.931319071415342,15
1340,86,40,36,17,4.927433251240005,23
1341,74,56,106,24,4.924754963776778,32
1342,65,31,17,11,4.917244641739984,20
1343,54,12,108,4,4.909695920764135,8
1344,46,48,54,20,4.906943181154001,28
1345,76,27,55,10,4.8923898677809445,17
1346,83,39,5,18,4.890865835189014,21
1347,65,44,9,18,4.887961308210911,26
1348,8,12,3,7,4.88781937501622,5
1349,69,11,95,4,4.882909765417961,7
1350,30,11,114,5,4.8820710984651585,6
1351,81,15,18,6,4.877040041598752,9
1352,85,12,88,5,4.8737543176102305,7
1353,51,11,38,4,4.8736842084361065,7
1354,88,10,110,5,4.870544753091405,5
1355,37,54,106,25,4.865641247327302,29
1356,5,10,89,3,4.86246564090175,7
1357,84,15,57,7,4.8613201853007775,8
1358,97,12,32,5,4.851459349576839,7
1359,104,23,100,9,4.850527098250832,14
1360,94,15,54,6,4.847006166736522,9
1361,5,30,51,11,4.841333405150811,19
1362,83,20,64,9,4.840996077098241,11
1363,13,54,87,21,4.8402419854282135,33
1364,16,99,51,43,4.839584083452132,56
1365,75,39,39,18,4.835166255544909,21
1366,8,15,67,6,4.831909846155583,9
1367,31,19,25,9,4.823839301099763,10
1368,14,15,54,5,4.820525855929132,10
1369,23,27,68,13,4.81982927042641,14
1370,83,30,8,14,4.811627367676455,16
1371,6,12,106,5,4.810944704219048,7
1372,100,13,17,4,4.805895298432701,9
1373,96,13,108,6,4.805162668071275,7
1374,114,36,51,17,4.804348446858166,19
1375,110,16,16,7,4.801952356665634,9
1376,75,22,96,7,4.801381492311931,15
1377,98,17,84,6,4.7978961426483835,11
1378,111,11,25,5,4.797175922879397,6
1379,8,29,9,15,4.796436219845455,14
1380,84,14,76,6,4.794994736983405,8
1381,9,17,1,9,4.794059502939978,8
1382,76,33,5,14,4.788314400539968,19
1383,87,33,40,15,4.7862632423252975,18
1384,9,12,5,5,4.777710715122403,7
1385,93,26,28,10,4.7762193932866115,16
1386,13,31,54,12,4.774769567956579,19
1387,90,13,70,6,4.771084444295362,7
1388,12,15,31,7,4.770632464521183,8
1389,60,16,97,8,4.770560692259114,8
1390,93,16,50,6,4.755526241513054,10
1391,90,30,5,12,4.752640516818983,18
1392,74,38,63,17,4.748458787006123,21
1393,25,16,77,7,4.745845616411638,9
1394,55,57,65,25,4.744057377410872,32
1395,16,97,7,43,4.743286222921809,54
1396,54,10,12,5,4.742791545217389,5
1397,97,11,3,4,4.740273088979023,7
1398,8,41,46,19,4.737192297274268,22
1399,6,11,46,5,4.730994669309113,6
1400,85,16,54,6,4.730021736475019,10
1401,15,14,75,5,4.729161606780822,9
1402,47,17,86,7,4.720142586161402,10
1403,3,12,43,5,4.714914149800726,7
1404,11,38,88,16,4.710454574435891,22
1405,15,19,68,7,4.704332289270894,12
1406,55,45,60,20,4.699539635247214,25
1407,9,15,38,7,4.694842617038377,8
1408,60,26,41,12,4.687979614839915,14
1409,71,16,5,7,4.686451238703377,9
1410,108,17,87,7,4.682000852364703,10
1411,70,27,20,11,4.678638629207437,16
1412,53,22,81,9,4.67351225402936,13
1413,52,12,8,5,4.669562642233978,7
1414,85,15,96,5,4.669149907673059,10
1415,55,14,98,5,4.662824671110214,9
1416,25,15,47,7,4.655390231832646,8
1417,64,27,63,12,4.655022536417097,15
1418,27,15,25,7,4.649655011418165,8
1419,73,14,13,6,4.642713338622983,8
1420,73,19,109,8,4.637139105733967,11
1421,43,24,88,10,4.636555985964769,14
1422,60,22,25,10,4.636282806493916,12
1423,106,15,110,7,4.633960085739299,8
1424,8,63,87,27,4.62091726825585,36
1425,49,17,9,8,4.620658268254684,9
1426,28,23,71,9,4.6154330872159655,14
1427,7,42,55,17,4.609551229914398,25
1428,37,72,86,32,4.607837359690983,40
1429,16,77,87,34,4.603852734885346,43
1430,7,35,3,14,4.603775118928216,21
1431,23,11,30,5,4.601908928188203,6
1432,77,13,95,6,4.60149322445291,7
1433,55,20,64,7,4.598509710106534,13
1434,7,94,88,42,4.598064452346124,52
1435,50,32,96,14,4.592653394244439,18
1436,78,16,87,8,4.5883039297327395,8
1437,60,30,8,14,4.584471076654316,16
1438,71,24,87,11,4.583143708944138,13
1439,100,12,30,5,4.575260966636385,7
1440,7,23,58,11,4.575034525669344,12
1441,99,14,95,6,4.572737764013027,8
1442,35,10,51,4,4.572048310137619,6
1443,99,16,104,8,4.5627492392393,8
1444,70,15,23,7,4.554568026577778,8
1445,109,13,67,7,4.5540965230597985,6
1446,74,10,112,4,4.553694289700708,6
1447,107,19,85,8,4.552488211197705,11
1448,83,15,46,7,4.551826612706301,8
1449,1,11,39,6,4.548291694643937,5
1450,23,24,76,11,4.537606040144393,13
1451,88,51,9,22,4.537426821075463,29
1452,8,24,102,11,4.537070383836359,13
1453,71,28,68,11,4.532265816801447,17
1454,106,23,75,11,4.532198108241345,12
1455,37,43,55,20,4.516821858156878,23
1456,62,10,104,3,4.50664568251795,7
1457,75,20,112,8,4.4989690721071325,12
1458,93,15,37,6,4.493445665639034,9
1459,64,15,3,6,4.492765978443915,9
1460,75,45,51,20,4.490318359114665,25
1461,55,11,27,5,4.4890470852362,6
1462,13,24,3,8,4.479086737291787,16
1463,88,29,70,12,4.478319588858416,17
1464,30,40,16,17,4.476195567754862,23
1465,95,33,107,15,4.475609109265348,18
1466,65,74,107,32,4.4743161182651745,42
1467,96,31,25,14,4.4728328775528,17
1468,68,16,8,7,4.472450037155224,9
1469,88,30,18,14,4.470121317889942,16
1470,16,19,108,8,4.469566431052606,11
1471,91,10,57,5,4.468260927215541,5
1472,19,11,28,5,4.4681779199018195,6
1473,37,18,32,8,4.466542082918521,10
1474,3,15,50,7,4.464463620895282,8
1475,78,13,98,6,4.463806568924881,7
1476,77,11,97,4,4.4549011553839994,7
1477,50,12,73,4,4.454782630059153,8
1478,95,44,16,20,4.453378575583387,24
1479,7,67,31,29,4.4532123702344615,38
1480,13,33,37,14,4.448467961015427,19
1481,95,15,109,6,4.444131433700797,9
1482,45,11,88,4,4.4416566980945715,7
1483,16,35,53,14,4.432680586189367,21
1484,86,115,5,49,4.430772584334587,66
1485,107,35,64,16,4.429693624174908,19
1486,102,20,87,8,4.423994697827657,12
1487,46,18,9,8,4.423884935946225,10
1488,99,30,13,13,4.420966828834258,17
1489,13,12,76,5,4.417032905676177,7
1490,7,64,53,28,4.416213736910661,36
1491,114,20,64,8,4.407773657880817,12
1492,97,14,29,6,4.39492891527919,8
1493,111,20,86,8,4.3910837466552355,12
1494,65,23,76,9,4.385586505985178,14
1495,63,38,96,15,4.376849709142971,23
1496,74,13,9,5,4.37578055371931,8
1497,60,13,98,6,4.372454949323835,7
1498,55,24,9,10,4.371040618945099,14
1499,57,32,16,14,4.3708612009725964,18
1500,55,13,58,6,4.369004483506264,7
1501,40,23,23,10,4.368423326803309,13
1502,33,13,11,7,4.365968233102095,6
1503,104,31,54,14,4.355933806560286,17
1504,47,24,88,11,4.347102674354304,13
1505,70,29,65,11,4.343984179663613,18
1506,28,49,109,20,4.336990918241798,29
1507,60,12,22,5,4.334241842742782,7
1508,95,19,41,8,4.332143979792177,11
1509,98,23,37,10,4.327931130640237,13
1510,15,19,86,8,4.320856963962771,11
1511,4,22,40,10,4.316643149060896,12
1512,17,19,20,8,4.3112321942034,11
1513,50,10,52,5,4.308197298973349,5
1514,20,22,109,8,4.302333411252667,14
1515,25,28,54,12,4.300413553073274,16
1516,20,21,44,9,4.299103845073809,12
1517,53,25,112,13,4.294359182673499,12
1518,33,12,96,7,4.271042933020869,5
1519,104,17,80,8,4.256665633473226,9
1520,106,14,34,7,4.243674039664675,7
1521,20,22,46,8,4.241307956001942,14
1522,31,12,74,5,4.240578281890586,7
1523,60,21,1,9,4.237560386673236,12
1524,109,16,65,5,4.2330518085976205,11
1525,30,20,28,8,4.226225794824841,12
1526,28,54,54,23,4.225159524354367,31
1527,71,11,44,5,4.223524348839462,6
1528,4,19,18,8,4.220670692754494,11
1529,30,36,87,16,4.216616531421399,20
1530,27,11,112,5,4.214543381192911,6
1531,41,41,68,18,4.207626519911898,23
1532,65,56,36,24,4.205692860728479,32
1533,47,13,28,6,4.1983584961153175,7
1534,23,18,100,7,4.197161790157007,11
1535,7,14,48,7,4.194687020035504,7
1536,40,55,88,24,4.188882138376305,31
1537,23,27,25,12,4.182190113226028,15
1538,40,22,50,8,4.17370334148128,14
1539,86,26,78,11,4.169788407826314,15
1540,53,15,62,7,4.1594095703321505,8
1541,75,15,2,7,4.157456952203449,8
1542,60,10,62,4,4.155747625311636,6
1543,6,16,107,7,4.1501606565339015,9
1544,96,13,3,6,4.149840606440919,7
1545,20,13,73,5,4.146065391689569,8
1546,53,47,71,20,4.141303557057986,27
1547,100,18,74,8,4.138016461047893,10
1548,23,11,29,5,4.138000210796417,6
1549,11,11,69,4,4.13792149131312,7
1550,71,11,20,4,4.13643055739397,7
1551,76,32,104,13,4.1357118218948905,19
1552,45,22,65,11,4.1259231703887,11
1553,29,11,106,5,4.122686341567239,6
1554,12,14,68,6,4.108669111305504,8
1555,16,15,93,7,4.106290602314813,8
1556,114,21,46,9,4.104107153511736,12
1557,93,14,109,6,4.103558953267082,8
1558,83,20,93,9,4.100880722204593,11
1559,20,24,35,10,4.098728722002914,14
1560,87,26,64,12,4.098181725889203,14
1561,36,11,19,5,4.088590218421688,6
1562,74,22,50,10,4.086243740312162,12
1563,60,57,40,25,4.067256254892929,32
1564,9,29,63,13,4.065325398742935,16
1565,7,26,17,11,4.064887482017846,15
1566,43,10,95,4,4.063398320607949,6
1567,34,10,38,4,4.0610942900478735,6
1568,16,28,80,12,4.056076921695064,16
1569,107,23,62,12,4.0504669700597535,11
1570,32,10,40,5,4.050021677419869,5
1571,11,13,79,7,4.047561716338114,6
1572,7,21,50,10,4.045740478776832,11
1573,1,10,43,5,4.038976715758721,5
1574,71,13,47,6,4.030916530509353,7
1575,96,30,88,14,4.030096740212507,16
1576,104,16,3,7,4.020656220421076,9
1577,102,28,114,12,4.017120825737178,16
1578,104,44,51,17,4.0154244082227635,27
1579,8,20,110,8,4.013172679497404,12
1580,50,70,28,30,4.011477637487843,40
1581,55,36,54,17,4.011039158800403,19
1582,99,20,86,8,4.0098912228328505,12
1583,66,12,31,5,4.008754872558654,7
1584,86,20,77,8,4.0075201103206535,12
1585,58,10,51,4,3.9912030401078082,6
1586,13,70,107,32,3.9870909466214273,38
1587,34,17,17,7,3.985705258546001,10
1588,41,14,43,6,3.977377796491963,8
1589,96,12,14,5,3.975747798085754,7
1590,104,72,65,33,3.97064919727685,39
1591,13,11,29,5,3.9675884694704666,6
1592,49,22,17,8,3.9654437170334917,14
1593,74,24,93,11,3.9601017688790825,13
1594,88,50,104,21,3.9536343834384886,29
1595,72,17,16,8,3.952768658773343,9
1596,34,12,76,6,3.9517678907570333,6
1597,37,17,100,7,3.9481789557688414,10
1598,6,11,40,5,3.9442678680230823,6
1599,51,40,46,17,3.9395834900065485,23
1600,80,10,97,4,3.9365866928471034,6
1601,64,13,15,7,3.9332029302911167,6
1602,16,20,3,8,3.933123710020239,12
1603,57,11,50,4,3.9290278222481443,7
1604,100,21,13,9,3.928732330408649,12
1605,5,28,2,12,3.923277825320168,16
1606,37,38,70,16,3.9227382855891664,22
1607,20,17,48,7,3.9196076613306303,10
1608,49,30,86,14,3.9188195592198185,16
1609,89,13,86,7,3.91749283769541,6
1610,27,16,53,6,3.9149964442694025,10
1611,68,33,1,14,3.9146334053388845,19
1612,60,21,96,7,3.912428069824762,14
1613,98,19,49,9,3.906322793569991,10
1614,102,26,37,11,3.9015784283610255,15
1615,7,29,47,12,3.897446682675393,17
1616,17,16,63,7,3.896935952486399,9
1617,55,44,11,18,3.8920841591670343,26
1618,76,13,62,6,3.8913968956310088,7
1619,110,10,17,4,3.8887191359542532,6
1620,11,15,17,7,3.886158778436342,8
1621,1,11,112,6,3.882693398534097,5
1622,43,11,35,4,3.879532298464463,7
1623,18,13,98,7,3.8754830902904014,6
1624,28,17,100,7,3.874972007810441,10
1625,95,36,87,16,3.86940077356921,20
1626,108,11,68,5,3.868849039567309,6
1627,11,16,51,8,3.8660778701548058,8
1628,41,25,114,12,3.854494902198664,13
1629,65,14,6,6,3.853639209419111,8
1630,65,34,111,14,3.8475275648066685,20
1631,28,11,31,5,3.8453747580936164,6
1632,86,54,46,21,3.8441180756964655,33
1633,18,23,31,11,3.843025830767866,12
1634,91,26,13,12,3.831748260733109,14
1635,13,78,51,36,3.830975362019476,42
1636,70,30,51,14,3.8297117807076555,16
1637,44,16,87,7,3.8267549460576484,9
1638,60,12,66,4,3.826632219817407,8
1639,55,21,4,10,3.821660634263142,11
1640,49,10,3,4,3.8208441036339096,6
1641,86,32,18,13,3.8203668272153473,19
1642,91,18,31,7,3.8197018311679423,11
1643,110,16,5,7,3.8138584796050923,9
1644,39,12,78,6,3.805891795343841,6
1645,20,13,104,5,3.7974160411444706,8
1646,20,48,28,21,3.791556613480696,27
1647,28,12,49,6,3.781572164594755,6
1648,104,13,92,7,3.7768187223532306,6
1649,63,19,4,8,3.775833657808686,11
1650,88,16,6,7,3.757051253043465,9
1651,18,55,53,25,3.751842811643862,30
1652,15,21,65,9,3.7445792583431645,12
1653,53,42,40,19,3.7429391558119995,23
1654,1,13,4,5,3.736039087851971,8
1655,86,65,25,30,3.735239092039536,35
1656,75,42,88,18,3.726903391628384,24
1657,91,10,80,4,3.7198935399827406,6
1658,12,14,3,5,3.71740069479101,9
1659,15,21,5,8,3.714734226349825,13
1660,106,17,43,8,3.7068539679712273,9
1661,28,28,102,13,3.6997830630198973,15
1662,87,41,20,19,3.692217589912374,22
1663,13,68,40,31,3.690363085789059,37
1664,46,20,84,8,3.686829488531013,12
1665,39,48,53,21,3.6851162429567523,27
1666,52,11,107,4,3.6792228295103513,7
1667,101,14,68,5,3.6742625668258913,9
1668,71,12,27,5,3.672482180614424,7
1669,20,25,80,11,3.67142842734406,14
1670,62,10,50,4,3.6657345895143245,6
1671,19,10,88,5,3.6656067392732057,5
1672,86,53,104,24,3.66553549979236,29
1673,97,33,96,16,3.657438935158263,17
1674,53,11,100,5,3.656950058764998,6
1675,63,22,23,9,3.656375723040438,13
1676,90,10,71,5,3.6561036030201253,5
1677,107,21,32,10,3.6546977761524686,11
1678,109,15,9,8,3.6538651478462696,7
1679,76,35,107,13,3.6519592132431544,22
1680,17,11,18,6,3.651905683853181,5
1681,23,47,65,22,3.6506323242088645,25
1682,27,13,50,5,3.6503401008022798,8
1683,16,19,2,8,3.6499962386684337,11
1684,14,10,70,5,3.647042134114848,5
1685,87,36,60,17,3.6433827041407536,19
1686,30,28,60,10,3.642920901334595,18
1687,30,20,37,8,3.640395609700316,12
1688,20,15,68,7,3.640176972936066,8
1689,88,60,5,28,3.63799769202775,32
1690,75,14,108,6,3.6340908116173014,8
1691,48,11,108,4,3.6336145248971845,7
1692,86,82,84,40,3.631145683992793,42
1693,43,19,18,10,3.6267699505365183,9
1694,84,14,17,6,3.6228474870048992,8
1695,28,16,62,7,3.6140960069707964,9
1696,55,13,94,6,3.6120696685756317,7
1697,34,16,84,8,3.6041106207285085,8
1698,107,19,69,8,3.6039989635628795,11
1699,34,14,13,7,3.5918746626908384,7
1700,58,13,71,6,3.5901555481142546,7
1701,97,10,95,4,3.58943247133478,6
1702,69,11,20,5,3.5870175414258565,6
1703,63,14,45,6,3.582850982463552,8
1704,33,12,23,5,3.5712223539857573,7
1705,1,23,51,11,3.568045705832745,12
1706,107,45,23,21,3.563700288354352,24
1707,16,71,8,31,3.5597923636148616,40
1708,64,11,33,4,3.5581108018586245,7
1709,28,19,36,9,3.5549996153541237,10
1710,23,13,57,6,3.554408044637193,7
1711,16,31,49,14,3.5542822347062724,17
1712,30,13,4,6,3.554167963462701,7
1713,86,30,38,13,3.545802580470499,17
1714,40,65,36,28,3.5400829247343655,37
1715,88,26,69,11,3.536532050456282,15
1716,44,15,7,7,3.5352660207554516,8
1717,20,17,76,9,3.5278207011714735,8
1718,63,18,43,8,3.524851733785241,10
1719,7,17,30,9,3.521225077195732,8
1720,109,28,13,12,3.519799337045931,16
1721,112,11,17,5,3.5191492672023625,6
1722,97,22,17,10,3.51760245978497,12
1723,16,34,62,14,3.517446163588128,20
1724,8,38,104,17,3.50734140656749,21
1725,91,15,84,7,3.506943767095505,8
1726,49,10,33,4,3.5057518320537766,6
1727,74,16,23,7,3.505315761927058,9
1728,85,14,68,5,3.5027894631624408,9
1729,50,26,9,11,3.4989626487903873,15
1730,97,36,114,16,3.4948097299506915,20
1731,87,83,107,37,3.4895508090477105,46
1732,62,13,36,6,3.489528327052378,7
1733,36,30,51,14,3.4874600225025074,16
1734,25,20,70,9,3.484518115943736,11
1735,55,16,18,8,3.4810467173744706,8
1736,96,57,54,28,3.4766133859583515,29
1737,23,10,81,4,3.474530372802633,6
1738,73,14,16,7,3.4738693799097953,7
1739,74,60,5,28,3.469996146708342,32
1740,9,26,54,12,3.4668855776458427,14
1741,30,19,106,9,3.463995690702536,10
1742,13,32,1,13,3.4629329225242813,19
1743,13,12,84,5,3.4627368734629638,7
1744,77,10,17,4,3.4626586322684796,6
1745,20,46,37,21,3.4576214767552655,25
1746,106,49,51,22,3.457607975311814,27
1747,33,23,5,11,3.454327509177194,12
1748,37,21,23,10,3.453043705748743,11
1749,13,56,39,26,3.443344119398472,30
1750,114,29,39,14,3.441117211126096,15
1751,102,31,25,14,3.4382241991917164,17
1752,4,12,37,5,3.421871703775507,7
1753,17,11,36,6,3.4172736451567545,5
1754,104,26,98,14,3.4091853213510754,12
1755,13,46,64,23,3.4066631144062174,23
1756,68,20,17,8,3.395638967050425,12
1757,4,13,28,6,3.3940824912486867,7
1758,43,28,40,13,3.3929222536074835,15
1759,73,10,104,4,3.391491099464731,6
1760,39,48,55,21,3.389422612270981,27
1761,60,28,9,11,3.384232112219374,17
1762,36,28,55,13,3.383336577257353,15
1763,73,15,98,7,3.380055365181917,8
1764,39,16,81,7,3.3797099233441705,9
1765,107,56,55,26,3.3696189355898034,30
1766,40,17,20,7,3.3649339637959645,10
1767,54,25,97,12,3.3648153427656755,13
1768,14,23,8,10,3.3634201583462158,13
1769,7,48,27,22,3.361741499616722,26
1770,13,52,46,23,3.3558421358827237,29
1771,54,12,3,6,3.355227899021248,6
1772,97,34,16,16,3.3525321991063115,18
1773,83,10,20,5,3.3478898251644025,5
1774,40,15,91,7,3.345577169162442,8
1775,16,47,70,20,3.3445553948476245,27
1776,20,21,2,9,3.343168498501612,12
1777,75,13,33,5,3.342736023465548,8
1778,54,20,98,9,3.3414082574982986,11
1779,68,13,5,6,3.3380294056441144,7
1780,71,13,76,7,3.3359186512389036,6
1781,69,12,109,5,3.3344685187765166,7
1782,50,22,31,10,3.333423687645379,12
1783,80,33,54,16,3.3322159324199094,17
1784,41,19,50,8,3.331657114556134,11
1785,78,10,34,5,3.3271359801886424,5
1786,64,30,39,13,3.324524230733537,17
1787,9,13,81,6,3.321776466067701,7
1788,64,10,57,4,3.3215297930391765,6
1789,97,16,84,6,3.316428205809935,10
1790,60,31,75,14,3.3139158628036856,17
1791,16,35,17,14,3.312370376088436,21
1792,86,11,66,5,3.3092941516234364,6
1793,20,61,54,30,3.3038924410847255,31
1794,104,60,5,28,3.3007473735225052,32
1795,38,23,13,12,3.2949567300335865,11
1796,57,20,13,10,3.292969695754844,10
1797,16,18,45,7,3.276855643218357,11
1798,114,13,67,6,3.2746706512348434,7
1799,102,11,91,5,3.2738070744638943,6
1800,70,14,93,6,3.271451863431868,8
1801,13,12,102,4,3.269263582511039,8
1802,50,49,107,23,3.267933465353471,26
1803,60,24,109,11,3.2667081082674905,13
1804,98,23,76,10,3.2651133620022033,13
1805,76,14,95,6,3.2576515088397957,8
1806,7,24,74,9,3.257493143792888,15
1807,84,14,95,6,3.2568961944145873,8
1808,114,47,25,20,3.2540864225169766,27
1809,94,15,107,5,3.253497352477997,10
1810,87,47,28,22,3.244764597626062,25
1811,107,49,36,23,3.234838704648264,26
1812,56,10,97,5,3.231426212036921,5
1813,2,21,87,9,3.2308938185741103,12
1814,51,44,41,20,3.228342506596857,24
1815,4,21,16,11,3.2239938149007976,10
1816,23,55,7,25,3.2229283053761675,30
1817,97,29,63,13,3.2191950537106915,16
1818,55,39,28,16,3.2184704312839787,23
1819,64,19,23,9,3.212372911598019,10
1820,50,19,97,8,3.210625734622642,11
1821,60,47,31,24,3.2094707274879264,23
1822,44,12,76,5,3.2019945343572473,7
1823,36,41,39,18,3.1998605067578225,23
1824,55,49,5,22,3.1989531771818034,27
1825,68,14,81,6,3.1985312995714845,8
1826,9,38,51,18,3.197373775958875,20
1827,37,54,50,26,3.188335276013606,28
1828,83,25,65,12,3.1850517665827933,13
1829,47,11,69,5,3.1775295332798312,6
1830,88,56,68,25,3.171688752257409,31
1831,106,25,60,10,3.171261503808182,15
1832,110,16,86,7,3.1694821197260503,9
1833,75,39,9,17,3.168115043855195,22
1834,90,14,74,5,3.1680613510289204,9
1835,13,17,62,8,3.1612952767397977,9
1836,23,32,87,13,3.1607512154600745,19
1837,86,21,82,9,3.1586560919846263,12
1838,46,21,63,11,3.15628045747171,10
1839,87,13,17,6,3.1557879324593294,7
1840,13,15,112,7,3.153591174260179,8
1841,75,23,23,12,3.1487336010920157,11
1842,62,24,71,11,3.138232146026574,13
1843,5,27,91,11,3.121858390948631,16
1844,36,11,80,5,3.115857421175661,6
1845,53,29,55,13,3.115426410914569,16
1846,25,25,17,11,3.1106502600539105,14
1847,50,24,4,12,3.110559237136959,12
1848,106,26,53,13,3.105027322219241,13
1849,109,25,106,12,3.1028448270841773,13
1850,92,15,60,6,3.101629065738582,9
1851,99,14,68,6,3.1001036150844663,8
1852,64,10,91,4,3.0993479020870796,6
1853,29,12,53,4,3.098310032912906,8
1854,13,27,77,12,3.097681583212727,15
1855,6,20,16,10,3.089484314971671,10
1856,45,14,87,6,3.0862202973256596,8
1857,74,11,41,6,3.0735662157516845,5
1858,16,105,86,47,3.0722654083229974,58
1859,64,40,88,17,3.072237959143945,23
1860,75,30,25,13,3.069551733540898,17
1861,60,40,114,22,3.0670908685799034,18
1862,71,18,25,8,3.0644100067848146,10
1863,48,14,55,6,3.06362691776684,8
1864,30,21,68,10,3.043602381995945,11
1865,38,13,96,6,3.0422152322461717,7
1866,25,39,65,16,3.0368934823131175,23
1867,41,16,47,7,3.031406429138557,9
1868,35,13,84,6,3.030499439916225,7
1869,54,47,51,22,3.0297759973580076,25
1870,78,10,55,5,3.027993385213423,5
1871,57,12,40,5,3.0270401513317453,7
1872,6,27,7,15,3.013941061604383,12
1873,88,19,38,7,3.0023329742590956,12
1874,96,14,34,6,3.0017630147825622,8
1875,31,21,58,10,2.9999355657905133,11
1876,4,11,69,5,2.999484176661719,6
1877,11,46,107,21,2.9990181027783187,25
1878,64,28,41,11,2.9985462284656723,17
1879,27,10,18,5,2.996654278290002,5
1880,65,37,37,18,2.9918797859979525,19
1881,100,10,98,5,2.991009310778455,5
1882,74,10,30,5,2.9862406732405895,5
1883,72,10,51,5,2.9819518577631134,5
1884,13,35,50,16,2.981537535104847,19
1885,95,27,53,10,2.9811343498680327,17
1886,10,12,84,5,2.980259678929738,7
1887,13,67,55,31,2.978208210155153,36
1888,84,36,106,18,2.9754739608250116,18
1889,36,32,4,13,2.9739066740354185,19
1890,60,12,94,6,2.9727316679047617,6
1891,2,21,37,10,2.9697580112694486,11
1892,47,11,53,5,2.9672181618537916,6
1893,7,89,86,38,2.9562630867796154,51
1894,20,36,16,14,2.9562315265653076,22
1895,87,23,49,12,2.9552067016674504,11
1896,80,16,8,8,2.9519293865537115,8
1897,86,78,8,38,2.9505503650201574,40
1898,15,25,7,13,2.945121443798055,12
1899,30,17,76,7,2.9372015853586086,10
1900,36,20,87,8,2.935573250897663,12
1901,61,15,3,8,2.934761403571649,7
1902,49,11,97,4,2.9318959143747887,7
1903,99,15,65,7,2.9253489592007305,8
1904,17,10,43,5,2.923505312587325,5
1905,74,82,86,39,2.921287780715151,43
1906,102,19,106,10,2.9207255392565097,9
1907,63,88,86,37,2.918942627105092,51
1908,25,12,108,5,2.9132670669268244,7
1909,91,19,37,9,2.9050960547005245,10
1910,71,13,108,6,2.8992906212622866,7
1911,44,10,70,5,2.8975248911261433,5
1912,68,20,78,9,2.8969266940151797,11
1913,13,113,7,52,2.8945975489338593,61
1914,75,24,74,10,2.8903655619324433,14
1915,43,31,7,13,2.8869337290340304,18
1916,29,13,38,6,2.8767159163647986,7
1917,63,23,60,10,2.8746236800640075,13
1918,27,21,75,10,2.874214711599615,11
1919,28,54,65,24,2.8645560920703144,30
1920,60,48,86,22,2.8571270629897767,26
1921,88,53,28,23,2.854042679776566,30
1922,51,18,99,9,2.853477797374065,9
1923,73,16,96,7,2.8534303980093814,9
1924,74,20,18,10,2.84961422222247,10
1925,97,13,33,6,2.8486496222061595,7
1926,47,10,61,4,2.846896267551427,6
1927,17,28,39,12,2.8462345861289604,16
1928,23,13,104,5,2.8445076862849494,8
1929,102,25,54,11,2.843956333831335,14
1930,16,84,65,38,2.8433317593388674,46
1931,95,19,23,9,2.8404436396815522,10
1932,89,12,60,6,2.839673113881044,6
1933,77,18,65,9,2.836180648453274,9
1934,104,33,74,14,2.8329598216365466,19
1935,16,21,38,8,2.8217292489636367,13
1936,18,13,71,6,2.821320109059578,7
1937,64,13,47,5,2.8212403790572256,8
1938,99,17,15,7,2.8189668514207984,10
1939,51,32,109,12,2.817926639661738,20
1940,65,17,48,7,2.813018636762518,10
1941,68,33,106,15,2.8127952198562456,18
1942,99,15,41,7,2.8081672918617278,8
1943,106,14,112,7,2.805082024542767,7
1944,60,57,88,25,2.7991697386489363,32
1945,4,25,114,12,2.797376255941943,13
1946,7,26,1,12,2.7932054952385035,14
1947,100,13,36,6,2.7923934619121087,7
1948,86,19,108,10,2.7920033870005008,9
1949,9,15,97,8,2.7891659901703596,7
1950,88,67,107,29,2.788634980843412,38
1951,3,16,55,7,2.785774326842637,9
1952,16,27,84,13,2.780568773232003,14
1953,107,27,3,14,2.774749446201735,13
1954,5,11,10,6,2.7716738654503197,5
1955,38,11,40,6,2.7715520430648577,5
1956,5,17,77,8,2.765837567194589,9
1957,18,31,60,14,2.7592417090229198,17
1958,53,42,64,19,2.759026680292717,23
1959,86,94,28,42,2.754352701034727,52
1960,51,67,107,28,2.7500079460300553,39
1961,29,19,107,7,2.739796334219244,12
1962,97,22,104,11,2.7396377781056174,11
1963,86,106,87,53,2.735845324305882,53
1964,65,50,106,23,2.735321183024918,27
1965,98,26,107,12,2.7337807533135248,14
1966,75,12,34,6,2.7327928404854553,6
1967,9,12,30,5,2.7296904854733155,7
1968,28,39,51,19,2.7279860075631754,20
1969,55,53,88,22,2.721264805593774,31
1970,104,31,70,14,2.720810924975006,17
1971,95,11,80,5,2.7197438471090796,6
1972,16,21,33,8,2.7169085795346413,13
1973,107,57,37,26,2.7122377942768776,31
1974,43,27,65,14,2.704466819899112,13
1975,12,14,18,6,2.7036570911929863,8
1976,88,32,109,14,2.698492977632003,18
1977,57,21,41,9,2.6943367288369697,12
1978,88,67,51,34,2.689202214280452,33
1979,65,40,71,17,2.686780335165667,23
1980,90,17,17,9,2.680753861205159,8
1981,39,25,5,12,2.679132217269287,13
1982,43,16,50,6,2.6787122504636622,10
1983,25,17,44,8,2.673535476281759,9
1984,95,18,75,8,2.672802736686619,10
1985,114,25,74,12,2.666972342657447,13
1986,47,10,76,7,2.6595736051653853,3
1987,74,13,91,6,2.658254293210725,7
1988,92,29,88,13,2.6541256559252315,16
1989,57,13,36,5,2.6531160901053807,8
1990,53,48,65,23,2.651912649859134,25
1991,30,24,8,11,2.6514132136935467,13
1992,23,43,86,20,2.6484576158238533,23
1993,16,60,5,25,2.6435184456824317,35
1994,86,28,62,13,2.642237041880456,15
1995,33,14,95,6,2.641545389608455,8
1996,54,28,114,14,2.6355280322257,14
1997,13,14,72,7,2.6344835838372402,7
1998,26,17,13,7,2.633153010513875,10
1999,16,85,13,38,2.6278459194386543,47
2000,41,44,16,22,2.6236346308099385,22
2001,11,26,20,11,2.6225934054521085,15
2002,11,12,41,4,2.61594797809933,8
2003,76,13,2,5,2.6134640032331116,8
2004,11,16,40,7,2.6127959858163616,9
2005,93,20,86,9,2.6126285193850958,11
2006,39,11,94,5,2.610241699131661,6
2007,36,23,91,10,2.600483205457648,13
2008,40,19,27,11,2.5947052105553365,8
2009,107,19,112,8,2.5936715899936584,11
2010,39,23,31,10,2.5934090452929373,13
2011,1,10,109,5,2.5929606771402254,5
2012,87,21,62,10,2.586304566496697,11
2013,104,50,7,23,2.5854072339864183,27
2014,47,11,91,5,2.565831417578021,6
2015,91,28,107,12,2.5653431282322665,16
2016,92,13,87,6,2.565186954563254,7
2017,102,20,74,9,2.5610411607037933,11
2018,83,10,63,6,2.557624644664858,4
2019,86,14,14,7,2.5565201304900333,7
2020,51,16,83,6,2.5563009225954785,10
2021,73,19,1,8,2.55342910039073,11
2022,52,13,16,6,2.542332195506542,7
2023,63,35,11,14,2.539597707853179,21
2024,111,11,60,4,2.535604443502029,7
2025,36,33,9,15,2.5279240780374668,18
2026,39,18,4,8,2.5267698999647226,10
2027,11,13,68,6,2.5250619833588033,7
2028,39,32,50,15,2.5245695496572065,17
2029,12,15,36,7,2.516319942513749,8
2030,62,18,39,9,2.5162035004252656,9
2031,63,30,13,14,2.513355364840314,16
2032,7,105,68,48,2.5114811010541342,57
2033,11,23,13,11,2.509450211026071,12
2034,106,37,96,16,2.50842381050559,21
2035,37,18,109,8,2.501013404341532,10
2036,11,20,48,9,2.499763597895506,11
2037,65,20,3,9,2.497136850038322,11
2038,87,20,31,10,2.492676559594957,10
2039,18,11,111,5,2.4899108726358863,6
2040,65,59,68,27,2.4863573145608644,32
2041,84,63,107,29,2.4836473699262265,34
2042,95,30,39,14,2.481130681096554,16
2043,7,61,9,30,2.475604646115282,31
2044,4,17,81,7,2.4678124777063273,10
2045,87,40,74,18,2.4671563114027473,22
2046,74,17,69,9,2.4664972820824542,8
2047,54,10,27,5,2.4638694969344774,5
2048,32,10,50,6,2.444054190716271,4
2049,57,18,51,9,2.4421495714004644,9
2050,12,18,86,8,2.4382543520920796,10
2051,55,39,106,17,2.438139246666604,22
2052,41,24,69,9,2.4354335303163985,15
2053,87,21,99,9,2.4324110326808843,12
2054,91,20,75,13,2.432369433261267,7
2055,109,11,99,5,2.4195174025010595,6
2056,107,46,25,22,2.4187485647838765,24
2057,71,35,39,16,2.4158892555534424,19
2058,65,11,92,5,2.4112859752548714,6
2059,8,33,93,16,2.4111455321691304,17
2060,47,24,51,12,2.409457368099758,12
2061,68,21,38,9,2.4070210829507572,12
2062,3,31,68,14,2.4024413251399013,17
2063,78,20,60,10,2.4024308351348855,10
2064,3,27,87,12,2.4014400128838447,15
2065,86,74,54,35,2.4008434716444915,39
2066,56,10,8,4,2.40008605471798,6
2067,12,17,39,8,2.3976280204278275,9
2068,85,10,7,4,2.393255933560983,6
2069,83,22,87,11,2.390357141943488,11
2070,111,12,8,6,2.390343846489095,6
2071,104,40,95,18,2.3890342183876085,22
2072,4,21,71,8,2.3871750117365993,13
2073,96,25,104,11,2.3866419839158346,14
2074,75,13,56,5,2.3840139649043497,8
2075,13,86,65,39,2.383373860419213,47
2076,71,31,106,14,2.3812089448162763,17
2077,71,41,86,20,2.3810130412337966,21
2078,55,28,84,13,2.379086300412449,15
2079,87,50,54,22,2.3775687879558385,28
2080,69,10,96,4,2.3715807543077463,6
2081,8,55,96,25,2.371439357092425,30
2082,7,19,70,7,2.364945757295021,12
2083,99,23,5,11,2.3616219022642833,12
2084,96,14,109,6,2.3566759619593642,8
2085,4,36,31,15,2.3535355966794667,21
2086,13,15,12,9,2.3425974502134457,6
2087,86,25,85,12,2.338504518006025,13
2088,49,20,51,9,2.337593611464387,11
2089,104,17,4,7,2.3357072159096575,10
2090,25,28,53,14,2.3301510854690854,14
2091,109,51,5,25,2.3285813949081655,26
2092,50,23,64,11,2.3285304422785047,12
2093,104,21,102,11,2.320627297470276,10
2094,65,24,69,11,2.3193082814773094,13
2095,34,28,107,12,2.319293954101742,16
2096,3,26,60,12,2.318286691403535,14
2097,9,23,3,11,2.3162904113567784,12
2098,58,12,50,6,2.3033767529431137,6
2099,23,13,109,6,2.301790643179129,7
2100,86,21,32,10,2.2989864902239003,11
2101,68,16,109,6,2.2985123206238915,10
2102,97,33,65,15,2.2943542233121987,18
2103,100,24,5,11,2.2932427434044684,13
2104,114,18,45,8,2.292094813707232,10
2105,94,10,114,4,2.2912532605689226,6
2106,106,13,4,7,2.287883468044352,6
2107,37,46,74,22,2.283869095408045,24
2108,46,21,17,10,2.279991454185123,11
2109,80,16,71,8,2.275392383804814,8
2110,61,10,31,5,2.2696136748473603,5
2111,28,66,96,31,2.267406944603933,35
2112,60,24,46,11,2.2638066641840875,13
2113,95,30,25,14,2.25397314365567,16
2114,41,14,54,7,2.251101436056138,7
2115,20,25,7,12,2.2510516710421498,13
2116,88,38,4,18,2.2459217004175493,20
2117,7,18,11,8,2.239320590268621,10
2118,87,35,104,18,2.2393020839894087,17
2119,81,14,3,6,2.2358028798300924,8
2120,68,25,70,12,2.2334926025833988,13
2121,90,16,25,7,2.2261576936837058,9
2122,88,11,33,6,2.22422094342155,5
2123,11,11,114,6,2.222333602098374,5
2124,98,13,99,7,2.2212581677933785,6
2125,104,11,69,4,2.217479448350339,7
2126,112,11,8,6,2.2144684353504553,5
2127,106,27,17,11,2.2117443407706983,16
2128,5,50,96,22,2.2114271922507607,28
2129,112,12,40,6,2.2105918484505556,6
2130,57,19,55,10,2.2104060039233278,9
2131,49,51,13,25,2.209069641169752,26
2132,94,19,87,9,2.2006255942838453,10
2133,107,50,106,24,2.1993074270722803,26
2134,31,10,54,5,2.186668926147148,5
2135,8,64,74,28,2.186622040651489,36
2136,68,82,13,37,2.1861093008549646,45
2137,63,26,70,12,2.1813121472430437,14
2138,84,16,93,8,2.173203038685072,8
2139,33,11,39,5,2.170155887452032,6
2140,86,63,55,29,2.1661509305052244,34
2141,88,14,74,5,2.165363961250821,9
2142,48,29,16,13,2.16366949518096,16
2143,80,17,7,7,2.151623343669696,10
2144,87,27,46,14,2.1507851989480726,13
2145,11,49,28,24,2.139899963041059,25
2146,87,18,43,8,2.1360829908334114,10
2147,28,30,91,14,2.1280361219889317,16
2148,53,11,70,5,2.117480208536356,6
2149,1,20,64,10,2.1164326209593654,10
2150,48,13,30,7,2.114145406665778,6
2151,74,12,33,6,2.113811361820999,6
2152,81,18,88,9,2.113043846902455,9
2153,1,13,17,6,2.1103206894628075,7
2154,8,23,100,10,2.1093275750438316,13
2155,77,10,3,4,2.1078393954054353,6
2156,99,24,60,11,2.100940382067205,13
2157,109,22,84,10,2.0978150302320926,12
2158,83,34,55,17,2.0962093979720215,17
2159,16,15,29,8,2.0960967700074415,7
2160,97,22,8,11,2.094799206270941,11
2161,7,73,36,34,2.0934963107077063,39
2162,17,12,91,5,2.0932516032559634,7
2163,98,13,114,6,2.082503686116617,7
2164,82,10,63,5,2.077975861296688,5
2165,50,23,114,10,2.0649465321872778,13
2166,68,16,49,8,2.0637805548779458,8
2167,3,25,31,13,2.0628076616728963,12
2168,86,45,90,20,2.0574221764428238,25
2169,84,17,9,8,2.0546690063899433,9
2170,65,31,80,15,2.0509198465423397,16
2171,18,34,51,17,2.042743355152735,17
2172,90,24,60,10,2.0397275719261816,14
2173,89,14,88,7,2.0354634990614118,7
2174,58,12,63,7,2.0345686518653676,5
2175,55,11,79,5,2.0315889229013426,6
2176,91,14,114,7,2.0312426341433967,7
2177,32,11,13,5,2.026181507027534,6
2178,75,30,87,14,2.0247725005088753,16
2179,8,36,90,16,2.0194647820717804,20
2180,83,22,97,12,2.007636873207567,10
2181,64,14,17,7,1.997717670710987,7
2182,69,24,7,12,1.9945381002011566,12
2183,104,15,112,7,1.99393597279257,8
2184,70,55,86,25,1.9917052888221574,30
2185,53,19,4,9,1.987694792892671,10
2186,48,13,13,6,1.9848220769452258,7
2187,28,38,25,16,1.9833898911599184,22
2188,88,33,37,15,1.9799898753785308,18
2189,41,18,76,10,1.9724048364464457,8
2190,50,11,35,5,1.9581460146246747,6
2191,78,12,71,6,1.95458083263832,6
2192,36,34,64,17,1.9485056781764598,17
2193,25,20,55,9,1.9429576796619945,11
2194,23,14,31,6,1.9392936999416424,8
2195,110,13,104,5,1.9388474450810558,8
2196,32,10,98,5,1.9380052263831626,5
2197,23,14,97,7,1.9330528734436567,7
2198,70,19,40,8,1.9276789997691202,11
2199,114,21,18,10,1.923577249757446,11
2200,80,25,28,12,1.9225523112040792,13
2201,70,21,41,11,1.919847111480952,10
2202,99,11,76,6,1.9173589523208343,5
2203,97,32,106,16,1.9159665785715099,16
2204,15,17,57,8,1.9121491415635457,9
2205,63,37,114,15,1.9099176429878706,22
2206,14,13,88,6,1.902096229341471,7
2207,43,10,84,4,1.9003461255076104,6
2208,108,25,51,12,1.9002486171144384,13
2209,39,37,28,18,1.8977614224864345,19
2210,20,35,106,16,1.890590591428699,19
2211,39,47,49,21,1.8896093654711354,26
2212,25,23,64,11,1.8857238852847684,12
2213,2,41,8,20,1.8848654476169697,21
2214,68,22,46,11,1.8807270075774953,11
2215,8,14,79,8,1.8787453444383122,6
2216,60,16,83,7,1.8774619090517453,9
2217,17,26,54,13,1.867393134138254,13
2218,37,95,5,46,1.8654288703425719,49
2219,64,28,54,14,1.8650724062797466,14
2220,39,49,60,24,1.859398798683601,25
2221,87,61,106,30,1.856632619724249,31
2222,98,19,51,9,1.8552094547524471,10
2223,6,11,86,5,1.8539951054916266,6
2224,46,22,76,10,1.8507100299988166,12
2225,53,22,97,10,1.849246682219108,12
2226,30,12,109,5,1.8472545205463433,7
2227,103,10,106,4,1.8460294979122147,6
2228,84,38,96,19,1.8356486827006797,19
2229,7,14,29,8,1.8294106613069705,6
2230,74,29,13,14,1.8278354237299064,15
2231,9,17,69,8,1.8276767965349943,9
2232,23,13,20,6,1.827570268386601,7
2233,44,13,114,6,1.8263733365516701,7
2234,69,18,114,10,1.822927242545525,8
2235,102,13,99,6,1.8212893413036875,7
2236,71,11,109,5,1.8196417828202216,6
2237,112,29,16,15,1.8181625400201864,14
2238,79,18,28,8,1.8130893193426152,10
2239,80,12,64,6,1.8118137894523878,6
2240,84,21,80,9,1.8116947476965417,12
2241,40,18,111,9,1.8104998545748818,9
2242,36,22,25,11,1.8071440138268557,11
2243,8,65,28,30,1.8060421386611976,35
2244,37,25,90,12,1.7816453937181782,13
2245,102,13,84,6,1.779322402529277,7
2246,104,62,16,29,1.778027708852634,33
2247,1,31,36,16,1.7697191195700568,15
2248,49,15,8,6,1.7678498041146895,9
2249,84,27,54,12,1.7533288896590717,15
2250,84,26,70,12,1.7530345342228948,14
2251,87,56,88,29,1.7513462767543788,27
2252,4,31,68,15,1.751066192618154,16
2253,97,38,107,19,1.7507246476170455,19
2254,53,39,51,19,1.7493185772901738,20
2255,76,25,11,11,1.745006286070099,14
2256,60,33,36,16,1.7416473627060747,17
2257,18,11,6,5,1.7414584600944751,6
2258,8,26,23,13,1.7400762718841152,13
2259,36,37,88,16,1.7392851936744347,21
2260,46,51,5,23,1.7323776092910628,28
2261,70,19,75,10,1.7314858975507377,9
2262,60,14,11,7,1.72978393860355,7
2263,50,13,12,8,1.7279667161947851,5
2264,83,11,50,6,1.7272952536822097,5
2265,8,49,11,22,1.725678638141755,27
2266,39,39,41,20,1.719188807068569,19
2267,51,34,84,16,1.7189303132534879,18
2268,74,10,85,5,1.7134982697618455,5
2269,41,31,40,15,1.7110878654501351,16
2270,54,40,7,19,1.7088310244062668,21
2271,51,22,43,11,1.7055396893146841,11
2272,48,10,37,5,1.7035937503192145,5
2273,20,16,102,8,1.6989391239814933,8
2274,36,15,23,9,1.6972875274185721,6
2275,60,58,16,28,1.696206200343733,30
2276,51,25,23,12,1.6961813528047331,13
2277,41,62,13,30,1.6944548774743582,32
2278,86,31,80,15,1.6766961831131937,16
2279,63,45,39,18,1.6729604614700202,27
2280,45,28,31,13,1.6710870406691087,15
2281,107,23,49,12,1.6706380215538046,11
2282,43,13,109,6,1.6656590774439002,7
2283,36,23,68,11,1.6511686348202657,12
2284,16,50,74,23,1.6504828930462028,27
2285,95,10,57,6,1.6443605111684718,4
2286,71,39,107,17,1.6439964154335995,22
2287,106,44,88,19,1.6421661548035555,25
2288,85,12,20,6,1.6390974332364696,6
2289,40,61,51,29,1.63752220282157,32
2290,39,19,96,8,1.6315253594413592,11
2291,91,35,86,17,1.6127783916757956,18
2292,114,28,20,13,1.609390659763289,15
2293,79,11,54,4,1.607153398950684,7
2294,70,13,43,6,1.6071210379776917,7
2295,99,18,30,8,1.5949338139614577,10
2296,64,10,90,5,1.5921132093044654,5
2297,7,73,40,33,1.5888049712895005,40
2298,2,15,25,8,1.5845186001024008,7
2299,55,22,90,12,1.578656952498874,10
2300,18,38,107,16,1.5770183315968969,22
2301,107,54,60,25,1.5627254967293458,29
2302,9,14,111,7,1.5621342613374551,7
2303,40,17,61,8,1.5607473214395389,9
2304,97,12,100,6,1.5601199386945834,6
2305,104,23,83,10,1.5563880557352996,13
2306,7,84,65,43,1.5543231245397546,41
2307,17,42,51,21,1.5539556128144005,21
2308,106,15,14,8,1.5523885439078582,7
2309,11,26,74,12,1.5483769164487977,14
2310,13,44,28,21,1.5480390864692148,23
2311,65,12,61,5,1.5448114274450557,7
2312,51,52,60,22,1.5379585605411303,30
2313,97,25,46,12,1.5379422598602892,13
2314,13,23,45,11,1.536281477648622,12
2315,1,34,88,17,1.5234508852206479,17
2316,35,14,37,7,1.523131742310598,7
2317,43,12,8,6,1.5194230889621367,6
2318,46,12,55,5,1.5148590180899557,7
2319,84,30,50,15,1.5145533767727444,15
2320,28,63,5,31,1.5122016375527902,32
2321,29,21,87,9,1.496087722033851,12
2322,4,59,13,27,1.4911690163054754,32
2323,73,15,63,8,1.4760785674332926,7
2324,11,17,32,9,1.4729852723414754,8
2325,86,32,2,16,1.4682447143488935,16
2326,63,89,65,43,1.4663105199346151,46
2327,31,21,47,10,1.4606130980712668,11
2328,25,23,83,10,1.4597201880554966,13
2329,8,16,38,8,1.4562520429495758,8
2330,50,16,89,7,1.4560158637801317,9
2331,58,24,9,12,1.4546505850429008,12
2332,106,55,63,27,1.4485566818099482,28
2333,20,21,97,11,1.439527960881874,10
2334,50,28,25,14,1.4391705454909012,14
2335,107,76,28,35,1.4297462541310921,41
2336,65,70,41,31,1.4285809086277084,39
2337,36,35,45,19,1.423273124508123,16
2338,80,23,87,11,1.4202226913102636,12
2339,49,17,63,8,1.4171594607729323,9
2340,9,45,40,21,1.4158523438373036,24
2341,102,15,11,6,1.4114820984859568,9
2342,86,76,20,36,1.4024782300511185,40
2343,70,17,95,9,1.4011695857654913,8
2344,75,12,44,5,1.399837377533035,7
2345,16,10,56,4,1.3984899579645478,6
2346,20,19,95,9,1.3957034121223277,10
2347,91,13,9,6,1.3946381880594532,7
2348,7,15,83,6,1.3943529604549396,9
2349,100,25,106,13,1.3941621457208537,12
2350,44,25,16,13,1.3924747988210242,12
2351,43,13,37,7,1.3915535608538905,6
2352,17,15,74,7,1.3910983775391357,8
2353,15,15,114,7,1.385848653276297,8
2354,36,11,29,6,1.3837445576600587,5
2355,9,41,86,19,1.3820081892435105,22
2356,50,41,11,19,1.3816262941644981,22
2357,95,31,7,14,1.3809406634768675,17
2358,106,30,41,15,1.3806292559177733,15
2359,87,29,109,13,1.3766608968038978,16
2360,46,37,28,16,1.3752615916090838,21
2361,75,10,48,5,1.3711471542080278,5
2362,90,11,76,6,1.3711097869836062,5
2363,27,13,23,7,1.3665703255989456,6
2364,30,23,40,11,1.3656919842952282,12
2365,25,26,30,14,1.363384718034577,12
2366,68,31,104,16,1.3616459533032328,15
2367,43,30,60,14,1.3551540889304812,16
2368,53,44,60,20,1.3503746570549047,24
2369,97,37,88,18,1.349074362930903,19
2370,84,17,90,8,1.3434141546201468,9
2371,71,27,114,13,1.3431780041778802,14
2372,71,48,7,25,1.3388864417450883,23
2373,77,53,60,25,1.338750114348228,28
2374,8,44,51,21,1.3380278840989286,23
2375,8,66,37,32,1.3357403383797626,34
2376,64,39,68,17,1.3356994520331131,22
2377,74,18,80,9,1.3199661328668575,9
2378,46,60,88,30,1.317189159463411,30
2379,10,16,8,7,1.3145513780375315,9
2380,32,12,51,6,1.314434714983352,6
2381,70,11,102,7,1.3043211125718095,4
2382,5,44,13,21,1.302350985374302,23
2383,15,11,81,5,1.2951302078525542,6
2384,112,21,65,11,1.2944639396554163,10
2385,65,43,60,18,1.292557414516089,25
2386,2,22,74,10,1.2925512141562505,12
2387,97,20,109,10,1.283406905257821,10
2388,65,15,49,7,1.2832734530229162,8
2389,50,30,51,15,1.277023353905357,15
2390,8,82,55,42,1.2721684605222603,40
2391,50,27,65,13,1.2644687002361983,14
2392,75,42,55,18,1.2635366494506202,24
2393,55,26,99,12,1.2605449554949548,14
2394,68,13,94,7,1.252803974637691,6
2395,109,30,16,15,1.2499451161124784,15
2396,65,10,89,5,1.246766687204138,5
2397,104,12,43,5,1.2430962980218274,7
2398,107,30,4,15,1.2387516471106226,15
2399,71,25,31,12,1.2380158081615504,13
2400,63,16,95,8,1.233969730193377,8
2401,13,14,61,6,1.2296565256158196,8
2402,86,62,13,31,1.228508610912882,31
2403,71,26,9,12,1.2262156519313812,14
2404,87,50,55,24,1.2223891795427406,26
2405,50,62,54,30,1.2219864026222231,32
2406,98,11,74,5,1.2137114800422117,6
2407,38,12,46,5,1.2117798317776198,7
2408,25,33,97,16,1.211209753293348,17
2409,9,36,39,19,1.202572711375458,17
2410,37,25,84,12,1.200224547121566,13
2411,25,25,109,12,1.1927554377225935,13
2412,88,34,31,17,1.1836541894089576,17
2413,84,15,114,8,1.1814293651570578,7
2414,76,29,87,13,1.173923997825125,16
2415,76,24,28,11,1.171307704252366,13
2416,47,16,27,7,1.1658557312566065,9
2417,86,47,30,24,1.1570405179503076,23
2418,7,77,41,38,1.15072550046604,39
2419,39,11,98,5,1.1404948944014273,6
2420,108,26,107,13,1.1401052195192969,13
2421,60,73,71,35,1.1360670304013205,38
2422,80,11,38,6,1.135431064035941,5
2423,88,31,91,15,1.1352768006015477,16
2424,48,15,109,7,1.133812900706227,8
2425,23,47,16,22,1.133588423461974,25
2426,36,26,106,13,1.1307287364062801,13
2427,81,19,107,10,1.1293503192154635,9
2428,33,13,114,7,1.1286658148323794,6
2429,61,18,88,10,1.1254133453483963,8
2430,9,51,13,26,1.12146754194808,25
2431,25,17,57,8,1.1122394350713356,9
2432,63,47,40,22,1.1085655861732644,25
2433,73,13,55,6,1.1082443575059586,7
2434,40,19,45,9,1.1043531225931202,10
2435,96,18,2,9,1.1039761816908797,9
2436,70,39,106,20,1.1024614638047308,19
2437,54,16,33,7,1.1000953180608282,9
2438,13,67,60,30,1.0987386561282546,37
2439,14,16,11,7,1.0923565448715802,9
2440,40,13,74,6,1.0901529369074687,7
2441,65,46,39,20,1.089267893981286,26
2442,43,13,71,7,1.0882014078273523,6
2443,64,19,97,9,1.0748997556854092,10
2444,107,29,1,14,1.072552937399315,15
2445,67,20,37,9,1.0707700527635258,11
2446,106,12,66,5,1.070759127853136,7
2447,70,55,8,27,1.0665028298167964,28
2448,8,43,20,21,1.064860256583808,22
2449,104,30,109,15,1.0638658496000608,15
2450,68,42,63,21,1.0605961778676247,21
2451,18,35,87,16,1.0595333397572304,19
2452,27,17,87,8,1.0572087388131586,9
2453,16,37,40,17,1.0479395774839413,20
2454,28,19,57,9,1.0424952222058044,10
2455,90,21,88,11,1.0373159148886417,10
2456,45,14,3,7,1.0349134798027078,7
2457,12,22,51,10,1.0312516072831304,12
2458,71,34,88,15,1.0311330418182323,19
2459,35,22,7,11,1.0299988339542105,11
2460,112,17,9,8,1.0274983646093445,9
2461,8,21,17,11,1.026318191087208,10
2462,63,20,44,9,1.0233184771026502,11
2463,70,10,33,5,1.0222975969230632,5
2464,93,20,88,9,1.0138818382921346,11
2465,13,43,75,20,1.005364432264769,23
2466,3,28,39,13,1.005279876255595,15
2467,68,14,6,6,1.005162162800652,8
2468,114,11,93,6,1.004990658958168,5
2469,114,39,7,18,1.0047894280060632,21
2470,8,40,39,20,0.9993368710228037,20
2471,107,14,79,8,0.9916516151596949,6
2472,23,17,111,10,0.9902411232186314,7
2473,60,21,28,12,0.9891037947174114,9
2474,64,14,100,6,0.9873146869937531,8
2475,51,33,31,14,0.9782499075201472,19
2476,107,65,5,32,0.9748363761521144,33
2477,79,11,88,5,0.9736004729947267,6
2478,14,16,87,7,0.9719183858987279,9
2479,37,50,51,27,0.9710667257210692,23
2480,65,49,75,23,0.9671493682311952,26
2481,104,38,106,19,0.9604760273979323,19
2482,14,14,5,6,0.9561035605846475,8
2483,7,20,8,9,0.9446580951337806,11
2484,112,13,114,7,0.9421647262329379,6
2485,47,33,39,16,0.9409236558902792,17
2486,102,11,83,5,0.9259324073609744,6
2487,33,17,86,9,0.9246066959077469,8
2488,39,33,104,16,0.9243967556000993,17
2489,102,18,65,10,0.9231577333764872,8
2490,69,17,50,7,0.9188452019230828,10
2491,13,20,33,10,0.918120505460343,10
2492,106,100,86,49,0.9173221659807225,51
2493,36,35,75,19,0.9076169876586753,16
2494,23,13,3,6,0.9036934098771335,7
2495,84,17,79,9,0.9012801816556621,8
2496,107,65,63,35,0.9004862155219548,30
2497,68,17,74,7,0.9001065237726507,10
2498,8,24,48,11,0.8990865709573224,13
2499,107,31,46,16,0.8942764168819464,15
2500,3,10,106,5,0.8904989515497614,5
2501,77,21,4,10,0.8810684428976758,11
2502,74,45,65,23,0.8800404347092065,22
2503,111,47,68,24,0.8746288393374696,23
2504,7,27,49,15,0.8744069756975954,12
2505,55,21,71,9,0.863684832703073,12
2506,10,10,114,4,0.8617397018011257,6
2507,34,17,16,8,0.8560019455164203,9
2508,71,28,63,13,0.8479499084443569,15
2509,27,39,68,18,0.8444718126987756,21
2510,54,40,74,20,0.8415267564978521,20
2511,87,20,47,10,0.8396314002741838,10
2512,28,16,3,7,0.8360030889582997,9
2513,2,16,46,8,0.8285194662826778,8
2514,7,57,18,29,0.8231688841647112,28
2515,16,79,28,38,0.8112414808815767,41
2516,96,58,107,27,0.8081270899904945,31
2517,112,15,23,7,0.8063745420595528,8
2518,56,14,40,7,0.8062835825274064,7
2519,79,17,50,8,0.8036407520519759,9
2520,2,22,88,11,0.7956469041111237,11
2521,68,19,77,9,0.792948245018335,10
2522,28,11,78,6,0.7898078034632366,5
2523,11,28,39,14,0.7894372385849194,14
2524,53,53,13,28,0.7874885927037626,25
2525,18,19,65,10,0.7868157298210118,9
2526,9,17,34,8,0.77910514985876,9
2527,104,45,114,21,0.7777920700848383,24
2528,16,24,15,11,0.7772765056505548,13
2529,97,20,93,10,0.7717644600090583,10
2530,33,15,104,8,0.7704375614853092,7
2531,107,80,8,36,0.7700051528352245,44
2532,3,37,86,19,0.7685094698143445,18
2533,75,27,64,13,0.7678085379778312,14
2534,86,52,109,26,0.765068890370714,26
2535,110,12,54,6,0.762633303380524,6
2536,50,19,109,9,0.7621588618054026,10
2537,28,27,48,13,0.7484805696104432,14
2538,3,20,71,10,0.744611540631482,10
2539,36,13,74,5,0.7437175733038444,8
2540,85,11,17,5,0.7402100763690623,6
2541,40,77,86,36,0.7352757671814381,41
2542,95,41,5,21,0.731606653431554,20
2543,15,23,25,10,0.7267013492378231,13
2544,69,12,3,5,0.7220114611067269,7
2545,82,13,28,7,0.7153587234866209,6
2546,87,45,63,23,0.7153353724609679,22
2547,51,22,30,11,0.7133256045305847,11
2548,54,85,65,41,0.7126472318729192,44
2549,76,25,8,13,0.7077738529790866,12
2550,18,23,104,13,0.701208945227421,10
2551,71,13,69,6,0.6992249594892737,7
2552,38,18,64,9,0.6972961224720624,9
2553,54,71,107,36,0.6943884704890407,35
2554,27,11,99,6,0.6941577039356042,5
2555,18,19,25,10,0.6816652439852776,9
2556,37,40,114,18,0.6680388190804037,22
2557,63,38,50,18,0.6599709375930062,20
2558,64,15,108,8,0.6582287703496978,7
2559,20,29,13,15,0.6574275541488422,14
2560,7,70,39,35,0.65708225310988,35
2561,41,27,1,12,0.6450987397179471,15
2562,98,16,50,8,0.6426219058041094,8
2563,62,16,37,6,0.6397394147846427,10
2564,25,25,41,14,0.6394054706376684,11
2565,111,17,36,8,0.6365354853619557,9
2566,114,58,88,29,0.636201245326286,29
2567,114,54,86,27,0.6322094644097674,27
2568,4,28,64,13,0.6316212138641686,15
2569,11,11,97,6,0.6269874474505769,5
2570,36,33,71,17,0.6241330409639582,16
2571,51,58,55,29,0.6228899757373463,29
2572,109,13,40,7,0.6223424064374103,6
2573,76,30,96,14,0.6223340675935091,16
2574,43,20,114,11,0.6074470201565788,9
2575,91,16,70,7,0.6063303701253773,9
2576,63,15,34,7,0.6010869874219945,8
2577,61,10,86,5,0.5990640749995453,5
2578,50,55,86,29,0.5948795299571148,26
2579,19,10,98,6,0.5939174582316639,4
2580,76,13,36,4,0.5885035889042722,9
2581,107,46,68,22,0.5820731036383072,24
2582,96,45,87,23,0.5775655020876899,22
2583,11,51,16,22,0.5759421625629789,29
2584,23,12,53,6,0.5700661218932129,6
2585,11,11,27,6,0.5615364354397145,5
2586,97,31,2,15,0.5614740846174435,16
2587,83,10,2,5,0.5594397265150824,5
2588,3,10,4,5,0.5556184418282119,5
2589,5,49,54,23,0.5526115688513309,26
2590,92,17,7,7,0.5480230211986101,10
2591,104,55,13,27,0.5474902747445213,28
2592,98,27,16,13,0.5462850233229243,14
2593,87,14,6,7,0.5451369775684941,7
2594,106,10,1,5,0.539652861011431,5
2595,63,43,7,18,0.5381341307781913,25
2596,28,19,33,8,0.5377400393884932,11
2597,46,16,57,8,0.5297057406629254,8
2598,107,38,70,20,0.5241539544793407,18
2599,73,19,28,10,0.5214155246375574,9
2600,43,17,25,10,0.5197036131496171,7
2601,106,68,28,33,0.5161436710076662,35
2602,41,11,90,6,0.513841479320257,5
2603,114,11,38,6,0.5127819422302534,5
2604,4,18,9,9,0.5118055197130339,9
2605,51,22,71,11,0.5066228412969123,11
2606,23,10,9,5,0.5053397207394539,5
2607,18,29,41,15,0.5040827449695365,14
2608,90,13,91,6,0.5003235284827323,7
2609,70,19,39,10,0.49953189293951183,9
2610,5,59,87,29,0.4991669720547012,30
2611,5,39,63,22,0.49187190353271276,17
2612,63,21,53,10,0.48560167214791355,11
2613,57,14,104,5,0.4845128262229356,9
2614,95,28,74,13,0.47842550860281996,15
2615,75,31,41,14,0.47837138213253816,17
2616,25,51,39,26,0.4759465051184244,25
2617,37,13,69,6,0.4741041536564538,7
2618,31,53,65,27,0.47237439181628066,26
2619,113,11,86,6,0.46954311123939263,5
2620,100,12,44,6,0.4671750406191804,6
2621,87,16,111,8,0.45897322341286445,8
2622,88,41,49,20,0.4529990219368629,21
2623,62,13,55,7,0.4490302976953222,6
2624,80,11,9,7,0.4439834453330457,4
2625,86,83,65,43,0.4411076558908754,40
2626,90,15,11,7,0.4409004522210816,8
2627,35,23,86,10,0.4354843809424514,13
2628,39,55,107,28,0.435337568685396,27
2629,87,34,84,17,0.43521410345734374,17
2630,40,43,31,22,0.429627197462679,21
2631,33,11,99,6,0.42486651226142574,5
2632,37,36,17,16,0.42335569980871807,20
2633,5,14,38,7,0.4168378546295618,7
2634,27,17,106,10,0.4013630945998079,7
2635,46,40,11,19,0.4001450319361854,21
2636,88,13,78,6,0.3934639813104847,7
2637,54,62,16,32,0.3930951100531193,30
2638,55,16,41,8,0.3929137359889599,8
2639,87,52,39,25,0.39238040439892136,27
2640,23,18,54,9,0.39214168570707464,9
2641,8,13,44,6,0.3904420875790005,7
2642,69,30,36,15,0.38598798110099336,15
2643,51,51,87,25,0.38566064440595554,26
2644,8,35,50,16,0.38293825667797665,19
2645,70,22,97,12,0.3783758219642565,10
2646,14,18,84,8,0.37783903496494214,10
2647,16,39,114,18,0.3744778890921723,21
2648,40,16,108,7,0.373845897515691,9
2649,114,26,75,13,0.3719126663008889,13
2650,57,23,86,12,0.3705226610368842,11
2651,40,21,75,10,0.36863713867004627,11
2652,95,26,28,12,0.36814720179538635,14
2653,63,17,47,7,0.3681401863793021,10
2654,25,30,63,16,0.3669879376751877,14
2655,92,18,13,7,0.36521745881563183,11
2656,46,18,41,8,0.36430211798636986,10
2657,39,41,54,21,0.33442242846591713,20
2658,83,20,106,11,0.33164456490941063,9
2659,15,20,60,9,0.3311042630925631,11
2660,76,28,70,13,0.3288931307094032,15
2661,49,14,114,6,0.32751436291229447,8
2662,41,34,63,17,0.326061354616667,17
2663,114,68,107,33,0.32070298196932506,35
2664,83,25,28,14,0.3193130867023741,11
2665,50,18,112,8,0.31747188429243445,10
2666,51,13,92,7,0.31029394338620886,6
2667,88,36,20,19,0.3041395250896581,17
2668,53,28,86,16,0.3007788516561258,12
2669,88,15,48,6,0.2955612335778544,9
2670,86,45,68,21,0.2946092815846377,24
2671,17,28,107,14,0.2941106702859755,14
2672,13,42,27,22,0.2905119523861549,20
2673,17,25,114,14,0.28496362892659627,11
2674,48,17,39,9,0.281951836002177,8
2675,67,12,25,6,0.2816428039469064,6
2676,96,12,67,7,0.27996501259109813,5
2677,53,18,5,8,0.2778213329671456,10
2678,36,11,38,4,0.26679215079866997,7
2679,31,10,35,5,0.2664857773065452,5
2680,50,28,17,13,0.26256574141142497,15
2681,37,22,76,12,0.2606095394442829,10
2682,40,25,47,14,0.24655985846699452,11
2683,38,15,60,7,0.24623826312842922,8
2684,8,74,88,37,0.2446779780170302,37
2685,86,32,31,15,0.24444323577164595,17
2686,83,20,88,11,0.24121558114701722,9
2687,30,10,108,5,0.24117256366227835,5
2688,64,19,45,9,0.2352744559029064,10
2689,68,15,57,8,0.23334024254481278,7
2690,16,26,111,12,0.2324255478959678,14
2691,57,14,20,7,0.22969067246688318,7
2692,65,10,101,5,0.22906131925901718,5
2693,72,16,7,8,0.22521266099875584,8
2694,11,40,87,22,0.22473431916089695,18
2695,11,24,65,11,0.2231872290555846,13
2696,107,59,74,28,0.21255364694604195,31
2697,53,21,44,9,0.2122113313421154,12
2698,41,46,107,21,0.2103526931245373,25
2699,28,11,66,5,0.2056598644516812,6
2700,44,14,107,7,0.20330478165271706,7
2701,46,16,71,7,0.19894184736909315,9
2702,8,66,54,35,0.1986057005994308,31
2703,60,50,68,24,0.19293391232953336,26
2704,69,19,87,10,0.18751867700367827,9
2705,35,12,70,7,0.18631436457958764,5
2706,44,15,65,6,0.18351226600640885,9
2707,96,16,13,8,0.18104275447657758,8
2708,71,33,8,17,0.17759312635004623,16
2709,96,37,55,19,0.17732770674363885,18
2710,88,53,41,27,0.17567237068802208,26
2711,15,30,13,14,0.17324984467329888,16
2712,11,47,106,26,0.17225906773687616,21
2713,17,28,13,14,0.1676823988018485,14
2714,57,20,37,10,0.16220303080862575,10
2715,7,51,4,26,0.16136746029798088,25
2716,62,12,106,6,0.1584669634691407,6
2717,12,15,40,8,0.14369807725415834,7
2718,37,47,28,23,0.1387371009601698,24
2719,73,10,25,5,0.1328731236438802,5
2720,51,13,44,8,0.13191763257362837,5
2721,60,76,7,38,0.13134493579901685,38
2722,69,14,43,7,0.12700967323830037,7
2723,27,40,107,20,0.1259702465930359,20
2724,28,22,98,9,0.12169006680659694,13
2725,68,47,9,23,0.12106464829716804,24
2726,108,16,50,7,0.11486075029930842,9
2727,40,28,18,16,0.11377047107058737,12
2728,98,13,97,7,0.11020600858990875,6
2729,35,19,88,9,0.10819589694575467,10
2730,86,99,107,50,0.10761073000794108,49
2731,2,18,84,9,0.10504403066305398,9
2732,68,13,44,7,0.10451112471006771,6
2733,84,33,88,15,0.10026530043554462,18
2734,47,18,65,9,0.09599132258442843,9
2735,74,39,25,20,0.09563368284676016,19
2736,25,65,16,32,0.09364645449744402,33
2737,30,15,96,8,0.09214636377364425,7
2738,114,29,36,13,0.09213128587786307,16
2739,95,52,86,24,0.08956033992826938,28
2740,107,94,7,42,0.07975391090501975,52
2741,97,36,74,17,0.07931920932357782,19
2742,51,30,3,12,0.07786889390674254,18
2743,76,20,109,9,0.07505370430495735,11
2744,55,15,108,8,0.07480659095217349,7
2745,84,20,65,9,0.07280165631996083,11
2746,106,21,40,10,0.06808253080226546,11
2747,108,15,74,7,0.06305457719799344,8
2748,20,18,30,9,0.05385247642414745,9
2749,8,70,106,37,0.05212763279076112,33
2750,8,16,27,7,0.051328614148521634,9
2751,34,19,50,10,0.05002588679712766,9
2752,73,16,106,8,0.04700386219362951,8
2753,112,19,63,9,0.04656981650604271,10
2754,65,44,8,22,0.044780594216323605,22
2755,54,19,49,10,0.044180244209844795,9
2756,13,17,78,8,0.04330270532554792,9
2757,31,11,97,5,0.04256244744109723,6
2758,12,36,65,17,0.04009292919049301,19
2759,41,23,27,11,0.03715076021582355,12
2760,68,62,51,29,0.034563812352960646,33
2761,45,17,71,7,0.03389797077786283,10
2762,106,42,50,20,0.025298087208634697,22
2763,89,15,28,8,0.018607611913672883,7
2764,109,17,83,7,0.00972932964701334,10
2765,90,33,16,15,0.006116246156991541,18
2766,109,20,102,10,0.0026602667859183526,10
2767,102,20,109,10,-0.0026602667859165763,10
2768,16,33,90,18,-0.0061162461569911645,15
2769,83,17,109,10,-0.009729329647013785,7
2770,28,15,89,7,-0.018607611913672648,8
2771,50,42,106,22,-0.02529808720863334,20
2772,71,17,45,10,-0.03389797077786216,7
2773,51,62,68,33,-0.03456381235296123,29
2774,27,23,41,12,-0.037150760215824086,11
2775,65,36,12,19,-0.04009292919049182,17
2776,97,11,31,6,-0.042562447441096586,5
2777,78,17,13,9,-0.04330270532554771,8
2778,49,19,54,9,-0.04418024420984498,10
2779,8,44,65,22,-0.04478059421632261,22
2780,63,19,112,10,-0.04656981650604271,9
2781,106,16,73,8,-0.0470038621936304,8
2782,50,19,34,9,-0.05002588679712785,10
2783,27,16,8,9,-0.051328614148522966,7
2784,106,70,8,33,-0.05212763279076128,37
2785,74,15,108,8,-0.06305457719799369,7
2786,40,21,106,11,-0.0680825308022658,10
2787,65,20,84,11,-0.07280165631996083,9
2788,108,15,55,7,-0.07480659095217229,8
2789,109,20,76,11,-0.07505370430495617,9
2790,3,30,51,18,-0.07786889390674313,12
2791,74,36,97,19,-0.07931920932357782,17
2792,7,94,107,52,-0.0797539109050192,42
2793,86,52,95,28,-0.08956033992827091,24
2794,36,29,114,16,-0.09213128587786189,13
2795,96,15,30,7,-0.09214636377364507,8
2796,16,65,25,33,-0.09364645449744435,32
2797,25,39,74,19,-0.0956336828467596,20
2798,65,18,47,9,-0.09599132258443177,9
2799,88,33,84,18,-0.10026530043554559,15
2800,44,13,68,6,-0.10451112471006657,7
2801,84,18,2,9,-0.10504403066305477,9
2802,107,99,86,49,-0.10761073000794094,50
2803,88,19,35,10,-0.10819589694575625,9
2804,97,13,98,6,-0.11020600858990862,7
2805,18,28,40,12,-0.11377047107058744,16
2806,50,16,108,9,-0.11486075029930998,7
2807,9,47,68,24,-0.12106464829716938,23
2808,98,22,28,13,-0.1216900668065983,9
2809,107,40,27,20,-0.1259702465930358,20
2810,43,14,69,7,-0.12700967323830023,7
2811,7,76,60,38,-0.13134493579901632,38
2812,44,13,51,5,-0.1319176325736292,8
2813,25,10,73,5,-0.1328731236438802,5
2814,28,47,37,24,-0.13873710096017047,23
2815,40,15,12,7,-0.14369807725415834,8
2816,106,12,62,6,-0.15846696346914188,6
2817,4,51,7,25,-0.16136746029798163,26
2818,37,20,57,10,-0.162203030808627,10
2819,13,28,17,14,-0.16768239880184893,14
2820,106,47,11,21,-0.17225906773687602,26
2821,13,30,15,16,-0.1732498446732979,14
2822,41,53,88,26,-0.17567237068802258,27
2823,55,37,96,18,-0.17732770674364082,19
2824,8,33,71,16,-0.17759312635004632,17
2825,13,16,96,8,-0.1810427544765778,8
2826,65,15,44,9,-0.1835122660064091,6
2827,70,12,35,5,-0.18631436457958692,7
2828,87,19,69,9,-0.18751867700367922,10
2829,68,50,60,26,-0.19293391232953336,24
2830,54,66,8,31,-0.19860570059943058,35
2831,71,16,46,9,-0.19894184736909182,7
2832,107,14,44,7,-0.20330478165271787,7
2833,66,11,28,6,-0.20565986445168055,5
2834,107,46,41,25,-0.21035269312453797,21
2835,44,21,53,12,-0.2122113313421161,9
2836,65,24,11,13,-0.22318722905558436,11
2837,87,40,11,18,-0.22473431916089676,22
2838,7,16,72,8,-0.22521266099875537,8
2839,101,10,65,5,-0.2290613192590168,5
2840,20,14,57,7,-0.2296906724668833,7
2841,111,26,16,14,-0.23242554789596853,12
2842,57,15,68,7,-0.23334024254481325,8
2843,45,19,64,10,-0.23527445590290527,9
2844,108,10,30,5,-0.24117256366227763,5
2845,88,20,83,9,-0.24121558114701463,11
2846,31,32,86,17,-0.24444323577164873,15
2847,88,74,8,37,-0.24467797801702856,37
2848,60,15,38,8,-0.24623826312843025,7
2849,47,25,40,11,-0.24655985846699366,14
2850,76,22,37,10,-0.26060953944428406,12
2851,17,28,50,15,-0.2625657414114243,13
2852,35,10,31,5,-0.2664857773065439,5
2853,38,11,36,7,-0.26679215079866964,4
2854,5,18,53,10,-0.277821332967146,8
2855,67,12,96,5,-0.279965012591097,7
2856,25,12,67,6,-0.2816428039469064,6
2857,39,17,48,8,-0.28195183600217677,9
2858,114,25,17,11,-0.2849636289265948,14
2859,27,42,13,20,-0.29051195238615496,22
2860,107,28,17,14,-0.2941106702859755,14
2861,68,45,86,24,-0.2946092815846377,21
2862,48,15,88,9,-0.29556123357785347,6
2863,86,28,53,12,-0.300778851656125,16
2864,92,13,51,6,-0.31029394338620975,7
2865,112,18,50,10,-0.31747188429243345,8
2866,28,25,83,11,-0.3193130867023753,14
2867,107,68,114,35,-0.3207029819693246,33
2868,63,34,41,17,-0.3260613546166661,17
2869,114,14,49,8,-0.32751436291229385,6
2870,70,28,76,15,-0.32889313070940346,13
2871,60,20,15,11,-0.33110426309256197,9
2872,106,20,83,9,-0.3316445649094112,11
2873,54,41,39,20,-0.3344224284659163,21
2874,41,18,46,10,-0.36430211798637085,8
2875,13,18,92,11,-0.3652174588156323,7
2876,63,30,25,14,-0.3669879376751877,16
2877,47,17,63,10,-0.368140186379302,7
2878,28,26,95,14,-0.36814720179538646,12
2879,75,21,40,11,-0.3686371386700461,10
2880,86,23,57,11,-0.37052266103688436,12
2881,75,26,114,13,-0.37191266630088854,13
2882,108,16,40,9,-0.3738458975156912,7
2883,114,39,16,21,-0.3744778890921726,18
2884,84,18,14,10,-0.37783903496494253,8
2885,97,22,70,10,-0.3783758219642562,12
2886,50,35,8,19,-0.3829382566779763,16
2887,87,51,51,26,-0.38566064440595466,25
2888,36,30,69,15,-0.3859879811009911,15
2889,44,13,8,7,-0.3904420875789997,6
2890,54,18,23,9,-0.39214168570707364,9
2891,39,52,87,27,-0.3923804043989204,25
2892,41,16,55,8,-0.39291373598895946,8
2893,16,62,54,30,-0.3930951100531199,32
2894,78,13,88,7,-0.3934639813104835,6
2895,11,40,46,21,-0.40014503193618634,19
2896,106,17,27,7,-0.40136309459980746,10
2897,102,23,16,12,-0.4055631726315678,11
2898,38,14,5,7,-0.4168378546295618,7
2899,17,36,37,20,-0.42335569980871945,16
2900,99,11,33,5,-0.4248665122614248,6
2901,31,43,40,21,-0.4296271974626791,22
2902,84,34,87,17,-0.4352141034573432,17
2903,107,55,39,27,-0.43533756868539614,28
2904,86,23,35,13,-0.43548438094245046,10
2905,11,15,90,8,-0.4409004522210813,7
2906,65,83,86,40,-0.44110765589087725,43
2907,9,11,80,4,-0.4439834453330448,7
2908,55,13,62,6,-0.4490302976953225,7
2909,49,41,88,21,-0.45299902193686364,20
2910,111,16,87,8,-0.45897322341286373,8
2911,44,12,100,6,-0.46717504061918014,6
2912,86,11,113,5,-0.46954311123939296,6
2913,65,53,31,26,-0.47237439181628094,27
2914,69,13,37,7,-0.47410415365645314,6
2915,39,51,25,25,-0.4759465051184236,26
2916,41,31,75,17,-0.47837138213253816,14
2917,74,28,95,15,-0.4784255086028221,13
2918,104,14,57,9,-0.4845128262229359,5
2919,53,21,63,11,-0.485601672147913,10
2920,20,13,93,7,-0.4910409331485479,6
2921,63,39,5,17,-0.4918719035327135,22
2922,87,59,5,30,-0.49916697205470045,29
2923,39,19,70,9,-0.49953189293951067,10
2924,91,13,90,7,-0.5003235284827329,6
2925,41,29,18,14,-0.5040827449695369,15
2926,9,10,23,5,-0.5053397207394532,5
2927,71,22,51,11,-0.5066228412969127,11
2928,9,18,4,9,-0.5118055197130339,9
2929,38,11,114,5,-0.5127819422302561,6
2930,90,11,41,5,-0.513841479320257,6
2931,28,68,106,35,-0.5161436710076651,33
2932,25,17,43,7,-0.5197036131496168,10
2933,28,19,73,9,-0.5214155246375576,10
2934,70,38,107,18,-0.5241539544793419,20
2935,57,16,46,8,-0.5297057406629241,8
2936,33,19,28,11,-0.5377400393884936,8
2937,7,43,63,25,-0.5381341307781913,18
2938,1,10,106,5,-0.5396528610114302,5
2939,6,14,87,7,-0.5451369775684937,7
2940,16,27,98,14,-0.5462850233229247,13
2941,13,55,104,28,-0.5474902747445204,27
2942,7,17,92,10,-0.5480230211986107,7
2943,54,49,5,26,-0.5526115688513301,23
2944,4,10,3,5,-0.5556184418282125,5
2945,2,10,83,5,-0.559439726515081,5
2946,2,31,97,16,-0.5614740846174444,15
2947,27,11,11,5,-0.5615364354397134,6
2948,107,36,90,19,-0.5646498466658356,17
2949,53,12,23,6,-0.5700661218932138,6
2950,87,45,96,22,-0.57756550208769,23
2951,68,46,107,24,-0.5820731036383069,22
2952,36,13,76,9,-0.5885035889042698,4
2953,98,10,19,4,-0.5939174582316646,6
2954,86,55,50,26,-0.5948795299571146,29
2955,86,10,61,5,-0.5990640749995453,5
2956,34,15,63,8,-0.6010869874219955,7
2957,70,16,91,9,-0.6063303701253777,7
2958,114,20,43,9,-0.6074470201565787,11
2959,96,30,76,16,-0.6223340675935105,14
2960,40,13,109,6,-0.6223424064374109,7
2961,55,58,51,29,-0.622889975737348,29
2962,106,45,76,25,-0.6229200096733949,20
2963,71,33,36,16,-0.6241330409639598,17
2964,97,11,11,5,-0.626987447450576,6
2965,64,28,4,15,-0.6316212138641698,13
2966,86,54,114,27,-0.6322094644097658,27
2967,88,58,114,29,-0.6362012453262859,29
2968,36,17,111,9,-0.6365354853619557,8
2969,41,25,25,11,-0.6394054706376676,14
2970,37,16,62,10,-0.6397394147846429,6
2971,50,16,98,8,-0.6426219058041119,8
2972,1,27,41,15,-0.6450987397179483,12
2973,39,70,7,35,-0.6570822531098801,35
2974,13,29,20,14,-0.6574275541488409,15
2975,108,15,64,7,-0.6582287703496964,8
2976,50,38,63,20,-0.6599709375930077,18
2977,114,40,37,22,-0.6680388190804033,18
2978,25,19,18,9,-0.6816652439852758,10
2979,99,11,27,5,-0.6941577039356038,6
2980,107,71,54,35,-0.6943884704890403,36
2981,64,18,38,9,-0.6972961224720612,9
2982,69,13,71,7,-0.6992249594892732,6
2983,104,23,18,10,-0.7012089452274208,13
2984,8,25,76,12,-0.7077738529790857,13
2985,65,85,54,44,-0.7126472318729195,41
2986,30,22,51,11,-0.7133256045305842,11
2987,63,45,87,22,-0.715335372460967,23
2988,28,13,82,6,-0.7153587234866207,7
2989,3,12,69,7,-0.7220114611067269,5
2990,25,23,15,13,-0.7267013492378236,10
2991,5,41,95,20,-0.7316066534315533,21
2992,86,77,40,41,-0.7352757671814375,36
2993,17,11,85,6,-0.7402100763690623,5
2994,74,13,36,8,-0.743717573303844,5
2995,71,20,3,10,-0.7446115406314829,10
2996,48,27,28,14,-0.7484805696104441,13
2997,109,19,50,10,-0.762158861805403,9
2998,54,12,110,6,-0.7626333033805247,6
2999,109,52,86,26,-0.7650688903707134,26
3000,64,27,75,14,-0.7678085379778318,13
3001,86,37,3,18,-0.768509469814344,19
3002,8,80,107,44,-0.7700051528352247,36
3003,104,15,33,7,-0.7704375614853106,8
3004,93,20,97,10,-0.7717644600090567,10
3005,15,24,16,13,-0.777276505650555,11
3006,114,45,104,24,-0.7777920700848373,21
3007,34,17,9,9,-0.77910514985876,8
3008,65,19,18,9,-0.7868157298210114,10
3009,13,53,53,25,-0.787488592703762,28
3010,39,28,11,14,-0.7894372385849192,14
3011,78,11,28,5,-0.7898078034632366,6
3012,77,19,68,10,-0.7929482450183345,9
3013,88,22,2,11,-0.7956469041111237,11
3014,50,17,79,9,-0.8036407520519754,8
3015,40,14,56,7,-0.8062835825274064,7
3016,23,15,112,8,-0.8063745420595543,7
3017,107,58,96,31,-0.8081270899904945,27
3018,28,79,16,41,-0.8112414808815771,38
3019,76,45,106,21,-0.8113571883686943,24
3020,20,27,74,13,-0.8203305748765273,14
3021,18,57,7,28,-0.8231688841647117,29
3022,46,16,2,8,-0.8285194662826783,8
3023,93,19,107,9,-0.8317061972633653,10
3024,3,16,28,9,-0.8360030889582999,7
3025,47,20,87,10,-0.8396314002741841,10
3026,74,40,54,20,-0.8415267564978521,20
3027,68,39,27,21,-0.8444718126987766,18
3028,63,28,71,15,-0.8479499084443569,13
3029,16,17,34,9,-0.8560019455164201,8
3030,114,10,10,6,-0.8617397018011254,4
3031,71,21,55,12,-0.8636848327030733,9
3032,49,27,7,12,-0.8744069756975955,15
3033,68,47,111,23,-0.87462883933747,24
3034,65,45,74,22,-0.8800404347092061,23
3035,4,21,77,11,-0.8810684428976734,10
3036,106,10,3,5,-0.8904989515497619,5
3037,46,31,107,15,-0.8942764168819444,16
3038,48,24,8,13,-0.8990865709573216,11
3039,74,17,68,10,-0.9001065237726515,7
3040,63,65,107,30,-0.9004862155219557,35
3041,79,17,84,8,-0.9012801816556617,9
3042,3,13,23,7,-0.9036934098771321,6
3043,75,35,36,16,-0.9076169876586756,19
3044,33,20,13,10,-0.9181205054603415,10
3045,50,17,69,10,-0.918845201923083,7
3046,65,18,102,8,-0.9231577333764884,10
3047,104,33,39,17,-0.924396755600099,16
3048,86,17,33,8,-0.9246066959077452,9
3049,83,11,102,6,-0.9259324073609722,5
3050,39,33,47,17,-0.9409236558902793,16
3051,114,13,112,6,-0.9421647262329372,7
3052,8,20,7,11,-0.9446580951337818,9
3053,5,14,14,8,-0.9561035605846475,6
3054,106,38,104,19,-0.9604760273979325,19
3055,75,49,65,26,-0.967149368231196,23
3056,51,50,37,23,-0.9710667257210696,27
3057,87,16,14,9,-0.9719183858987275,7
3058,88,11,79,6,-0.973600472994728,5
3059,5,65,107,33,-0.9748363761521153,32
3060,31,33,51,19,-0.9782499075201476,14
3061,100,14,64,8,-0.9873146869937529,6
3062,28,21,60,9,-0.9891037947174117,12
3063,111,17,23,7,-0.9902411232186308,10
3064,79,14,107,6,-0.9916516151596952,8
3065,39,40,8,20,-0.9993368710228037,20
3066,7,39,114,21,-1.0047894280060643,18
3067,93,11,114,5,-1.0049906589581687,6
3068,6,14,68,8,-1.005162162800652,6
3069,39,28,3,15,-1.0052798762555943,13
3070,75,43,13,23,-1.0053644322647692,20
3071,88,20,93,11,-1.013881838292134,9
3072,33,10,70,5,-1.0222975969230645,5
3073,44,20,63,11,-1.0233184771026504,9
3074,17,21,8,10,-1.026318191087207,11
3075,9,17,112,9,-1.0274983646093443,8
3076,7,22,35,11,-1.02999883395421,11
3077,88,34,71,19,-1.0311330418182334,15
3078,51,22,12,12,-1.03125160728313,10
3079,3,14,45,7,-1.0349134798027073,7
3080,88,21,90,10,-1.0373159148886413,11
3081,57,19,28,10,-1.042495222205806,9
3082,40,37,16,20,-1.0479395774839417,17
3083,87,17,27,9,-1.0572087388131575,8
3084,87,35,18,19,-1.059533339757231,16
3085,63,42,68,21,-1.0605961778676243,21
3086,109,30,104,15,-1.063865849600061,15
3087,20,43,8,22,-1.0648602565838075,21
3088,8,55,70,28,-1.0665028298167962,27
3089,66,12,106,7,-1.0707591278531368,5
3090,37,20,67,11,-1.0707700527635244,9
3091,1,29,107,15,-1.0725529373993175,14
3092,97,19,64,10,-1.0748997556854094,9
3093,71,13,43,6,-1.0882014078273534,7
3094,39,46,65,26,-1.0892678939812854,20
3095,74,13,40,7,-1.0901529369074696,6
3096,11,16,14,9,-1.0923565448715815,7
3097,60,67,13,37,-1.0987386561282542,30
3098,33,16,54,9,-1.1000953180608284,7
3099,106,39,70,19,-1.1024614638047292,20
3100,2,18,96,9,-1.1039761816908782,9
3101,45,19,40,10,-1.1043531225931214,9
3102,55,13,73,7,-1.1082443575059588,6
3103,40,47,63,25,-1.1085655861732648,22
3104,57,17,25,9,-1.1122394350713356,8
3105,13,51,9,25,-1.1214675419480795,26
3106,88,18,61,8,-1.1254133453483963,10
3107,114,13,33,6,-1.1286658148323805,7
3108,107,19,81,9,-1.1293503192154632,10
3109,106,26,36,13,-1.1307287364062808,13
3110,16,47,23,25,-1.1335884234619735,22
3111,109,15,48,8,-1.1338129007062274,7
3112,91,31,88,16,-1.1352768006015461,15
3113,38,11,80,5,-1.1354310640359402,6
3114,71,73,60,38,-1.1360670304013198,35
3115,107,26,108,13,-1.1401052195192967,13
3116,98,11,39,6,-1.1404948944014273,5
3117,41,77,7,39,-1.1507255004660388,38
3118,30,47,86,23,-1.1570405179503085,24
3119,27,16,47,9,-1.1658557312566071,7
3120,28,24,76,13,-1.1713077042523665,11
3121,114,15,84,7,-1.181429365157058,8
3122,31,34,88,17,-1.1836541894089585,17
3123,109,25,25,13,-1.1927554377225942,12
3124,84,25,37,13,-1.2002245471215662,12
3125,39,36,9,17,-1.2025727113754594,19
3126,97,33,25,17,-1.2112097532933461,16
3127,46,12,38,7,-1.2117798317776216,5
3128,74,11,98,6,-1.2137114800422124,5
3129,54,62,50,32,-1.2219864026222214,30
3130,55,50,87,26,-1.2223891795427406,24
3131,9,26,71,14,-1.2262156519313807,12
3132,13,62,86,31,-1.228508610912882,31
3133,61,14,13,8,-1.2296565256158196,6
3134,95,16,63,8,-1.233969730193377,8
3135,31,25,71,13,-1.2380158081615502,12
3136,4,30,107,15,-1.2387516471106224,15
3137,43,12,104,7,-1.2430962980218272,5
3138,89,10,65,5,-1.2467666872041385,5
3139,16,30,109,15,-1.2499451161124762,15
3140,94,13,68,6,-1.252803974637691,7
3141,99,26,55,14,-1.260544955494955,12
3142,14,15,107,7,-1.262180496300674,8
3143,55,42,75,24,-1.263536649450621,18
3144,65,27,50,14,-1.2644687002361992,13
3145,55,82,8,40,-1.2721684605222614,42
3146,51,30,50,15,-1.277023353905357,15
3147,49,15,65,8,-1.283273453022916,7
3148,109,20,97,10,-1.2834069052578214,10
3149,74,22,2,12,-1.2925512141562505,10
3150,60,43,65,25,-1.2925574145160876,18
3151,65,21,112,10,-1.294463939655417,11
3152,81,11,15,6,-1.2951302078525535,5
3153,13,44,5,23,-1.3023509853743016,21
3154,102,11,70,4,-1.3043211125718082,7
3155,51,12,32,6,-1.314434714983353,6
3156,8,16,10,9,-1.3145513780375313,7
3157,88,60,46,30,-1.3171891594634109,30
3158,80,18,74,9,-1.3199661328668575,9
3159,68,39,64,22,-1.3356994520331136,17
3160,37,66,8,34,-1.3357403383797612,32
3161,51,44,8,23,-1.3380278840989295,21
3162,60,53,77,28,-1.3387501143482283,25
3163,7,48,71,23,-1.3388864417450879,25
3164,114,27,71,14,-1.3431780041778798,13
3165,90,17,84,9,-1.3434141546201466,8
3166,88,37,97,19,-1.3490743629309028,18
3167,60,44,53,24,-1.3503746570549038,20
3168,60,30,43,16,-1.3551540889304803,14
3169,104,31,68,15,-1.3616459533032323,16
3170,30,26,25,12,-1.3633847180345777,14
3171,40,23,30,12,-1.3656919842952278,11
3172,23,13,27,6,-1.3665703255989474,7
3173,76,11,90,5,-1.371109786983603,6
3174,48,10,75,5,-1.3711471542080287,5
3175,28,37,46,21,-1.375261591609085,16
3176,109,29,87,16,-1.3766608968038976,13
3177,41,30,106,15,-1.3806292559177735,15
3178,7,31,95,17,-1.3809406634768695,14
3179,11,41,50,22,-1.3816262941644981,19
3180,86,41,9,22,-1.382008189243511,19
3181,29,11,36,5,-1.3837445576600587,6
3182,114,15,15,8,-1.3858486532762986,7
3183,74,15,17,8,-1.3910983775391348,7
3184,37,13,43,6,-1.39155356085389,7
3185,16,25,44,12,-1.3924747988210244,13
3186,106,25,100,12,-1.3941621457208517,13
3187,83,15,7,9,-1.3943529604549403,6
3188,9,13,91,7,-1.3946381880594534,6
3189,95,19,20,10,-1.3957034121223266,9
3190,56,10,16,6,-1.398489957964547,4
3191,44,12,75,7,-1.3998373775330364,5
3192,95,17,70,8,-1.4011695857654913,9
3193,20,76,86,40,-1.4024782300511205,36
3194,11,15,102,9,-1.4114820984859553,6
3195,40,45,9,24,-1.4158523438373032,21
3196,63,17,49,9,-1.4171594607729328,8
3197,87,23,80,12,-1.4202226913102634,11
3198,45,35,36,16,-1.4232731245081227,19
3199,41,70,65,39,-1.4285809086277088,31
3200,28,76,107,41,-1.4297462541310915,35
3201,25,28,50,14,-1.4391705454909016,14
3202,97,21,20,10,-1.4395279608818727,11
3203,63,55,106,28,-1.4485566818099482,27
3204,9,24,58,12,-1.4546505850429015,12
3205,89,16,50,9,-1.4560158637801313,7
3206,38,16,8,8,-1.4562520429495762,8
3207,83,23,25,13,-1.459720188055496,10
3208,47,21,31,11,-1.4606130980712662,10
3209,65,89,63,46,-1.4663105199346156,43
3210,2,32,86,16,-1.4682447143488924,16
3211,32,17,11,8,-1.4729852723414758,9
3212,63,15,73,7,-1.4760785674332912,8
3213,13,59,4,32,-1.4911690163054772,27
3214,12,16,88,8,-1.492888142675182,8
3215,87,21,29,12,-1.496087722033852,9
3216,5,63,28,32,-1.5122016375527894,31
3217,50,30,84,15,-1.5145533767727424,15
3218,55,12,46,7,-1.514859018089955,5
3219,8,12,43,6,-1.5194230889621378,6
3220,37,14,35,7,-1.523131742310598,7
3221,88,34,1,17,-1.5234508852206479,17
3222,45,23,13,12,-1.5362814776486233,11
3223,46,25,97,13,-1.53794225986029,12
3224,60,52,51,30,-1.5379585605411297,22
3225,61,12,65,7,-1.5448114274450557,5
3226,28,44,13,23,-1.5480390864692188,21
3227,74,26,11,14,-1.5483769164487973,12
3228,14,15,106,7,-1.552388543907857,8
3229,51,42,17,21,-1.5539556128144012,21
3230,65,84,7,41,-1.5543231245397562,43
3231,83,23,104,13,-1.5563880557352991,10
3232,100,12,97,6,-1.5601199386945845,6
3233,61,17,40,9,-1.5607473214395375,8
3234,111,14,9,7,-1.5621342613374538,7
3235,60,54,107,29,-1.5627254967293462,25
3236,86,100,106,52,-1.5692663469089445,48
3237,107,38,18,22,-1.5770183315969,16
3238,90,22,55,10,-1.578656952498874,12
3239,25,15,2,7,-1.5845186001024019,8
3240,40,73,7,40,-1.588804971289502,33
3241,90,10,64,5,-1.5921132093044663,5
3242,30,18,99,10,-1.5949338139614573,8
3243,43,13,70,7,-1.6071210379776915,6
3244,54,11,79,7,-1.6071533989506848,4
3245,74,59,107,32,-1.6086403256327972,27
3246,20,28,114,15,-1.6093906597632899,13
3247,86,35,91,18,-1.6127783916757956,17
3248,96,19,39,11,-1.6315253594413601,8
3249,51,61,40,32,-1.6375222028215697,29
3250,20,12,85,6,-1.6390974332364685,6
3251,88,44,106,25,-1.6421661548035542,19
3252,107,39,71,22,-1.6439964154336006,17
3253,57,10,95,4,-1.6443605111684718,6
3254,74,50,16,27,-1.6504828930462023,23
3255,68,23,36,12,-1.6511686348202665,11
3256,48,19,106,10,-1.6634533717988316,9
3257,109,13,43,7,-1.6656590774438986,6
3258,49,23,107,11,-1.6706380215538053,12
3259,31,28,45,15,-1.6710870406691087,13
3260,39,45,63,27,-1.672960461470019,18
3261,80,31,86,16,-1.6766961831131946,15
3262,13,62,41,32,-1.6944548774743566,30
3263,23,25,51,13,-1.6961813528047356,12
3264,16,58,60,30,-1.6962062003437322,28
3265,23,15,36,6,-1.6972875274185715,9
3266,102,16,20,8,-1.6989391239814924,8
3267,37,10,48,5,-1.703593750319215,5
3268,43,22,51,11,-1.7055396893146837,11
3269,7,40,54,21,-1.7088310244062668,19
3270,40,31,41,16,-1.7110878654501351,15
3271,85,10,74,5,-1.7134982697618457,5
3272,84,34,51,18,-1.7189303132534872,16
3273,41,39,39,19,-1.7191888070685701,20
3274,90,36,107,18,-1.723381098959678,18
3275,11,49,8,27,-1.7256786381417557,22
3276,50,11,83,5,-1.7272952536822093,6
3277,12,13,50,5,-1.7279667161947843,8
3278,11,14,60,7,-1.729783938603551,7
3279,75,19,70,9,-1.7314858975507368,10
3280,5,51,46,28,-1.7323776092910628,23
3281,106,19,48,10,-1.7335189393534853,9
3282,88,37,36,21,-1.7392851936744331,16
3283,23,26,8,13,-1.7400762718841147,13
3284,6,11,18,6,-1.7414584600944745,5
3285,36,33,60,17,-1.7416473627060742,16
3286,51,39,53,20,-1.7493185772901758,19
3287,107,38,97,19,-1.7507246476170446,19
3288,68,31,4,16,-1.7510661926181545,15
3289,88,56,87,27,-1.7513462767543797,29
3290,70,26,84,14,-1.7530345342228948,12
3291,54,27,84,15,-1.7533288896590713,12
3292,8,15,49,9,-1.7678498041146895,6
3293,36,31,1,15,-1.7697191195700561,16
3294,16,62,104,33,-1.7780277088526335,29
3295,84,13,102,7,-1.7793224025292758,6
3296,90,25,37,13,-1.7816453937181784,12
3297,28,65,8,35,-1.8060421386611965,30
3298,25,22,36,11,-1.8071440138268584,11
3299,111,18,40,9,-1.8104998545748818,9
3300,80,21,84,12,-1.8116947476965408,9
3301,64,12,80,6,-1.8118137894523876,6
3302,28,18,79,10,-1.8130893193426156,8
3303,16,29,112,14,-1.8181625400201853,15
3304,109,11,71,6,-1.819641782820222,5
3305,99,13,102,7,-1.8212893413036864,6
3306,114,18,69,8,-1.8229272425455245,10
3307,114,13,44,7,-1.8263733365516708,6
3308,20,13,23,7,-1.8275702683866017,6
3309,69,17,9,9,-1.8276767965349947,8
3310,13,29,74,15,-1.8278354237299068,14
3311,29,14,7,6,-1.8294106613069705,8
3312,96,38,84,19,-1.835648682700679,19
3313,106,10,103,6,-1.8460294979122165,4
3314,97,22,53,12,-1.8492466822191078,10
3315,76,22,46,12,-1.8507100299988153,10
3316,86,11,6,6,-1.8539951054916275,5
3317,51,19,98,10,-1.8552094547524458,9
3318,106,61,87,31,-1.8566326197242504,30
3319,60,49,39,25,-1.8593987986836014,24
3320,54,28,64,14,-1.8650724062797466,14
3321,5,95,37,49,-1.865428870342572,46
3322,54,26,17,13,-1.867393134138254,13
3323,83,16,60,9,-1.8774619090517453,7
3324,79,14,8,6,-1.8787453444383126,8
3325,46,22,68,11,-1.8807270075774944,11
3326,8,41,2,21,-1.8848654476169693,20
3327,64,23,25,12,-1.8857238852847689,11
3328,49,47,39,26,-1.889609365471135,21
3329,106,35,20,19,-1.890590591428699,16
3330,16,51,11,30,-1.8931355077036744,21
3331,28,37,39,19,-1.8977614224864356,18
3332,51,25,108,13,-1.9002486171144384,12
3333,84,10,43,6,-1.900346125507611,4
3334,88,13,14,7,-1.902096229341472,6
3335,114,37,63,22,-1.909917642987871,15
3336,57,17,15,9,-1.9121491415635448,8
3337,106,32,97,16,-1.9159665785715099,16
3338,76,11,99,5,-1.9173589523208336,6
3339,41,21,70,10,-1.9198471114809519,11
3340,28,25,80,13,-1.9225523112040797,12
3341,18,21,114,11,-1.923577249757447,10
3342,40,19,70,11,-1.9276789997691202,8
3343,97,14,23,7,-1.9330528734436563,7
3344,98,10,32,5,-1.9380052263831622,5
3345,104,13,110,8,-1.9388474450810558,5
3346,31,14,23,8,-1.9392936999416424,6
3347,55,20,25,11,-1.9429576796619947,9
3348,64,34,36,17,-1.9485056781764598,17
3349,71,12,78,6,-1.9545808326383198,6
3350,35,11,50,6,-1.9581460146246743,5
3351,76,18,41,8,-1.972404836446448,10
3352,37,33,88,18,-1.979989875378531,15
3353,25,38,28,22,-1.983389891159918,16
3354,13,13,48,7,-1.984822076945226,6
3355,4,19,53,10,-1.987694792892672,9
3356,86,55,70,30,-1.99170528882216,25
3357,112,15,104,8,-1.9939359727925703,7
3358,7,24,69,12,-1.9945381002011557,12
3359,17,14,64,7,-1.997717670710988,7
3360,97,22,83,10,-2.007636873207568,12
3361,90,36,8,20,-2.01946478207178,16
3362,87,30,75,16,-2.024772500508876,14
3363,13,11,32,6,-2.026181507027533,5
3364,114,14,91,7,-2.031242634143396,7
3365,79,11,55,6,-2.0315889229013417,5
3366,63,12,58,5,-2.0345686518653676,7
3367,88,14,89,7,-2.035463499061412,7
3368,60,24,90,14,-2.039727571926182,10
3369,51,34,18,17,-2.042743355152735,17
3370,80,31,65,16,-2.05091984654234,15
3371,9,17,84,9,-2.0546690063899433,8
3372,90,45,86,25,-2.0574221764428238,20
3373,31,25,3,12,-2.062807661672897,13
3374,49,16,68,8,-2.063780554877947,8
3375,114,23,50,13,-2.0649465321872778,10
3376,63,10,82,5,-2.0779758612966877,5
3377,114,13,98,7,-2.0825036861166173,6
3378,91,12,17,7,-2.0932516032559643,5
3379,36,73,7,39,-2.0934963107077063,34
3380,8,22,97,11,-2.094799206270941,11
3381,29,15,16,7,-2.096096770007441,8
3382,55,34,83,17,-2.0962093979720193,17
3383,84,22,109,12,-2.0978150302320913,10
3384,60,24,99,13,-2.100940382067204,11
3385,3,10,77,6,-2.1078393954054353,4
3386,100,23,8,13,-2.1093275750438307,10
3387,17,13,1,7,-2.1103206894628075,6
3388,88,18,81,9,-2.113043846902455,9
3389,33,12,74,6,-2.113811361821,6
3390,30,13,48,6,-2.114145406665778,7
3391,64,20,1,10,-2.116432620959366,10
3392,70,11,53,6,-2.117480208536356,5
3393,91,30,28,16,-2.128036121988931,14
3394,43,18,87,10,-2.1360829908334114,8
3395,28,49,11,25,-2.1398999630410587,24
3396,46,27,87,13,-2.150785198948074,14
3397,7,17,80,10,-2.151623343669696,7
3398,16,29,48,16,-2.1636694951809585,13
3399,74,14,88,9,-2.16536396125082,5
3400,55,63,86,34,-2.1661509305052244,29
3401,39,11,33,6,-2.1701558874520313,5
3402,93,16,84,8,-2.173203038685071,8
3403,70,26,63,14,-2.1813121472430432,12
3404,13,82,68,45,-2.1861093008549624,37
3405,74,64,8,36,-2.1866220406514896,28
3406,54,10,31,5,-2.1866689261471493,5
3407,87,19,94,10,-2.200625594283846,9
3408,13,51,49,26,-2.2090696411697515,25
3409,55,19,57,9,-2.210406003923328,10
3410,40,12,112,6,-2.2105918484505547,6
3411,96,50,5,28,-2.21142719225076,22
3412,17,27,106,16,-2.2117443407707005,11
3413,8,11,112,5,-2.214468435350456,6
3414,69,11,104,7,-2.21747944835034,4
3415,99,13,98,6,-2.22125816779338,7
3416,114,11,11,5,-2.2223336020983733,6
3417,33,11,88,5,-2.224220943421554,6
3418,25,16,90,9,-2.226157693683706,7
3419,74,27,20,15,-2.230377352624161,12
3420,70,25,68,13,-2.2334926025833965,12
3421,3,14,81,8,-2.2358028798300933,6
3422,104,35,87,17,-2.2393020839894078,18
3423,11,18,7,10,-2.23932059026862,8
3424,4,38,88,20,-2.24592170041755,18
3425,7,25,20,13,-2.251051671042148,12
3426,54,14,41,7,-2.2511014360561394,7
3427,25,30,95,16,-2.25397314365567,14
3428,46,24,60,13,-2.263806664184089,11
3429,96,66,28,35,-2.2674069446039327,31
3430,31,10,61,5,-2.2696136748473594,5
3431,71,16,80,8,-2.2753923838048147,8
3432,17,21,46,11,-2.279991454185124,10
3433,74,46,37,24,-2.2838690954080456,22
3434,4,13,106,6,-2.287883468044352,7
3435,114,10,94,6,-2.2912532605689226,4
3436,45,18,114,10,-2.292094813707231,8
3437,5,24,100,13,-2.2932427434044693,11
3438,65,33,97,18,-2.294354223312199,15
3439,109,16,68,10,-2.29851232062389,6
3440,32,21,86,11,-2.2989864902239,10
3441,109,13,23,7,-2.3017906431791286,6
3442,50,12,58,6,-2.303376752943112,6
3443,3,23,9,12,-2.3162904113567793,11
3444,60,26,3,14,-2.3182866914035363,12
3445,107,28,34,16,-2.3192939541017417,12
3446,69,24,65,13,-2.3193082814773103,11
3447,102,21,104,10,-2.320627297470276,11
3448,64,23,50,12,-2.3285304422785043,11
3449,5,51,109,26,-2.3285813949081646,25
3450,53,28,25,14,-2.3301510854690832,14
3451,4,17,104,10,-2.3357072159096566,7
3452,51,20,49,11,-2.337593611464387,9
3453,85,25,86,13,-2.3385045180060255,12
3454,12,15,13,6,-2.3425974502134452,9
3455,31,36,4,21,-2.3535355966794675,15
3456,109,14,96,8,-2.3566759619593642,6
3457,5,23,99,12,-2.3616219022642833,11
3458,70,19,7,12,-2.364945757295021,7
3459,96,55,8,30,-2.3714393570924233,25
3460,96,10,69,6,-2.371580754307745,4
3461,54,50,87,28,-2.377568787955836,22
3462,84,28,55,15,-2.3790863004124483,13
3463,86,41,71,21,-2.381013041233798,20
3464,106,31,71,17,-2.3812089448162745,14
3465,65,86,13,47,-2.3833738604192134,39
3466,56,13,75,8,-2.3840139649043506,5
3467,104,25,96,14,-2.3866419839158355,11
3468,71,21,4,13,-2.3871750117365993,8
3469,95,40,104,22,-2.389034218387607,18
3470,8,12,111,6,-2.390343846489093,6
3471,87,22,83,11,-2.3903571419434884,11
3472,7,10,85,6,-2.3932559335609835,4
3473,39,17,12,9,-2.397628020427829,8
3474,8,10,56,6,-2.4000860547179794,4
3475,54,74,86,39,-2.400843471644491,35
3476,87,27,3,15,-2.4014400128838447,12
3477,60,20,78,10,-2.402430835134886,10
3478,68,31,3,17,-2.4024413251399017,14
3479,38,21,68,12,-2.407021082950757,9
3480,51,24,47,12,-2.4094573680997575,12
3481,93,33,8,17,-2.4111455321691304,16
3482,92,11,65,6,-2.411285975254871,5
3483,39,35,71,19,-2.4158892555534424,16
3484,25,46,107,24,-2.4187485647838773,22
3485,99,11,109,6,-2.419517402501058,5
3486,75,20,91,7,-2.4323694332612673,13
3487,99,21,87,12,-2.432411032680885,9
3488,69,24,41,15,-2.435433530316399,9
3489,106,39,55,22,-2.4381392466666045,17
3490,86,18,12,10,-2.4382543520920796,8
3491,51,18,57,9,-2.4421495714004644,9
3492,50,10,32,4,-2.4440541907162716,6
3493,27,10,54,5,-2.463869496934477,5
3494,69,17,74,8,-2.466497282082454,9
3495,74,40,87,22,-2.4671563114027464,18
3496,81,17,4,10,-2.467812477706327,7
3497,9,61,7,31,-2.4756046461152823,30
3498,39,30,95,16,-2.481130681096556,14
3499,107,63,84,34,-2.4836473699262256,29
3500,68,59,65,32,-2.4863573145608657,27
3501,111,11,18,6,-2.489910872635885,5
3502,31,20,87,10,-2.492676559594957,10
3503,3,20,65,11,-2.4971368500383213,9
3504,109,18,37,10,-2.5010134043415313,8
3505,96,37,106,21,-2.5084238105055885,16
3506,13,23,11,12,-2.5094502110260706,11
3507,68,105,7,57,-2.5114811010541356,48
3508,13,30,63,16,-2.513355364840316,14
3509,39,18,62,9,-2.5162035004252656,9
3510,36,15,12,8,-2.5163199425137495,7
3511,50,32,39,17,-2.524569549657206,15
3512,68,13,11,7,-2.5250619833588037,6
3513,4,18,39,10,-2.5267698999647226,8
3514,9,33,36,18,-2.527924078037467,15
3515,16,23,102,12,-2.528185641545434,11
3516,60,11,111,7,-2.535604443502029,4
3517,11,35,63,21,-2.539597707853179,14
3518,16,13,52,7,-2.542332195506543,6
3519,1,19,73,11,-2.5534291003907295,8
3520,83,16,51,10,-2.556300922595479,6
3521,63,10,83,4,-2.557624644664858,6
3522,87,13,92,7,-2.5651869545632544,6
3523,107,28,91,16,-2.5653431282322647,12
3524,91,11,47,6,-2.565831417578021,5
3525,7,50,104,27,-2.5854072339864174,23
3526,62,21,87,11,-2.586304566496697,10
3527,20,36,88,18,-2.5921704707151747,18
3528,109,10,1,5,-2.592960677140225,5
3529,31,23,39,13,-2.5934090452929364,10
3530,112,19,107,11,-2.593671589993662,8
3531,27,19,40,8,-2.5947052105553348,11
3532,91,23,36,13,-2.600483205457647,10
3533,94,11,39,6,-2.6102416991316604,5
3534,86,20,93,11,-2.6126285193850958,9
3535,40,16,11,9,-2.612795985816362,7
3536,2,13,76,8,-2.6134640032331116,5
3537,41,12,11,8,-2.6159479780993316,4
3538,20,26,11,15,-2.6225934054521076,11
3539,16,44,41,22,-2.6236346308099376,22
3540,13,85,16,47,-2.627845919438654,38
3541,13,17,26,10,-2.6331530105138743,7
3542,72,14,13,7,-2.6344835838372416,7
3543,114,28,54,14,-2.6355280322257006,14
3544,95,14,33,8,-2.6415453896084555,6
3545,62,28,86,15,-2.642237041880456,13
3546,5,60,16,35,-2.643518445682432,25
3547,86,43,23,23,-2.6484576158238538,20
3548,8,24,30,13,-2.6514132136935475,11
3549,65,48,53,25,-2.6519126498591334,23
3550,36,13,57,8,-2.653116090105381,5
3551,88,29,92,16,-2.65412565592523,13
3552,91,13,74,7,-2.658254293210725,6
3553,76,10,47,3,-2.6595736051653853,7
3554,74,25,114,13,-2.666972342657448,12
3555,75,18,95,10,-2.672802736686619,8
3556,44,17,25,9,-2.673535476281759,8
3557,50,16,43,10,-2.6787122504636622,6
3558,5,25,39,13,-2.6791322172692884,12
3559,17,17,90,8,-2.680753861205159,9
3560,71,40,65,23,-2.6867803351656674,17
3561,51,67,88,33,-2.689202214280451,34
3562,41,21,57,12,-2.694336728836968,9
3563,18,14,12,8,-2.7036570911929836,6
3564,65,27,43,13,-2.7044668198991113,14
3565,37,57,107,31,-2.7122377942768767,26
3566,33,21,16,13,-2.716908579534641,8
3567,80,11,95,6,-2.7197438471090796,5
3568,70,31,104,17,-2.7208109249750048,14
3569,88,53,55,31,-2.721264805593774,22
3570,51,39,28,20,-2.727986007563174,19
3571,30,12,9,7,-2.7296904854733155,5
3572,34,12,75,6,-2.7327928404854562,6
3573,107,26,98,14,-2.733780753313525,12
3574,106,50,65,27,-2.735321183024918,23
3575,104,22,97,11,-2.7396377781056187,11
3576,107,19,29,12,-2.739796334219244,7
3577,107,67,51,39,-2.750007946030056,28
3578,28,94,86,52,-2.7543527010347275,42
3579,64,42,53,23,-2.7590266802927172,19
3580,60,31,18,17,-2.759241709022921,14
3581,77,17,5,9,-2.7658375671945885,8
3582,40,11,38,5,-2.771552043064858,6
3583,10,11,5,5,-2.7716738654503192,6
3584,3,27,107,13,-2.7747494462017355,14
3585,84,27,16,14,-2.7805687732320044,13
3586,55,16,3,9,-2.7857743268426365,7
3587,97,15,9,7,-2.7891659901703596,8
3588,108,19,86,9,-2.7920033870005003,10
3589,36,13,100,7,-2.7923934619121096,6
3590,1,26,7,14,-2.793205495238504,12
3591,114,25,4,13,-2.7973762559419417,12
3592,88,57,60,32,-2.7991697386489376,25
3593,112,14,106,7,-2.805082024542768,7
3594,41,15,99,8,-2.808167291861728,7
3595,106,33,68,18,-2.8127952198562447,15
3596,48,17,65,10,-2.813018636762518,7
3597,109,32,51,20,-2.817926639661738,12
3598,15,17,99,10,-2.8189668514207975,7
3599,47,13,64,8,-2.821240379057225,5
3600,71,13,18,7,-2.821320109059578,6
3601,38,21,16,13,-2.8217292489636367,8
3602,74,33,104,19,-2.832959821636547,14
3603,65,18,77,9,-2.836180648453273,9
3604,60,12,89,6,-2.8396731138810423,6
3605,23,19,95,10,-2.8404436396815522,9
3606,65,84,16,46,-2.8433317593388634,38
3607,54,25,102,14,-2.843956333831333,11
3608,104,13,23,8,-2.8445076862849517,5
3609,39,28,17,16,-2.8462345861289586,12
3610,61,10,47,6,-2.846896267551428,4
3611,33,13,97,7,-2.8486496222061595,6
3612,18,20,74,10,-2.8496142222224696,10
3613,96,16,73,9,-2.853430398009382,7
3614,99,18,51,9,-2.8534777973740635,9
3615,28,53,88,30,-2.8540426797765646,23
3616,86,48,60,26,-2.8571270629897767,22
3617,65,54,28,30,-2.864556092070314,24
3618,75,21,27,11,-2.8742147115996155,10
3619,60,23,63,13,-2.8746236800640066,10
3620,38,13,29,7,-2.8767159163647986,6
3621,7,31,43,18,-2.8869337290340296,13
3622,74,24,75,14,-2.8903655619324415,10
3623,7,113,13,61,-2.894597548933859,52
3624,78,20,68,11,-2.8969266940151783,9
3625,70,10,44,5,-2.8975248911261424,5
3626,108,13,71,7,-2.8992906212622866,6
3627,74,13,12,7,-2.901854459581128,6
3628,37,19,91,10,-2.9050960547005253,9
3629,108,12,25,7,-2.9132670669268257,5
3630,86,88,63,51,-2.9189426271050922,37
3631,106,19,102,9,-2.9207255392565092,10
3632,86,82,74,43,-2.9212877807151494,39
3633,43,10,17,5,-2.923505312587325,5
3634,65,15,99,8,-2.925348959200731,7
3635,97,11,49,7,-2.931895914374789,4
3636,3,15,61,7,-2.93476140357165,8
3637,87,20,36,12,-2.9355732508976633,8
3638,76,17,30,10,-2.9372015853586078,7
3639,7,25,15,12,-2.945121443798056,13
3640,8,78,86,40,-2.9505503650201597,38
3641,8,16,80,8,-2.9519293865537106,8
3642,49,23,87,11,-2.9552067016674513,12
3643,16,36,20,22,-2.956231526565309,14
3644,86,89,7,51,-2.9562630867796145,38
3645,53,11,47,6,-2.967218161853792,5
3646,37,21,2,11,-2.96975801126945,10
3647,94,12,60,6,-2.9727316679047604,6
3648,4,32,36,19,-2.9739066740354194,13
3649,106,36,84,18,-2.9754739608250116,18
3650,55,67,13,36,-2.9782082101551524,31
3651,84,12,10,7,-2.980259678929739,5
3652,53,27,95,17,-2.981134349868032,10
3653,50,35,13,19,-2.981537535104847,16
3654,51,10,72,5,-2.9819518577631126,5
3655,30,10,74,5,-2.9862406732405895,5
3656,98,10,100,5,-2.991009310778455,5
3657,37,37,65,19,-2.9918797859979525,18
3658,18,10,27,5,-2.996654278290003,5
3659,41,28,64,17,-2.998546228465672,11
3660,69,11,4,6,-2.9994841766617175,5
3661,58,21,31,11,-2.999935565790512,10
3662,34,14,96,8,-3.001763014782562,6
3663,38,19,88,12,-3.0023329742590943,7
3664,7,27,6,12,-3.013941061604383,15
3665,40,12,57,7,-3.0270401513317453,5
3666,55,10,78,5,-3.0279933852134207,5
3667,51,47,54,25,-3.029775997358006,22
3668,84,13,35,7,-3.0304994399162246,6
3669,47,16,41,9,-3.031406429138557,7
3670,65,39,25,23,-3.0368934823131157,16
3671,96,13,38,7,-3.0422152322461713,6
3672,68,21,30,11,-3.0436023819959455,10
3673,55,14,48,8,-3.0636269177668387,6
3674,25,18,71,10,-3.0644100067848146,8
3675,114,40,60,18,-3.0670908685799043,22
3676,25,30,75,17,-3.069551733540898,13
3677,88,40,64,23,-3.072237959143943,17
3678,86,105,16,58,-3.0722654083229983,47
3679,41,11,74,5,-3.0735662157516845,6
3680,87,14,45,8,-3.086220297325659,6
3681,16,20,6,10,-3.0894843149716715,10
3682,77,27,13,15,-3.0976815832127267,12
3683,53,12,29,8,-3.0983100329129045,4
3684,91,10,64,6,-3.0993479020870796,4
3685,68,14,99,8,-3.100103615084465,6
3686,60,15,92,9,-3.101629065738581,6
3687,106,25,109,13,-3.1028448270841773,12
3688,53,26,106,13,-3.1050273222192404,13
3689,4,24,50,12,-3.1105592371369597,12
3690,17,25,25,14,-3.1106502600539105,11
3691,55,29,53,16,-3.1154264109145684,13
3692,80,11,36,6,-3.1158574211756616,5
3693,91,27,5,16,-3.121858390948631,11
3694,71,24,62,13,-3.138232146026573,11
3695,23,23,75,11,-3.148733601092015,12
3696,112,15,13,8,-3.153591174260179,7
3697,17,13,87,7,-3.155787932459329,6
3698,63,21,46,10,-3.156280457471709,11
3699,82,21,86,12,-3.1586560919846263,9
3700,87,32,23,19,-3.1607512154600745,13
3701,62,17,13,9,-3.161295276739798,8
3702,74,14,90,9,-3.168061351028922,5
3703,9,39,75,22,-3.1681150438551966,17
3704,86,16,110,9,-3.1694821197260485,7
3705,60,25,106,15,-3.171261503808182,10
3706,68,56,88,31,-3.1716887522574075,25
3707,69,11,47,6,-3.1775295332798312,5
3708,65,25,83,13,-3.1850517665827933,12
3709,50,54,37,28,-3.1883352760136074,26
3710,51,38,9,20,-3.197373775958875,18
3711,81,14,68,8,-3.1985312995714845,6
3712,5,49,55,27,-3.198953177181802,22
3713,39,41,36,23,-3.1998605067578225,18
3714,76,12,44,7,-3.2019945343572456,5
3715,31,47,60,23,-3.2094707274879264,24
3716,97,19,50,11,-3.210625734622642,8
3717,23,19,64,10,-3.2123729115980186,9
3718,28,39,55,23,-3.2184704312839756,16
3719,63,29,97,16,-3.219195053710692,13
3720,7,55,23,30,-3.222928305376168,25
3721,16,21,4,10,-3.223993814900797,11
3722,41,44,51,24,-3.228342506596857,20
3723,87,21,2,12,-3.2308938185741103,9
3724,97,10,56,5,-3.2314262120369195,5
3725,36,49,107,26,-3.234838704648262,23
3726,28,47,87,25,-3.2447645976260606,22
3727,107,15,94,10,-3.2534973524779978,5
3728,25,47,114,27,-3.2540864225169766,20
3729,95,14,84,8,-3.2568961944145873,6
3730,74,24,7,15,-3.257493143792889,9
3731,95,14,76,8,-3.257651508839797,6
3732,76,23,98,13,-3.2651133620022033,10
3733,109,24,60,13,-3.2667081082674914,11
3734,107,49,50,26,-3.2679334653534724,23
3735,102,12,13,8,-3.269263582511039,4
3736,93,14,70,8,-3.2714518634318708,6
3737,91,11,102,6,-3.2738070744638943,5
3738,67,13,114,7,-3.274670651234843,6
3739,45,18,16,11,-3.276855643218356,7
3740,13,20,57,10,-3.292969695754846,10
3741,13,23,38,11,-3.2949567300335874,12
3742,5,60,104,32,-3.3007473735225057,28
3743,54,61,20,31,-3.303892441084724,30
3744,66,11,86,6,-3.309294151623436,5
3745,17,35,16,21,-3.312370376088436,14
3746,75,31,60,17,-3.313915862803686,14
3747,84,16,97,10,-3.316428205809935,6
3748,57,10,64,6,-3.321529793039179,4
3749,81,13,9,7,-3.3217764660677,6
3750,39,30,64,17,-3.3245242307335383,13
3751,34,10,78,5,-3.3271359801886407,5
3752,50,19,41,11,-3.331657114556132,8
3753,54,33,80,17,-3.332215932419911,16
3754,31,22,50,12,-3.3334236876453813,10
3755,109,12,69,7,-3.3344685187765157,5
3756,76,13,71,6,-3.3359186512389036,7
3757,5,13,68,7,-3.3380294056441127,6
3758,98,20,54,11,-3.3414082574983,9
3759,33,13,75,8,-3.342736023465549,5
3760,2,21,20,12,-3.343168498501611,9
3761,70,47,16,27,-3.3445553948476245,20
3762,91,15,40,8,-3.345577169162442,7
3763,20,10,83,5,-3.347889825164404,5
3764,107,15,14,9,-3.3479962116917545,6
3765,16,34,97,18,-3.3525321991063106,16
3766,3,12,54,6,-3.3552278990212483,6
3767,46,52,13,29,-3.3558421358827215,23
3768,87,106,86,54,-3.3564460349971705,52
3769,27,48,7,26,-3.3617414996167194,22
3770,8,23,14,13,-3.3634201583462153,10
3771,97,25,54,13,-3.364815342765676,12
3772,20,17,40,10,-3.3649339637959637,7
3773,55,56,107,30,-3.369618935589803,26
3774,81,16,39,9,-3.3797099233441696,7
3775,98,15,73,8,-3.3800553651819163,7
3776,55,28,36,15,-3.383336577257353,13
3777,9,28,60,17,-3.384232112219374,11
3778,55,48,39,27,-3.3894226122709816,21
3779,104,10,73,6,-3.391491099464731,4
3780,40,28,43,15,-3.392922253607483,13
3781,28,13,4,7,-3.3940824912486858,6
3782,17,20,68,12,-3.395638967050424,8
3783,87,29,76,17,-3.3995265465111264,12
3784,64,46,13,23,-3.4066631144062156,23
3785,98,26,104,12,-3.4091853213510745,14
3786,36,11,17,5,-3.417273645156755,6
3787,37,12,4,7,-3.4218717037755084,5
3788,12,13,74,7,-3.4342312359972222,6
3789,25,31,102,17,-3.4382241991917164,14
3790,39,29,114,15,-3.4411172111260955,14
3791,39,56,13,30,-3.443344119398473,26
3792,23,21,37,11,-3.4530437057487418,10
3793,5,23,33,12,-3.454327509177194,11
3794,51,49,106,27,-3.457607975311812,22
3795,37,46,20,25,-3.457621476755263,21
3796,17,10,77,6,-3.4626586322684796,4
3797,84,12,13,7,-3.4627368734629633,5
3798,1,32,13,19,-3.462932922524283,13
3799,106,19,30,10,-3.463995690702536,9
3800,54,26,9,14,-3.4668855776458423,12
3801,5,60,74,32,-3.4699961467083447,28
3802,16,14,73,7,-3.4738693799097957,7
3803,81,10,23,6,-3.4745303728026347,4
3804,54,57,96,29,-3.47661338595835,28
3805,18,16,55,8,-3.481046717374471,8
3806,70,20,25,11,-3.484518115943737,9
3807,51,30,36,16,-3.4874600225025065,14
3808,36,13,62,7,-3.489528327052378,6
3809,114,36,97,20,-3.494809729950691,16
3810,9,26,50,15,-3.4989626487903873,11
3811,68,14,85,9,-3.5027894631624408,5
3812,107,19,93,11,-3.5035103312902427,8
3813,23,16,74,9,-3.5053157619270587,7
3814,33,10,49,6,-3.5057518320537775,4
3815,84,15,91,8,-3.5069437670955055,7
3816,104,38,8,21,-3.5073414065674897,17
3817,106,50,107,27,-3.5165007722129795,23
3818,62,34,16,20,-3.5174461635881284,14
3819,17,22,97,12,-3.5176024597849698,10
3820,17,11,112,6,-3.5191492672023625,5
3821,13,28,109,16,-3.519799337045931,12
3822,30,17,7,8,-3.5212250771957296,9
3823,43,18,63,10,-3.5248517337852396,8
3824,76,17,20,8,-3.5278207011714757,9
3825,7,15,44,8,-3.535266020755452,7
3826,69,26,88,15,-3.536532050456282,11
3827,36,65,40,37,-3.5400829247343655,28
3828,38,30,86,17,-3.545802580470499,13
3829,4,13,30,7,-3.554167963462701,6
3830,49,31,16,17,-3.554282234706272,14
3831,57,13,23,7,-3.554408044637194,6
3832,36,19,28,10,-3.554999615354126,9
3833,33,11,64,7,-3.558110801858625,4
3834,8,71,16,40,-3.5597923636148607,31
3835,23,45,107,24,-3.5637002883543505,21
3836,51,23,1,12,-3.568045705832745,11
3837,23,12,33,7,-3.5712223539857573,5
3838,45,14,63,8,-3.582850982463552,6
3839,20,11,69,6,-3.5870175414258565,5
3840,95,10,97,6,-3.58943247133478,4
3841,71,13,58,7,-3.5901555481142533,6
3842,13,14,34,7,-3.5918746626908375,7
3843,69,19,107,11,-3.6039989635628786,8
3844,84,16,34,8,-3.604110620728508,8
3845,94,13,55,7,-3.6120696685756326,6
3846,62,16,28,9,-3.6140960069707972,7
3847,17,14,84,8,-3.6228474870048992,6
3848,18,19,43,9,-3.6267699505365183,10
3849,84,82,86,42,-3.6311456839927936,40
3850,108,11,48,7,-3.633614524897183,4
3851,108,14,75,8,-3.634090811617301,6
3852,5,60,88,32,-3.63799769202775,28
3853,68,15,20,8,-3.6401769729360676,7
3854,37,20,30,12,-3.640395609700316,8
3855,60,28,30,18,-3.6429209013345942,10
3856,60,36,87,19,-3.6433827041407523,17
3857,70,10,14,5,-3.6470421341148493,5
3858,2,19,16,11,-3.6499962386684315,8
3859,50,13,27,8,-3.6503401008022798,5
3860,65,47,23,25,-3.650632324208862,22
3861,18,11,17,5,-3.6519056838531805,6
3862,107,35,76,22,-3.6519592132431544,13
3863,9,15,109,7,-3.6538651478462696,8
3864,32,21,107,11,-3.6546977761524695,10
3865,88,16,12,9,-3.655181484982228,7
3866,71,10,90,5,-3.656103603020123,5
3867,23,22,63,13,-3.656375723040438,9
3868,100,11,53,6,-3.6569500587649983,5
3869,96,33,97,17,-3.6574389351582637,16
3870,104,53,86,29,-3.66553549979236,24
3871,88,10,19,5,-3.665606739273205,5
3872,50,10,62,6,-3.6657345895143245,4
3873,80,25,20,14,-3.6714284273440603,11
3874,27,12,71,7,-3.672482180614423,5
3875,68,14,101,9,-3.6742625668258904,5
3876,107,11,52,7,-3.67922282951035,4
3877,53,48,39,27,-3.685116242956752,21
3878,84,20,46,12,-3.686829488531012,8
3879,40,68,13,37,-3.6903630857890595,31
3880,20,41,87,22,-3.692217589912372,19
3881,102,28,28,15,-3.699783063019897,13
3882,43,17,106,9,-3.706853967971227,8
3883,5,21,15,13,-3.7147342263498238,8
3884,3,14,12,9,-3.71740069479101,5
3885,80,10,91,6,-3.719893539982741,4
3886,88,42,75,24,-3.726903391628383,18
3887,25,65,86,35,-3.735239092039536,30
3888,4,13,1,8,-3.7360390878519714,5
3889,40,42,53,23,-3.7429391558119995,19
3890,65,21,15,12,-3.7445792583431627,9
3891,53,55,18,30,-3.7518428116438605,25
3892,6,16,88,9,-3.7570512530434645,7
3893,4,19,63,11,-3.7758336578086884,8
3894,92,13,104,6,-3.7768187223532292,7
3895,49,12,28,6,-3.781572164594755,6
3896,28,48,20,27,-3.791556613480695,21
3897,104,13,20,8,-3.7974160411444697,5
3898,78,12,39,6,-3.805891795343841,6
3899,5,16,110,9,-3.8138584796050923,7
3900,31,18,91,11,-3.819701831167943,7
3901,18,32,86,19,-3.8203668272153477,13
3902,3,10,49,6,-3.8208441036339096,4
3903,4,21,55,11,-3.821660634263143,10
3904,66,12,60,8,-3.8266322198174065,4
3905,87,16,44,9,-3.826754946057649,7
3906,51,30,70,16,-3.8297117807076546,14
3907,51,78,13,42,-3.830975362019476,36
3908,13,26,91,14,-3.8317482607331113,12
3909,31,23,18,12,-3.8430258307678655,11
3910,46,54,86,33,-3.844118075696465,21
3911,31,11,28,6,-3.845374758093618,5
3912,111,34,65,20,-3.8475275648066676,14
3913,6,14,65,8,-3.8536392094191116,6
3914,114,25,41,13,-3.8544949021986654,12
3915,51,16,11,8,-3.8660778701548084,8
3916,68,11,108,6,-3.86884903956731,5
3917,87,36,95,20,-3.8694007735692093,16
3918,100,17,28,10,-3.874972007810441,7
3919,98,13,18,6,-3.8754830902904,7
3920,35,11,43,7,-3.879532298464464,4
3921,112,11,1,5,-3.8826933985340957,6
3922,17,15,11,8,-3.886158778436342,7
3923,17,10,110,6,-3.888719135954252,4
3924,62,13,76,7,-3.8913968956310074,6
3925,11,44,55,26,-3.8920841591670357,18
3926,63,16,17,9,-3.896935952486399,7
3927,47,29,7,17,-3.8974466826753917,12
3928,37,26,102,15,-3.901578428361024,11
3929,49,19,98,10,-3.906322793569991,9
3930,96,21,60,14,-3.9124280698247627,7
3931,1,33,68,19,-3.9146334053388845,14
3932,53,16,27,10,-3.914996444269401,6
3933,86,13,89,6,-3.9174928376954097,7
3934,86,30,49,16,-3.918819559219819,14
3935,48,17,20,10,-3.9196076613306294,7
3936,70,38,37,22,-3.9227382855891673,16
3937,2,28,5,16,-3.923277825320168,12
3938,13,21,100,12,-3.92873233040865,9
3939,50,11,57,7,-3.929027822248146,4
3940,3,20,16,12,-3.933123710020241,8
3941,15,13,64,6,-3.9332029302911167,7
3942,97,10,80,6,-3.9365866928471034,4
3943,46,40,51,23,-3.9395834900065476,17
3944,40,11,6,6,-3.9442678680230827,5
3945,100,17,37,10,-3.9481789557688427,7
3946,76,12,34,6,-3.9517678907570324,6
3947,16,17,72,9,-3.952768658773343,8
3948,104,50,88,29,-3.9536343834384904,21
3949,93,24,74,13,-3.960101768879081,11
3950,17,22,49,14,-3.9654437170334917,8
3951,29,11,13,6,-3.9675884694704666,5
3952,65,72,104,39,-3.970649197276848,33
3953,14,12,96,7,-3.975747798085754,5
3954,43,14,41,8,-3.9773777964919623,6
3955,17,17,34,10,-3.9857052585459996,7
3956,107,70,13,38,-3.9870909466214264,32
3957,51,10,58,6,-3.991203040107808,4
3958,77,20,86,12,-4.007520110320655,8
3959,31,12,66,7,-4.0087548725586535,5
3960,86,20,99,12,-4.00989122283285,8
3961,54,36,55,19,-4.011039158800405,17
3962,28,70,50,40,-4.011477637487842,30
3963,110,20,8,12,-4.013172679497405,8
3964,51,44,104,27,-4.015424408222765,17
3965,114,28,102,16,-4.0171208257371775,12
3966,3,16,104,9,-4.020656220421077,7
3967,88,30,96,16,-4.030096740212504,14
3968,47,13,71,7,-4.030916530509354,6
3969,43,10,1,5,-4.03897671575872,5
3970,50,21,7,11,-4.045740478776831,10
3971,79,13,11,6,-4.047561716338114,7
3972,40,10,32,5,-4.050021677419869,5
3973,62,23,107,11,-4.0504669700597535,12
3974,107,67,88,39,-4.055852119959083,28
3975,80,28,16,16,-4.056076921695063,12
3976,38,10,34,6,-4.0610942900478735,4
3977,95,10,43,6,-4.0633983206079485,4
3978,17,26,7,15,-4.064887482017846,11
3979,63,29,9,16,-4.065325398742937,13
3980,40,57,60,32,-4.06725625489293,25
3981,50,22,74,12,-4.086243740312161,10
3982,19,11,36,6,-4.0885902184216905,5
3983,64,26,87,14,-4.098181725889204,12
3984,35,24,20,14,-4.098728722002913,10
3985,93,20,83,11,-4.100880722204593,9
3986,46,21,114,12,-4.104107153511736,9
3987,93,15,16,8,-4.1062906023148145,7
3988,68,14,12,8,-4.108669111305504,6
3989,106,11,29,6,-4.1226863415672375,5
3990,65,22,45,11,-4.125923170388699,11
3991,104,32,76,19,-4.135711821894891,13
3992,20,11,71,7,-4.136430557393971,4
3993,69,11,11,7,-4.1379214913131195,4
3994,29,11,23,6,-4.138000210796417,5
3995,74,18,100,10,-4.138016461047894,8
3996,71,47,53,27,-4.141303557057988,20
3997,73,13,20,8,-4.146065391689571,5
3998,3,13,96,7,-4.14984060644092,6
3999,107,16,6,9,-4.150160656533904,7
4000,62,10,60,6,-4.155747625311636,4
4001,2,15,75,8,-4.157456952203448,7
4002,62,15,53,8,-4.159409570332151,7
4003,78,26,86,15,-4.169788407826315,11
4004,50,22,40,14,-4.173703341481282,8
4005,25,27,23,15,-4.182190113226027,12
4006,88,55,40,31,-4.188882138376304,24
4007,48,14,7,7,-4.194687020035504,7
4008,100,18,23,11,-4.197161790157007,7
4009,28,13,47,7,-4.198358496115318,6
4010,36,56,65,32,-4.205692860728475,24
4011,68,41,41,23,-4.207626519911899,18
4012,112,11,27,6,-4.214543381192909,5
4013,87,36,30,20,-4.216616531421398,16
4014,18,19,4,11,-4.220670692754493,8
4015,44,11,71,6,-4.223524348839462,5
4016,54,54,28,31,-4.225159524354366,23
4017,28,20,30,12,-4.22622579482484,8
4018,65,16,109,11,-4.2330518085976205,5
4019,1,21,60,12,-4.237560386673236,9
4020,74,12,31,7,-4.240578281890586,5
4021,46,22,20,14,-4.241307956001941,8
4022,34,14,106,7,-4.243674039664674,7
4023,80,17,104,9,-4.256665633473226,8
4024,96,12,33,5,-4.271042933020871,7
4025,107,83,87,47,-4.276654149436662,36
4026,112,25,53,12,-4.2943591826734995,13
4027,44,21,20,12,-4.299103845073811,9
4028,54,28,25,16,-4.300413553073274,12
4029,109,22,20,14,-4.302333411252665,8
4030,52,10,50,5,-4.308197298973348,5
4031,20,19,17,11,-4.3112321942034,8
4032,40,22,4,12,-4.316643149060896,10
4033,86,19,15,11,-4.320856963962772,8
4034,11,25,76,15,-4.3267052425458585,10
4035,37,23,98,13,-4.327931130640238,10
4036,41,19,95,11,-4.332143979792176,8
4037,22,12,60,7,-4.334241842742782,5
4038,109,49,28,29,-4.336990918241798,20
4039,65,29,70,18,-4.3439841796636145,11
4040,88,24,47,13,-4.347102674354305,11
4041,54,31,104,17,-4.355933806560285,14
4042,11,13,33,6,-4.365968233102095,7
4043,23,23,40,13,-4.36842332680331,10
4044,58,13,55,7,-4.369004483506263,6
4045,16,32,57,18,-4.370861200972596,14
4046,9,24,55,14,-4.371040618945101,10
4047,98,13,60,7,-4.372454949323837,6
4048,9,13,74,8,-4.37578055371931,5
4049,96,38,63,23,-4.376849709142973,15
4050,76,23,65,14,-4.385586505985179,9
4051,86,20,111,12,-4.3910837466552355,8
4052,29,14,97,8,-4.39492891527919,6
4053,64,20,114,12,-4.407773657880816,8
4054,53,64,7,36,-4.416213736910661,28
4055,76,12,13,7,-4.417032905676176,5
4056,13,30,99,17,-4.420966828834257,13
4057,9,18,46,10,-4.4238849359462264,8
4058,87,20,102,12,-4.423994697827658,8
4059,64,35,107,19,-4.429693624174907,16
4060,5,115,86,66,-4.430772584334585,49
4061,53,35,16,21,-4.432680586189367,14
4062,107,46,11,26,-4.433295300820407,20
4063,88,11,45,7,-4.4416566980945715,4
4064,109,15,95,9,-4.444131433700797,6
4065,37,33,13,19,-4.448467961015428,14
4066,31,67,7,38,-4.453212370234459,29
4067,16,44,95,24,-4.453378575583385,20
4068,73,12,50,8,-4.454782630059153,4
4069,97,11,77,7,-4.454901155383999,4
4070,98,13,78,7,-4.46380656892488,6
4071,50,15,3,8,-4.464463620895281,7
4072,32,18,37,10,-4.466542082918519,8
4073,28,11,19,6,-4.46817791990182,5
4074,57,10,91,5,-4.468260927215542,5
4075,108,19,16,11,-4.469566431052606,8
4076,18,30,88,16,-4.47012131788994,14
4077,8,16,68,9,-4.472450037155225,7
4078,25,31,96,17,-4.472832877552798,14
4079,107,74,65,42,-4.474316118265179,32
4080,107,33,95,18,-4.475609109265347,15
4081,16,40,30,23,-4.476195567754862,17
4082,70,29,88,17,-4.478319588858415,12
4083,3,24,13,16,-4.479086737291788,8
4084,27,11,55,6,-4.4890470852362,5
4085,51,45,75,25,-4.490318359114664,20
4086,3,15,64,9,-4.492765978443915,6
4087,37,15,93,9,-4.4934456656390305,6
4088,112,20,75,12,-4.4989690721071325,8
4089,104,10,62,7,-4.506645682517949,3
4090,55,43,37,23,-4.516821858156877,20
4091,75,23,106,12,-4.532198108241345,11
4092,68,28,71,17,-4.532265816801446,11
4093,102,24,8,13,-4.537070383836358,11
4094,9,51,88,29,-4.537426821075462,22
4095,76,24,23,13,-4.537606040144393,11
4096,39,11,1,5,-4.548291694643937,6
4097,46,15,83,8,-4.551826612706302,7
4098,85,19,107,11,-4.552488211197707,8
4099,112,10,74,6,-4.553694289700708,4
4100,67,13,109,6,-4.5540965230597985,7
4101,23,15,70,8,-4.554568026577778,7
4102,104,16,99,8,-4.562749239239297,8
4103,51,10,35,6,-4.57204831013762,4
4104,95,14,99,8,-4.572737764013027,6
4105,58,23,7,12,-4.575034525669345,11
4106,30,12,100,7,-4.575260966636385,5
4107,87,24,71,13,-4.583143708944139,11
4108,8,30,60,16,-4.584471076654315,14
4109,87,16,78,8,-4.58830392973274,8
4110,96,32,50,18,-4.592653394244437,14
4111,88,94,7,52,-4.598064452346123,42
4112,64,20,55,13,-4.5985097101065335,7
4113,95,13,77,7,-4.601493224452909,6
4114,30,11,23,6,-4.601908928188203,5
4115,3,35,7,21,-4.603775118928218,14
4116,86,72,37,40,-4.607837359690986,32
4117,55,42,7,25,-4.609551229914398,17
4118,71,23,28,14,-4.615433087215965,9
4119,9,17,49,9,-4.620658268254684,8
4120,87,63,8,36,-4.620917268255847,27
4121,30,18,20,10,-4.629914367675179,8
4122,110,15,106,8,-4.633960085739299,7
4123,25,22,60,12,-4.636282806493915,10
4124,88,24,43,14,-4.636555985964769,10
4125,109,19,73,11,-4.637139105733963,8
4126,13,14,73,8,-4.6427133386229835,6
4127,25,15,27,8,-4.649655011418167,7
4128,63,27,64,15,-4.655022536417097,12
4129,47,15,25,8,-4.655390231832644,7
4130,98,14,55,9,-4.662824671110213,5
4131,96,15,85,10,-4.66914990767306,5
4132,8,12,52,7,-4.669562642233976,5
4133,81,22,53,13,-4.67351225402936,9
4134,20,27,70,16,-4.678638629207435,11
4135,87,17,108,10,-4.682000852364703,7
4136,5,16,71,9,-4.686451238703376,7
4137,41,26,60,14,-4.687979614839917,12
4138,38,15,9,8,-4.694842617038376,7
4139,60,45,55,25,-4.699539635247212,20
4140,68,19,15,12,-4.704332289270896,7
4141,88,38,11,22,-4.710454574435896,16
4142,43,12,3,7,-4.714914149800726,5
4143,86,17,47,10,-4.720142586161406,7
4144,75,14,15,9,-4.7291616067808215,5
4145,54,16,85,10,-4.730021736475019,6
4146,46,11,6,6,-4.730994669309113,5
4147,46,41,8,22,-4.737192297274267,19
4148,3,11,97,7,-4.7402730889790226,4
4149,12,10,54,5,-4.742791545217388,5
4150,7,97,16,54,-4.743286222921811,43
4151,65,57,55,32,-4.74405737741087,25
4152,77,16,25,9,-4.745845616411638,7
4153,63,38,74,21,-4.748458787006122,17
4154,5,30,90,18,-4.752640516818982,12
4155,50,16,93,10,-4.755526241513055,6
4156,97,16,60,8,-4.770560692259115,8
4157,31,15,12,8,-4.770632464521183,7
4158,70,13,90,7,-4.771084444295363,6
4159,54,31,13,19,-4.774769567956581,12
4160,28,26,93,16,-4.7762193932866115,10
4161,5,12,9,7,-4.777710715122403,5
4162,40,33,87,18,-4.786263242325296,15
4163,5,33,76,19,-4.788314400539968,14
4164,1,17,9,8,-4.79405950293998,9
4165,76,14,84,8,-4.794994736983406,6
4166,9,29,8,14,-4.796436219845456,15
4167,25,11,111,6,-4.797175922879397,5
4168,84,17,98,11,-4.7978961426483835,6
4169,96,22,75,15,-4.80138149231193,7
4170,16,16,110,9,-4.801952356665633,7
4171,51,36,114,19,-4.804348446858166,17
4172,108,13,96,7,-4.805162668071275,6
4173,17,13,100,9,-4.805895298432701,4
4174,106,12,6,7,-4.810944704219048,5
4175,8,30,83,16,-4.811627367676455,14
4176,68,27,23,14,-4.819829270426411,13
4177,54,15,14,10,-4.820525855929131,5
4178,25,19,31,10,-4.823839301099763,9
4179,67,15,8,9,-4.8319098461555825,6
4180,39,39,75,21,-4.835166255544909,18
4181,51,99,16,56,-4.839584083452132,43
4182,87,54,13,33,-4.840241985428211,21
4183,64,20,83,11,-4.840996077098241,9
4184,51,30,5,19,-4.841333405150811,11
4185,54,15,94,9,-4.847006166736521,6
4186,100,23,104,14,-4.850527098250833,9
4187,32,12,97,7,-4.851459349576838,5
4188,57,15,84,8,-4.861320185300776,7
4189,89,10,5,7,-4.862465640901751,3
4190,106,54,37,29,-4.865641247327304,25
4191,110,10,88,5,-4.870544753091406,5
4192,38,11,51,7,-4.873684208436107,4
4193,88,12,85,7,-4.873754317610231,5
4194,18,15,81,9,-4.877040041598751,6
4195,114,11,30,6,-4.882071098465157,5
4196,95,11,69,7,-4.882909765417962,4
4197,3,12,8,5,-4.887819375016217,7
4198,9,44,65,26,-4.887961308210908,18
4199,5,39,83,21,-4.890865835189012,18
4200,55,27,76,17,-4.892389867780943,10
4201,54,48,46,28,-4.906943181154002,20
4202,108,12,54,8,-4.909695920764134,4
4203,17,31,65,20,-4.917244641739983,11
4204,106,56,74,32,-4.924754963776778,24
4205,36,40,86,23,-4.927433251240003,17
4206,9,22,114,15,-4.931319071415344,7
4207,55,21,20,12,-4.931554548881413,9
4208,108,11,37,6,-4.94147061612662,5
4209,87,14,77,8,-4.94240192025149,6
4210,49,12,76,7,-4.943121216792114,5
4211,17,33,86,17,-4.94749630527028,16
4212,68,19,56,10,-4.94813216675333,9
4213,8,32,13,19,-4.955794878282507,13
4214,39,20,57,11,-4.958056164867145,9
4215,96,36,20,21,-4.958331873160827,15
4216,77,18,39,10,-4.961640817784316,8
4217,90,23,96,14,-4.963939687748077,9
4218,8,12,62,8,-4.964220736900479,4
4219,38,16,109,10,-4.9644619615709695,6
4220,107,49,40,30,-4.964616090179718,19
4221,87,15,1,8,-4.968031301569398,7
4222,51,18,14,12,-4.969794868699568,6
4223,15,17,23,10,-4.9841342107101605,7
4224,39,25,27,13,-4.989393098929608,12
4225,71,15,74,8,-4.993812181109021,7
4226,63,30,104,17,-4.993963037729945,13
4227,68,12,32,8,-4.994599728673894,4
4228,106,41,7,21,-5.003800212982272,20
4229,5,26,93,16,-5.004460526821323,10
4230,63,14,81,8,-5.016441825370757,6
4231,63,29,55,16,-5.056066807562622,13
4232,65,17,46,11,-5.06610491085495,6
4233,107,90,16,56,-5.070523610597529,34
4234,33,13,90,8,-5.072843762888294,5
4235,20,10,32,7,-5.08216341529211,3
4236,62,17,7,10,-5.083532766636536,7
4237,104,61,107,36,-5.084587806965312,25
4238,95,24,60,14,-5.089480392621887,10
4239,110,11,87,7,-5.0925904586002675,4
4240,104,25,53,14,-5.094260383198605,11
4241,70,23,55,13,-5.1032220329288345,10
4242,4,18,75,11,-5.1124286444655915,7
4243,58,30,40,16,-5.133397385337809,14
4244,4,12,109,7,-5.135069245647407,5
4245,20,58,107,33,-5.1376242090423085,25
4246,88,15,44,8,-5.148664566159752,7
4247,9,24,106,14,-5.150083731218861,10
4248,79,13,63,8,-5.150156389678723,5
4249,50,46,87,25,-5.151620252108098,21
4250,63,54,8,30,-5.156454172512432,24
4251,39,14,111,8,-5.158992286191917,6
4252,5,12,67,7,-5.159840528973067,5
4253,56,11,91,6,-5.160182814393273,5
4254,50,40,2,23,-5.1602643680773745,17
4255,47,26,75,17,-5.17693162231529,9
4256,97,17,75,10,-5.183439015487436,7
4257,51,24,4,15,-5.183921696313045,9
4258,38,30,107,18,-5.186335555044985,12
4259,48,24,84,15,-5.188857256683019,9
4260,6,20,44,13,-5.189449523361067,7
4261,113,13,40,8,-5.193726392686624,5
4262,89,15,41,9,-5.196780511481055,6
4263,55,18,34,10,-5.202160532736089,8
4264,91,12,33,6,-5.213867650447791,6
4265,84,11,67,7,-5.2182852361738945,4
4266,37,22,40,12,-5.218981261850287,10
4267,5,11,35,6,-5.226534281744142,5
4268,112,17,88,10,-5.231027938888665,7
4269,13,47,71,26,-5.235216499316669,21
4270,25,21,91,12,-5.23677892954369,9
4271,14,15,65,8,-5.239230657167625,7
4272,40,15,98,8,-5.239271076053038,7
4273,79,19,16,11,-5.241758370421844,8
4274,40,26,25,15,-5.242222631716463,11
4275,92,11,28,7,-5.266199037582341,4
4276,109,32,88,19,-5.272527791460708,13
4277,30,17,50,10,-5.272543611954233,7
4278,88,11,56,6,-5.280224334897691,5
4279,28,19,14,12,-5.2887953454841945,7
4280,35,11,30,6,-5.293385259461386,5
4281,55,25,111,15,-5.307717141421055,10
4282,65,62,87,37,-5.3117934902325254,25
4283,60,15,61,8,-5.316729344745585,7
4284,102,14,97,9,-5.335160623731844,5
4285,65,18,62,10,-5.345755023288058,8
4286,97,35,7,19,-5.356987360153851,16
4287,63,30,75,17,-5.362343223381898,13
4288,109,24,107,15,-5.374789076628487,9
4289,7,24,100,14,-5.390746304293862,10
4290,54,24,93,15,-5.392828840599425,9
4291,90,31,54,18,-5.397442007333916,13
4292,66,11,9,6,-5.404825557202403,5
4293,58,11,4,7,-5.405037105567146,4
4294,37,11,49,6,-5.405793666619149,5
4295,18,18,91,11,-5.437015235679075,7
4296,87,77,16,44,-5.4420666817930625,33
4297,57,18,97,10,-5.45235309786646,8
4298,71,43,75,27,-5.454468163058883,16
4299,30,17,49,10,-5.458460770772242,7
4300,68,11,80,7,-5.466227321340817,4
4301,86,30,69,17,-5.472935342008731,13
4302,36,17,99,11,-5.476671917231901,6
4303,75,10,14,6,-5.479308338136782,4
4304,70,23,114,14,-5.484820175107314,9
4305,40,49,65,28,-5.488110460552834,21
4306,54,20,15,11,-5.491526659354752,9
4307,62,10,18,6,-5.493140482819633,4
4308,40,20,62,10,-5.493314127309688,10
4309,102,10,67,6,-5.497246561771841,4
4310,109,13,32,7,-5.508051897308618,6
4311,83,19,95,12,-5.510188596504647,7
4312,37,59,87,35,-5.516733087496061,24
4313,20,10,62,6,-5.517288163699186,4
4314,7,33,28,20,-5.522079859732704,13
4315,57,24,88,13,-5.524909922819241,11
4316,102,14,33,8,-5.525239013163607,6
4317,88,23,30,12,-5.525413582454541,11
4318,68,45,114,26,-5.528966703625285,19
4319,68,30,54,18,-5.5293608762892505,12
4320,23,31,106,16,-5.535479536227777,15
4321,18,36,28,20,-5.538955354420102,16
4322,84,16,75,9,-5.542746956131477,7
4323,75,51,86,28,-5.544222274149607,23
4324,84,18,25,11,-5.5466876181289715,7
4325,31,53,36,30,-5.548564460468652,23
4326,25,41,8,25,-5.550067480025435,16
4327,4,11,46,6,-5.55622187464566,5
4328,95,10,31,6,-5.5581891593402775,4
4329,10,11,63,7,-5.56040496031845,4
4330,104,60,37,36,-5.5634752610620195,24
4331,54,31,11,18,-5.565049065297328,13
4332,69,11,42,6,-5.570250078296482,5
4333,71,17,12,10,-5.576190752449122,7
4334,68,54,39,30,-5.5781138607757725,24
4335,79,14,7,8,-5.580594560810973,6
4336,68,21,62,12,-5.5910040455918875,9
4337,25,32,87,18,-5.592843725263718,14
4338,63,11,99,6,-5.5958077337997105,5
4339,98,17,70,11,-5.604121247592223,6
4340,18,13,38,7,-5.6081144260834686,6
4341,43,14,27,7,-5.609839390205424,7
4342,50,15,100,9,-5.612526049660052,6
4343,90,14,30,8,-5.614315415339312,6
4344,50,10,6,6,-5.616920699281765,4
4345,3,22,114,14,-5.6169459155328765,8
4346,50,48,16,28,-5.617696720442926,20
4347,50,26,95,15,-5.619957219349124,11
4348,17,21,5,14,-5.625033929201381,7
4349,73,28,86,15,-5.62531345595925,13
4350,54,16,78,10,-5.628849020354991,6
4351,77,11,109,6,-5.645459503468275,5
4352,74,23,73,14,-5.649045009007229,9
4353,97,13,39,8,-5.649731064357227,5
4354,97,10,4,6,-5.649870700339136,4
4355,61,13,9,8,-5.652969843590385,5
4356,112,13,18,9,-5.661004110361593,4
4357,68,12,43,7,-5.661402151081362,5
4358,82,11,54,7,-5.66427830231393,4
4359,37,48,16,28,-5.664774565241773,20
4360,99,31,16,18,-5.66581833704302,13
4361,37,39,75,25,-5.670197882049106,14
4362,25,10,94,5,-5.671887186214519,5
4363,68,18,47,11,-5.681623794437403,7
4364,95,10,102,6,-5.68531996234082,4
4365,55,25,30,15,-5.686463879094617,10
4366,5,46,106,28,-5.689619439430468,18
4367,43,10,23,6,-5.689859175567735,4
4368,32,10,70,5,-5.692479372096212,5
4369,85,10,28,6,-5.696401332147328,4
4370,69,26,51,16,-5.708510695737556,10
4371,54,11,29,6,-5.709851331879876,5
4372,40,26,114,17,-5.715670519906255,9
4373,102,10,23,6,-5.716053822653882,4
4374,37,18,41,11,-5.716493275276267,7
4375,17,13,98,7,-5.72342530511381,6
4376,51,26,25,15,-5.726135112848949,11
4377,48,20,11,12,-5.726887293490206,8
4378,9,14,45,9,-5.727853500458989,5
4379,25,48,13,26,-5.729332953997916,22
4380,106,42,25,26,-5.737688222420908,16
4381,9,44,107,25,-5.73971793039242,19
4382,77,12,36,7,-5.751140829309579,5
4383,53,13,58,6,-5.756559382638664,7
4384,71,30,64,19,-5.764884814228726,11
4385,35,19,11,11,-5.768399159544,8
4386,35,17,16,11,-5.790753866714487,6
4387,63,26,98,15,-5.795644107915215,11
4388,55,28,74,16,-5.797157459674131,12
4389,64,45,7,25,-5.8010614589687695,20
4390,51,32,27,20,-5.804553521558319,12
4391,88,84,86,49,-5.809179862821955,35
4392,20,13,79,8,-5.810117746469,5
4393,106,28,80,17,-5.812470547213422,11
4394,49,10,100,5,-5.813425744151518,5
4395,5,16,40,9,-5.82052725169565,7
4396,87,13,58,8,-5.838329621055198,5
4397,93,13,20,7,-5.845044762429803,6
4398,46,37,74,23,-5.850135921281392,14
4399,84,12,85,8,-5.86323385034251,4
4400,112,20,7,12,-5.863389950487481,8
4401,7,17,34,10,-5.863504951401834,7
4402,65,52,51,32,-5.865717524678075,20
4403,95,36,54,20,-5.865979569344108,16
4404,9,17,62,10,-5.866001447424248,7
4405,81,27,86,18,-5.867982727130611,9
4406,28,49,104,28,-5.869912935195165,21
4407,106,53,54,29,-5.8811146934590965,24
4408,36,12,46,7,-5.88209418081934,5
4409,34,19,109,11,-5.8910600256239505,8
4410,25,16,93,9,-5.904464695396422,7
4411,107,33,100,17,-5.907266287901797,16
4412,45,15,41,10,-5.914462706154762,5
4413,63,10,93,6,-5.917563250275586,4
4414,114,20,73,12,-5.924435121305104,8
4415,63,45,37,27,-5.933785173114153,18
4416,71,40,16,25,-5.9385712385767615,15
4417,7,15,33,8,-5.9471342175078945,7
4418,14,12,39,7,-5.9475481477923315,5
4419,10,12,97,6,-5.950831581917707,6
4420,53,52,68,31,-5.964244334939566,21
4421,40,18,97,11,-5.966918416140385,7
4422,76,19,112,10,-5.9691922227288705,9
4423,18,20,64,12,-5.974775055211904,8
4424,27,12,74,6,-5.991317096712257,6
4425,31,25,114,14,-5.9918765203954925,11
4426,97,20,87,13,-5.994662201156698,7
4427,70,57,54,34,-6.000249372764341,23
4428,17,10,99,6,-6.011623328938978,4
4429,71,31,30,18,-6.024215205048038,13
4430,46,20,95,12,-6.027785407812037,8
4431,50,17,91,11,-6.027790824025908,6
4432,65,30,64,17,-6.029400567070288,13
4433,86,38,64,22,-6.0307653391474,16
4434,31,31,75,17,-6.03348213428737,14
4435,98,24,7,15,-6.033686003781978,9
4436,32,16,8,9,-6.041444852098721,7
4437,68,48,16,30,-6.053036366464971,18
4438,63,19,90,11,-6.053395439788755,8
4439,68,19,69,11,-6.057902735707315,8
4440,28,18,23,10,-6.0662027716624305,8
4441,86,64,11,37,-6.067296101317877,27
4442,41,27,23,16,-6.068042449918635,11
4443,48,14,74,7,-6.068043245358376,7
4444,108,10,79,7,-6.083927302918585,3
4445,107,23,111,12,-6.08814286411973,11
4446,86,39,98,22,-6.096402500191196,17
4447,88,40,23,26,-6.098802854801483,14
4448,60,12,102,7,-6.1025406778466875,5
4449,7,12,90,7,-6.108519045195329,5
4450,31,13,81,9,-6.1171597913254026,4
4451,88,35,25,23,-6.12387967695023,12
4452,97,24,55,15,-6.128965912516969,9
4453,80,13,31,9,-6.13276887148396,4
4454,48,10,23,6,-6.136507124451631,4
4455,46,14,109,8,-6.137839688733693,6
4456,63,16,78,8,-6.142144937717797,8
4457,17,23,28,14,-6.144271685607967,9
4458,39,48,40,29,-6.1478732659202615,19
4459,112,15,31,10,-6.149641402394962,5
4460,58,13,16,8,-6.156802466115247,5
4461,89,10,63,7,-6.159771716986654,3
4462,36,47,13,29,-6.167141158071527,18
4463,60,28,54,17,-6.171029746511067,11
4464,76,23,97,13,-6.171425808149793,10
4465,84,54,28,32,-6.1786789402149065,22
4466,35,14,55,8,-6.18171019735336,6
4467,2,28,63,16,-6.200018491851487,12
4468,70,28,74,15,-6.203999405338755,13
4469,34,18,86,11,-6.204793306210544,7
4470,65,21,38,11,-6.2252846155522565,10
4471,55,31,80,17,-6.225846961531595,14
4472,6,17,13,10,-6.2267295430039455,7
4473,50,41,104,25,-6.230364171354916,16
4474,9,32,28,18,-6.2373511594029205,14
4475,62,15,54,9,-6.240490314200173,6
4476,5,17,43,10,-6.250727481432203,7
4477,39,22,92,12,-6.263991845659126,10
4478,95,12,15,7,-6.265255655621161,5
4479,43,28,16,18,-6.265547285575691,10
4480,5,45,20,28,-6.270373633442783,17
4481,4,21,86,13,-6.2794844995496994,8
4482,102,11,41,7,-6.282861273718874,4
4483,92,12,16,9,-6.284475222709882,3
4484,64,16,70,11,-6.2860092045587415,5
4485,57,26,87,16,-6.2897492965158115,10
4486,114,17,23,11,-6.291790840234865,6
4487,83,16,39,10,-6.297771796270442,6
4488,55,13,29,8,-6.301089833667023,5
4489,57,11,76,7,-6.324386635638288,4
4490,60,12,80,7,-6.326591453694461,5
4491,112,14,54,9,-6.326711825622494,5
4492,94,18,13,11,-6.333471224988879,7
4493,98,20,11,11,-6.3386776528601825,9
4494,27,13,92,7,-6.356396578041118,6
4495,44,12,28,6,-6.3579705752280935,6
4496,56,21,7,12,-6.361794853449643,9
4497,84,32,74,17,-6.37967811989364,15
4498,71,27,50,16,-6.37993434567586,11
4499,77,13,74,8,-6.38427445953612,5
4500,77,13,106,7,-6.407119934187455,6
4501,88,57,65,36,-6.40859303614746,21
4502,77,19,107,11,-6.4169470483546815,8
4503,86,30,100,16,-6.417275816064882,14
4504,53,13,28,8,-6.426853986137569,5
4505,33,16,40,11,-6.427211772717695,5
4506,109,20,41,13,-6.432688342356182,7
4507,16,49,75,29,-6.443913435512627,20
4508,87,20,4,13,-6.445923142452617,7
4509,28,10,6,6,-6.452419128804086,4
4510,86,30,27,19,-6.453315924089684,11
4511,87,25,90,15,-6.454852453391627,10
4512,9,20,70,13,-6.477071321597405,7
4513,104,10,48,6,-6.493358473776669,4
4514,54,20,1,12,-6.4933945511101445,8
4515,28,15,35,8,-6.525585250622974,7
4516,55,10,49,6,-6.541972088163769,4
4517,18,21,77,14,-6.545250800191178,7
4518,27,29,16,18,-6.548968077490891,11
4519,53,44,107,27,-6.556157644451659,17
4520,25,37,104,21,-6.567754121461538,16
4521,114,26,53,15,-6.571088082289226,11
4522,1,26,40,16,-6.58137324665705,10
4523,43,40,13,22,-6.584602401444724,18
4524,96,28,65,16,-6.593487230396348,12
4525,37,18,80,11,-6.59536314979572,7
4526,30,16,34,10,-6.601140375094156,6
4527,51,75,39,44,-6.615588090433581,31
4528,81,18,71,11,-6.61709770119633,7
4529,100,30,16,19,-6.617449381235234,11
4530,68,25,97,15,-6.6196959499026775,10
4531,37,20,39,12,-6.620813501609792,8
4532,5,48,25,29,-6.626414170343123,19
4533,65,30,4,18,-6.635600395573753,12
4534,64,28,16,18,-6.646602698554465,10
4535,5,26,32,16,-6.6474470604519045,10
4536,114,15,76,10,-6.653911993113485,5
4537,37,19,71,11,-6.65399605348867,8
4538,88,74,54,44,-6.654867228993362,30
4539,71,11,83,6,-6.6562053803338666,5
4540,13,13,14,9,-6.663851771345143,4
4541,88,36,27,20,-6.672694825026895,16
4542,70,14,49,8,-6.672966411521807,6
4543,74,20,102,12,-6.679496862829723,8
4544,47,20,107,12,-6.679988416533417,8
4545,38,21,7,12,-6.693287820142804,9
4546,106,11,111,8,-6.697425895741327,3
4547,91,12,15,6,-6.697476716978325,6
4548,74,15,83,8,-6.703298030488857,7
4549,12,21,60,10,-6.704537300087495,11
4550,97,35,28,22,-6.716635909782018,13
4551,32,10,65,6,-6.718474357729474,4
4552,95,11,100,6,-6.722166987268522,5
4553,98,11,27,6,-6.722224921815258,5
4554,95,13,14,8,-6.731405281187272,5
4555,96,38,74,24,-6.731828732252354,14
4556,71,10,94,6,-6.748460655059317,4
4557,18,19,30,11,-6.749976540021853,8
4558,90,13,53,8,-6.752088210585149,5
4559,23,43,13,24,-6.759962036733637,19
4560,107,23,33,13,-6.763493299081546,10
4561,108,10,81,6,-6.778588424753946,4
4562,27,14,6,8,-6.780540737481573,6
4563,29,14,39,8,-6.784253183420456,6
4564,31,10,55,6,-6.798197972656263,4
4565,71,10,49,6,-6.8003776926672845,4
4566,13,25,108,16,-6.801707995205208,9
4567,45,18,60,10,-6.802248227913869,8
4568,114,16,100,10,-6.806713890734191,6
4569,38,22,39,13,-6.807429116943057,9
4570,96,20,51,12,-6.8091583197949745,8
4571,9,14,25,9,-6.810304163725227,5
4572,4,13,56,7,-6.816273515879698,6
4573,104,22,30,12,-6.820606807560422,10
4574,31,69,68,41,-6.8216343585610195,28
4575,68,10,89,6,-6.826893879643049,4
4576,46,20,7,13,-6.8293660676717325,7
4577,106,25,95,16,-6.830338155584793,9
4578,96,14,78,9,-6.830515928543477,5
4579,96,80,86,49,-6.839782165020976,31
4580,51,99,7,62,-6.849475435937795,37
4581,95,29,13,17,-6.852052215706936,12
4582,96,19,114,12,-6.857320738328298,7
4583,11,17,75,10,-6.860129083231022,7
4584,4,43,60,24,-6.864343045215706,19
4585,87,48,7,30,-6.8660731048454515,18
4586,78,13,84,8,-6.8775899451817635,5
4587,99,15,106,10,-6.882359612487446,5
4588,5,47,114,28,-6.885144276646174,19
4589,65,22,90,12,-6.887045978873849,10
4590,88,16,76,9,-6.891817282335724,7
4591,53,10,49,6,-6.90781300095477,4
4592,55,36,104,22,-6.909075624793387,14
4593,46,38,16,23,-6.920639082616032,15
4594,30,19,75,11,-6.923427737676235,8
4595,19,15,68,8,-6.924559442631492,7
4596,51,29,20,16,-6.932399765519158,13
4597,88,12,99,7,-6.939131232028662,5
4598,39,13,19,7,-6.948417519072791,6
4599,50,11,15,7,-6.9507529081852075,4
4600,104,18,32,12,-6.959225086389547,6
4601,36,34,16,21,-6.96230955324868,13
4602,12,18,53,10,-6.969479938527376,8
4603,33,17,8,11,-6.9756022430017754,6
4604,39,23,46,12,-6.9816941894182785,11
4605,55,20,17,11,-6.987444025974705,9
4606,13,23,111,13,-6.988942249892523,10
4607,1,19,114,12,-6.990089974683046,7
4608,5,15,62,9,-6.9927087595973925,6
4609,48,13,80,9,-6.99747900943173,4
4610,86,14,45,8,-7.001591160951406,6
4611,98,30,91,18,-7.00578119436403,12
4612,53,27,87,15,-7.0226395127694765,12
4613,40,15,95,9,-7.026458120737084,6
4614,18,16,100,9,-7.026565168419708,7
4615,51,15,62,9,-7.028758985101916,6
4616,112,15,41,9,-7.039515078376401,6
4617,38,28,37,17,-7.041316380566512,11
4618,43,14,94,9,-7.042088076774411,5
4619,73,16,65,10,-7.056062739811477,6
4620,65,39,30,24,-7.058570840380226,15
4621,64,13,44,8,-7.05920038211248,5
4622,25,21,100,12,-7.062312436550092,9
4623,49,14,50,8,-7.064134383315742,6
4624,38,21,63,14,-7.071277555225252,7
4625,98,14,102,8,-7.075813129571892,6
4626,70,35,28,21,-7.078735797739843,14
4627,85,11,63,6,-7.079874969572199,5
4628,3,20,36,13,-7.093052097907007,7
4629,83,28,86,19,-7.104640535135333,9
4630,107,12,67,8,-7.124134838046419,4
4631,18,21,50,12,-7.126622020199371,9
4632,3,23,88,14,-7.12663205785296,9
4633,67,11,88,8,-7.127393540580368,3
4634,48,32,63,20,-7.1299692009467925,12
4635,107,57,75,39,-7.131800392099847,18
4636,75,39,18,23,-7.143872456900073,16
4637,60,17,5,11,-7.144002600647478,6
4638,93,23,87,14,-7.164798687762666,9
4639,14,14,86,8,-7.166696838482464,6
4640,112,16,36,10,-7.175574629533439,6
4641,47,12,23,8,-7.180906240191951,4
4642,63,20,27,11,-7.19472225275396,9
4643,3,12,41,9,-7.218526234783575,3
4644,40,20,35,13,-7.223846117897835,7
4645,106,60,13,37,-7.224822308695077,23
4646,75,10,20,6,-7.241047227766171,4
4647,40,32,54,19,-7.243609732204197,13
4648,5,14,31,9,-7.246607645789562,5
4649,90,13,46,8,-7.250761878801305,5
4650,93,12,98,7,-7.251352809271133,5
4651,54,11,38,7,-7.25460278530091,4
4652,81,19,75,12,-7.259552889264539,7
4653,31,31,41,19,-7.267301725174955,12
4654,98,17,20,11,-7.267496359610283,6
4655,70,16,110,10,-7.267896542251016,6
4656,96,10,62,7,-7.268496266352443,3
4657,57,13,106,7,-7.272492874678534,6
4658,68,20,55,13,-7.273979151335479,7
4659,20,42,65,27,-7.275621933808214,15
4660,54,16,91,9,-7.277443024389351,7
4661,106,24,2,14,-7.283295399336635,10
4662,13,19,44,12,-7.286242475868136,7
4663,11,14,93,10,-7.294440502359943,4
4664,36,17,97,10,-7.301788222671786,7
4665,91,41,16,27,-7.309347152714906,14
4666,106,24,39,14,-7.312269199982411,10
4667,55,26,109,14,-7.3182997081126135,12
4668,65,23,1,13,-7.319832649719675,10
4669,5,42,70,25,-7.323141246130922,17
4670,107,25,58,16,-7.327155673902655,9
4671,8,25,73,15,-7.3587900254771785,10
4672,23,13,49,8,-7.360298065336568,5
4673,61,18,53,12,-7.3640960284192225,6
4674,64,12,49,7,-7.364918196286091,5
4675,114,10,77,6,-7.365477220397804,4
4676,33,16,25,11,-7.36592627296452,5
4677,74,15,34,10,-7.367415754617588,5
4678,71,10,73,6,-7.373234065194552,4
4679,5,10,1,6,-7.391988711274882,4
4680,46,41,37,27,-7.398384968299376,14
4681,55,65,16,42,-7.408891459698617,23
4682,69,27,13,17,-7.410798113719346,10
4683,41,34,36,18,-7.412500474371831,16
4684,91,19,8,12,-7.416456742894205,7
4685,109,44,54,28,-7.42149631612999,16
4686,18,23,63,15,-7.424434558796219,8
4687,39,26,84,16,-7.428032986604076,10
4688,43,17,64,10,-7.438967254563773,7
4689,84,28,8,18,-7.447150756775401,10
4690,71,13,70,7,-7.447387393345607,6
4691,75,30,46,18,-7.449361290092636,12
4692,100,17,75,9,-7.449782688238095,8
4693,97,53,86,32,-7.453774682156136,21
4694,110,21,37,12,-7.457046552670356,9
4695,68,64,40,41,-7.460123554388274,23
4696,53,12,45,7,-7.463487107897495,5
4697,31,37,64,23,-7.4738922265185375,14
4698,63,15,108,9,-7.475559971035059,6
4699,36,14,70,8,-7.476080415111231,6
4700,89,10,48,7,-7.47675761274391,3
4701,96,11,41,8,-7.480521636982391,3
4702,52,11,65,8,-7.511225896554021,3
4703,77,18,55,11,-7.520653437888105,7
4704,55,11,6,8,-7.526848268362213,3
4705,51,31,64,19,-7.52751645484338,12
4706,33,20,51,14,-7.541152096210821,6
4707,107,16,12,11,-7.554377135078079,5
4708,5,14,34,10,-7.5706698448560905,4
4709,77,12,46,7,-7.574271980014295,5
4710,36,10,72,6,-7.585561627806541,4
4711,88,18,58,11,-7.5880987725104365,7
4712,36,20,18,12,-7.59490287850123,8
4713,41,27,87,17,-7.608960513510674,10
4714,84,16,38,9,-7.623292346759982,7
4715,63,63,16,38,-7.626908070861485,25
4716,91,13,23,7,-7.630492751883035,6
4717,80,22,96,14,-7.6325568595370585,8
4718,5,29,97,19,-7.639418302115126,10
4719,30,27,53,16,-7.642346295513206,11
4720,88,20,108,13,-7.642505031143239,7
4721,9,35,16,23,-7.644783932906994,12
4722,60,11,70,7,-7.646435749026202,4
4723,31,13,33,7,-7.647223417443056,6
4724,96,24,37,14,-7.66584492569651,10
4725,11,32,5,20,-7.6874421575338765,12
4726,7,25,111,15,-7.6903234257719815,10
4727,11,11,64,8,-7.699861982788658,3
4728,104,39,40,25,-7.699889638025223,14
4729,77,15,41,10,-7.700447698799745,5
4730,64,13,46,8,-7.70178518963715,5
4731,87,44,68,27,-7.713445601645925,17
4732,102,19,57,11,-7.725209435984635,8
4733,2,28,28,18,-7.726967938716942,10
4734,112,28,86,17,-7.7335421287606225,11
4735,52,10,63,6,-7.736846011905837,4
4736,84,11,44,6,-7.741464370739851,5
4737,54,13,73,8,-7.746921178252214,5
4738,1,11,46,6,-7.7522327504760105,5
4739,25,49,37,29,-7.755599308877523,20
4740,73,11,53,7,-7.756297558195456,4
4741,86,14,10,8,-7.764445720347282,6
4742,81,15,41,10,-7.770221546669878,5
4743,114,14,92,10,-7.774797164908212,4
4744,18,28,68,17,-7.775566947501909,11
4745,48,15,50,10,-7.798532000224026,5
4746,110,12,114,8,-7.80031681097971,4
4747,49,21,75,13,-7.802050873504806,8
4748,81,23,60,14,-7.817127893520487,9
4749,46,46,25,27,-7.8204011950255445,19
4750,98,17,8,11,-7.832264077196576,6
4751,54,57,63,36,-7.834983225160243,21
4752,2,11,7,7,-7.836909370766421,4
4753,109,19,53,12,-7.841205358929898,7
4754,13,41,114,23,-7.855529583445472,18
4755,91,26,106,17,-7.859341034872017,9
4756,35,12,44,7,-7.859665557157517,5
4757,90,25,114,15,-7.8701656835045455,10
4758,23,17,55,9,-7.8715706098888365,8
4759,60,13,84,10,-7.874921397384912,3
4760,104,17,15,11,-7.875168892784025,6
4761,16,14,103,9,-7.884424733518567,5
4762,69,15,70,10,-7.889236203805598,5
4763,108,11,76,7,-7.890267325318873,4
4764,76,23,16,12,-7.906950340887347,11
4765,82,10,88,6,-7.9125780836424955,4
4766,18,22,54,13,-7.917650548154778,9
4767,20,16,33,10,-7.9280624383644875,6
4768,64,12,77,6,-7.928282722369054,6
4769,34,10,18,7,-7.93407311360503,3
4770,77,13,27,8,-7.939137496569419,5
4771,87,17,73,12,-7.94220715025842,5
4772,53,12,89,7,-7.949973026478008,5
4773,5,25,65,15,-7.967561696591303,10
4774,13,30,81,19,-7.974436586188656,11
4775,4,12,12,8,-7.976222296376226,4
4776,84,28,5,17,-7.986435375626319,11
4777,70,16,13,10,-7.990308468406848,6
4778,96,19,102,12,-7.995631160966494,7
4779,39,51,86,30,-8.000320040451781,21
4780,31,18,43,8,-8.011472574516002,10
4781,25,12,48,7,-8.01244102921806,5
4782,9,11,35,6,-8.012816785902407,5
4783,50,41,75,27,-8.02466935745211,14
4784,27,16,37,10,-8.030406858059436,6
4785,12,11,9,7,-8.058955245687951,4
4786,91,15,51,10,-8.060157448942936,5
4787,86,24,43,16,-8.063012454340047,8
4788,46,13,53,8,-8.064750592390654,5
4789,39,72,16,44,-8.06739491860954,28
4790,97,16,110,10,-8.077466293642948,6
4791,5,61,8,37,-8.080732178020163,24
4792,37,11,29,7,-8.087342118064884,4
4793,50,30,60,17,-8.087484578525556,13
4794,7,31,45,19,-8.09975676882742,12
4795,57,14,114,9,-8.115945976762234,5
4796,88,19,100,12,-8.116464062015531,7
4797,16,15,81,10,-8.120114808218235,5
4798,29,12,75,7,-8.144839094845086,5
4799,112,10,4,6,-8.145974306589782,4
4800,33,11,68,7,-8.166895131198164,4
4801,47,19,16,12,-8.178952833737181,7
4802,98,13,108,8,-8.179403178791246,5
4803,60,35,104,25,-8.183651908443377,10
4804,61,10,107,6,-8.19056957850756,4
4805,35,10,13,6,-8.193263635625328,4
4806,13,13,19,8,-8.19483920053687,5
4807,109,24,11,16,-8.196422948591085,8
4808,57,25,8,16,-8.20914757769532,9
4809,3,24,40,16,-8.21009163331203,8
4810,104,28,41,16,-8.222150207467427,12
4811,39,10,102,6,-8.224547128845817,4
4812,106,21,69,13,-8.230262561693124,8
4813,2,10,94,6,-8.235738884159375,4
4814,55,49,40,31,-8.264830770768937,18
4815,14,12,37,7,-8.266467835075433,5
4816,84,28,20,19,-8.268193588498614,9
4817,55,34,50,20,-8.268886532039618,14
4818,76,12,75,7,-8.269580351796622,5
4819,55,15,100,8,-8.275270908208638,7
4820,91,18,41,12,-8.276671952774393,6
4821,106,31,90,21,-8.28384546124837,10
4822,97,22,18,14,-8.298065482812461,8
4823,50,25,76,17,-8.328303760573554,8
4824,29,11,28,7,-8.329043879308335,4
4825,51,39,76,26,-8.339242903099509,13
4826,98,18,13,12,-8.341994513785483,6
4827,5,22,7,14,-8.357081514884824,8
4828,9,11,11,7,-8.359525570926444,4
4829,107,21,45,13,-8.374668953212842,8
4830,52,14,28,8,-8.38312541721312,6
4831,104,10,67,6,-8.393331116483225,4
4832,20,19,91,11,-8.407006886407046,8
4833,38,10,30,7,-8.411592281207323,3
4834,91,24,68,14,-8.412577437061726,10
4835,8,20,64,13,-8.418575329228208,7
4836,79,21,48,13,-8.423308200700253,8
4837,90,19,73,12,-8.424101991862472,7
4838,13,20,90,13,-8.424919065495569,7
4839,13,31,47,19,-8.428277126431585,12
4840,114,20,55,13,-8.432483182241098,7
4841,70,24,96,13,-8.437417991026262,11
4842,20,12,52,8,-8.437421503459813,4
4843,114,32,8,21,-8.446067232393617,11
4844,107,30,80,20,-8.450019757222567,10
4845,96,14,95,9,-8.450373982592183,5
4846,16,10,85,7,-8.463981088255796,3
4847,68,56,75,37,-8.483707229345061,19
4848,1,16,75,11,-8.487454866261048,5
4849,37,10,94,7,-8.495177713557316,3
4850,40,28,64,18,-8.49607162432113,10
4851,41,20,20,12,-8.49990215185767,8
4852,45,10,91,6,-8.504304930616431,4
4853,69,17,63,12,-8.506537399631055,5
4854,88,23,62,14,-8.51262512712999,9
4855,48,28,86,18,-8.527783865058888,10
4856,106,13,12,9,-8.530975907772833,4
4857,20,12,18,8,-8.532272478061662,4
4858,3,14,84,8,-8.535145143847831,6
4859,62,13,114,8,-8.549556180002718,5
4860,36,11,78,7,-8.552435160203329,4
4861,84,42,63,25,-8.556534866486706,17
4862,51,86,86,51,-8.557465951431581,35
4863,7,19,78,11,-8.565348954184037,8
4864,55,23,95,15,-8.57500650986488,8
4865,49,15,40,9,-8.588514005098899,6
4866,50,22,90,14,-8.598522697493998,8
4867,60,34,23,22,-8.60880728241122,12
4868,97,19,41,12,-8.638943706099203,7
4869,112,14,51,9,-8.662465094799598,5
4870,31,31,9,20,-8.678153869820548,11
4871,88,16,77,10,-8.678317130754186,6
4872,60,15,76,11,-8.678706996102923,4
4873,39,14,110,10,-8.694421097429624,4
4874,2,10,30,6,-8.704387763563812,4
4875,20,35,63,21,-8.70524806527441,14
4876,102,15,63,9,-8.71016569998991,6
4877,45,10,58,6,-8.721721801464438,4
4878,17,22,4,15,-8.72773506800961,7
4879,88,35,39,22,-8.74018182363142,13
4880,11,23,104,15,-8.742484307216113,8
4881,106,14,38,7,-8.74501943352997,7
4882,39,21,100,13,-8.754145947004437,8
4883,18,23,106,15,-8.778191080978738,8
4884,51,22,97,15,-8.785196874414885,7
4885,31,28,107,15,-8.798674063671838,13
4886,42,10,106,7,-8.802546839644418,3
4887,47,18,36,12,-8.810892372607713,6
4888,76,28,63,19,-8.821395394022662,9
4889,36,19,63,12,-8.822881427312195,7
4890,63,47,51,28,-8.825173206487683,19
4891,77,13,49,9,-8.842593838828112,4
4892,87,15,32,10,-8.84415502943487,5
4893,3,17,53,11,-8.845189139081638,6
4894,51,16,102,10,-8.84826485855953,6
4895,84,12,112,8,-8.85414320771021,4
4896,43,29,107,19,-8.857175926154701,10
4897,12,16,23,10,-8.872217683410863,6
4898,114,30,28,18,-8.875783073761175,12
4899,40,16,28,9,-8.877350715587879,7
4900,91,26,87,17,-8.887112732676092,9
4901,97,12,69,8,-8.888377862411463,4
4902,109,20,7,13,-8.908032141063202,7
4903,107,15,89,10,-8.908975430626485,5
4904,25,19,110,13,-8.917701672558223,6
4905,88,101,16,66,-8.91886711620617,35
4906,91,10,11,7,-8.923724837318142,3
4907,31,12,73,8,-8.93891957013575,4
4908,80,13,11,8,-8.941133144462878,5
4909,32,11,28,7,-8.963821007682874,4
4910,114,20,47,12,-8.969382880850324,8
4911,60,17,17,11,-8.995312545980157,6
4912,69,10,62,6,-9.00706523943993,4
4913,36,15,5,9,-9.008614310253614,6
4914,112,10,58,6,-9.041979275484929,4
4915,112,18,39,11,-9.062101008825088,7
4916,75,34,28,22,-9.068390514566694,12
4917,86,29,44,19,-9.073857704921481,10
4918,39,23,74,14,-9.075238839119185,9
4919,8,34,95,21,-9.07920947405897,13
4920,51,11,48,6,-9.079697327016946,5
4921,31,15,109,10,-9.113887572404183,5
4922,17,11,92,7,-9.114563540800457,4
4923,17,18,104,11,-9.118260519592534,7
4924,1,25,86,16,-9.124826219314393,9
4925,18,42,13,26,-9.15021879704067,16
4926,5,43,50,26,-9.156049369840705,17
4927,43,27,39,16,-9.158740133364715,11
4928,30,12,27,7,-9.159316291712273,5
4929,40,15,92,10,-9.168940871834318,5
4930,102,15,40,9,-9.171373555966687,6
4931,49,15,41,9,-9.171912615870816,6
4932,86,39,41,26,-9.172157333193885,13
4933,88,30,15,21,-9.176202112652083,9
4934,9,16,17,10,-9.184055414811953,6
4935,40,17,73,11,-9.199997222971483,6
4936,40,12,2,8,-9.204153353273353,4
4937,76,15,54,10,-9.214343370527448,5
4938,4,15,27,9,-9.21491506769711,6
4939,81,11,64,7,-9.217681779438383,4
4940,37,15,64,10,-9.227089681457189,5
4941,107,31,2,20,-9.235597195463592,11
4942,76,10,15,6,-9.241288842836557,4
4943,66,13,65,9,-9.24629898792323,4
4944,93,13,75,8,-9.279825087560207,5
4945,77,19,63,13,-9.291814452323939,6
4946,22,11,109,7,-9.30323095736105,4
4947,67,15,86,9,-9.306541844943451,6
4948,107,12,110,8,-9.307853181235297,4
4949,70,17,50,10,-9.316243790355681,7
4950,58,16,60,10,-9.319426070200468,6
4951,109,12,30,8,-9.335355797138938,4
4952,29,10,109,5,-9.339951738191695,5
4953,96,46,16,32,-9.342765312407819,14
4954,48,10,98,7,-9.346073134818255,3
4955,9,25,18,17,-9.349773872691086,8
4956,50,12,23,9,-9.354699302165743,3
4957,39,16,109,12,-9.356347251836707,4
4958,87,15,15,9,-9.356894108440965,6
4959,111,15,28,10,-9.365771514395545,5
4960,39,17,76,12,-9.374915521858478,5
4961,51,11,29,7,-9.382792177373643,4
4962,36,11,109,8,-9.390936468630553,3
4963,109,25,63,15,-9.392892060380623,10
4964,76,37,86,24,-9.404159373470087,13
4965,93,35,65,21,-9.411885467293354,14
4966,112,11,38,8,-9.413940162098223,3
4967,1,10,15,7,-9.42159486047143,3
4968,92,14,64,7,-9.432471863302016,7
4969,53,12,78,7,-9.436495389192622,5
4970,63,11,32,7,-9.44232166344675,4
4971,94,14,86,9,-9.444879533453692,5
4972,110,18,51,12,-9.45247565646282,6
4973,68,28,76,21,-9.459920139276978,7
4974,29,10,112,6,-9.468799644939955,4
4975,66,17,107,11,-9.469730190602778,6
4976,7,29,37,18,-9.500511382222342,11
4977,99,22,37,15,-9.502759058160713,7
4978,2,13,114,8,-9.50915856241785,5
4979,80,14,90,10,-9.509239360264804,4
4980,36,17,8,11,-9.51236026695053,6
4981,69,25,60,14,-9.516572001635847,11
4982,25,32,20,21,-9.520523686179052,11
4983,31,22,1,13,-9.525804060927038,9
4984,108,13,106,9,-9.535201707134298,4
4985,68,15,92,10,-9.538113226799515,5
4986,97,24,13,15,-9.567486234498414,9
4987,60,44,64,30,-9.569439655645416,14
4988,20,32,39,19,-9.577578273711381,13
4989,7,20,73,12,-9.582485903794177,8
4990,39,14,80,9,-9.589468521855673,5
4991,53,13,8,9,-9.596286006275326,4
4992,84,18,83,11,-9.60947373437216,7
4993,8,14,99,8,-9.611065592860308,6
4994,9,16,76,11,-9.62150457184245,5
4995,109,17,70,11,-9.623350653501726,6
4996,109,22,74,15,-9.62539761750223,7
4997,63,17,100,10,-9.628829836647936,7
4998,53,23,41,15,-9.631953807885303,8
4999,107,28,57,18,-9.636004223648033,10
5000,104,10,93,6,-9.63796658188527,4
5001,114,10,22,5,-9.649313306364819,5
5002,17,15,41,10,-9.654478177971626,5
5003,63,16,111,10,-9.656549842780757,6
5004,9,30,87,18,-9.657202776782615,12
5005,71,12,100,8,-9.66068752031631,4
5006,108,19,53,11,-9.662757254259093,8
5007,45,14,35,8,-9.663816215290336,6
5008,38,12,53,8,-9.664145468055217,4
5009,109,17,17,11,-9.67292277687966,6
5010,84,13,30,9,-9.677396996952375,4
5011,87,19,100,11,-9.686243494464469,8
5012,57,13,78,8,-9.706642642705255,5
5013,32,16,16,10,-9.721720922013692,6
5014,16,13,89,8,-9.733195931265595,5
5015,18,42,16,28,-9.75454627994462,14
5016,28,10,38,6,-9.755543154623545,4
5017,62,12,100,7,-9.768885934940618,5
5018,51,10,6,6,-9.769920787003374,4
5019,83,24,37,15,-9.783726366978415,9
5020,93,10,62,6,-9.798162399200404,4
5021,84,15,104,9,-9.801640239199909,6
5022,107,27,48,17,-9.812988008703408,10
5023,75,25,104,16,-9.822163907084752,9
5024,57,13,54,10,-9.824315369895016,3
5025,98,10,53,6,-9.839111782848335,4
5026,79,26,86,17,-9.841357831333447,9
5027,63,16,30,10,-9.842696842263113,6
5028,18,12,76,8,-9.8476224935035,4
5029,91,34,63,23,-9.863803572303501,11
5030,71,15,17,9,-9.874078720771612,6
5031,39,39,18,26,-9.885046818102037,13
5032,3,14,25,9,-9.907996037168818,5
5033,2,10,95,7,-9.9203126299905,3
5034,17,10,38,6,-9.957251396991314,4
5035,88,18,73,12,-9.974203425238962,6
5036,52,13,87,8,-9.98485251805505,5
5037,109,14,93,9,-9.987067099161266,5
5038,10,13,107,8,-9.98735340517921,5
5039,48,11,34,7,-9.987399142382838,4
5040,65,25,95,16,-9.987438820754939,9
5041,57,12,75,8,-10.001839571130395,4
5042,43,15,54,9,-10.003127798418701,6
5043,9,13,43,8,-10.011482215577137,5
5044,29,15,60,9,-10.014518053593555,6
5045,3,12,20,8,-10.029309207648433,4
5046,18,14,11,9,-10.031989827572827,5
5047,29,12,70,7,-10.037060199943543,5
5048,38,10,44,7,-10.048373138060267,3
5049,71,11,91,7,-10.05883228964285,4
5050,28,10,110,6,-10.066740720619942,4
5051,106,12,79,8,-10.079963228120917,4
5052,94,14,28,10,-10.089052267433146,4
5053,74,11,89,7,-10.093150392265773,4
5054,8,24,18,17,-10.10300859124231,7
5055,36,36,53,25,-10.11473282468799,11
5056,102,20,50,12,-10.118106239071224,8
5057,35,10,8,7,-10.118762046100299,3
5058,15,20,8,12,-10.121581558030638,8
5059,70,14,46,9,-10.128652016947743,5
5060,109,10,92,7,-10.132066653367776,3
5061,31,37,53,23,-10.136338371296794,14
5062,23,11,96,7,-10.143008283174424,4
5063,39,13,58,9,-10.147489402696785,4
5064,102,14,76,9,-10.166991590900437,5
5065,69,11,40,8,-10.175676528085834,3
5066,9,24,64,17,-10.178655144521004,7
5067,104,13,89,8,-10.178686881843591,5
5068,37,41,97,27,-10.190687502541847,14
5069,33,13,71,9,-10.195530501937561,4
5070,2,15,98,9,-10.198603389321665,6
5071,96,24,48,16,-10.200121519345737,8
5072,106,63,16,43,-10.201810935158226,20
5073,37,36,11,24,-10.207174749413833,12
5074,68,24,25,16,-10.21179043309895,8
5075,31,17,30,10,-10.214096274935343,7
5076,25,43,7,29,-10.249875265637383,14
5077,106,16,67,10,-10.252161434234205,6
5078,99,12,77,9,-10.252199704478636,3
5079,104,12,34,8,-10.27427919250402,4
5080,84,10,71,7,-10.279461085413814,3
5081,78,13,40,10,-10.282455211399137,3
5082,63,18,57,11,-10.314939985261887,7
5083,81,14,7,8,-10.321582987727558,6
5084,1,13,37,8,-10.34216426905315,5
5085,63,17,1,10,-10.344681903521664,7
5086,7,10,94,7,-10.355621654064775,3
5087,81,13,104,7,-10.361322759461327,6
5088,18,11,3,8,-10.36192093091692,3
5089,1,24,16,18,-10.362823173840477,6
5090,93,16,106,10,-10.37915501513517,6
5091,7,11,110,6,-10.42257657923173,5
5092,114,19,95,12,-10.422604339796184,7
5093,39,16,44,10,-10.434810009571377,6
5094,60,11,34,8,-10.444545857082172,3
5095,62,10,49,7,-10.453994552700898,3
5096,31,10,6,6,-10.459894630543896,4
5097,77,12,23,8,-10.47207373365885,4
5098,102,19,107,12,-10.474471969151432,7
5099,8,35,75,24,-10.477015226263449,11
5100,102,14,75,10,-10.47886729381523,4
5101,20,37,50,25,-10.501577095705532,12
5102,12,12,114,7,-10.504954578013217,5
5103,37,14,89,8,-10.519274673853,6
5104,36,27,27,17,-10.523349599331356,10
5105,97,19,71,13,-10.523533962196899,6
5106,56,16,86,11,-10.543126647721751,5
5107,54,45,37,30,-10.551214199845804,15
5108,84,24,11,16,-10.56388232319587,8
5109,9,15,95,9,-10.569002592922953,6
5110,28,18,69,11,-10.575983527327306,7
5111,7,51,75,34,-10.587695481592943,17
5112,38,15,75,11,-10.597530026810052,4
5113,91,31,7,22,-10.60910028610159,9
5114,101,12,16,8,-10.62271769748288,4
5115,71,18,98,12,-10.627953776602759,6
5116,64,20,30,13,-10.642272986004782,7
5117,98,25,5,16,-10.662918685540621,9
5118,86,32,102,22,-10.668729155825625,10
5119,17,23,40,16,-10.673939896309559,7
5120,74,25,51,18,-10.704030149650722,7
5121,18,14,47,10,-10.710476641545714,4
5122,36,13,43,8,-10.713552025008546,5
5123,81,13,114,8,-10.713660949239014,5
5124,111,11,54,8,-10.714143810197228,3
5125,17,18,53,12,-10.71991335829738,6
5126,60,15,37,9,-10.721994289598655,6
5127,39,20,23,13,-10.742827162036495,7
5128,31,27,27,16,-10.758919665279386,11
5129,7,11,59,8,-10.771239818059199,3
5130,15,11,47,7,-10.775485769989336,4
5131,91,25,55,18,-10.791612827626562,7
5132,77,27,104,18,-10.795670361212089,9
5133,81,17,106,10,-10.816681182916206,7
5134,8,34,109,21,-10.819891467814774,13
5135,87,25,98,17,-10.830753925226263,8
5136,65,30,27,20,-10.856587825173339,10
5137,9,18,20,12,-10.86548400794927,6
5138,54,25,30,17,-10.869653792907938,8
5139,77,16,71,11,-10.872072685026803,5
5140,78,11,17,7,-10.875549356054371,4
5141,41,21,111,13,-10.875724405637953,8
5142,88,41,63,29,-10.892208716891064,12
5143,35,10,102,6,-10.90320798703147,4
5144,46,11,100,7,-10.904685887838546,4
5145,5,17,73,11,-10.90738305979487,6
5146,31,10,78,6,-10.912809716780334,4
5147,64,14,27,10,-10.925557497140751,4
5148,13,10,89,6,-10.939542022741616,4
5149,107,19,15,14,-10.951282290046715,5
5150,53,10,15,7,-10.9539479023651,3
5151,47,15,9,10,-10.968614103246171,5
5152,88,37,50,24,-10.986958086725291,13
5153,43,18,75,13,-10.9894348107113,5
5154,69,16,58,10,-10.993413968782217,6
5155,107,13,56,8,-11.000292497508868,5
5156,71,13,15,9,-11.00914391321026,4
5157,68,10,98,7,-11.014423279510455,3
5158,92,14,41,9,-11.016394202336143,5
5159,68,12,45,8,-11.02401972838907,4
5160,88,11,98,8,-11.027639102171303,3
5161,114,12,32,8,-11.045874107216177,4
5162,11,11,99,7,-11.04788337752713,4
5163,87,10,12,7,-11.056786464431308,3
5164,80,13,78,9,-11.09791576617006,4
5165,50,10,85,7,-11.098189393682759,3
5166,68,16,58,11,-11.098600977228577,5
5167,32,13,74,9,-11.101664191982367,4
5168,4,16,43,10,-11.162760468553993,6
5169,107,38,30,25,-11.164530658826866,13
5170,46,15,30,10,-11.187097177578686,5
5171,13,15,58,11,-11.187681570256993,4
5172,109,10,91,7,-11.192740070217315,3
5173,61,12,6,8,-11.200388242698184,4
5174,83,22,13,15,-11.207026527024828,7
5175,65,45,114,29,-11.20792553692763,16
5176,1,11,89,7,-11.20901106938993,4
5177,68,21,28,15,-11.213633194972727,6
5178,106,18,98,12,-11.217270403208776,6
5179,51,13,73,9,-11.219804453521853,4
5180,96,20,46,12,-11.223825219116964,8
5181,109,17,75,12,-11.242273446455997,5
5182,51,28,95,20,-11.244919045567018,8
5183,81,13,40,9,-11.249205674756395,4
5184,83,16,107,11,-11.24958512039028,5
5185,70,29,87,18,-11.250414739740132,11
5186,48,12,90,8,-11.252381363492235,4
5187,16,12,78,8,-11.25916175296747,4
5188,103,14,86,9,-11.266539954551964,5
5189,29,23,65,14,-11.27269887311909,9
5190,20,10,64,8,-11.273683916826545,2
5191,55,14,2,9,-11.276816159574057,5
5192,86,10,29,7,-11.288307199014056,3
5193,5,10,80,7,-11.295210617596885,3
5194,96,25,7,18,-11.300422106484014,7
5195,70,15,30,9,-11.302914088005606,6
5196,79,10,80,6,-11.30670069299901,4
5197,28,46,63,32,-11.30701920844641,14
5198,60,23,47,16,-11.31330562577917,7
5199,18,12,69,8,-11.324568934723304,4
5200,43,15,100,9,-11.350388483589276,6
5201,57,18,11,11,-11.36115181121274,7
5202,38,11,4,8,-11.395009854616482,3
5203,35,23,76,15,-11.39691854534874,8
5204,95,10,29,7,-11.401888238693147,3
5205,86,21,26,15,-11.412432841806389,6
5206,106,39,114,26,-11.417874917507989,13
5207,72,19,86,13,-11.423615729846851,6
5208,51,33,100,19,-11.434832550293006,14
5209,81,14,47,10,-11.445134927289029,4
5210,57,12,65,8,-11.482165332996512,4
5211,91,10,69,6,-11.501202941557144,4
5212,27,12,49,8,-11.521519655834481,4
5213,76,15,74,9,-11.544600382799558,6
5214,15,10,49,7,-11.54727068179138,3
5215,71,10,111,7,-11.563837134119527,3
5216,104,16,36,10,-11.564722196156035,6
5217,50,15,33,10,-11.568332857311571,5
5218,39,15,90,10,-11.577976501423594,5
5219,18,21,15,15,-11.590119158022436,6
5220,88,65,13,44,-11.59374697560307,21
5221,10,14,7,9,-11.631959119868696,5
5222,103,11,55,8,-11.639657223031874,3
5223,107,17,78,12,-11.645622319804351,5
5224,39,30,30,20,-11.676641348162722,10
5225,96,13,91,9,-11.692854193124042,4
5226,19,20,7,15,-11.707331952559505,5
5227,70,23,108,16,-11.716508786473792,7
5228,69,27,16,18,-11.757721074864538,9
5229,67,11,16,8,-11.761532223804268,3
5230,1,37,55,26,-11.769033555767942,11
5231,57,20,70,12,-11.777168573797624,8
5232,71,19,104,12,-11.784281392964676,7
5233,65,12,91,8,-11.784658313781671,4
5234,54,10,44,7,-11.791894285038754,3
5235,40,21,8,15,-11.791921402372775,6
5236,91,10,53,7,-11.811611902058761,3
5237,17,10,83,6,-11.812775268760374,4
5238,87,23,48,16,-11.827762552608771,7
5239,47,10,78,6,-11.843066191666676,4
5240,14,18,16,12,-11.861448285420282,6
5241,104,18,90,12,-11.89837391797068,6
5242,63,18,62,12,-11.898616241132698,6
5243,18,27,95,18,-11.951490678023534,9
5244,54,10,53,7,-11.951994898142779,3
5245,104,12,1,8,-12.020108292717424,4
5246,96,28,98,19,-12.0522531035848,9
5247,28,21,34,15,-12.064560123194633,6
5248,20,14,34,10,-12.080633416209027,4
5249,63,12,92,7,-12.136993324985582,5
5250,70,22,2,14,-12.153236389251056,8
5251,76,18,7,11,-12.196617315781682,7
5252,106,11,78,8,-12.21024325274275,3
5253,70,21,11,15,-12.225051268467027,6
5254,39,23,91,16,-12.232573714352018,7
5255,39,10,32,7,-12.25900875776762,3
5256,114,27,87,17,-12.286422589064637,10
5257,35,23,107,17,-12.292793992800659,6
5258,108,10,28,6,-12.299856976610261,4
5259,46,11,18,8,-12.326844972781839,3
5260,20,10,78,7,-12.337947782230119,3
5261,19,12,87,8,-12.345271535363189,4
5262,54,22,100,15,-12.349967715760693,7
5263,33,13,87,9,-12.350753088118475,4
5264,60,20,49,14,-12.35214452080387,6
5265,97,12,67,9,-12.35346782744064,3
5266,112,10,37,7,-12.392005916673295,3
5267,53,16,43,12,-12.41343484704957,4
5268,50,17,36,10,-12.423703215189779,7
5269,51,14,111,10,-12.456032818979448,4
5270,88,40,53,28,-12.503961998215974,12
5271,5,27,75,17,-12.535083552437035,10
5272,58,14,54,9,-12.535089602873326,5
5273,5,27,57,19,-12.572003913811173,8
5274,63,34,80,24,-12.572385685987724,10
5275,112,24,64,18,-12.57665854379635,6
5276,54,33,75,22,-12.657132724468568,11
5277,5,14,48,10,-12.657719903594751,4
5278,52,11,30,8,-12.667026316194525,3
5279,88,16,111,12,-12.710530076381987,4
5280,51,16,80,11,-12.71390947989441,5
5281,106,24,46,15,-12.725492516069489,9
5282,106,14,33,10,-12.736963404825662,4
5283,36,10,95,7,-12.746346244298937,3
5284,81,12,54,8,-12.757047966098474,4
5285,27,20,104,15,-12.796343894614779,5
5286,104,20,49,14,-12.812277987885736,6
5287,9,10,108,6,-12.825707088631287,4
5288,109,19,27,12,-12.854514856980064,7
5289,45,14,23,10,-12.875487654765546,4
5290,35,11,87,7,-12.88940090296237,4
5291,65,21,2,16,-12.8900275785182,5
5292,75,12,98,8,-12.900340980932176,4
5293,17,16,23,11,-12.920452187354222,5
5294,28,33,74,23,-12.957271538108255,10
5295,31,72,13,49,-12.99330264938673,23
5296,114,12,27,8,-13.009570993376595,4
5297,9,11,6,7,-13.029614696230583,4
5298,46,38,104,26,-13.083570903140272,12
5299,90,15,20,10,-13.08396173697106,5
5300,38,10,2,6,-13.106587736027677,4
5301,38,12,71,9,-13.11375866950239,3
5302,70,10,83,6,-13.118339150755117,4
5303,77,15,53,10,-13.125923769197522,5
5304,37,28,95,21,-13.149042342745602,7
5305,88,17,102,13,-13.153141792955822,4
5306,35,12,97,9,-13.15953893586328,3
5307,87,14,79,11,-13.17533484699995,3
5308,28,13,41,9,-13.19117071449606,4
5309,54,18,36,12,-13.217744798273172,6
5310,54,26,48,18,-13.218100464174018,8
5311,46,16,50,10,-13.220197801431315,6
5312,60,13,108,9,-13.225499906177387,4
5313,17,11,102,8,-13.231752901126407,3
5314,41,16,8,12,-13.244566662838952,4
5315,88,36,95,25,-13.24512473637818,11
5316,96,39,11,27,-13.252582377716239,12
5317,11,23,95,17,-13.263288005084238,6
5318,5,31,102,21,-13.269431869962297,10
5319,99,12,7,8,-13.274517260788413,4
5320,106,19,64,13,-13.295192075566398,6
5321,112,12,100,8,-13.302851040311163,4
5322,3,11,15,7,-13.34908879632687,4
5323,83,18,16,13,-13.35123547721314,5
5324,32,11,55,7,-13.36363963009391,4
5325,35,12,104,8,-13.369677424437175,4
5326,62,18,74,13,-13.411803700884379,5
5327,53,15,75,10,-13.423496737137004,5
5328,32,12,25,7,-13.427877456338663,5
5329,35,15,36,11,-13.440272285829963,4
5330,55,17,102,12,-13.448934349992442,5
5331,90,10,93,7,-13.452391800759145,3
5332,51,16,15,11,-13.474823536409177,5
5333,39,14,108,9,-13.481039273987522,5
5334,70,10,34,7,-13.500624883981926,3
5335,1,10,78,7,-13.511302040012385,3
5336,66,11,7,7,-13.514093541012448,4
5337,38,15,104,10,-13.530669032796668,5
5338,103,11,74,8,-13.53565105452587,3
5339,10,10,37,6,-13.538762623915119,4
5340,60,26,27,20,-13.540065663312776,6
5341,104,18,64,13,-13.541290561517043,5
5342,46,12,93,9,-13.65474091099076,3
5343,86,16,92,11,-13.67676060817369,5
5344,57,19,7,12,-13.697105013999769,7
5345,44,14,104,10,-13.703910249073422,4
5346,31,25,63,18,-13.714594813504094,7
5347,33,14,63,10,-13.733555706081619,4
5348,112,11,97,9,-13.794615799527321,2
5349,52,19,86,14,-13.851910838120485,5
5350,83,13,11,10,-13.863860744018641,3
5351,13,23,30,15,-13.875626061777945,8
5352,50,19,53,13,-13.883151416746287,6
5353,54,16,2,12,-13.913344645570438,4
5354,57,11,34,8,-13.937862830072245,3
5355,69,19,75,14,-13.94230448490658,5
5356,71,24,40,17,-13.948125771645659,7
5357,39,25,15,19,-14.010931018079326,6
5358,77,29,40,21,-14.048771071022598,8
5359,54,18,71,12,-14.18324547541803,6
5360,80,11,41,8,-14.186716292232557,3
5361,66,11,63,8,-14.209916362631542,3
5362,60,28,91,19,-14.21948701708733,9
5363,77,15,30,11,-14.240898393688356,4
5364,94,21,16,15,-14.265495530226403,6
5365,60,21,74,14,-14.268042080973927,7
5366,11,11,30,8,-14.299516136130784,3
5367,37,12,34,9,-14.300571264435137,3
5368,102,11,46,8,-14.307494713152051,3
5369,50,18,80,14,-14.309192739594003,4
5370,77,27,7,19,-14.33556677589385,8
5371,51,22,77,15,-14.341625905559265,7
5372,83,10,40,8,-14.347262135245904,2
5373,112,16,60,12,-14.375050795639751,4
5374,81,22,51,14,-14.413069140354862,8
5375,14,11,80,7,-14.435345395194508,4
5376,13,15,80,10,-14.445550827997446,5
5377,5,12,44,9,-14.447481002517355,3
5378,2,10,73,7,-14.457830254043136,3
5379,25,12,34,9,-14.468789684868275,3
5380,51,18,45,13,-14.493324057948728,5
5381,2,12,13,8,-14.516038794033763,4
5382,37,12,73,8,-14.533349572792924,4
5383,99,12,50,8,-14.581629542155014,4
5384,97,11,14,9,-14.634263785488013,2
5385,8,14,78,11,-14.668119505967436,3
5386,83,19,114,14,-14.71253096490687,5
5387,102,10,90,6,-14.739148726840858,4
5388,106,14,32,11,-14.741977351969277,3
5389,109,26,114,20,-14.744077219906973,6
5390,2,10,57,7,-14.75670329182861,3
5391,1,13,18,10,-14.814066225099426,3
5392,85,11,55,8,-14.836765173492132,3
5393,91,17,30,13,-14.854653528597783,4
5394,57,12,69,9,-14.86920981303713,3
5395,108,10,8,8,-14.88327570809189,2
5396,112,10,55,8,-14.907032679929216,2
5397,104,16,9,11,-14.915937256999365,5
5398,9,25,41,18,-14.929419745005406,7
5399,17,21,95,16,-14.970865650802967,5
5400,75,10,45,8,-15.003649946946844,2
5401,99,18,25,13,-15.014737107768294,5
5402,3,17,63,14,-15.071396371833842,3
5403,54,10,72,7,-15.080610884546303,3
5404,9,12,48,9,-15.097519161061683,3
5405,29,13,84,9,-15.120150931852738,4
5406,35,11,27,8,-15.129282720135883,3
5407,71,17,41,13,-15.162388636591329,4
5408,29,18,88,13,-15.20029012502142,5
5409,68,15,61,11,-15.24709195978541,4
5410,112,18,20,14,-15.347636279185814,4
5411,99,18,107,13,-15.347683777553833,5
5412,37,13,18,10,-15.368965567811568,3
5413,46,12,98,8,-15.381140721878973,4
5414,71,10,11,7,-15.386871545741162,3
5415,25,14,49,10,-15.43786379260084,4
5416,107,25,73,17,-15.460672720698524,8
5417,94,16,81,10,-15.463781780556559,6
5418,60,13,100,10,-15.468043250681323,3
5419,31,15,69,10,-15.502962092044207,5
5420,2,18,104,12,-15.50344370749933,6
5421,106,10,89,6,-15.508251121091035,4
5422,14,11,25,9,-15.536643242754739,2
5423,31,12,104,8,-15.561592201078605,4
5424,5,20,23,15,-15.563915929412014,5
5425,45,14,4,10,-15.600891470448104,4
5426,85,11,106,8,-15.605731963514037,3
5427,97,13,90,9,-15.62188808576594,4
5428,88,16,80,11,-15.676196886577952,5
5429,51,12,34,9,-15.6894891289244,3
5430,1,13,8,10,-15.702434313684371,3
5431,80,13,75,10,-15.71805205236554,3
5432,35,12,80,9,-15.72406211872363,3
5433,77,14,37,10,-15.73169378416834,4
5434,96,16,93,12,-15.73319462766121,4
5435,35,10,75,8,-15.755761764469415,2
5436,81,16,87,10,-15.759058609918435,6
5437,37,10,15,8,-15.78269510258246,2
5438,12,12,75,8,-15.785867542761379,4
5439,77,16,8,12,-15.792942369486319,4
5440,70,10,48,7,-15.796496446665468,3
5441,31,45,16,33,-15.837412153743443,12
5442,39,18,99,14,-15.84878961626863,4
5443,12,15,41,11,-15.852631956602023,4
5444,91,11,76,9,-15.872477419459234,2
5445,8,18,34,13,-15.876296726362224,5
5446,9,30,53,22,-15.894615033798411,8
5447,70,13,80,11,-15.90133341789594,2
5448,63,13,14,9,-15.961958621197994,4
5449,31,16,98,11,-16.004000710168857,5
5450,5,18,41,12,-16.050377082501456,6
5451,112,17,28,13,-16.099232147809676,4
5452,83,12,23,9,-16.123810814063006,3
5453,58,18,65,13,-16.230092308358206,5
5454,69,21,53,15,-16.247322250303586,6
5455,91,13,43,10,-16.255864059996068,3
5456,7,16,61,11,-16.426968020447948,5
5457,25,25,11,20,-16.429746187224737,5
5458,55,15,14,12,-16.464885141480416,3
5459,36,10,101,8,-16.627946704419497,2
5460,55,12,15,10,-16.63699492471769,2
5461,41,12,30,8,-16.67014747818193,4
5462,20,10,60,7,-16.689435106346487,3
5463,85,11,39,7,-16.691830444179978,4
5464,71,15,95,10,-16.72675418994599,5
5465,76,10,1,7,-16.815372977495876,3
5466,30,14,95,10,-16.836817117204564,4
5467,97,14,38,11,-16.838290194315167,3
5468,112,13,47,9,-16.872460541477547,4
5469,31,10,38,6,-16.97274158238424,4
5470,50,16,77,13,-16.97319460562341,3
5471,87,12,34,9,-16.98781036825935,3
5472,79,13,104,9,-17.056081750892357,4
5473,10,13,51,10,-17.100960272868033,3
5474,9,15,15,11,-17.12648608718579,4
5475,69,14,49,10,-17.144708838601282,4
5476,5,22,27,16,-17.186967099907662,6
5477,35,12,63,9,-17.190706154289504,3
5478,106,10,35,7,-17.319051156851785,3
5479,39,10,45,7,-17.32115834390289,3
5480,43,10,45,7,-17.339723268429022,3
5481,19,11,55,8,-17.435802328445057,3
5482,18,14,23,10,-17.468338798211544,4
5483,83,11,110,9,-17.575104905290946,2
5484,28,27,90,21,-17.5763540242808,6
5485,3,11,5,7,-17.694163901939547,4
5486,69,14,30,10,-17.76525861498344,4
5487,55,12,44,9,-17.771847163193563,3
5488,5,18,30,15,-17.81053305502534,3
5489,8,10,69,8,-17.824588271872045,2
5490,88,17,32,13,-17.824594134673823,4
5491,57,10,38,7,-17.846604787717634,3
5492,114,11,111,8,-17.846918134233796,3
5493,51,21,78,15,-17.855529352416692,6
5494,43,16,55,14,-17.88766939591472,2
5495,68,21,95,18,-17.962668451083434,3
5496,33,18,55,14,-17.969879843551904,4
5497,103,10,109,7,-18.37872283171988,3
5498,18,10,5,8,-18.464269170029826,2
5499,33,14,65,11,-18.512762180418843,3
5500,31,15,106,11,-18.52908676481624,4
5501,68,14,50,10,-18.562076689620618,4
5502,28,17,99,13,-18.754584808369174,4
5503,47,11,55,8,-18.857554518412744,3
5504,112,13,71,10,-18.866115742328503,3
5505,11,10,2,8,-18.92308479788875,2
5506,4,13,98,11,-18.936498509144613,2
5507,112,13,87,10,-18.936535119389838,3
5508,68,19,112,14,-18.94009636585638,5
5509,106,10,92,8,-19.041690772468705,2
5510,2,10,100,7,-19.143504228869272,3
5511,57,10,31,7,-19.217116599721326,3
5512,54,16,4,14,-19.244087603842104,2
5513,18,14,99,11,-19.290873438644514,3
5514,36,19,30,17,-19.30529767168729,2
5515,12,11,27,9,-19.43334632488541,2
5516,77,16,16,13,-19.494965112936953,3
5517,58,17,86,13,-19.50459908880172,4
5518,51,10,101,8,-19.538804927619935,2
5519,72,10,28,8,-19.667105139612282,2
5520,68,10,90,8,-19.75244962865367,2
5521,32,12,95,10,-19.760326388824467,2
5522,68,15,100,11,-19.919601065708385,4
5523,75,11,111,8,-20.026411874817093,3
5524,5,10,64,8,-20.37578731830582,2
5525,35,11,48,9,-20.438098241934796,2
5526,81,12,49,9,-20.5963472275708,3
5527,79,10,30,8,-20.824119521738712,2
5528,38,11,55,9,-20.87506721402826,2
5529,84,10,7,8,-21.17364400986741,2
5530,77,10,98,8,-21.266559747636286,2
5531,91,16,104,15,-21.31971827875211,1
5532,51,16,2,12,-21.322170492802826,4
5533,51,19,90,17,-21.393287092982963,2
5534,4,13,25,11,-21.42004260246313,2
5535,4,15,41,10,-21.480590173913868,5
5536,31,12,62,9,-21.790941067775986,3
5537,69,10,78,8,-22.058413120869442,2
5538,97,12,91,10,-22.175648770183788,2
5539,65,25,100,22,-22.41765276800298,3
5540,3,15,75,13,-22.902900400824407,2
5541,28,10,10,9,-23.03135332069283,1
5542,8,11,4,10,-23.17790508365148,1
5543,102,10,30,8,-23.768301124479738,2
5544,69,11,27,9,-23.965125451311458,2
5545,9,22,27,18,-24.023674987501078,4
5546,97,11,34,9,-24.058676404388496,2
5547,97,12,73,9,-24.10757303293757,3
5548,107,10,19,10,-24.226623453768692,0
5549,112,19,78,16,-24.293257718319964,3
5550,112,10,49,9,-24.460078908180627,1
5551,77,16,75,14,-26.22826719913648,2
5552,37,10,44,10,-28.25347707422472,0
5553,23,11,90,10,-28.300961743533676,1
