,againstHero,games,hero,losses,shift,wins
0,64,10,65,1,31.455780164415444,9
1,107,10,73,1,28.662979189254322,9
2,91,10,43,0,27.34458455824453,10
3,103,15,86,2,23.967936503754764,13
4,57,12,41,2,23.379405756490282,10
5,26,10,10,2,22.77202326046866,8
6,84,10,94,1,22.762013140609877,9
7,20,11,85,2,22.58682017719025,9
8,17,11,44,2,22.072912946241175,9
9,111,25,70,6,21.76194128198864,19
10,106,10,87,1,21.564542850873863,9
11,87,29,109,6,21.22636324198765,23
12,74,14,110,3,20.875047711546735,11
13,64,10,9,2,20.434576500484816,8
14,110,12,109,2,20.16933250309851,10
15,41,13,10,2,19.737157878272868,11
16,5,10,9,2,19.535484203654335,8
17,55,12,75,2,19.502608543209234,10
18,110,12,29,2,19.248543702222978,10
19,62,13,50,3,19.2021134597274,10
20,57,18,28,3,19.087300718744142,15
21,87,10,85,2,19.06738234368308,8
22,62,12,71,1,19.04348733516107,11
23,26,11,88,3,18.785991491960512,8
24,70,15,86,4,18.585222369284793,11
25,18,10,37,2,18.37479944857912,8
26,106,12,20,4,18.311540077061185,8
27,58,11,87,2,18.229025747195358,9
28,51,11,98,3,18.11615896281521,8
29,79,12,7,3,18.096381711285996,9
30,93,13,48,2,18.078353771886377,11
31,90,11,76,4,18.0318690370992,7
32,63,13,70,3,17.959510637912523,10
33,41,10,110,1,17.607251464829996,9
34,63,13,76,2,17.535738224915978,11
35,87,17,46,5,17.514030324475865,12
36,26,11,49,4,17.344464565076983,7
37,30,22,65,5,17.168512411131367,17
38,26,13,54,5,16.93978716229654,8
39,43,14,38,5,16.91598228541753,9
40,38,12,15,3,16.880495720481193,9
41,63,13,28,3,16.83915101157232,10
42,20,10,48,2,16.747092552182814,8
43,73,16,109,4,16.722107664046142,12
44,57,13,76,3,16.71990929044005,10
45,88,14,75,3,16.698120760316787,11
46,30,13,85,3,16.38402642563884,10
47,62,13,103,4,16.29915650058687,9
48,59,11,103,3,16.266656443008642,8
49,88,18,49,4,16.108818713025215,14
50,90,12,91,4,16.098702445179015,8
51,55,16,109,4,15.902114621962271,12
52,17,15,38,4,15.678044683298898,11
53,29,12,73,3,15.669782329836798,9
54,16,10,59,4,15.561569445873218,6
55,70,13,88,3,15.44587119057327,10
56,74,11,112,3,15.445414304360199,8
57,90,11,18,3,15.206260273523743,8
58,90,17,88,5,15.203720699131468,12
59,84,14,40,5,15.139436492633184,9
60,57,15,37,4,15.067776643574769,11
61,73,14,23,4,15.06705739412856,10
62,14,10,65,2,15.014185877069243,8
63,9,10,51,3,14.933479318486382,7
64,26,24,38,7,14.873702675608982,17
65,93,11,17,3,14.792328082005683,8
66,93,25,38,8,14.706979782976543,17
67,88,14,13,6,14.6368480815469,8
68,62,19,20,5,14.584809923949425,14
69,110,11,50,3,14.531978974156038,8
70,111,30,62,9,14.365589379046465,21
71,107,25,62,8,14.352538477201138,17
72,28,10,66,4,14.329185091749263,6
73,86,12,17,3,14.311620358508236,9
74,46,11,91,3,14.304066831342244,8
75,84,10,44,3,14.273373064789189,7
76,60,10,8,3,14.262033464961128,7
77,50,12,109,4,14.261856398454313,8
78,98,11,71,3,14.175605929164409,8
79,110,16,8,4,14.09581292777676,12
80,17,13,37,5,14.003196529897787,8
81,57,20,9,5,13.952239963411898,15
82,46,14,79,5,13.926744437290191,9
83,70,12,109,3,13.902253335630233,9
84,26,33,107,8,13.875366782102597,25
85,55,22,2,7,13.871872112800908,15
86,63,10,10,3,13.847715879097754,7
87,54,26,109,8,13.824526520753494,18
88,38,16,73,6,13.771113964229547,10
89,111,16,109,5,13.722443192828694,11
90,37,10,13,3,13.710588735524032,7
91,20,18,10,5,13.692854024847371,13
92,26,13,69,4,13.66583811938565,9
93,84,17,13,6,13.614397809771186,11
94,37,12,5,3,13.593067112324485,9
95,13,15,73,5,13.471561712276639,10
96,86,16,55,6,13.429599224429367,10
97,90,10,93,4,13.383501710064952,6
98,70,12,74,3,13.332522800110311,9
99,18,13,2,4,13.31796160775977,9
100,89,12,73,4,13.292782754035754,8
101,58,10,89,3,13.242354787086834,7
102,64,16,86,5,13.126489420837816,11
103,112,10,50,3,13.007963386743388,7
104,63,15,79,5,12.990676793013693,10
105,37,13,34,4,12.941927105411443,9
106,3,11,8,3,12.917286316124727,8
107,87,11,14,3,12.902634224263666,8
108,6,14,66,4,12.900366001703459,10
109,54,13,104,4,12.823245238040407,9
110,87,13,5,4,12.788098556943204,9
111,69,10,41,4,12.786110356364535,6
112,8,13,89,4,12.710180677943116,9
113,73,11,90,3,12.699639901607053,8
114,63,11,86,3,12.694676726792158,8
115,28,28,109,9,12.60200219907949,19
116,18,16,84,5,12.53715723328449,11
117,93,22,62,7,12.439036445917942,15
118,20,18,23,5,12.419097927334024,13
119,93,12,26,4,12.342400061412198,8
120,55,21,62,8,12.32662089581423,13
121,107,26,6,8,12.322254797620149,18
122,93,17,50,6,12.303370496346986,11
123,2,20,76,7,12.297418547243822,13
124,84,17,62,6,12.256108525265194,11
125,51,15,48,4,12.237016972870082,11
126,74,20,48,7,12.230658480119438,13
127,10,23,23,9,12.202189639863427,14
128,93,20,41,5,12.152619394683915,15
129,49,10,62,4,12.115401300524658,6
130,58,11,103,3,12.093407699535737,8
131,79,11,112,3,12.089617166544242,8
132,38,15,10,4,12.029907406435383,11
133,98,15,11,5,11.975065250902471,10
134,104,16,98,6,11.93364499732059,10
135,93,10,76,3,11.9232506042626,7
136,18,13,17,5,11.905263091036245,8
137,48,17,111,5,11.902706300174232,12
138,43,14,109,5,11.866460109925438,9
139,23,15,62,4,11.828374088275869,11
140,15,10,79,3,11.756403792330063,7
141,70,13,62,5,11.719880801732709,8
142,8,17,71,6,11.702151139266467,11
143,93,15,91,5,11.673165263369297,10
144,107,14,70,5,11.658453467748302,9
145,98,17,15,6,11.628891195956703,11
146,65,16,18,5,11.593628436717697,11
147,16,18,13,6,11.568229122492738,12
148,65,16,102,6,11.565057266886955,10
149,38,22,109,7,11.561969316834697,15
150,109,15,6,5,11.553622356231047,10
151,41,31,109,7,11.540113156994366,24
152,17,20,41,5,11.462467383182338,15
153,9,10,97,4,11.373867326772803,6
154,46,18,9,7,11.371108835096301,11
155,2,22,103,6,11.358008021341288,16
156,13,13,41,5,11.285884419294261,8
157,93,14,1,4,11.222746146114876,10
158,85,16,37,4,11.183890538456172,12
159,15,10,28,3,11.176545961741331,7
160,26,13,46,5,11.17021351687407,8
161,93,19,37,6,11.135373057728058,13
162,98,12,110,4,11.026999619900328,8
163,30,21,9,6,11.009407613122825,15
164,38,14,6,4,11.005398790381081,10
165,30,10,43,3,10.958461383133036,7
166,87,17,51,6,10.954751209558498,11
167,11,10,8,3,10.874801270533911,7
168,30,11,62,4,10.859839313714291,7
169,98,48,41,18,10.835326353590219,30
170,37,13,63,5,10.805969524077794,8
171,87,27,6,9,10.792781333267998,18
172,30,25,103,8,10.782874613377906,17
173,17,16,23,5,10.781653305644484,11
174,93,37,9,12,10.753480854770812,25
175,50,10,37,4,10.742277179240864,6
176,55,20,30,8,10.741156330527383,12
177,8,13,66,4,10.73746092576915,9
178,91,10,85,5,10.702453755941072,5
179,37,14,41,5,10.694476243263011,9
180,107,16,109,6,10.668493285549742,10
181,75,16,16,5,10.668295124883429,11
182,38,13,58,4,10.642287291889902,9
183,98,37,88,11,10.639663528048942,26
184,65,10,101,4,10.616476001261294,6
185,86,12,109,5,10.607119538943415,7
186,103,14,109,4,10.579033749442829,10
187,70,15,65,5,10.573807897523746,10
188,98,32,76,12,10.566257306689167,20
189,20,17,49,6,10.413212284497671,11
190,29,10,17,3,10.395985227153457,7
191,93,12,75,5,10.370088912225684,7
192,2,11,75,4,10.369833561069749,7
193,2,16,73,6,10.299221262346556,10
194,104,20,28,6,10.280976450513137,14
195,70,22,84,8,10.2219111812329,14
196,65,12,96,5,10.190345361441286,7
197,60,10,38,4,10.186949801542621,6
198,74,17,18,6,10.161044876408575,11
199,109,14,84,5,10.149942855967595,9
200,2,31,86,10,10.078946678849759,21
201,63,18,54,7,10.075840147553762,11
202,10,18,1,6,10.049405294208206,12
203,63,13,9,5,10.036609783490736,8
204,65,14,59,6,10.036164804159641,8
205,88,11,30,5,10.02483572373662,6
206,76,17,34,6,9.994247540573088,11
207,34,14,91,5,9.98713094249012,9
208,29,10,70,3,9.97437186041017,7
209,111,24,38,9,9.966212518632439,15
210,10,17,55,7,9.95517779426481,10
211,55,46,87,15,9.941456749458233,31
212,93,11,70,4,9.928875321549775,7
213,87,13,17,5,9.922998390575081,8
214,10,14,50,5,9.907166966632534,9
215,107,30,41,12,9.880991735942342,18
216,32,22,109,8,9.859589833142886,14
217,28,10,64,4,9.858359509289869,6
218,79,31,48,12,9.853595538086754,19
219,111,20,37,8,9.840471570719451,12
220,6,34,44,13,9.768613303295998,21
221,73,21,111,8,9.713634051639158,13
222,111,42,54,15,9.68998535179476,27
223,29,32,38,11,9.681299801122258,21
224,88,11,85,4,9.65630194872786,7
225,55,23,54,7,9.648181025800831,16
226,98,26,62,10,9.641858129313677,16
227,23,22,89,8,9.576875474490599,14
228,60,21,65,8,9.571951123571171,13
229,32,14,88,4,9.505084521049728,10
230,43,16,28,5,9.500596764145225,11
231,6,11,58,4,9.489496457414935,7
232,103,11,19,4,9.481054864710421,7
233,65,17,44,7,9.443702457838901,10
234,70,10,55,4,9.43695211448136,6
235,57,11,10,4,9.43267475148189,7
236,34,16,74,6,9.430626027485216,10
237,76,14,62,7,9.422068732882327,7
238,91,20,76,7,9.390956065597498,13
239,93,14,30,5,9.378386095833301,9
240,46,16,8,6,9.372412655150535,10
241,49,17,86,8,9.34317243367324,9
242,23,15,55,6,9.33524063849589,9
243,50,17,23,7,9.300090532650529,10
244,43,14,50,5,9.27474781724881,9
245,54,37,41,13,9.187270230665858,24
246,30,20,87,7,9.180499280009718,13
247,50,15,48,6,9.13089598930206,9
248,93,29,103,11,9.099325117611023,18
249,26,12,32,5,9.09769401619869,7
250,106,13,109,5,9.062668099795829,8
251,91,16,50,5,9.044194652502608,11
252,74,35,76,12,9.02110943529627,23
253,30,19,54,7,8.941378731198725,12
254,107,20,110,8,8.933567921834609,12
255,10,11,85,5,8.810276618143424,6
256,32,17,107,5,8.731768023357226,12
257,79,16,75,5,8.729196308002653,11
258,23,23,37,8,8.700238300329007,15
259,34,18,109,7,8.662734980033562,11
260,84,27,10,10,8.646492586790982,17
261,37,40,86,16,8.603825624585157,24
262,76,36,28,14,8.544961108918415,22
263,41,18,62,7,8.537234992782361,11
264,89,10,109,4,8.517312082575362,6
265,54,23,76,10,8.51187755649848,13
266,93,31,84,11,8.465363334016377,20
267,84,26,85,12,8.43749111456715,14
268,98,21,1,7,8.436557583367685,14
269,73,21,10,7,8.419335562342072,14
270,43,17,87,6,8.417190390098328,11
271,90,11,89,4,8.396796914570167,7
272,90,19,23,7,8.394839451243378,12
273,23,23,93,10,8.387201678617911,13
274,48,12,38,4,8.376240779730173,8
275,77,12,8,4,8.373441110755328,8
276,84,20,63,8,8.347628578121027,12
277,104,11,84,4,8.339235828654417,7
278,8,10,35,4,8.335806667410798,6
279,76,18,41,7,8.284971187696902,11
280,65,12,58,6,8.279172093518044,6
281,16,24,70,8,8.272893937971956,16
282,20,33,9,11,8.272596506781882,22
283,111,14,17,6,8.239799794462428,8
284,26,10,16,4,8.231874067384071,6
285,28,13,94,5,8.222371266039163,8
286,13,19,8,7,8.198779355292587,12
287,17,29,8,11,8.17510581548791,18
288,28,20,89,8,8.17193070180919,12
289,32,24,41,10,8.170536046764159,14
290,16,65,86,24,8.16060087580244,41
291,84,42,48,17,8.151068929408751,25
292,26,44,87,17,8.146474895568335,27
293,19,14,9,6,8.117304295019109,8
294,93,32,54,10,8.106367720057328,22
295,79,28,107,10,8.08896000624074,18
296,38,19,86,6,8.08239085687564,13
297,30,15,10,5,8.08039942607508,10
298,6,12,13,5,8.074590184679876,7
299,1,11,86,4,8.004187715591307,7
300,98,58,65,22,8.003844385049874,36
301,90,15,41,6,7.997737246515682,9
302,49,23,9,8,7.992519163965536,15
303,32,14,86,6,7.973587175462614,8
304,109,12,37,5,7.972273664149992,7
305,55,18,76,7,7.950732428839994,11
306,65,17,68,7,7.944869327403054,10
307,54,25,37,8,7.94308393267222,17
308,49,14,13,6,7.890029815709072,8
309,74,11,12,5,7.8813359238936185,6
310,93,33,87,12,7.8407981779405524,21
311,17,26,9,10,7.831275179780669,16
312,76,32,37,11,7.820497576953577,21
313,28,10,11,4,7.813271079515417,6
314,65,20,50,8,7.794013777008706,12
315,2,40,65,14,7.773153242011129,26
316,29,13,109,5,7.7648215544268036,8
317,111,14,85,5,7.729378570457984,9
318,23,11,59,4,7.703199044299857,7
319,16,23,85,9,7.699328173457129,14
320,88,40,76,17,7.693645081601592,23
321,104,12,10,5,7.685162882867616,7
322,49,22,65,9,7.648203777845676,13
323,111,26,86,11,7.59951633000359,15
324,8,49,76,19,7.599383660078002,30
325,20,33,79,12,7.546840294896305,21
326,79,17,70,8,7.531628680674288,9
327,46,15,88,5,7.530723715486483,10
328,29,20,107,7,7.525530619454996,13
329,28,53,41,23,7.494799478271726,30
330,87,33,86,13,7.461882361903259,20
331,17,14,48,6,7.444960593591361,8
332,87,31,50,12,7.429484842498573,19
333,98,14,68,4,7.427653338623123,10
334,103,29,74,10,7.419118005067162,19
335,88,29,54,12,7.418874182686383,17
336,41,13,49,4,7.406139067429071,9
337,98,15,5,6,7.40308817440165,9
338,13,24,28,8,7.385148355874093,16
339,20,28,84,10,7.362780437625792,18
340,63,45,65,18,7.3553612783054705,27
341,43,14,65,6,7.3477742435965085,8
342,89,23,10,9,7.332600528276465,14
343,54,21,10,8,7.316914939103651,13
344,50,11,68,4,7.299975074722132,7
345,23,15,70,6,7.277989111704888,9
346,30,10,73,4,7.27524129591905,6
347,10,19,86,7,7.266452513785874,12
348,28,12,112,5,7.260189333899192,7
349,8,46,93,17,7.259434595610275,29
350,88,14,38,6,7.257573306252311,8
351,84,24,88,9,7.256956915758401,15
352,55,41,98,16,7.2398162826998345,25
353,30,13,49,5,7.228582193886499,8
354,10,19,76,8,7.223608714939963,11
355,87,10,56,4,7.222698791088141,6
356,111,13,34,6,7.201437198359541,7
357,94,17,20,6,7.200649176708726,11
358,70,21,87,8,7.188789144484619,13
359,5,11,6,4,7.175117705775805,7
360,74,28,86,11,7.130541060573803,17
361,86,14,20,6,7.118094837224454,8
362,16,16,89,6,7.102664218068734,10
363,104,14,62,5,7.094567188746601,9
364,30,21,86,5,7.093547407861881,16
365,87,15,34,6,7.057985714791884,9
366,74,52,65,20,7.057974081058533,32
367,109,29,9,12,7.056487417755328,17
368,91,37,28,14,7.047707205955762,23
369,59,19,79,8,7.0352036880537865,11
370,111,20,6,8,7.01838566892247,12
371,51,10,6,3,7.003530037614207,7
372,90,19,6,8,7.0034906221582,11
373,79,21,104,7,7.001432407845644,14
374,79,11,101,5,6.9908614259308735,6
375,107,27,50,10,6.978239572703387,17
376,73,10,68,4,6.95394987102174,6
377,55,25,38,11,6.947960322969587,14
378,90,14,17,6,6.930186835428711,8
379,57,12,74,4,6.9176042424257504,8
380,8,36,38,14,6.910326910265974,22
381,41,45,103,15,6.896034695840802,30
382,15,11,16,4,6.875773988595895,7
383,88,10,63,4,6.87340914266048,6
384,87,45,79,19,6.859799779773055,26
385,30,16,70,6,6.824605553405183,10
386,32,26,79,10,6.821690929992381,16
387,88,21,6,8,6.808639243885847,13
388,91,35,41,13,6.801656465480552,22
389,93,14,43,5,6.79067137162001,9
390,55,35,20,15,6.786443158254519,20
391,26,24,109,9,6.785414157125367,15
392,87,46,28,18,6.771264575755612,28
393,46,17,54,6,6.756375555864047,11
394,98,36,50,16,6.748525889961953,20
395,73,13,93,5,6.746815708884676,8
396,111,42,41,18,6.742879314894578,24
397,65,24,32,10,6.740147619373068,14
398,2,19,34,8,6.729658072634226,11
399,111,29,32,13,6.714992004730652,16
400,89,11,74,5,6.7140175484003635,6
401,79,18,62,8,6.70668334197217,10
402,28,19,85,8,6.70566330304257,11
403,88,16,57,7,6.698470388803919,9
404,32,23,9,9,6.676114746540028,14
405,18,24,9,10,6.669379438735331,14
406,74,16,49,7,6.669033870592301,9
407,98,23,34,8,6.66465867049253,15
408,17,15,49,6,6.655321673670165,9
409,8,21,57,9,6.644454597179956,12
410,86,14,85,7,6.640232602185862,7
411,23,14,18,5,6.63118753114106,9
412,34,14,65,6,6.615174326051721,8
413,107,20,76,8,6.611819543573891,12
414,16,21,18,8,6.609959415609469,13
415,55,15,91,5,6.584228246945671,10
416,84,12,66,5,6.578044154096627,7
417,74,23,38,10,6.562267688513878,13
418,30,14,16,5,6.5572067828085405,9
419,14,18,84,5,6.53962511920746,13
420,74,26,88,9,6.515151171646331,17
421,16,68,9,25,6.511357169334913,43
422,17,13,62,5,6.51109228837904,8
423,87,25,18,9,6.500921078177537,16
424,8,35,62,14,6.4900564019856555,21
425,23,11,48,5,6.485113687277626,6
426,93,26,74,9,6.479775766836972,17
427,17,10,10,4,6.479497194252798,6
428,65,32,48,13,6.477954122109943,19
429,20,16,88,6,6.450213485704791,10
430,90,10,62,4,6.441503246890602,6
431,12,14,28,5,6.429365216940004,9
432,28,38,54,15,6.411584180634182,23
433,49,14,16,6,6.40036562253603,8
434,10,28,28,10,6.393353899415197,18
435,30,22,37,8,6.384018768768751,14
436,15,14,84,5,6.375647385580588,9
437,103,22,88,8,6.368772240906124,14
438,31,10,28,4,6.368565836830035,6
439,86,18,73,7,6.340120760849839,11
440,55,26,41,12,6.334267485528576,14
441,20,80,65,31,6.318535384282401,49
442,16,57,65,24,6.310296262259337,33
443,8,33,109,14,6.3077294568861335,19
444,90,16,54,7,6.290244829620479,9
445,111,15,44,6,6.282001615200402,9
446,87,25,76,10,6.268639154144937,15
447,73,34,9,14,6.263734230116223,20
448,23,40,8,16,6.243153204885935,24
449,75,12,9,4,6.239095019020707,8
450,2,35,41,13,6.231438093089566,22
451,16,14,34,6,6.229556768499603,8
452,2,11,66,4,6.205381429919993,7
453,28,68,9,29,6.158626932406421,39
454,111,11,56,4,6.133528731729061,7
455,73,15,88,6,6.130278796806204,9
456,111,70,65,32,6.128152820402619,38
457,49,17,6,7,6.097985660912411,10
458,107,27,2,11,6.062909258737936,16
459,63,13,98,6,6.056134732306893,7
460,1,14,107,6,6.012748941227003,8
461,98,48,91,22,6.010481139866045,26
462,49,10,77,5,6.002993751357126,5
463,16,26,6,12,5.97888965897873,14
464,74,25,6,10,5.973570320498578,15
465,17,10,34,4,5.97086385916694,6
466,20,33,103,11,5.96431634987825,22
467,8,23,49,10,5.962799116224744,13
468,87,28,91,11,5.954439761122977,17
469,70,20,76,8,5.93646339837733,12
470,98,49,103,19,5.894528502030377,30
471,17,17,16,7,5.868342075872022,10
472,107,10,48,4,5.863597775104664,6
473,2,10,44,4,5.82972376449153,6
474,16,36,88,13,5.820662989223605,23
475,13,21,79,7,5.816978385717296,14
476,38,22,87,9,5.809647209419688,13
477,87,44,41,20,5.804454173879385,24
478,63,13,8,5,5.788280347549517,8
479,17,19,84,8,5.7860858723157875,11
480,15,23,76,9,5.782831260117769,14
481,32,18,54,7,5.782610489553489,11
482,51,14,79,6,5.7725066910082035,8
483,75,15,28,7,5.767432508412387,8
484,38,29,9,13,5.756435186772363,16
485,90,20,37,8,5.742590617036877,12
486,54,38,6,13,5.738166771423007,25
487,89,23,65,10,5.729458742490648,13
488,18,11,51,5,5.697627847770078,6
489,43,13,9,6,5.682535108763634,7
490,63,16,91,7,5.669548453730623,9
491,8,13,56,5,5.662090518526135,8
492,74,18,109,8,5.655848733560979,10
493,41,45,9,17,5.6439057397283525,28
494,107,41,20,18,5.643773896247951,23
495,2,16,48,8,5.635246627200363,8
496,54,16,51,7,5.634722358696406,9
497,104,12,87,4,5.633009975820381,8
498,6,25,20,12,5.631661671252286,13
499,26,22,29,8,5.630548836449718,14
500,86,11,57,5,5.628641785626694,6
501,6,33,48,14,5.6181707068996145,19
502,74,35,91,15,5.590543375115505,20
503,93,40,28,17,5.590270900759402,23
504,9,26,88,11,5.58192892839205,15
505,28,25,17,10,5.573169674184406,15
506,49,14,48,7,5.572044813615615,7
507,49,29,98,13,5.553486162622288,16
508,28,11,97,6,5.54697078214519,5
509,34,22,79,10,5.544717629215146,12
510,46,10,2,4,5.541906116456113,6
511,111,36,103,15,5.530917867453256,21
512,23,40,98,16,5.527481430978805,24
513,107,16,34,7,5.514558906998724,9
514,74,21,73,9,5.496437468937688,12
515,89,10,87,4,5.494352199749723,6
516,65,15,15,7,5.468158414216742,8
517,93,13,49,6,5.465162375246014,7
518,90,20,87,7,5.46489906820686,13
519,54,33,38,13,5.464199343195866,20
520,14,10,9,3,5.463439437022661,7
521,30,15,50,7,5.456889712897822,8
522,55,14,37,6,5.45661891092027,8
523,49,27,87,13,5.451792030762737,14
524,84,39,76,19,5.438513858870126,20
525,109,16,23,6,5.438260955948294,10
526,20,26,38,11,5.422962328602487,15
527,37,23,88,9,5.420331892037574,14
528,43,11,103,5,5.4056340195812504,6
529,110,23,65,9,5.3850619906564345,14
530,8,66,41,30,5.38335326188138,36
531,20,24,109,8,5.375774718225749,16
532,6,38,28,16,5.362669207148232,22
533,29,21,84,9,5.3406675655013585,12
534,90,23,8,9,5.338168133162711,14
535,30,18,6,6,5.328184059941263,12
536,54,46,9,19,5.328004432423594,27
537,84,14,71,6,5.316384874786534,8
538,50,36,79,16,5.311051747194992,20
539,87,45,9,19,5.2769682720811675,26
540,63,15,85,7,5.266282773446653,8
541,74,22,29,10,5.260819792223967,12
542,50,12,89,5,5.253704218444142,7
543,1,10,111,5,5.238983537325087,5
544,55,30,9,11,5.234489127276958,19
545,30,22,8,8,5.213064512809206,14
546,55,14,18,6,5.21003106995447,8
547,9,36,86,16,5.18822556538464,20
548,111,10,57,4,5.186942618450884,6
549,8,74,79,34,5.181361620021705,40
550,107,34,9,16,5.177997873535454,18
551,16,15,57,7,5.174682414292543,8
552,26,38,20,16,5.156160372920298,22
553,98,10,52,5,5.141825899051737,5
554,20,12,32,5,5.135866792699633,7
555,54,12,17,5,5.132650672697678,7
556,41,29,89,12,5.128070897369617,17
557,103,21,18,9,5.1172633080953505,12
558,9,11,1,5,5.096238795529086,6
559,16,20,73,9,5.070658783374491,11
560,84,26,34,10,5.0345191207409545,16
561,65,58,54,26,5.034371936668327,32
562,89,15,84,5,5.015269353437395,10
563,55,20,32,8,5.0109481732467795,12
564,62,17,54,7,5.001633115691913,10
565,26,30,65,13,4.98261857456072,17
566,50,18,73,9,4.9783134285735455,9
567,89,10,20,4,4.976403038151212,6
568,18,23,79,11,4.97103956030986,12
569,41,20,86,9,4.96812288725616,11
570,10,10,59,5,4.967497448599417,5
571,46,11,103,5,4.9349144398730305,6
572,28,23,70,11,4.90631827034395,12
573,65,11,5,5,4.90161537792141,6
574,8,46,48,20,4.8288846721587095,26
575,55,29,6,10,4.803715742468646,19
576,90,11,70,4,4.801865378344786,7
577,87,22,88,8,4.796769422048856,14
578,86,11,18,5,4.795064637153174,6
579,17,11,30,5,4.793161472453948,6
580,34,10,103,3,4.7904730345691835,7
581,13,12,20,4,4.788358918637374,8
582,111,10,104,4,4.785383853867563,6
583,8,13,106,6,4.770713481148755,7
584,98,17,94,7,4.761676089313327,10
585,6,12,32,5,4.741771241477238,7
586,74,18,55,9,4.738810454561625,9
587,90,30,9,13,4.71783274464291,17
588,109,19,93,8,4.710552248323453,11
589,87,35,29,15,4.710088352572669,20
590,26,16,6,6,4.685058896386023,10
591,41,53,20,21,4.672832095577478,32
592,86,10,15,5,4.60305467364883,5
593,28,19,49,7,4.587943557807992,12
594,2,31,6,13,4.57536971568475,18
595,46,13,37,6,4.568700097838744,7
596,9,20,89,7,4.555028073124964,13
597,87,15,57,7,4.5524099729129395,8
598,2,10,51,5,4.541060117126738,5
599,26,45,8,21,4.5356979974590255,24
600,74,24,23,11,4.530539923458648,13
601,65,26,109,13,4.522732343847645,13
602,91,36,9,16,4.519475424395421,20
603,111,29,93,14,4.510765206652466,15
604,38,38,28,17,4.506160175549613,21
605,9,17,59,7,4.5029610514141964,10
606,29,11,62,5,4.502398822563124,6
607,111,29,91,14,4.500138929465921,15
608,29,21,93,9,4.4989593922467,12
609,111,21,29,11,4.484029622528672,10
610,111,25,15,10,4.472513123100842,15
611,73,23,84,8,4.463513313785126,15
612,84,32,2,14,4.438454989875698,18
613,90,10,13,5,4.435057658973358,5
614,84,36,41,14,4.405400183867787,22
615,111,38,74,17,4.395421398955392,21
616,75,11,50,4,4.392668801200932,7
617,1,14,65,6,4.384642024421804,8
618,107,15,104,6,4.384096889948018,9
619,54,13,89,5,4.375934710162813,8
620,87,11,94,5,4.375015437142173,6
621,70,17,2,6,4.37241029305553,11
622,79,13,44,6,4.35641543376227,7
623,93,71,65,31,4.339245718156344,40
624,54,17,3,8,4.336905078418527,9
625,8,94,9,42,4.330862656922902,52
626,41,20,1,7,4.310885836842606,13
627,57,22,84,9,4.3073427304627385,13
628,85,15,48,6,4.3053632687921874,9
629,103,34,28,15,4.283445470085917,19
630,79,18,106,9,4.260883343518002,9
631,58,11,9,4,4.244957448818405,7
632,18,13,49,6,4.243576516469453,7
633,97,11,8,4,4.238412616249588,7
634,29,26,20,11,4.235090000321542,15
635,65,106,9,47,4.223360140775499,59
636,104,24,8,9,4.217796324401939,15
637,16,37,37,14,4.211147077007781,23
638,26,24,103,11,4.2106057067079385,13
639,62,26,9,11,4.200068098711877,15
640,17,22,79,10,4.186747232119098,12
641,2,16,32,7,4.169077635966495,9
642,29,19,79,9,4.163523890816755,10
643,63,15,48,7,4.152796736858189,8
644,65,23,91,12,4.150101209000142,11
645,37,15,2,7,4.147220527730259,8
646,103,28,54,13,4.131111544590628,15
647,23,14,30,7,4.121797276586662,7
648,37,39,98,17,4.116775978907109,22
649,54,19,29,7,4.092788521879803,12
650,2,36,9,17,4.083891693569189,19
651,98,16,85,8,4.042048861968958,8
652,10,11,109,5,4.004247407956422,6
653,26,26,28,11,3.9790441547640487,15
654,16,29,74,12,3.974341734686631,17
655,1,16,8,8,3.972443483770406,8
656,91,40,8,19,3.961945852137986,21
657,93,18,10,7,3.9549788743691674,11
658,23,39,84,18,3.9529498437083554,21
659,6,22,73,11,3.947699618921396,11
660,79,36,74,14,3.925115604285722,22
661,94,16,54,8,3.8978006398785645,8
662,98,47,84,21,3.890833745652655,26
663,55,11,17,5,3.8840410393606315,6
664,20,10,50,4,3.866423191070092,6
665,51,20,86,9,3.863362217006627,11
666,38,14,49,7,3.855128614080598,7
667,23,40,9,18,3.825851357048053,22
668,32,14,91,7,3.8253106560348464,7
669,37,14,20,6,3.824098686874727,8
670,93,15,18,7,3.8000555745474087,8
671,110,12,103,5,3.7849274590311146,7
672,26,11,110,6,3.7814954576991564,5
673,79,15,73,7,3.7804037585321275,8
674,98,26,18,12,3.7616966957049445,14
675,57,12,18,4,3.7525453734501917,8
676,55,31,88,12,3.752259279704296,19
677,37,37,8,17,3.7513378121907266,20
678,10,20,74,8,3.741560720435788,12
679,87,24,37,12,3.737636947444375,12
680,48,16,41,7,3.7233952099256955,9
681,84,22,38,9,3.7215580721113755,13
682,60,10,87,5,3.716219490276845,5
683,32,14,10,5,3.709056496740225,9
684,32,35,8,16,3.704344714378896,19
685,86,40,76,19,3.6671645346353188,21
686,30,19,84,9,3.664539402131773,10
687,48,14,89,6,3.6638704916482574,8
688,106,12,65,5,3.663753693390408,7
689,57,17,65,6,3.66200460796526,11
690,88,18,93,10,3.6422156721699728,8
691,10,12,18,4,3.6042571144804363,8
692,29,12,46,5,3.5756011188612877,7
693,16,34,76,16,3.57137268597902,18
694,50,25,38,11,3.5687465201033057,14
695,73,28,8,11,3.5539511566695987,17
696,65,13,94,6,3.5056909876146594,7
697,79,41,76,17,3.500613863685392,24
698,51,10,55,4,3.4788515156123396,6
699,1,14,55,6,3.472860068937084,8
700,111,21,76,11,3.468863949107616,10
701,48,12,91,5,3.4664297594725237,7
702,23,15,26,7,3.459704667443896,8
703,51,18,8,8,3.4518310636103333,10
704,5,10,91,6,3.4255398118724356,4
705,86,14,93,6,3.420418426819413,8
706,98,31,10,14,3.404355165617583,17
707,57,12,6,4,3.4000169565132325,8
708,48,32,37,15,3.3973368766785685,17
709,79,57,37,24,3.3937774135660375,33
710,87,51,20,23,3.3933610070267357,28
711,57,14,91,5,3.387917143764696,9
712,76,14,13,7,3.383197454645703,7
713,2,14,85,7,3.3798876085075156,7
714,6,26,91,12,3.3700663593758144,14
715,54,36,84,15,3.3687833567687187,21
716,29,26,8,12,3.3557915076756846,14
717,28,60,16,27,3.3154718725196664,33
718,104,12,76,6,3.2960173494490537,6
719,10,11,46,5,3.290581679590821,6
720,32,24,98,11,3.2868277404205144,13
721,59,11,98,5,3.2664563544762513,6
722,30,21,29,10,3.244422511134119,11
723,55,72,8,31,3.2426799159519524,41
724,76,15,18,6,3.2371919896499475,9
725,49,11,85,5,3.2340490592317157,6
726,23,19,86,9,3.2169168727971016,10
727,32,25,16,11,3.2091711041875453,14
728,8,75,107,35,3.203023338305838,40
729,88,17,41,8,3.1907658333962803,9
730,91,13,37,6,3.1893915884876662,7
731,87,26,48,12,3.143928347009634,14
732,106,10,98,4,3.1299996913347945,6
733,54,27,50,11,3.10751627479821,16
734,50,33,103,15,3.0926951561661493,18
735,111,49,9,24,3.075459194725251,25
736,26,17,43,7,3.0481873322386313,10
737,9,14,44,8,3.0418979222799787,6
738,16,59,84,27,3.03164315466034,32
739,20,33,28,13,3.0274591386657286,20
740,38,18,16,9,3.0174584469144032,9
741,26,16,89,8,3.0015441091670585,8
742,46,19,76,8,2.9807444539776413,11
743,8,62,16,27,2.9777798914412936,35
744,74,60,8,28,2.9442423049029256,32
745,18,18,48,8,2.9186933860892363,10
746,68,10,87,5,2.9185962554972145,5
747,8,24,68,11,2.912062784717025,13
748,90,30,111,13,2.8905447130543305,17
749,46,15,28,7,2.8691534505866247,8
750,55,11,13,5,2.867532212513362,6
751,98,31,29,15,2.8666453310461617,16
752,13,27,9,11,2.849893927277836,16
753,54,36,16,17,2.8472057120467213,19
754,84,49,86,23,2.8306913658972572,26
755,103,26,91,14,2.81795550429567,12
756,38,55,65,25,2.8065899103574585,30
757,63,15,107,6,2.8021473545431568,9
758,29,17,34,9,2.8011697136542724,8
759,14,12,8,5,2.8008148246776265,7
760,17,30,103,13,2.786263791329437,17
761,98,33,86,14,2.783908924775315,19
762,41,40,23,18,2.767380745524291,22
763,2,18,23,9,2.7670043698876174,9
764,29,30,28,14,2.7417268938351826,16
765,34,21,28,9,2.734662710408205,12
766,23,14,29,6,2.7325720738957853,8
767,79,25,89,10,2.7323432784581803,15
768,26,14,30,9,2.729526864464305,5
769,16,20,91,9,2.7214582735625514,11
770,62,25,87,11,2.7185367714166633,14
771,90,29,28,13,2.709626925847091,16
772,103,24,55,11,2.703742749314949,13
773,46,10,18,4,2.6832650728648453,6
774,65,69,28,31,2.66126583420825,38
775,30,25,38,13,2.6609022960305304,12
776,86,20,88,8,2.659869775460948,12
777,15,14,8,7,2.659395326985167,7
778,87,27,54,13,2.65183749405934,14
779,8,42,103,17,2.6366758249260935,25
780,30,13,107,5,2.6326975250966647,8
781,70,11,50,6,2.626702900417426,5
782,111,23,50,10,2.6260965282140734,13
783,9,16,94,8,2.620832608628453,8
784,29,24,9,12,2.607396405650484,12
785,38,20,112,9,2.5875581099779743,11
786,2,25,109,10,2.564163534371064,15
787,50,12,88,6,2.5594560508545734,6
788,23,11,34,6,2.5306742696464357,5
789,98,52,54,26,2.529015499138276,26
790,50,19,29,8,2.5251415163545525,11
791,16,50,98,22,2.5197213230509203,28
792,48,21,55,9,2.51047778877817,12
793,16,17,62,8,2.48847406843989,9
794,65,50,103,21,2.4835688434443703,29
795,74,29,107,13,2.4812045730116683,16
796,37,15,62,7,2.478947668963917,8
797,26,27,98,15,2.4699465773486544,12
798,16,13,93,6,2.460583316835962,7
799,41,40,38,19,2.4535603181412866,21
800,111,17,46,8,2.451868962313777,9
801,28,55,18,26,2.451529125268619,29
802,2,40,10,18,2.4466609344910117,22
803,9,33,6,15,2.442634272815349,18
804,18,16,50,8,2.435107533000617,8
805,32,14,38,6,2.405973678085734,8
806,76,18,35,7,2.4023433325283063,11
807,43,22,74,10,2.3993639128069244,12
808,18,18,6,8,2.3903639022739704,10
809,55,12,34,5,2.3742853226893694,7
810,16,21,107,10,2.371918332267291,11
811,63,14,16,7,2.3500753449010623,7
812,41,56,79,27,2.337441224056112,29
813,104,11,86,5,2.3312767847407874,6
814,65,39,29,16,2.326033904196744,23
815,16,30,87,14,2.292110942535406,16
816,62,18,32,9,2.263686769900323,9
817,103,26,87,12,2.244435120608379,14
818,84,30,55,14,2.243237050292714,16
819,107,44,28,22,2.230559467730818,22
820,8,11,58,6,2.225895511877211,5
821,79,28,93,15,2.2181833550633505,13
822,73,15,54,7,2.217586045542856,8
823,73,35,41,16,2.1896111209660925,19
824,54,34,86,16,2.187612017738007,18
825,44,19,28,7,2.1816767204067147,12
826,74,45,9,20,2.167006985909848,25
827,98,40,107,18,2.1579093706359807,22
828,9,11,15,5,2.1575516880448644,6
829,18,10,32,5,2.157224109221358,5
830,16,49,41,24,2.1541831229994863,25
831,98,61,2,29,2.1431661416362235,32
832,111,33,26,15,2.137133581510591,18
833,16,18,104,8,2.126469952320215,10
834,84,11,1,5,2.1264466771262907,6
835,55,14,73,7,2.1000754331910327,7
836,75,18,84,8,2.093719925532618,10
837,107,24,88,12,2.087135439756401,12
838,13,19,48,7,2.077711897708858,12
839,9,16,104,7,2.074620642084027,9
840,55,31,16,14,2.0741417426586506,17
841,91,11,18,5,2.068864434806556,6
842,32,19,84,8,2.06215086903803,11
843,65,77,88,35,2.0539867836081296,42
844,91,18,10,8,2.053920396033922,10
845,30,25,98,10,2.050620342220537,15
846,38,52,98,24,2.0498657703552294,28
847,23,30,87,13,2.01719025247438,17
848,59,14,8,7,2.010238389237962,7
849,98,55,74,27,2.0085674767082775,28
850,37,10,71,4,1.989603705819686,6
851,103,13,37,6,1.9837820518429876,7
852,6,47,79,22,1.9831957209831137,25
853,79,60,111,27,1.9806558598524882,33
854,23,41,65,20,1.9794334553560233,21
855,49,11,29,4,1.9792119029563418,7
856,6,47,65,25,1.9776748983278993,22
857,54,18,23,8,1.9726565822582194,10
858,79,35,55,18,1.9591996630760304,17
859,37,33,65,15,1.948336028419335,18
860,87,10,13,4,1.9417659717514895,6
861,28,37,37,17,1.9409348825611596,20
862,76,24,6,12,1.937944044447951,12
863,10,13,29,6,1.9268740097605626,7
864,65,20,13,11,1.923636761815708,9
865,87,22,73,11,1.9187809773134352,11
866,6,22,37,11,1.9187411338779805,11
867,48,35,16,17,1.9177064489155904,18
868,76,10,17,4,1.904894860536603,6
869,84,42,111,18,1.9043195084453128,24
870,41,11,61,5,1.903478014849791,6
871,104,11,51,5,1.896724728424177,6
872,91,18,88,8,1.8878660605312687,10
873,84,27,49,13,1.878620730491277,14
874,79,57,16,26,1.877958900201377,31
875,74,21,30,11,1.8748715955653132,10
876,54,17,112,8,1.871566293788823,9
877,73,19,98,9,1.8513717297876215,10
878,6,39,98,18,1.8448936378969205,21
879,90,23,107,12,1.8399920811097459,11
880,35,12,79,5,1.8379035956261764,7
881,2,30,111,14,1.8367449192872438,16
882,90,19,84,9,1.8307456952070562,10
883,8,48,18,22,1.8210825548731258,26
884,20,22,73,11,1.8197178736344486,11
885,85,13,76,5,1.8000085206097032,8
886,94,10,41,5,1.7939224836809728,5
887,57,10,109,4,1.7866317267766754,6
888,14,10,28,4,1.771696362645693,6
889,111,53,28,25,1.7612142471001206,28
890,8,66,87,30,1.7501098519415277,36
891,107,35,38,17,1.7434138897292857,18
892,71,18,65,9,1.7385086790308775,9
893,32,32,28,15,1.7383561900488511,17
894,16,29,103,14,1.7358551004647216,15
895,106,15,38,7,1.7348192516378764,8
896,87,13,75,7,1.7332300811803307,6
897,9,19,70,10,1.7325740605828825,9
898,76,10,45,5,1.7263356630732685,5
899,16,47,2,22,1.7122028906623927,25
900,38,11,76,5,1.699907222636557,6
901,34,15,20,6,1.6974281353522305,9
902,30,37,28,17,1.695148135028505,20
903,91,21,30,11,1.6670009255194491,10
904,50,32,9,15,1.6560822478283976,17
905,103,26,6,11,1.6275337563735748,15
906,20,18,68,9,1.616802764124798,9
907,17,13,50,6,1.587542514822458,7
908,90,16,48,8,1.5828630197509534,8
909,50,18,16,9,1.5602090710005878,9
910,106,12,41,6,1.5589796315432007,6
911,50,33,2,15,1.5483452933241444,18
912,107,26,86,12,1.542374498402116,14
913,85,12,38,6,1.5317416798467223,6
914,103,12,85,5,1.5052357650596415,7
915,98,16,89,8,1.5011020579783918,8
916,55,18,43,9,1.4993353058682126,9
917,37,39,9,18,1.4788236748148047,21
918,41,18,18,8,1.4488156792449156,10
919,50,36,41,18,1.4450486751473977,18
920,103,10,57,6,1.4334929374709406,4
921,109,11,112,5,1.4303792106135154,6
922,62,24,28,10,1.430081518616343,14
923,111,14,75,8,1.4265352540751042,6
924,65,10,3,5,1.425825292351592,5
925,13,11,2,4,1.4221213524937664,7
926,88,31,111,14,1.4213124620809892,17
927,8,47,20,22,1.420582435666663,25
928,2,24,38,13,1.4146987667991204,11
929,34,10,48,5,1.412318598449887,5
930,76,30,48,14,1.405190282699339,16
931,54,18,15,9,1.4023674366161885,9
932,50,21,86,9,1.3996923807256987,12
933,54,13,85,7,1.3987454013140679,6
934,65,34,10,16,1.3889990791790807,18
935,44,13,8,5,1.382360749568672,8
936,16,32,10,15,1.3769942516048166,17
937,79,25,30,13,1.3756609281230874,12
938,23,14,32,8,1.36299015760623,6
939,8,58,54,28,1.3404695893425032,30
940,84,70,65,35,1.3269531130271417,35
941,98,13,57,7,1.3243405021868635,6
942,87,15,110,7,1.3076573931351647,8
943,87,43,107,19,1.3071600665172027,24
944,48,27,98,13,1.2896849035906786,14
945,54,39,20,18,1.273425394676017,21
946,87,36,84,17,1.2473160473972962,19
947,20,43,98,20,1.2404189901414024,23
948,8,53,86,25,1.2344403994491582,28
949,79,11,96,6,1.2340245916617472,5
950,51,20,84,9,1.23384352612348,11
951,23,37,28,18,1.232835357364572,19
952,74,24,46,13,1.2274275532310792,11
953,49,24,55,14,1.212014442669993,10
954,103,10,1,6,1.178228962480731,4
955,109,23,98,11,1.1685291459099245,12
956,79,76,9,37,1.156057079763386,39
957,50,18,34,10,1.148352191382895,8
958,54,25,107,12,1.1450631376312899,13
959,79,36,38,17,1.1399672014475488,19
960,23,22,88,10,1.1194514842315597,12
961,55,27,50,12,1.1136011471986094,15
962,88,20,62,10,1.1096322170107622,10
963,16,10,56,4,1.1063673005412145,6
964,73,16,28,9,1.102601583168376,7
965,6,41,8,19,1.0938107771145273,22
966,91,14,62,7,1.083463407829189,7
967,48,10,35,5,1.0695374428464177,5
968,28,29,88,13,1.0651097674029193,16
969,76,15,103,6,1.064891024931597,9
970,79,46,86,22,1.0425261635108987,24
971,74,16,62,9,1.038357756374001,7
972,9,28,76,14,1.0341615578112182,14
973,74,44,54,23,1.0319640649256887,21
974,90,20,16,10,1.030661051555181,10
975,48,27,86,13,1.0300347247258272,14
976,107,39,65,17,1.0164693815500512,22
977,58,11,2,5,1.0060883991850635,6
978,87,31,98,14,1.0052207296323061,17
979,79,11,94,5,0.999869198006996,6
980,87,62,65,29,0.9969072233617808,33
981,32,15,74,7,0.9878312338208298,8
982,41,16,30,8,0.9850557086879019,8
983,111,16,68,7,0.9831903657030904,9
984,91,20,23,10,0.9792678927031672,10
985,103,44,9,24,0.9734466854109779,20
986,68,10,16,5,0.9723777343104946,5
987,10,11,15,6,0.9620268464624092,5
988,28,36,50,17,0.9559412289162638,19
989,93,23,107,11,0.9535678875740131,12
990,48,11,30,5,0.9383914724110447,6
991,23,35,16,17,0.937387264272767,18
992,84,71,9,32,0.9296549234939684,39
993,85,19,9,8,0.9266510351352133,11
994,13,11,74,5,0.9258529887550367,6
995,51,16,16,7,0.9254181289183436,9
996,103,12,89,5,0.9245541578032253,7
997,79,29,88,12,0.9179800734687579,17
998,60,11,9,6,0.9156618531106675,5
999,79,39,90,17,0.8969827248841548,22
1000,8,61,2,31,0.8823794512979253,30
1001,62,21,65,9,0.8755953834255741,12
1002,29,12,18,7,0.8741742779448103,5
1003,16,34,111,18,0.8706079983684201,16
1004,5,12,79,7,0.8638337222987199,5
1005,8,18,75,9,0.8583987416596419,9
1006,55,52,65,22,0.8552133427187645,30
1007,98,67,8,32,0.8537292484745975,35
1008,103,16,32,7,0.8405021181328091,9
1009,111,44,87,22,0.837629282060696,22
1010,57,11,55,6,0.8315236951519526,5
1011,54,27,70,14,0.8260404525362445,13
1012,87,23,10,10,0.8212452099335941,13
1013,54,31,79,15,0.820427361898058,16
1014,9,34,48,18,0.8138314912844855,16
1015,70,47,98,23,0.8130313901104028,24
1016,84,56,37,28,0.7869802805275414,28
1017,85,21,65,9,0.7821322420670122,12
1018,23,24,6,12,0.757380072902326,12
1019,76,37,65,17,0.7568795201651481,20
1020,74,46,84,22,0.7518721095348239,24
1021,90,10,104,6,0.7461340238107435,4
1022,37,11,73,5,0.7437455399697707,6
1023,8,60,10,30,0.7407705754471612,30
1024,107,23,23,11,0.7397315330825384,12
1025,104,31,65,13,0.7351510467171646,18
1026,50,17,74,8,0.7251672527310546,9
1027,87,24,32,13,0.7236548346311565,11
1028,86,43,28,19,0.7167553120703369,24
1029,51,12,65,6,0.7082823610974588,6
1030,41,23,43,11,0.6921842337130496,12
1031,44,12,16,7,0.6740631728235357,5
1032,90,17,10,9,0.6720080859782234,8
1033,111,44,55,23,0.671535328999238,21
1034,91,23,86,11,0.6661452371009022,12
1035,76,13,20,7,0.6610311160325412,6
1036,88,15,48,9,0.6584132572102235,6
1037,65,79,79,40,0.6544923516921638,39
1038,32,10,30,5,0.6490824873820774,5
1039,74,39,41,21,0.6406425090111565,18
1040,16,17,1,9,0.638053866963686,8
1041,10,21,48,11,0.6314146317442502,10
1042,79,61,84,30,0.628198230115059,31
1043,74,13,63,6,0.6231938435062159,7
1044,91,18,44,8,0.6160976329615543,10
1045,55,22,29,12,0.608123085968795,10
1046,111,37,20,19,0.6068837109506102,18
1047,62,18,38,9,0.6043816495722358,9
1048,98,20,101,11,0.594870864776421,9
1049,48,18,103,9,0.5903706399248485,9
1050,70,50,8,26,0.5792404511939322,24
1051,48,34,28,15,0.5739510260260693,19
1052,54,26,91,15,0.570268898485947,11
1053,6,41,84,20,0.5685620720746435,21
1054,15,14,2,7,0.5683026145731128,7
1055,89,17,111,9,0.5563633904658294,8
1056,90,18,2,9,0.5540783404275302,9
1057,10,18,37,8,0.5468156041706492,10
1058,2,22,62,10,0.5462872756743675,12
1059,66,13,41,7,0.534743534153649,6
1060,91,13,73,5,0.5133686150476426,8
1061,79,16,49,7,0.5123191767325035,9
1062,50,39,84,20,0.49953786158025776,19
1063,54,32,2,15,0.4972568733461067,17
1064,87,16,112,7,0.4965133955506218,9
1065,46,13,98,6,0.4949016763373522,7
1066,16,16,20,9,0.49084719994134707,7
1067,88,12,18,6,0.48640028582812594,6
1068,32,10,94,5,0.48339556643762405,5
1069,26,39,41,23,0.4754162497584248,16
1070,84,63,28,31,0.4652551764224547,32
1071,2,19,88,9,0.45627885372645427,10
1072,98,16,58,9,0.4540736471862188,7
1073,23,37,103,19,0.4333042786770578,18
1074,26,11,50,6,0.4324180875363617,5
1075,98,33,93,16,0.4249481440030074,17
1076,9,41,98,18,0.424424835693392,23
1077,109,14,79,7,0.42130275303052095,7
1078,98,66,79,35,0.4098187288682279,31
1079,93,16,55,8,0.39897461255756417,8
1080,41,13,85,6,0.3897097634286919,7
1081,44,10,50,5,0.37049181398411835,5
1082,86,19,6,9,0.36002907163374875,10
1083,49,17,91,9,0.3285488305810779,8
1084,98,31,90,16,0.30813626797031257,15
1085,19,14,41,8,0.30768619148938015,6
1086,2,23,30,12,0.29321348863964647,11
1087,65,32,86,16,0.2921614298707558,16
1088,98,58,28,30,0.2696965888382482,28
1089,34,20,9,10,0.25268208409127835,10
1090,103,28,38,14,0.2481523476415201,14
1091,57,10,54,5,0.241204011702208,5
1092,66,20,9,10,0.23945533670543603,10
1093,85,10,66,5,0.23847533791686767,5
1094,70,19,37,9,0.23151847633400466,10
1095,8,42,88,20,0.21289914554912484,22
1096,55,47,28,21,0.2032823609872515,26
1097,29,36,41,18,0.19641039337775912,18
1098,5,14,28,8,0.19093094318377293,6
1099,30,18,18,8,0.18809198027763627,10
1100,30,32,20,17,0.18006835825975015,15
1101,18,25,54,13,0.17269825689702856,12
1102,26,19,2,10,0.15549736717273138,9
1103,32,18,50,10,0.14361277931057495,8
1104,107,35,103,17,0.13970070555149355,18
1105,74,20,37,10,0.1351513012183972,10
1106,6,29,41,15,0.0941275477253323,14
1107,13,22,98,9,0.08977817869064826,13
1108,38,15,110,8,0.07451058664372948,7
1109,8,18,85,10,0.0557982015995376,8
1110,23,26,111,12,0.03864525196535908,14
1111,85,24,79,13,0.034805559038930234,11
1112,13,13,111,6,0.03396852683521733,7
1113,73,27,65,13,0.03310401758066601,14
1114,40,14,65,6,0.022138801901295854,8
1115,8,38,50,20,0.0026780543899767614,18
1116,37,15,38,8,0.0011031238349569132,7
1117,38,15,37,7,-0.0011031238349578606,8
1118,65,14,40,8,-0.022138801901296672,6
1119,65,27,73,14,-0.03310401758066535,13
1120,79,50,103,24,-0.05775390300531491,26
1121,2,25,20,13,-0.06141520142574363,12
1122,110,15,38,7,-0.07451058664372871,8
1123,87,42,74,20,-0.07958529470361445,22
1124,84,47,103,22,-0.09369403051445593,25
1125,41,29,6,14,-0.09412754772533327,15
1126,43,19,20,10,-0.09655439021695145,9
1127,28,61,2,31,-0.13470852705824074,30
1128,8,23,43,12,-0.13486260335750042,11
1129,37,20,74,10,-0.135151301218397,10
1130,8,87,65,40,-0.14216691698172162,47
1131,111,25,30,13,-0.14558741487159338,12
1132,54,25,18,12,-0.1726982568970277,13
1133,28,50,74,24,-0.17793202645056747,26
1134,20,32,30,15,-0.1800683582597512,17
1135,17,19,74,10,-0.18384205614173943,9
1136,18,18,30,10,-0.18809198027763716,8
1137,28,14,5,6,-0.19093094318377268,8
1138,88,42,8,22,-0.21289914554912398,20
1139,79,38,91,20,-0.22211474912049806,18
1140,2,30,74,16,-0.22227104506397838,14
1141,91,21,84,10,-0.22598499748931863,11
1142,37,19,70,10,-0.23151847633400355,9
1143,66,10,85,5,-0.23847533791686928,5
1144,9,20,66,10,-0.23945533670543603,10
1145,54,10,57,5,-0.24120401170220837,5
1146,38,28,103,14,-0.24815234764151944,14
1147,86,32,65,16,-0.29216142987075866,16
1148,30,23,2,11,-0.29321348863964564,12
1149,41,14,19,6,-0.30768619148938214,8
1150,91,17,49,8,-0.32854883058107764,9
1151,43,16,98,8,-0.334919329248079,8
1152,54,21,48,12,-0.3530248887429356,9
1153,6,19,86,10,-0.36002907163374687,9
1154,50,10,44,5,-0.37049181398411835,5
1155,90,30,65,14,-0.37730681884186645,16
1156,85,13,41,7,-0.3897097634286919,6
1157,8,69,111,33,-0.39678371929634243,36
1158,55,16,93,8,-0.3989746125575646,8
1159,79,14,109,7,-0.42130275303052045,7
1160,98,41,9,23,-0.42442483569339234,18
1161,93,33,98,17,-0.42494814400300696,16
1162,28,59,79,33,-0.43622515784956406,26
1163,51,22,28,11,-0.44446843006512377,11
1164,88,19,2,10,-0.456278853726455,9
1165,28,63,84,32,-0.46525517642245307,31
1166,94,10,32,5,-0.4833955664376234,5
1167,18,12,88,6,-0.4864002858281247,6
1168,55,25,107,12,-0.49082237211228164,13
1169,98,13,46,7,-0.494901676337354,6
1170,112,16,87,9,-0.496513395550622,7
1171,2,32,54,17,-0.4972568733461067,15
1172,73,13,91,8,-0.5133686150476421,5
1173,20,23,110,11,-0.5195268671329448,12
1174,84,64,8,32,-0.522707927820123,32
1175,86,18,90,8,-0.530984332272809,10
1176,41,13,66,6,-0.5347435341536495,7
1177,49,22,107,12,-0.5403853948936642,10
1178,62,22,2,12,-0.5462872756743683,10
1179,37,18,10,10,-0.5468156041706485,8
1180,111,17,89,8,-0.556363390465831,9
1181,84,41,6,21,-0.5685620720746437,20
1182,91,26,54,11,-0.5702688984859479,15
1183,8,50,70,24,-0.5792404511939323,26
1184,103,18,48,9,-0.590370639924845,9
1185,101,20,98,9,-0.5948708647764195,11
1186,23,33,79,18,-0.5991196107820859,15
1187,38,18,62,9,-0.6043816495722345,9
1188,29,22,55,10,-0.6081230859687949,12
1189,87,32,2,17,-0.6092720590189449,15
1190,44,18,91,10,-0.6160976329615553,8
1191,63,13,74,7,-0.6231938435062153,6
1192,48,21,10,10,-0.6314146317442528,11
1193,41,39,74,18,-0.640642509011156,21
1194,30,10,32,5,-0.6490824873820789,5
1195,6,19,46,9,-0.6560730930479052,10
1196,29,20,103,10,-0.6578144863835312,10
1197,48,15,88,6,-0.6584132572102235,9
1198,20,13,76,6,-0.6610311160325401,7
1199,93,24,6,12,-0.662762996898009,12
1200,86,23,91,12,-0.6661452371009026,11
1201,10,17,90,8,-0.6720080859782221,9
1202,16,12,44,5,-0.6740631728235359,7
1203,101,15,23,7,-0.6750621504160544,8
1204,8,64,84,33,-0.6829085676002623,31
1205,65,12,51,6,-0.7082823610974588,6
1206,28,43,86,24,-0.7167553120703373,19
1207,32,24,87,11,-0.723654834631157,13
1208,74,42,87,23,-0.7245745938864455,19
1209,74,17,50,9,-0.7251672527310556,8
1210,62,18,6,8,-0.7348526325115939,10
1211,65,31,104,18,-0.7351510467171638,13
1212,23,23,107,12,-0.7397315330825399,11
1213,73,11,37,6,-0.7437455399697719,5
1214,104,10,90,4,-0.7461340238107453,6
1215,84,46,74,24,-0.7518721095348248,22
1216,65,21,85,12,-0.7821322420670123,9
1217,74,17,85,9,-0.8095598497605868,8
1218,98,47,70,24,-0.8130313901104015,23
1219,48,34,9,16,-0.8138314912844851,18
1220,10,23,87,13,-0.8212452099335924,10
1221,70,27,54,13,-0.8260404525362451,14
1222,55,11,57,5,-0.8315236951519509,6
1223,91,21,29,10,-0.8357535316372816,11
1224,32,17,49,9,-0.8453605230907211,8
1225,75,18,8,9,-0.8583987416596415,9
1226,38,18,91,10,-0.8605561818804589,8
1227,79,12,5,5,-0.8638337222987221,7
1228,18,12,29,5,-0.8741742779448094,7
1229,65,21,62,12,-0.8755953834255741,9
1230,29,26,6,13,-0.8939970404365951,13
1231,98,42,17,22,-0.896764910757158,20
1232,93,30,20,17,-0.8968767950978295,13
1233,111,29,18,15,-0.9151185639276579,14
1234,9,11,60,5,-0.9156618531106686,6
1235,89,12,103,7,-0.9245541578032253,5
1236,16,16,51,9,-0.9254181289183445,7
1237,9,19,85,11,-0.9266510351352133,8
1238,8,72,28,37,-0.9368904973724419,35
1239,30,11,48,6,-0.938391472411044,5
1240,107,23,93,12,-0.9535678875740138,11
1241,50,12,6,6,-0.9593349652988987,6
1242,15,11,10,5,-0.9620268464624092,6
1243,16,10,68,5,-0.9723777343104946,5
1244,68,16,111,9,-0.9831903657030906,7
1245,30,16,41,8,-0.9850557086879017,8
1246,91,23,20,11,-0.9903622576025491,12
1247,94,11,79,6,-0.9998691980069959,5
1248,41,33,70,17,-1.0073100144887814,16
1249,41,13,75,7,-1.0160682715228835,6
1250,86,27,48,14,-1.0300347247258272,13
1251,76,28,9,14,-1.034161557811218,14
1252,103,10,75,5,-1.035188460357086,5
1253,62,16,74,7,-1.0383577563740003,9
1254,86,46,79,24,-1.0425261635108982,22
1255,2,32,87,16,-1.0461530255566571,16
1256,91,13,17,7,-1.0470112494613972,6
1257,89,13,6,6,-1.0487640819634654,7
1258,79,66,98,32,-1.0629583697982146,34
1259,103,15,76,9,-1.0648910249315973,6
1260,88,29,28,16,-1.0651097674029202,13
1261,35,10,48,5,-1.0695374428464184,5
1262,73,20,103,10,-1.0728746625988024,10
1263,62,14,91,7,-1.0834634078291885,7
1264,28,16,73,7,-1.102601583168377,9
1265,56,10,16,6,-1.1063673005412131,4
1266,62,20,88,10,-1.1096322170107622,10
1267,88,22,23,12,-1.1194514842315604,10
1268,107,25,54,13,-1.14506313763129,12
1269,34,18,50,8,-1.1483521913828947,10
1270,41,80,65,38,-1.162711714387654,42
1271,28,72,8,37,-1.1716593488855898,35
1272,111,26,10,14,-1.17280808920051,12
1273,1,10,103,4,-1.178228962480731,6
1274,63,10,111,5,-1.1830016075807657,5
1275,84,31,107,16,-1.1883174819228042,15
1276,111,49,98,25,-1.1971941446177512,24
1277,107,36,111,18,-1.1978257080625474,18
1278,55,24,49,10,-1.2120144426699921,14
1279,107,31,84,16,-1.2210869288992972,15
1280,2,49,79,26,-1.2271248327335278,23
1281,84,20,51,11,-1.2338435261234795,9
1282,96,11,79,5,-1.234024591661747,6
1283,86,53,8,28,-1.2344403994491593,25
1284,91,28,107,14,-1.2435079650119625,14
1285,84,36,87,19,-1.2473160473972953,17
1286,65,30,17,15,-1.2597701896564553,15
1287,79,79,65,40,-1.27335297823569,39
1288,98,27,48,14,-1.2896849035906786,13
1289,107,18,10,10,-1.302641998274499,8
1290,110,15,87,8,-1.307657393135164,7
1291,74,31,20,16,-1.3078088890253396,15
1292,103,47,84,26,-1.3117535282727075,21
1293,57,13,98,6,-1.3243405021868624,7
1294,65,70,84,35,-1.3269531130271437,35
1295,32,14,23,6,-1.3629901576062295,8
1296,59,16,41,9,-1.3704315284875221,7
1297,23,15,76,7,-1.3791825091008199,8
1298,8,13,44,8,-1.3823607495686732,5
1299,85,13,54,6,-1.3987454013140654,7
1300,86,21,50,12,-1.399692380725698,9
1301,15,18,54,9,-1.402367436616189,9
1302,48,30,76,16,-1.4051902826993394,14
1303,84,61,79,32,-1.409382955424102,29
1304,111,31,88,17,-1.4213124620809878,14
1305,3,10,65,5,-1.425825292351591,5
1306,65,80,41,44,-1.4259190406310245,36
1307,75,14,111,6,-1.4265352540751037,8
1308,107,23,18,13,-1.4296389206294247,10
1309,28,24,62,14,-1.4300815186163431,10
1310,112,11,109,6,-1.4303792106135154,5
1311,57,10,103,4,-1.43349293747094,6
1312,20,13,90,6,-1.4684862703100507,7
1313,9,39,37,21,-1.4788236748148051,18
1314,89,16,98,8,-1.5011020579783914,8
1315,85,12,103,7,-1.505235765059642,5
1316,74,50,28,27,-1.5230965628089277,23
1317,38,12,85,6,-1.5317416798467212,6
1318,6,18,62,11,-1.5340589440321593,7
1319,86,26,107,14,-1.5423744984021162,12
1320,41,12,106,6,-1.558979631543201,6
1321,8,24,34,11,-1.5596726153138405,13
1322,16,18,50,9,-1.5602090710005876,9
1323,94,11,2,6,-1.566847919784111,5
1324,29,16,16,9,-1.5836522711307057,7
1325,79,16,57,9,-1.6225267683647033,7
1326,87,44,111,23,-1.641789170650758,21
1327,10,50,79,29,-1.6576142605157707,21
1328,23,18,57,10,-1.6948872060166507,8
1329,28,37,30,20,-1.695148135028504,17
1330,18,13,20,7,-1.69876804268239,6
1331,76,11,38,6,-1.6999072226365548,5
1332,45,10,76,5,-1.7263356630732685,5
1333,16,16,29,8,-1.7271978980205005,8
1334,70,19,9,9,-1.7325740605828819,10
1335,75,13,87,6,-1.7332300811803312,7
1336,38,15,106,8,-1.7348192516378762,7
1337,103,29,16,15,-1.735855100464721,14
1338,65,18,71,9,-1.7385086790308772,9
1339,38,35,107,18,-1.7434138897292857,17
1340,28,10,14,6,-1.771696362645692,4
1341,13,12,107,6,-1.7761401570676238,6
1342,109,10,57,6,-1.7866317267766754,4
1343,41,10,94,5,-1.7939224836809735,5
1344,76,13,85,8,-1.8000085206097036,5
1345,18,11,85,7,-1.8067340182792189,4
1346,10,26,111,13,-1.814853380218898,13
1347,84,19,90,10,-1.8307456952070555,9
1348,79,12,35,7,-1.8379035956261767,5
1349,107,23,90,11,-1.8399920811097439,12
1350,98,19,73,10,-1.851371729787623,9
1351,8,67,98,36,-1.8537292484745975,31
1352,112,17,54,9,-1.8715662937888236,8
1353,30,21,74,10,-1.8748715955653132,11
1354,49,27,84,14,-1.878620730491277,13
1355,88,18,91,10,-1.8878660605312692,8
1356,51,11,104,6,-1.8967247284241764,5
1357,103,14,70,8,-1.9027941936339994,6
1358,61,11,41,6,-1.9034780148497894,5
1359,111,42,84,24,-1.9043195084453128,18
1360,17,10,76,6,-1.9048948605366014,4
1361,16,35,48,18,-1.9177064489155888,17
1362,37,22,6,11,-1.9187411338779805,11
1363,73,22,87,11,-1.9187809773134346,11
1364,13,20,65,9,-1.9236367618157104,11
1365,6,24,76,12,-1.937944044447951,12
1366,37,37,28,20,-1.9409348825611594,17
1367,13,10,87,6,-1.9417659717514895,4
1368,65,33,37,18,-1.9483360284193356,15
1369,65,87,8,49,-1.9561397360340722,38
1370,23,18,54,10,-1.9726565822582198,8
1371,29,11,49,7,-1.9792119029563418,4
1372,37,13,103,7,-1.9837820518429876,6
1373,41,16,34,9,-1.9846654519938336,7
1374,71,10,37,6,-1.9896037058196856,4
1375,74,55,98,28,-2.008567476708278,27
1376,9,30,10,15,-2.0135222581265264,15
1377,87,30,23,17,-2.017190252474381,13
1378,74,17,90,9,-2.030135359930969,8
1379,26,14,73,8,-2.0368384601286986,6
1380,98,52,38,28,-2.0498657703552294,24
1381,26,30,9,17,-2.052887996849143,13
1382,10,18,91,10,-2.0539203960339205,8
1383,34,15,6,7,-2.0594698658943718,8
1384,84,19,32,11,-2.0621508690380304,8
1385,104,16,9,9,-2.0746206420840276,7
1386,48,19,13,12,-2.0777118977088573,7
1387,90,17,74,9,-2.0848494229315673,8
1388,84,18,75,10,-2.0937199255326187,8
1389,73,14,55,7,-2.100075433191031,7
1390,1,11,84,6,-2.126446677126287,5
1391,104,18,16,10,-2.1264699523202126,8
1392,46,19,6,11,-2.1320112599215313,8
1393,1,15,87,7,-2.138632690920939,8
1394,98,22,13,14,-2.1425027644706014,8
1395,37,56,84,29,-2.1450082211727257,27
1396,17,42,98,22,-2.1560402623618153,20
1397,32,10,18,5,-2.1572241092213575,5
1398,84,39,50,20,-2.1572452386112704,19
1399,15,11,9,6,-2.1575516880448644,5
1400,107,40,98,22,-2.1579093706359798,18
1401,28,19,44,12,-2.1816767204067156,7
1402,86,34,54,18,-2.187612017738007,16
1403,65,62,87,34,-2.2105235873065796,28
1404,65,30,90,17,-2.2173212695918445,13
1405,54,15,73,8,-2.217586045542855,7
1406,58,11,8,5,-2.2258955118772117,6
1407,55,30,84,16,-2.2432370502927133,14
1408,20,15,17,7,-2.251306099354639,8
1409,32,18,62,9,-2.2636867699003225,9
1410,103,37,23,19,-2.3239729626949814,18
1411,29,39,65,23,-2.326033904196744,16
1412,86,11,104,6,-2.3312767847407865,5
1413,6,21,112,11,-2.3418628162884616,10
1414,16,14,63,7,-2.3500753449010636,7
1415,111,69,8,39,-2.351715592504463,30
1416,43,23,41,13,-2.3652994967791563,10
1417,107,21,16,11,-2.3719183322672905,10
1418,35,18,76,11,-2.4023433325283063,7
1419,57,16,79,8,-2.4270888358529543,8
1420,50,16,18,8,-2.4351075330006164,8
1421,6,33,9,18,-2.4426342728153476,15
1422,79,24,85,12,-2.448715961670296,12
1423,38,40,41,21,-2.4535603181412866,19
1424,93,13,16,7,-2.460583316835962,6
1425,9,44,103,21,-2.4769487250437585,23
1426,29,20,2,11,-2.477941203005181,9
1427,62,15,37,8,-2.4789476689639174,7
1428,107,29,74,16,-2.481204573011676,13
1429,62,17,16,9,-2.4884740684398885,8
1430,55,21,48,12,-2.510477788778171,9
1431,98,50,16,28,-2.5197213230509203,22
1432,29,19,50,11,-2.525141516354553,8
1433,54,52,98,26,-2.529015499138276,26
1434,70,33,41,17,-2.5290882561404504,16
1435,34,11,23,5,-2.5306742696464353,6
1436,88,12,50,6,-2.5594560508545734,6
1437,109,25,2,15,-2.5641635343710636,10
1438,107,25,55,15,-2.584454892774184,10
1439,65,37,76,21,-2.585450948736576,16
1440,112,20,38,11,-2.5875581099779774,9
1441,50,11,70,5,-2.626702900417428,6
1442,111,26,23,15,-2.6303992386646597,11
1443,107,13,30,8,-2.632697525096665,5
1444,107,12,85,8,-2.6471438550645616,4
1445,30,25,111,13,-2.6528736151948067,12
1446,65,39,107,23,-2.657495022575693,16
1447,8,14,15,7,-2.6593953269851673,7
1448,88,20,86,12,-2.6598697754609466,8
1449,98,49,111,27,-2.661784450073085,22
1450,111,13,43,8,-2.669621436422116,5
1451,43,17,107,9,-2.670387525820163,8
1452,9,71,84,41,-2.677423566055923,30
1453,90,39,79,23,-2.6906940404909006,16
1454,20,39,54,22,-2.705144386741404,17
1455,28,29,90,16,-2.709626925847093,13
1456,50,38,8,20,-2.7166843374091876,18
1457,87,25,62,14,-2.7185367714166615,11
1458,91,20,16,11,-2.721458273562551,9
1459,10,30,9,17,-2.725511572413539,13
1460,30,14,26,5,-2.7295268644643054,9
1461,29,14,23,8,-2.732572073895786,6
1462,28,21,34,12,-2.734662710408204,9
1463,90,31,98,16,-2.735368995859913,15
1464,79,49,2,26,-2.7373211518233562,23
1465,28,30,29,16,-2.7417268938351818,14
1466,79,50,10,24,-2.746120922049544,26
1467,87,66,8,37,-2.751858433815085,29
1468,65,52,55,32,-2.7542384607166874,20
1469,10,11,88,6,-2.7587208354368746,5
1470,86,33,98,19,-2.7839089247753153,14
1471,8,12,14,7,-2.8008148246776265,5
1472,12,11,8,6,-2.8009343879230215,5
1473,34,17,29,8,-2.8011697136542715,9
1474,107,15,63,9,-2.8021473545431568,6
1475,65,55,38,30,-2.806589910357459,25
1476,17,30,65,17,-2.836779237291186,13
1477,16,35,23,19,-2.843088725081075,16
1478,16,36,54,19,-2.8472057120467222,17
1479,18,29,111,16,-2.859497108899379,13
1480,65,47,6,23,-2.8655098630624103,24
1481,29,31,98,16,-2.8666453310461617,15
1482,13,11,55,6,-2.867532212513363,5
1483,28,15,46,8,-2.8691534505866247,7
1484,111,30,90,17,-2.89054471305433,13
1485,88,77,65,43,-2.896092046766025,34
1486,20,23,91,13,-2.91310351812833,10
1487,87,10,68,5,-2.918596255497213,5
1488,48,18,18,10,-2.9186933860892377,8
1489,41,36,29,19,-2.9244119186735795,17
1490,54,44,74,22,-2.926291357510124,22
1491,107,22,49,11,-2.938323040228233,11
1492,76,15,23,9,-2.940407468731348,6
1493,89,16,26,8,-3.0015441091670585,8
1494,16,57,79,32,-3.0146931048940533,25
1495,8,11,12,6,-3.0172474302587955,5
1496,16,18,38,9,-3.0174584469144037,9
1497,54,58,8,31,-3.034638933216957,27
1498,28,53,111,29,-3.0373034434579074,24
1499,44,14,9,6,-3.0418979222799787,8
1500,10,18,107,9,-3.050193716172087,9
1501,50,36,28,20,-3.0818186059352004,16
1502,28,34,48,20,-3.0997207494719854,14
1503,79,56,41,30,-3.1072129437235954,26
1504,50,27,54,16,-3.107516274798209,11
1505,17,15,20,9,-3.1232806552580437,6
1506,88,29,79,18,-3.124876625192895,11
1507,8,41,6,23,-3.1267473837905078,18
1508,98,10,106,6,-3.1299996913347967,4
1509,38,36,79,20,-3.1386740959807797,16
1510,48,26,87,14,-3.143928347009632,12
1511,90,10,1,5,-3.14882035881255,5
1512,37,13,91,7,-3.1893915884876662,6
1513,41,17,88,9,-3.1907658333962816,8
1514,86,19,23,10,-3.216916872797102,9
1515,26,37,79,21,-3.2224103393223973,16
1516,85,11,49,6,-3.234049059231714,5
1517,87,15,1,9,-3.235954063691745,6
1518,18,15,76,9,-3.237191989649946,6
1519,6,24,93,13,-3.240702778832872,11
1520,54,21,49,10,-3.2515113788114665,11
1521,98,11,59,6,-3.2664563544762517,5
1522,85,18,8,9,-3.274345405108027,9
1523,85,17,74,9,-3.280838878179328,8
1524,46,11,10,6,-3.290581679590821,5
1525,76,12,104,6,-3.2960173494490537,6
1526,79,59,28,29,-3.3058491126483527,30
1527,74,27,26,15,-3.318872656585847,12
1528,18,23,107,12,-3.3296591016307526,11
1529,84,21,91,12,-3.3334541794661074,9
1530,28,22,51,12,-3.3441861551037495,10
1531,8,26,29,14,-3.3557915076756832,12
1532,23,20,91,11,-3.3618813048957485,9
1533,84,36,54,21,-3.3687833567687178,15
1534,85,14,2,7,-3.3798876085075156,7
1535,13,14,76,7,-3.383197454645703,7
1536,91,14,57,9,-3.387917143764696,5
1537,37,57,79,33,-3.393777413566036,24
1538,28,32,32,18,-3.3937812746244553,14
1539,37,32,48,17,-3.3973368766785703,15
1540,6,12,57,8,-3.4000169565132334,4
1541,93,14,86,8,-3.420418426819413,6
1542,91,10,5,4,-3.4255398118724374,6
1543,8,18,51,10,-3.451831063610333,8
1544,6,12,50,7,-3.455131926902713,5
1545,20,31,74,17,-3.4627659895235983,14
1546,91,12,48,7,-3.4664297594725237,5
1547,76,21,111,10,-3.4688639491076154,11
1548,107,28,91,16,-3.470162400396327,12
1549,55,14,1,8,-3.472860068937083,6
1550,55,10,51,6,-3.4788515156123387,4
1551,91,38,79,20,-3.4922631180595523,18
1552,41,49,16,26,-3.501070366837183,23
1553,10,60,8,32,-3.5040882588587823,28
1554,18,55,28,30,-3.5048718464168536,25
1555,94,13,65,7,-3.505690987614661,6
1556,26,33,111,19,-3.5276889460712058,14
1557,8,28,73,17,-3.5539511566695987,11
1558,55,35,79,18,-3.5594817385076456,17
1559,38,25,50,14,-3.5687465201033057,11
1560,23,15,101,9,-3.591604516250614,6
1561,79,31,54,17,-3.598774057688567,14
1562,18,12,10,8,-3.6042571144804363,4
1563,48,21,54,10,-3.616041819529219,11
1564,10,40,2,23,-3.6379676405873043,17
1565,93,18,88,8,-3.6422156721699714,10
1566,73,22,20,12,-3.6521774474687554,10
1567,65,17,57,11,-3.66200460796526,6
1568,65,12,106,7,-3.6637536933904076,5
1569,89,14,48,8,-3.663870491648256,6
1570,84,19,30,10,-3.6645394021317745,9
1571,10,14,32,9,-3.709056496740224,5
1572,87,10,60,5,-3.716219490276847,5
1573,38,22,84,13,-3.721558072111377,9
1574,41,16,48,9,-3.723395209925695,7
1575,37,24,87,12,-3.7376369474443747,12
1576,10,34,65,19,-3.7403807843221304,15
1577,28,69,65,39,-3.7517616974629986,30
1578,88,31,55,19,-3.752259279704297,12
1579,18,12,57,8,-3.7525453734501912,4
1580,28,47,55,28,-3.7714851181849864,19
1581,73,15,79,8,-3.780403758532128,7
1582,110,11,26,5,-3.781495457699158,6
1583,103,12,110,7,-3.784927459031115,5
1584,49,21,54,13,-3.788826048016568,8
1585,18,15,93,8,-3.8000555745474087,7
1586,98,16,43,9,-3.8123705589147328,7
1587,49,16,79,10,-3.82316934588371,6
1588,20,14,37,8,-3.8240986868747266,6
1589,91,14,32,7,-3.8253106560348464,7
1590,29,21,91,12,-3.840820511726981,9
1591,18,18,41,11,-3.84366102932153,7
1592,49,14,38,7,-3.8551286140805963,7
1593,86,20,51,11,-3.863362217006626,9
1594,50,10,20,6,-3.866423191070092,4
1595,17,11,55,6,-3.8840410393606315,5
1596,84,47,98,26,-3.8908337456526567,21
1597,2,61,28,34,-3.8971268310607425,27
1598,2,26,91,15,-3.8971597312680113,11
1599,54,16,94,8,-3.897800639878564,8
1600,9,30,26,15,-3.917115924375875,15
1601,74,22,43,13,-3.9345782455697673,9
1602,112,10,91,5,-3.946754868280294,5
1603,73,22,6,11,-3.9476996189213933,11
1604,111,13,13,8,-3.9528063724151337,5
1605,8,40,91,21,-3.961945852137986,19
1606,20,20,112,10,-3.9655619093439842,10
1607,74,29,16,17,-3.974341734686631,12
1608,26,14,55,8,-3.9805474058369166,6
1609,74,30,2,16,-4.002224854294569,14
1610,79,33,23,17,-4.005580416521516,16
1611,103,50,79,29,-4.028559233170849,21
1612,28,58,98,31,-4.030600698284184,27
1613,88,11,10,6,-4.0314188677890535,5
1614,2,19,26,10,-4.041871884320681,9
1615,85,16,98,8,-4.042048861968959,8
1616,98,23,109,13,-4.0431120330253485,10
1617,10,32,16,18,-4.051397029804468,14
1618,87,30,16,17,-4.057897699416048,13
1619,9,36,2,19,-4.08389169356919,17
1620,98,39,37,22,-4.11677597890711,17
1621,10,16,103,9,-4.145748166667432,7
1622,2,15,37,8,-4.14722052773026,7
1623,91,23,65,11,-4.15010120900014,12
1624,48,15,63,8,-4.152796736858189,7
1625,2,61,98,34,-4.158496116358836,27
1626,32,16,2,9,-4.169077635966493,7
1627,30,25,79,13,-4.1738505804696135,12
1628,9,26,62,15,-4.200068098711876,11
1629,37,37,16,23,-4.21114707700778,14
1630,91,14,109,7,-4.213752581267606,7
1631,8,24,104,15,-4.217796324401938,9
1632,90,18,86,11,-4.223509495637682,7
1633,6,24,23,13,-4.230313442640459,11
1634,79,47,6,27,-4.237391580830745,20
1635,8,11,97,7,-4.238412616249588,4
1636,49,13,18,7,-4.243576516469454,6
1637,98,39,6,23,-4.250381101594533,16
1638,46,24,74,12,-4.250765743447537,12
1639,55,44,111,24,-4.253083069824154,20
1640,103,35,107,20,-4.274205878998454,15
1641,48,15,85,9,-4.305363268792187,6
1642,84,22,57,13,-4.307342730462738,9
1643,41,39,26,18,-4.308213459712551,21
1644,1,20,41,13,-4.310885836842604,7
1645,90,13,20,8,-4.319530234657456,5
1646,26,27,74,15,-4.321080857814067,12
1647,3,17,54,9,-4.336905078418528,8
1648,44,13,79,7,-4.356415433762269,6
1649,2,11,57,7,-4.360321050424336,4
1650,107,43,87,26,-4.366588065151469,17
1651,94,11,87,6,-4.375015437142172,5
1652,1,10,90,6,-4.375601097645208,4
1653,89,13,54,8,-4.375934710162814,5
1654,104,15,107,9,-4.384096889948017,6
1655,41,36,50,20,-4.39168406813968,16
1656,50,11,75,7,-4.392668801200932,4
1657,41,36,84,22,-4.405400183867785,14
1658,20,19,43,10,-4.407702920435093,9
1659,103,20,73,11,-4.408542656876506,9
1660,13,10,90,5,-4.435057658973358,5
1661,2,18,90,10,-4.440452857575481,8
1662,58,16,98,8,-4.454073647186219,8
1663,84,23,73,15,-4.463513313785124,8
1664,110,23,20,13,-4.46357978693552,10
1665,15,25,111,15,-4.472513123100842,10
1666,29,21,111,10,-4.484029622528673,11
1667,16,31,55,18,-4.485374733499422,13
1668,93,21,29,12,-4.498959392246701,9
1669,62,11,29,6,-4.502398822563125,5
1670,93,28,79,14,-4.503897640777635,14
1671,23,40,41,23,-4.507259861409941,17
1672,93,29,111,15,-4.510765206652467,14
1673,85,11,18,5,-4.514791288537011,6
1674,74,15,32,9,-4.519404747582117,6
1675,109,26,65,13,-4.522732343847644,13
1676,23,24,74,13,-4.530539923458647,11
1677,51,10,2,5,-4.541060117126738,5
1678,98,43,20,25,-4.552220105497898,18
1679,57,15,87,8,-4.5524099729129395,7
1680,89,20,9,13,-4.555028073124964,7
1681,37,13,46,7,-4.568700097838745,6
1682,8,60,74,34,-4.573820893582637,26
1683,86,49,84,27,-4.577240119007232,22
1684,49,19,28,12,-4.587943557807992,7
1685,16,60,28,34,-4.590998298731028,26
1686,15,10,86,5,-4.603054673648832,5
1687,54,27,87,15,-4.613822779482278,12
1688,9,49,111,26,-4.631532876714527,23
1689,2,20,29,11,-4.659724574406296,9
1690,9,76,79,43,-4.699969329384482,33
1691,29,35,87,20,-4.710088352572669,15
1692,93,19,109,11,-4.710552248323455,8
1693,9,30,90,17,-4.717832744642908,13
1694,106,13,8,7,-4.770713481148755,6
1695,65,41,23,23,-4.770740161452314,18
1696,28,37,23,21,-4.773448036217731,16
1697,2,61,8,33,-4.776225618469158,28
1698,104,10,111,6,-4.78538385386756,4
1699,20,12,13,8,-4.788358918637375,4
1700,103,33,50,19,-4.789964024048163,14
1701,30,11,17,6,-4.793161472453949,5
1702,18,11,86,6,-4.795064637153174,5
1703,88,22,87,14,-4.796769422048855,8
1704,48,46,8,26,-4.828884672158708,20
1705,13,13,103,7,-4.835710066696813,6
1706,111,60,79,36,-4.845673626000181,24
1707,98,25,30,16,-4.849081372286935,9
1708,20,30,93,15,-4.900735470483163,15
1709,5,11,65,6,-4.901615377921411,5
1710,70,23,28,12,-4.906318270343949,11
1711,20,51,87,29,-4.928957222630361,22
1712,6,15,34,9,-4.930033055320858,6
1713,103,11,46,6,-4.934914439873031,5
1714,20,37,111,20,-4.9479559141790075,17
1715,111,36,107,21,-4.95140635788508,15
1716,59,10,10,5,-4.967497448599415,5
1717,86,20,41,11,-4.968122887256159,9
1718,20,10,89,6,-4.97640303815121,4
1719,54,17,62,10,-5.001633115691913,7
1720,32,20,55,12,-5.0109481732467795,8
1721,84,15,89,10,-5.0152693534373975,5
1722,1,17,16,9,-5.031673674933401,8
1723,43,13,111,7,-5.0327903736846205,6
1724,54,58,65,32,-5.034371936668328,26
1725,73,20,16,11,-5.0706587833744905,9
1726,41,16,59,9,-5.075333393683101,7
1727,49,17,32,9,-5.084232180469871,8
1728,18,21,103,12,-5.117263308095348,9
1729,89,29,41,17,-5.128070897369619,12
1730,17,12,54,7,-5.132650672697679,5
1731,32,12,20,7,-5.135866792699633,5
1732,20,47,8,28,-5.13696712403145,19
1733,87,26,103,15,-5.13844337309213,11
1734,52,10,98,5,-5.141825899051739,5
1735,57,15,16,8,-5.174682414292543,7
1736,84,39,23,22,-5.174802875601986,17
1737,57,10,111,6,-5.186942618450885,4
1738,86,36,9,20,-5.1882255653846405,16
1739,88,24,107,13,-5.19928280373495,11
1740,9,106,65,61,-5.210618625384625,45
1741,8,22,30,14,-5.213064512809206,8
1742,9,30,55,19,-5.234489127276957,11
1743,111,10,1,5,-5.238983537325088,5
1744,65,71,93,41,-5.253531432442059,30
1745,89,12,50,7,-5.253704218444141,5
1746,85,15,63,8,-5.266282773446651,7
1747,2,33,50,20,-5.273652216296242,13
1748,9,45,87,26,-5.276968272081167,19
1749,103,30,17,18,-5.294404276815358,12
1750,16,20,90,11,-5.309705496674622,9
1751,79,36,50,20,-5.311051747194994,16
1752,71,14,84,8,-5.316384874786531,6
1753,8,23,90,14,-5.338168133162711,9
1754,84,21,29,12,-5.340667565501357,9
1755,6,13,89,8,-5.362805216014631,5
1756,41,66,8,36,-5.383353261881381,30
1757,41,35,73,20,-5.413974250069213,15
1758,38,26,20,15,-5.422962328602488,11
1759,9,32,50,19,-5.426721633588274,13
1760,23,16,109,10,-5.438260955948294,6
1761,76,39,84,20,-5.438513858870126,19
1762,9,27,13,17,-5.440810272043136,10
1763,87,27,49,14,-5.451792030762737,13
1764,37,14,55,8,-5.456618910920272,6
1765,38,25,30,13,-5.45936332609693,12
1766,9,10,14,7,-5.463439437022661,3
1767,38,33,54,20,-5.464199343195866,13
1768,87,20,90,13,-5.4648990682068606,7
1769,49,13,93,7,-5.465162375246015,6
1770,15,15,65,8,-5.468158414216741,7
1771,87,10,89,6,-5.49435219974972,4
1772,73,21,74,12,-5.49643746893769,9
1773,85,12,107,5,-5.501246863309672,7
1774,107,75,8,43,-5.502573365722743,32
1775,34,16,107,9,-5.514558906998724,7
1776,28,33,20,21,-5.535599624151648,12
1777,2,10,46,6,-5.541906116456114,4
1778,97,11,28,5,-5.54697078214519,6
1779,98,31,87,19,-5.565208502801091,12
1780,48,14,49,7,-5.572044813615613,7
1781,55,24,103,14,-5.588813975862993,10
1782,48,33,6,19,-5.618170706899613,14
1783,57,11,86,6,-5.628641785626694,5
1784,29,22,26,14,-5.630548836449718,8
1785,20,25,6,13,-5.631661671252286,12
1786,87,12,104,8,-5.633009975820382,4
1787,48,16,2,8,-5.635246627200363,8
1788,9,45,41,28,-5.6439057397283525,17
1789,6,26,103,16,-5.659939287843899,10
1790,50,13,17,8,-5.662435030700867,5
1791,91,29,111,16,-5.664784285354977,13
1792,91,16,63,9,-5.6695484537306235,7
1793,9,13,43,7,-5.682535108763632,6
1794,51,11,18,6,-5.697627847770079,5
1795,65,23,89,13,-5.729458742490648,10
1796,55,14,26,8,-5.738748859328644,6
1797,37,20,90,12,-5.742590617036875,8
1798,9,29,38,16,-5.756435186772364,13
1799,28,15,75,8,-5.767432508412389,7
1800,79,14,51,8,-5.772506691008202,6
1801,50,27,55,17,-5.779208495041811,10
1802,54,18,32,11,-5.782610489553489,7
1803,8,13,63,8,-5.788280347549516,5
1804,73,14,26,7,-5.793757710550314,7
1805,94,12,8,7,-5.79404543544707,5
1806,76,40,86,22,-5.806686757195042,18
1807,8,37,37,21,-5.826102721509761,16
1808,44,10,2,6,-5.829723764491529,4
1809,10,31,98,18,-5.831587893507183,13
1810,48,10,107,6,-5.863597775104665,4
1811,16,17,17,10,-5.868342075872026,7
1812,9,45,74,27,-5.903246001506488,18
1813,2,32,84,19,-5.92758837249606,13
1814,112,20,20,12,-5.92853113025916,8
1815,30,21,91,11,-5.9422253465580335,10
1816,91,28,87,17,-5.954439761122977,11
1817,48,16,90,9,-5.9550343515423965,7
1818,49,23,8,13,-5.962799116224744,10
1819,34,10,17,6,-5.970863859166942,4
1820,23,18,2,10,-5.985551573396107,8
1821,77,10,49,5,-6.002993751357126,5
1822,91,18,38,10,-6.003578716041363,8
1823,2,11,94,6,-6.010461250553638,5
1824,91,48,98,26,-6.010481139866049,22
1825,98,27,26,14,-6.028495429489334,13
1826,8,72,55,44,-6.055158512520887,28
1827,98,13,63,7,-6.056134732306893,6
1828,2,27,107,16,-6.062909258737935,11
1829,89,25,79,16,-6.066359313406789,9
1830,74,38,111,22,-6.079631925271179,16
1831,76,34,16,19,-6.08845765369634,15
1832,6,17,49,10,-6.097985660912411,7
1833,56,11,111,7,-6.133528731729063,4
1834,66,11,2,7,-6.205381429919995,4
1835,34,14,16,8,-6.229556768499603,6
1836,41,35,2,22,-6.231438093089563,13
1837,9,12,75,8,-6.239095019020707,4
1838,9,34,73,20,-6.263734230116223,14
1839,76,25,87,15,-6.268639154144934,10
1840,16,25,32,15,-6.270434527094816,10
1841,50,23,111,14,-6.270457745960824,9
1842,44,15,111,9,-6.2820016152004,6
1843,54,16,90,9,-6.290244829620479,7
1844,79,74,8,41,-6.3077183885854256,33
1845,16,62,8,38,-6.324271270247478,24
1846,111,30,2,18,-6.328590766591992,12
1847,6,26,29,15,-6.3363017192733935,11
1848,9,94,8,55,-6.3376207318031605,39
1849,73,18,86,11,-6.340120760849839,7
1850,28,10,31,6,-6.368565836830035,4
1851,88,22,103,14,-6.368772240906126,8
1852,37,22,30,14,-6.384018768768752,8
1853,28,28,10,18,-6.393353899415193,10
1854,54,38,28,23,-6.41158418063418,15
1855,74,36,79,23,-6.418996516558229,13
1856,28,14,12,9,-6.429365216940005,5
1857,62,10,90,6,-6.4415032468905995,4
1858,88,16,20,10,-6.450213485704791,6
1859,48,32,65,19,-6.477954122109943,13
1860,48,11,23,6,-6.485113687277626,5
1861,62,35,8,21,-6.490056401985654,14
1862,8,35,32,20,-6.494741280760348,15
1863,28,34,103,20,-6.496510604338202,14
1864,18,25,87,16,-6.500921078177539,9
1865,62,13,17,8,-6.51109228837904,5
1866,88,26,74,17,-6.515151171646331,9
1867,70,14,103,7,-6.530155528635705,7
1868,57,18,23,10,-6.535348935161005,8
1869,84,18,14,13,-6.539625119207457,5
1870,16,14,30,9,-6.55720678280854,5
1871,66,12,84,7,-6.578044154096628,5
1872,79,22,17,13,-6.594638264229067,9
1873,18,48,8,29,-6.594687381789504,19
1874,18,21,16,13,-6.6099594156094685,8
1875,76,20,107,12,-6.61181954357389,8
1876,55,18,74,10,-6.615183527938431,8
1877,85,14,86,7,-6.640232602185863,7
1878,76,41,79,26,-6.641927270209355,15
1879,49,15,17,9,-6.655321673670166,6
1880,34,23,98,15,-6.664658670492527,8
1881,49,16,74,9,-6.6690338705923,7
1882,9,24,18,14,-6.669379438735331,10
1883,9,23,32,14,-6.676114746540027,9
1884,2,14,15,8,-6.68122325045803,6
1885,57,16,88,9,-6.698470388803919,7
1886,62,18,79,10,-6.706683341972167,8
1887,74,11,89,6,-6.714017548400364,5
1888,34,19,2,11,-6.729658072634228,8
1889,32,24,65,14,-6.740147619373065,10
1890,41,42,111,24,-6.742879314894576,18
1891,50,36,98,20,-6.748525889961948,16
1892,54,17,46,11,-6.756375555864047,6
1893,28,38,6,23,-6.756711383632952,15
1894,28,46,87,28,-6.771264575755612,18
1895,20,25,2,14,-6.800156386602417,11
1896,41,35,91,22,-6.801656465480553,13
1897,6,21,88,13,-6.808639243885848,8
1898,91,26,6,15,-6.823132237906975,11
1899,70,16,30,10,-6.824605553405184,6
1900,28,38,38,22,-6.8687841977025155,16
1901,63,10,88,6,-6.87340914266048,4
1902,16,11,15,7,-6.875773988595896,4
1903,74,12,57,8,-6.91760424242575,4
1904,17,14,90,8,-6.930186835428714,6
1905,79,19,29,11,-6.9516082437861915,8
1906,68,10,73,6,-6.95394987102174,4
1907,50,27,107,17,-6.978239572703387,10
1908,101,11,79,6,-6.990861425930873,5
1909,104,21,79,14,-7.001432407845643,7
1910,6,19,90,11,-7.0034906221582,8
1911,6,10,51,7,-7.0035300376142064,3
1912,91,26,103,13,-7.011657257024809,13
1913,6,20,111,12,-7.01838566892247,8
1914,9,40,23,24,-7.023066131343451,16
1915,79,19,59,11,-7.0352036880537865,8
1916,34,12,55,8,-7.041774709364912,4
1917,28,37,91,23,-7.04770720595576,14
1918,9,29,109,17,-7.056487417755326,12
1919,34,15,87,9,-7.057985714791882,6
1920,86,21,30,16,-7.093547407861882,5
1921,62,14,104,9,-7.094567188746597,5
1922,89,16,16,10,-7.102664218068734,6
1923,20,14,86,8,-7.118094837224455,6
1924,86,28,74,17,-7.130541060573803,11
1925,103,20,29,12,-7.147753101442872,8
1926,32,16,103,10,-7.165401001930772,6
1927,6,38,54,26,-7.169885763488394,12
1928,6,11,5,7,-7.175117705775805,4
1929,98,40,23,25,-7.180366591070175,15
1930,87,21,70,13,-7.188789144484621,8
1931,20,17,94,11,-7.200649176708728,6
1932,34,13,111,7,-7.201437198359538,6
1933,29,19,54,13,-7.2088827987279975,6
1934,6,29,55,20,-7.216182147698299,9
1935,76,19,10,11,-7.223608714939963,8
1936,49,13,30,8,-7.228582193886497,5
1937,73,18,50,10,-7.241939960957099,8
1938,103,49,98,31,-7.248745608369252,18
1939,88,24,84,15,-7.256956915758404,9
1940,38,14,88,8,-7.257573306252311,6
1941,93,46,8,29,-7.2594345956102755,17
1942,112,12,28,7,-7.260189333899192,5
1943,9,46,54,28,-7.266385848091386,18
1944,86,19,10,12,-7.266452513785876,7
1945,73,10,30,6,-7.2752412959190496,4
1946,70,15,23,9,-7.277989111704888,6
1947,68,24,8,14,-7.280502110476545,10
1948,94,16,9,9,-7.284482029205993,7
1949,41,44,87,25,-7.307077046689725,19
1950,10,21,54,13,-7.316914939103655,8
1951,10,23,89,14,-7.332600528276465,9
1952,103,16,10,9,-7.341759223830171,7
1953,87,22,38,14,-7.344861542182531,8
1954,65,14,43,8,-7.3477742435965085,6
1955,84,28,20,18,-7.362780437625792,10
1956,111,10,63,6,-7.375087282658117,4
1957,8,12,94,7,-7.380839863701195,5
1958,28,24,13,16,-7.385148355874094,8
1959,65,80,20,50,-7.401837775451882,30
1960,5,15,98,9,-7.40308817440165,6
1961,38,14,32,9,-7.403225517490019,5
1962,49,13,41,9,-7.40613906742907,4
1963,75,13,41,7,-7.41688145074682,6
1964,54,29,88,17,-7.418874182686384,12
1965,68,14,98,10,-7.427653338623123,4
1966,50,31,87,19,-7.429484842498572,12
1967,48,14,17,8,-7.444960593591363,6
1968,86,33,87,20,-7.461882361903258,13
1969,9,68,16,44,-7.462101106161526,24
1970,8,16,1,9,-7.473060523777063,7
1971,9,34,107,19,-7.482440310595418,15
1972,79,23,18,13,-7.489902589142591,10
1973,41,53,28,30,-7.494799478271726,23
1974,38,24,2,13,-7.498014725943601,11
1975,54,28,103,16,-7.519450232339535,12
1976,34,26,84,17,-7.521080186287478,9
1977,107,20,29,13,-7.525530619454991,7
1978,70,17,79,9,-7.531628680674292,8
1979,112,21,6,12,-7.552230223314681,9
1980,86,26,111,15,-7.599516330003592,11
1981,74,20,10,13,-7.659112863437717,7
1982,10,12,104,7,-7.6851628828676155,5
1983,65,70,111,40,-7.692935034996462,30
1984,76,40,88,23,-7.693645081601591,17
1985,28,44,107,25,-7.70030747690758,19
1986,59,11,23,7,-7.703199044299859,4
1987,85,14,111,9,-7.729378570457982,5
1988,74,19,17,11,-7.746897696537681,8
1989,109,13,29,8,-7.7648215544268036,5
1990,2,11,58,7,-7.801381373372695,4
1991,11,10,28,6,-7.813271079515417,4
1992,37,32,76,21,-7.820497576953574,11
1993,9,26,17,16,-7.831275179780667,10
1994,38,36,8,23,-7.848513446954377,13
1995,12,11,74,6,-7.881335923893619,5
1996,13,14,49,8,-7.890029815709072,6
1997,88,36,16,24,-7.895427898542639,12
1998,37,25,54,17,-7.943083932672221,8
1999,68,17,65,10,-7.94486932740305,7
2000,76,18,55,11,-7.9507324288399905,7
2001,29,13,10,8,-7.953877306686606,5
2002,18,26,98,16,-7.97184494616587,10
2003,37,12,109,7,-7.972273664149992,5
2004,86,14,32,8,-7.973587175462616,6
2005,2,47,16,29,-7.9815590536605585,18
2006,8,40,23,25,-7.983032320771588,15
2007,34,16,41,9,-7.985588983079854,7
2008,46,12,29,8,-7.990068011062898,4
2009,9,23,49,15,-7.992519163965534,8
2010,41,15,90,9,-7.997737246515682,6
2011,86,11,1,7,-8.004187715591307,4
2012,28,40,93,24,-8.034788116271674,16
2013,79,45,87,27,-8.036990951026816,18
2014,111,34,16,19,-8.046487125961022,15
2015,74,11,13,7,-8.04867506694036,4
2016,13,12,6,7,-8.074590184679874,5
2017,10,15,30,10,-8.08039942607508,5
2018,86,19,38,13,-8.08239085687564,6
2019,54,32,93,22,-8.106367720057326,10
2020,84,59,16,36,-8.110816647171314,23
2021,9,14,19,8,-8.117304295019109,6
2022,43,23,8,14,-8.14423209940399,9
2023,106,18,79,10,-8.147257860665952,8
2024,20,16,16,9,-8.147746017528714,7
2025,48,42,84,25,-8.151068929408753,17
2026,86,65,16,41,-8.160600875802444,24
2027,8,29,17,18,-8.17510581548791,11
2028,98,29,49,17,-8.192506354783728,12
2029,8,19,13,12,-8.198779355292585,7
2030,94,13,28,8,-8.222371266039165,5
2031,16,10,26,6,-8.231874067384071,4
2032,17,14,111,8,-8.239799794462428,6
2033,9,33,20,22,-8.272596506781884,11
2034,70,24,16,16,-8.272893937971954,8
2035,58,12,65,6,-8.279172093518044,6
2036,41,18,76,11,-8.284971187696902,7
2037,65,52,74,33,-8.288743311827762,19
2038,84,19,17,12,-8.294099990413244,7
2039,59,17,9,11,-8.305936798720639,6
2040,109,33,8,20,-8.311226620633244,13
2041,103,45,41,31,-8.332714422601015,14
2042,35,10,8,6,-8.335806667410798,4
2043,9,36,91,22,-8.337030454552696,14
2044,84,11,104,7,-8.339235828654417,4
2045,107,12,13,8,-8.345381439717178,4
2046,63,20,84,12,-8.347628578121029,8
2047,65,14,1,9,-8.38534721300084,5
2048,93,23,23,13,-8.387201678617911,10
2049,23,19,90,12,-8.394839451243376,7
2050,89,11,90,7,-8.396796914570167,4
2051,87,17,43,11,-8.41719039009833,6
2052,10,21,73,14,-8.419335562342074,7
2053,1,21,98,14,-8.436557583367687,7
2054,85,26,84,14,-8.437491114567154,12
2055,88,26,9,16,-8.454680341295328,10
2056,84,31,93,20,-8.465363334016377,11
2057,56,13,8,9,-8.47665012859135,4
2058,76,23,54,13,-8.511877556498478,10
2059,109,10,89,6,-8.517312082575362,4
2060,103,24,26,14,-8.523036763842914,10
2061,62,18,41,11,-8.537234992782361,7
2062,28,36,76,22,-8.544961108918415,14
2063,10,18,93,12,-8.563863748489084,6
2064,86,40,37,24,-8.603825624585157,16
2065,109,18,34,11,-8.66273498003356,7
2066,88,23,37,15,-8.667790010971713,8
2067,20,15,34,10,-8.68693105656746,5
2068,37,23,23,15,-8.700238300329007,8
2069,75,16,79,11,-8.729196308002651,5
2070,20,35,55,21,-8.738108987978196,14
2071,91,26,2,15,-8.783750173530157,11
2072,9,24,29,14,-8.786804079346389,10
2073,20,53,41,35,-8.79255140026366,18
2074,85,11,10,6,-8.810276618143424,5
2075,79,26,32,17,-8.859137187931584,9
2076,94,17,98,11,-8.877059957058028,6
2077,76,49,8,31,-8.921707122679685,18
2078,110,20,107,12,-8.933567921834605,8
2079,54,19,30,12,-8.941378731198725,7
2080,65,40,2,27,-8.964459948107422,13
2081,107,17,43,11,-8.971497306643272,6
2082,20,10,46,5,-8.988887305938196,5
2083,76,35,74,23,-9.021109435296268,12
2084,65,57,16,35,-9.041777655106586,22
2085,50,16,91,11,-9.044194652502608,5
2086,109,13,106,8,-9.06266809979583,5
2087,46,10,20,7,-9.077995926942414,3
2088,32,12,26,7,-9.09769401619869,5
2089,57,11,2,6,-9.107338089684553,5
2090,30,14,23,8,-9.118564512919738,6
2091,91,35,74,22,-9.120669894046731,13
2092,65,58,98,37,-9.126651402593732,21
2093,48,15,50,9,-9.13089598930206,6
2094,87,20,30,13,-9.180499280009718,7
2095,6,18,30,13,-9.214935490589038,5
2096,65,45,63,28,-9.25715880946967,17
2097,50,14,43,9,-9.27474781724881,5
2098,23,17,50,10,-9.300090532650529,7
2099,32,29,111,17,-9.306159625162506,12
2100,79,22,34,13,-9.33337221438402,9
2101,55,15,23,9,-9.335240638495891,6
2102,29,22,74,13,-9.341715830488068,9
2103,86,17,49,9,-9.343172433673239,8
2104,8,16,46,10,-9.372412655150535,6
2105,8,14,59,9,-9.376826871718674,5
2106,76,20,91,13,-9.390956065597498,7
2107,62,14,76,7,-9.422068732882325,7
2108,10,11,57,7,-9.432674751481889,4
2109,55,10,70,6,-9.436952114481361,4
2110,44,17,65,10,-9.443702457838898,7
2111,34,24,8,16,-9.455603000494804,8
2112,109,24,20,17,-9.46777700616948,7
2113,19,11,103,7,-9.481054864710421,4
2114,58,11,6,7,-9.489496457414932,4
2115,28,16,43,11,-9.500596764145225,5
2116,76,23,15,15,-9.503739473265108,8
2117,88,14,32,10,-9.505084521049728,4
2118,8,45,26,27,-9.507536225083523,18
2119,17,13,91,8,-9.524679603281824,5
2120,79,21,13,15,-9.547980426671515,6
2121,65,21,60,13,-9.571951123571171,8
2122,89,22,23,14,-9.576875474490599,8
2123,68,18,20,11,-9.579258034610845,7
2124,107,28,79,19,-9.628503445575708,9
2125,18,10,46,7,-9.6369429103627,3
2126,62,26,98,16,-9.641858129313675,10
2127,54,23,55,16,-9.648181025800833,7
2128,85,11,88,7,-9.656301948727862,4
2129,38,32,29,21,-9.681299801122256,11
2130,54,42,111,27,-9.689985351794757,15
2131,2,17,70,12,-9.721215849454834,5
2132,48,10,34,6,-9.747358685821412,4
2133,103,36,111,23,-9.751404731703087,13
2134,85,19,28,12,-9.754813285313771,7
2135,103,42,8,29,-9.755203687685839,13
2136,76,19,46,13,-9.759368120687249,6
2137,44,34,6,21,-9.768613303295997,13
2138,48,31,79,19,-9.853595538086747,12
2139,64,10,28,6,-9.858359509289869,4
2140,50,14,10,9,-9.907166966632534,5
2141,17,13,87,8,-9.92299839057508,5
2142,75,10,103,6,-9.92764617859353,4
2143,70,11,93,7,-9.928875321549777,4
2144,18,14,55,9,-9.949790942140542,5
2145,55,17,10,10,-9.95517779426481,7
2146,38,24,111,15,-9.966212518632437,9
2147,70,10,29,7,-9.97437186041017,3
2148,34,17,76,11,-9.994247540573088,6
2149,30,11,88,6,-10.024835723736619,5
2150,46,17,111,11,-10.027977766283337,6
2151,9,13,63,8,-10.036609783490738,5
2152,74,26,93,18,-10.070964280509381,8
2153,54,18,63,11,-10.075840147553764,7
2154,74,29,103,20,-10.120878103689181,9
2155,50,15,30,9,-10.12099142967515,6
2156,84,14,109,9,-10.149942855967593,5
2157,65,23,110,15,-10.151511833678441,8
2158,18,17,74,11,-10.161044876408573,6
2159,38,10,60,6,-10.186949801542625,4
2160,96,12,65,7,-10.190345361441285,5
2161,6,16,26,11,-10.241752287967037,5
2162,109,14,91,9,-10.246844938152377,5
2163,9,68,28,43,-10.257395044502449,25
2164,28,20,104,14,-10.28097645051314,6
2165,73,16,2,10,-10.299221262346556,6
2166,75,11,2,7,-10.369833561069749,4
2167,75,12,93,7,-10.370088912225684,5
2168,17,10,29,7,-10.39598522715346,3
2169,88,15,73,10,-10.39694546347287,5
2170,49,17,20,11,-10.413212284497675,6
2171,76,20,70,13,-10.440720709029375,7
2172,9,20,34,13,-10.45322514499284,7
2173,79,37,26,23,-10.48182801922156,14
2174,76,32,98,20,-10.566257306689163,12
2175,32,12,6,8,-10.5718983874489,4
2176,65,15,70,10,-10.573807897523746,5
2177,109,14,103,10,-10.579033749442829,4
2178,109,12,86,7,-10.607119538943413,5
2179,101,10,65,6,-10.616476001261296,4
2180,88,37,98,26,-10.63966352804894,11
2181,58,13,38,9,-10.642287291889899,4
2182,109,18,74,11,-10.643610558105994,7
2183,16,16,75,11,-10.668295124883427,5
2184,109,16,107,10,-10.668493285549742,6
2185,6,26,16,16,-10.690827392878646,10
2186,41,14,37,9,-10.69447624326301,5
2187,103,50,65,34,-10.69843242130798,16
2188,85,10,91,5,-10.702453755941068,5
2189,41,26,55,16,-10.703172393729925,10
2190,85,23,16,15,-10.722666363673586,8
2191,66,13,8,9,-10.737460925769152,4
2192,30,20,55,12,-10.741156330527382,8
2193,37,10,50,6,-10.742277179240862,4
2194,18,14,23,10,-10.769319649937687,4
2195,23,16,17,11,-10.781653305644483,5
2196,103,25,30,17,-10.782874613377903,8
2197,6,27,87,18,-10.792781333267998,9
2198,68,11,50,8,-10.798306988405807,3
2199,87,33,93,22,-10.803849348258458,11
2200,63,13,37,8,-10.805969524077794,5
2201,41,48,98,30,-10.835326353590224,18
2202,51,16,54,10,-10.84412241330361,6
2203,62,11,30,7,-10.85983931371429,4
2204,8,10,11,7,-10.874801270533911,3
2205,65,30,26,19,-10.898269254189744,11
2206,20,38,26,25,-10.94603615247926,13
2207,2,11,13,8,-10.953261699605443,3
2208,51,17,87,11,-10.954751209558498,6
2209,43,10,30,7,-10.958461383133036,3
2210,56,10,87,7,-10.97544493784176,3
2211,6,14,38,10,-11.005398790381081,4
2212,9,21,30,15,-11.009407613122827,6
2213,50,20,65,13,-11.026543162219186,7
2214,110,12,98,8,-11.026999619900332,4
2215,103,13,13,8,-11.054952217566056,5
2216,6,25,74,17,-11.078169532223491,8
2217,37,19,93,13,-11.13537305772806,6
2218,46,13,26,8,-11.170213516874066,5
2219,28,10,15,7,-11.176545961741331,3
2220,37,16,85,12,-11.18389053845617,4
2221,1,14,93,10,-11.222746146114872,4
2222,50,18,32,11,-11.225096892130631,7
2223,29,21,30,13,-11.231145218657787,8
2224,65,14,34,9,-11.233073447780972,5
2225,103,22,2,16,-11.358008021341288,6
2226,9,18,46,11,-11.371108835096297,7
2227,97,10,9,6,-11.373867326772801,4
2228,10,27,84,18,-11.41284579921636,9
2229,41,20,17,15,-11.462467383182341,5
2230,79,33,20,23,-11.526375009031396,10
2231,109,22,38,15,-11.561969316834697,7
2232,102,16,65,10,-11.565057266886953,6
2233,91,15,55,11,-11.567443094683266,4
2234,13,18,16,12,-11.568229122492735,6
2235,18,16,65,11,-11.593628436717696,5
2236,18,11,91,7,-11.600004781918232,4
2237,15,17,98,11,-11.628891195956705,6
2238,70,14,107,9,-11.658453467748302,5
2239,93,13,73,9,-11.6698926319616,4
2240,91,15,93,10,-11.673165263369297,5
2241,20,13,18,8,-11.715025972179685,5
2242,20,41,107,26,-11.716667295780276,15
2243,62,13,70,8,-11.719880801732709,5
2244,26,15,23,10,-11.729655071897735,5
2245,79,10,15,7,-11.756403792330063,3
2246,107,14,1,9,-11.758251767033554,5
2247,88,15,46,11,-11.79739038215315,4
2248,103,29,93,19,-11.801085216233043,10
2249,9,11,58,8,-11.82226661915616,3
2250,41,37,54,25,-11.822644765581678,12
2251,62,15,23,11,-11.828374088275872,4
2252,109,14,43,9,-11.866460109925436,5
2253,87,44,26,29,-11.871386146117102,15
2254,1,11,9,7,-11.88637849875501,4
2255,111,17,48,12,-11.90270630017423,5
2256,17,13,18,8,-11.905263091036245,5
2257,76,10,93,7,-11.923250604262599,3
2258,98,16,104,10,-11.93364499732059,6
2259,98,24,32,16,-11.959293567844906,8
2260,65,22,49,14,-11.960634834980652,8
2261,11,15,98,10,-11.975065250902471,5
2262,87,46,55,32,-12.067123893381954,14
2263,6,18,18,12,-12.078104024118801,6
2264,112,11,79,8,-12.089617166544242,3
2265,103,11,58,8,-12.093407699535737,3
2266,62,10,49,6,-12.115401300524661,4
2267,41,20,93,15,-12.152619394683914,5
2268,109,11,10,7,-12.166039484484626,4
2269,48,20,74,13,-12.23065848011944,7
2270,48,15,51,11,-12.237016972870084,4
2271,62,17,84,11,-12.256108525265194,6
2272,41,24,32,15,-12.295470101415006,9
2273,50,17,93,11,-12.303370496346982,6
2274,89,20,28,13,-12.339450745494954,7
2275,26,12,93,8,-12.342400061412198,4
2276,23,18,20,13,-12.419097927334022,5
2277,62,22,93,15,-12.439036445917942,7
2278,84,14,15,10,-12.488568021465507,4
2279,84,16,18,11,-12.537157233284487,5
2280,70,11,90,8,-12.581946187652864,3
2281,98,41,55,29,-12.606268888418896,12
2282,103,33,20,24,-12.666531668869954,9
2283,86,11,63,8,-12.694676726792155,3
2284,90,11,73,8,-12.699639901607055,3
2285,89,13,8,9,-12.71018067794311,4
2286,111,21,73,14,-12.761253099258202,7
2287,5,13,87,9,-12.788098556943204,4
2288,104,13,54,9,-12.823245238040407,4
2289,86,31,2,22,-12.839620514410687,9
2290,9,37,93,26,-12.871076607744827,11
2291,14,11,87,8,-12.902634224263666,3
2292,8,11,3,8,-12.917286316124729,3
2293,34,13,37,9,-12.941927105411445,4
2294,79,15,63,10,-12.990676793013693,5
2295,50,10,112,7,-13.007963386743388,3
2296,43,18,55,12,-13.012921035450152,6
2297,86,16,64,11,-13.126489420837816,5
2298,41,30,107,19,-13.154593566297324,11
2299,103,11,43,7,-13.18571482888933,4
2300,17,25,28,18,-13.189393025867652,7
2301,107,17,32,13,-13.233625998220862,4
2302,89,10,58,7,-13.242354787086834,3
2303,109,24,26,17,-13.281044125686407,7
2304,73,12,89,8,-13.292782754035754,4
2305,74,12,70,9,-13.332522800110311,3
2306,109,22,32,15,-13.338298268264783,7
2307,91,10,112,7,-13.34887289439105,3
2308,93,10,90,6,-13.383501710064953,4
2309,55,16,86,10,-13.429599224429369,6
2310,73,15,13,10,-13.471561712276635,5
2311,38,23,74,15,-13.50724395592576,8
2312,37,20,111,13,-13.57504840749371,7
2313,5,12,37,9,-13.593067112324485,3
2314,43,17,26,13,-13.59933768355571,4
2315,13,17,84,11,-13.614397809771184,6
2316,57,21,8,14,-13.698942718189373,7
2317,13,10,37,7,-13.71058873552403,3
2318,73,16,38,10,-13.771113964229546,6
2319,8,12,77,9,-13.772928583045534,3
2320,43,14,93,10,-13.775006273083642,4
2321,109,26,54,18,-13.82452652075349,8
2322,50,11,26,8,-13.83833866908602,3
2323,2,22,55,15,-13.871872112800904,7
2324,38,25,55,17,-13.895599618213817,8
2325,109,12,70,9,-13.902253335630233,3
2326,79,14,46,9,-13.926744437290193,5
2327,9,20,57,15,-13.952239963411907,5
2328,37,13,17,8,-14.00319652989779,5
2329,8,16,110,12,-14.095812927776763,4
2330,71,11,98,8,-14.175605929164407,3
2331,38,12,48,9,-14.205802555452095,3
2332,109,12,50,8,-14.261856398454313,4
2333,8,10,60,7,-14.262033464961128,3
2334,62,21,55,14,-14.271402247137448,7
2335,44,10,84,7,-14.273373064789189,3
2336,84,22,70,15,-14.297191605156181,7
2337,91,11,46,8,-14.304066831342237,3
2338,17,12,86,9,-14.311620358508238,3
2339,66,10,28,6,-14.329185091749263,4
2340,62,25,107,17,-14.35253847720114,8
2341,23,23,10,15,-14.368201832765767,8
2342,20,26,29,18,-14.478890408494554,8
2343,50,11,110,8,-14.531978974156036,3
2344,20,19,62,14,-14.584809923949425,5
2345,13,14,88,8,-14.636848081546901,6
2346,74,16,34,11,-14.640026082092419,5
2347,59,14,65,9,-14.654063925888893,5
2348,38,25,93,17,-14.706979782976546,8
2349,17,11,93,8,-14.792328082005685,3
2350,41,13,13,9,-14.878152444409187,4
2351,51,10,9,7,-14.933479318486382,3
2352,65,10,14,8,-15.014185877069242,2
2353,37,15,57,11,-15.067776643574774,4
2354,40,14,84,9,-15.139436492633186,5
2355,107,33,26,26,-15.181646063962567,7
2356,88,17,90,12,-15.203720699131468,5
2357,18,11,90,8,-15.206260273523743,3
2358,28,26,26,19,-15.211295764909368,7
2359,6,31,2,22,-15.303923962237263,9
2360,88,13,70,10,-15.445871190573264,3
2361,76,20,2,14,-15.53711103061795,6
2362,59,10,16,6,-15.561569445873218,4
2363,73,12,29,9,-15.669782329836792,3
2364,38,15,17,11,-15.678044683298898,4
2365,62,30,111,22,-15.726936324972716,8
2366,30,14,93,10,-15.791222727391169,4
2367,66,14,6,11,-15.817538028688281,3
2368,109,16,55,12,-15.902114621962273,4
2369,91,12,90,8,-16.09870244517901,4
2370,6,26,107,19,-16.099487678798972,7
2371,49,18,88,14,-16.108818713025215,4
2372,103,11,59,8,-16.266656443008642,3
2373,103,13,62,9,-16.299156500586875,4
2374,16,14,49,10,-16.36230318246688,4
2375,85,13,30,10,-16.38402642563884,3
2376,69,13,26,10,-16.625965123271836,3
2377,41,10,69,7,-16.634275461416582,3
2378,75,14,88,11,-16.69812076031679,3
2379,76,13,57,10,-16.71990929044005,3
2380,109,16,73,12,-16.722107664046142,4
2381,71,17,8,12,-16.73632107470111,5
2382,48,10,20,8,-16.74709255218282,2
2383,28,13,63,10,-16.83915101157232,3
2384,109,31,41,26,-16.84086997358483,5
2385,15,12,38,9,-16.880495720481193,3
2386,54,13,26,8,-16.93978716229654,5
2387,65,22,30,17,-17.168512411131363,5
2388,91,14,34,10,-17.47588407236358,4
2389,76,13,63,11,-17.535738224915978,2
2390,110,10,41,9,-17.607251464829996,1
2391,70,13,63,10,-17.959510637912523,3
2392,10,15,38,12,-18.015221595889397,3
2393,76,11,90,7,-18.0318690370992,4
2394,48,13,93,11,-18.078353771886377,2
2395,7,12,79,9,-18.096381711285996,3
2396,98,11,51,8,-18.116158962815213,3
2397,87,11,58,9,-18.229025747195358,2
2398,20,12,106,8,-18.31154007706119,4
2399,37,10,18,8,-18.374799448579125,2
2400,1,18,10,14,-18.3791692553228,4
2401,6,15,109,11,-18.568483421277442,4
2402,86,15,70,11,-18.585222369284796,4
2403,38,24,26,18,-18.614524044017738,6
2404,2,13,18,10,-18.666944559681195,3
2405,109,28,28,21,-18.76167991813475,7
2406,88,11,26,8,-18.785991491960512,3
2407,109,16,111,12,-18.82454889767414,4
2408,71,12,62,11,-19.04348733516107,1
2409,85,10,87,8,-19.067382343683075,2
2410,28,18,57,15,-19.087300718744142,3
2411,50,13,62,10,-19.2021134597274,3
2412,29,12,110,10,-19.248543702222975,2
2413,38,14,43,10,-19.328461951187712,4
2414,75,12,55,10,-19.502608543209234,2
2415,9,10,5,8,-19.535484203654338,2
2416,23,14,73,11,-19.638485965557127,3
2417,10,13,41,11,-19.737157878272868,2
2418,103,10,34,9,-19.87880862427678,1
2419,109,12,110,10,-20.16933250309851,2
2420,10,10,17,8,-20.222695302818984,2
2421,9,10,64,8,-20.43457650048482,2
2422,46,17,87,13,-20.82488049362707,4
2423,110,14,74,11,-20.875047711546735,3
2424,109,29,87,23,-21.22636324198766,6
2425,87,10,106,9,-21.564542850873863,1
2426,70,25,111,19,-21.761941281988644,6
2427,44,11,17,9,-22.072912946241182,2
2428,10,10,63,8,-22.405804769336637,2
2429,85,11,20,9,-22.58682017719025,2
2430,10,18,20,15,-22.627581995234394,3
2431,94,10,84,9,-22.762013140609877,1
2432,10,10,26,8,-22.77202326046866,2
2433,41,12,57,10,-23.379405756490275,2
2434,86,15,103,13,-23.967936503754764,2
2435,112,11,74,9,-24.423385588541223,2
2436,49,11,26,8,-26.831812890773925,3
2437,43,10,91,10,-27.34458455824453,0
2438,73,10,107,9,-28.662979189254322,1
2439,65,10,64,9,-31.455780164415454,1
