,againstHero,games,hero,losses,shift,wins
0,5,11,98,1,27.76470658649971,10
1,88,12,37,1,27.444768307289483,11
2,30,11,54,1,25.713620235434703,10
3,48,10,35,1,25.155197930838906,9
4,76,13,35,3,24.45415726080802,10
5,34,10,51,1,22.213174768846972,9
6,93,13,96,2,21.644278578741655,11
7,50,18,55,4,21.384042844031153,14
8,30,12,107,2,21.034566601211726,10
9,107,10,66,2,20.152222817707916,8
10,2,13,54,2,19.759970484752476,11
11,28,14,112,3,19.249826897720943,11
12,104,12,2,3,18.7400943913113,9
13,50,10,70,3,18.66920839814296,7
14,88,14,109,2,18.52791141944204,12
15,16,10,70,2,18.132036089559314,8
16,63,17,91,4,18.120595699414864,13
17,16,11,98,3,18.093280468518255,8
18,88,10,57,3,18.03608858455504,7
19,90,23,28,5,17.842079516061677,18
20,11,12,98,3,17.79113396344492,9
21,41,13,86,2,17.568343007541294,11
22,114,11,106,3,17.502347470464006,8
23,16,22,74,5,17.470138560724315,17
24,34,11,87,3,17.338115350277818,8
25,35,10,106,3,17.319051156851785,7
26,73,10,54,2,17.106743436572106,8
27,90,12,63,3,16.840668609829066,9
28,114,12,109,2,16.832451560804284,10
29,16,12,46,3,16.483729162085577,9
30,11,13,70,3,16.32604658673946,10
31,106,10,23,3,16.05394351537058,7
32,8,11,98,2,15.96259366832557,9
33,48,11,9,3,15.643745764186933,8
34,93,10,11,2,15.321419061771829,8
35,74,24,28,6,15.31519507992004,18
36,73,11,37,4,15.237735204111457,7
37,114,15,20,3,15.220589720677065,12
38,2,16,70,5,15.20234077608459,11
39,73,14,90,4,15.181297397438652,10
40,91,12,96,3,15.083901067533665,9
41,100,14,54,4,14.930697835147345,10
42,80,12,50,2,14.926124931290452,10
43,95,11,88,3,14.83873132426491,8
44,46,16,96,6,14.744941109171663,10
45,8,11,65,3,14.67711948639893,8
46,80,11,35,3,14.578551377058158,8
47,63,33,84,10,14.557123158417967,23
48,14,11,63,4,14.53302527333945,7
49,107,14,35,3,14.477847243885739,11
50,95,11,107,3,14.460264509685397,8
51,34,12,28,3,14.433851353414235,9
52,90,10,48,3,14.062301149493257,7
53,71,13,8,4,13.992705985768803,9
54,46,12,84,3,13.974033982222737,9
55,91,12,20,4,13.840742693250826,8
56,75,10,5,3,13.751440551521483,7
57,87,15,70,5,13.709203230326096,10
58,88,24,46,6,13.65005256735965,18
59,16,11,91,3,13.591952616906621,8
60,97,12,25,4,13.551137798789016,8
61,51,12,74,3,13.519826421822684,9
62,55,25,11,6,13.485189958967284,19
63,69,11,28,4,13.38734226962898,7
64,63,14,109,4,13.371852687868843,10
65,84,10,76,3,13.371791794476119,7
66,90,11,97,4,13.178561240127799,7
67,97,10,84,2,13.1315313075884,8
68,48,19,54,6,13.122325082638987,13
69,16,30,106,8,13.120750145694194,22
70,80,10,14,4,13.097202558791373,6
71,17,10,107,3,13.095515887019284,7
72,97,13,8,4,13.031573471749283,9
73,86,16,73,6,12.90546934044994,10
74,78,10,96,3,12.899686199305037,7
75,20,10,98,2,12.882632104752002,8
76,17,14,37,5,12.777771600020978,9
77,16,34,87,11,12.76704720332023,23
78,98,10,87,3,12.766560909926934,7
79,37,27,54,9,12.577195310341338,18
80,86,10,39,4,12.521968554365156,6
81,73,17,107,6,12.476279417058619,11
82,63,39,54,12,12.439421659836578,27
83,11,38,96,12,12.43376452627604,26
84,54,12,104,3,12.3253951145141,9
85,86,18,109,4,12.213282587444157,14
86,11,12,25,3,12.166771335730745,9
87,30,10,87,3,11.954020606538128,7
88,88,12,104,4,11.911529882206118,8
89,76,10,55,2,11.845869320079572,8
90,75,16,8,4,11.794220762958481,12
91,80,15,107,3,11.678062977381895,12
92,91,10,98,3,11.6111736728835,7
93,8,14,114,4,11.423698115816398,10
94,11,18,37,5,11.382728976908798,13
95,11,19,84,6,11.373729994467022,13
96,97,16,107,6,11.336758264943471,10
97,5,19,11,7,11.267343991372716,12
98,50,11,109,3,11.21767101593788,8
99,16,16,104,6,11.179121316519469,10
100,97,16,5,5,11.001465278853818,11
101,30,13,16,4,10.882729052195028,9
102,50,26,20,9,10.759663700123562,17
103,50,11,98,3,10.6914012264267,8
104,5,21,84,7,10.562529198843299,14
105,90,19,106,6,10.479311473888153,13
106,48,22,96,7,10.412031756955415,15
107,16,37,96,11,10.284315397893865,26
108,87,14,93,5,10.257204602761986,9
109,28,11,18,4,10.21986320292799,7
110,16,24,107,7,10.150129279172639,17
111,73,14,5,5,10.145620716643505,9
112,55,12,70,4,10.141434019068976,8
113,16,19,55,6,10.104969962268774,13
114,109,11,102,4,10.030166218885235,7
115,106,14,75,7,10.013304733371458,7
116,28,19,25,6,10.004409761163549,13
117,98,16,63,6,9.997373775280366,10
118,104,10,50,3,9.949311401554116,7
119,86,20,76,7,9.940010233613187,13
120,51,17,96,6,9.90017056684033,11
121,86,23,79,8,9.865377107457421,15
122,98,24,96,9,9.85522726903532,15
123,20,22,84,6,9.790302500691975,16
124,102,11,16,5,9.773079005258337,6
125,74,16,70,7,9.770873759550817,9
126,98,14,106,5,9.701360201061402,9
127,50,13,102,6,9.690108951217553,7
128,2,14,106,5,9.646176024663943,9
129,50,28,107,10,9.593575141846495,18
130,95,10,106,4,9.576212388563865,6
131,79,12,87,3,9.532024747647966,9
132,95,13,8,5,9.502751434643129,8
133,90,17,50,6,9.438413402091001,11
134,87,13,2,5,9.430732046556473,8
135,63,18,2,7,9.424323722958958,11
136,20,16,51,7,9.352748618003375,9
137,2,25,107,8,9.34845410579801,17
138,63,25,20,10,9.320091766955512,15
139,90,13,80,4,9.306752684001106,9
140,108,14,63,5,9.298531248541144,9
141,2,11,65,3,9.274625860779652,8
142,114,13,104,6,9.25838880894678,7
143,76,14,50,4,9.228465475536328,10
144,2,10,16,3,9.214178381730257,7
145,30,15,8,5,9.185211827951935,10
146,30,11,28,4,9.144215115290798,7
147,50,26,96,9,9.051096363617635,17
148,63,38,28,13,9.045203898145056,25
149,57,12,107,5,8.988403130065704,7
150,50,21,5,9,8.97348826108785,12
151,102,14,114,4,8.905179438200168,10
152,102,20,86,6,8.876334285027802,14
153,28,20,114,9,8.84184705741822,11
154,74,11,62,4,8.814812195756357,7
155,7,11,96,3,8.775501150402919,8
156,86,27,51,11,8.740860643352912,16
157,106,11,91,3,8.717801627050898,8
158,8,14,91,5,8.717379143115322,9
159,88,23,28,8,8.674081432323941,15
160,106,17,104,6,8.650515897387708,11
161,102,10,87,3,8.61362310955975,7
162,37,23,104,9,8.601891744395864,14
163,8,40,87,14,8.572049681412182,26
164,90,22,5,7,8.559685419611386,15
165,50,17,88,7,8.503859481033004,10
166,102,12,5,5,8.446024367020586,7
167,86,26,70,11,8.431070575550432,15
168,50,13,114,5,8.388183657848247,8
169,88,10,25,4,8.38577497515839,6
170,20,14,25,5,8.344789162642355,9
171,69,13,86,5,8.329501489122975,8
172,11,20,20,6,8.234400855107406,14
173,20,11,44,4,8.212958514210372,7
174,86,12,108,5,8.204205290543774,7
175,20,11,95,4,8.18646759603118,7
176,80,14,65,5,8.117894882236026,9
177,114,21,5,8,8.112945893634581,13
178,63,20,88,8,8.087843670572429,12
179,88,26,107,9,8.073286316322777,17
180,16,14,48,6,8.053586068768567,8
181,73,20,74,7,8.01522036427702,13
182,28,18,91,7,8.01457036803685,11
183,102,19,96,7,7.9956311609664965,12
184,96,15,104,6,7.984287616150155,9
185,93,13,28,4,7.977780890104037,9
186,86,18,104,8,7.975989606379795,10
187,76,17,107,6,7.961856909329562,11
188,8,20,25,7,7.955817207245067,13
189,96,12,34,4,7.949755484984076,8
190,80,24,106,9,7.948937081453317,15
191,88,13,70,5,7.915858076944355,8
192,114,14,96,5,7.889762565328155,9
193,48,20,79,8,7.777732866617034,12
194,106,18,70,8,7.764435141080124,10
195,46,23,28,7,7.7505833090146155,16
196,79,10,106,4,7.723339908977314,6
197,76,14,70,5,7.7067801731883225,9
198,48,18,87,7,7.681552221415861,11
199,55,10,108,4,7.660382487173957,6
200,96,22,80,8,7.6325568595370585,14
201,2,14,97,5,7.627801324727646,9
202,63,12,46,4,7.600674717701955,8
203,46,12,75,4,7.596466468990946,8
204,85,10,107,4,7.595499375056901,6
205,25,10,54,4,7.5639667575356455,6
206,54,20,90,8,7.5559021418376044,12
207,28,19,70,8,7.544208909658004,11
208,30,10,84,3,7.509917010745374,7
209,54,24,88,10,7.473458607651673,14
210,16,17,84,7,7.47114031170461,10
211,74,23,46,8,7.468438399345944,15
212,63,11,25,4,7.385187766970543,7
213,102,16,8,6,7.376211425683788,10
214,102,15,25,5,7.370724163994214,10
215,48,22,107,9,7.330278865374194,13
216,5,21,20,9,7.290920498639451,12
217,63,18,76,6,7.244525780520105,12
218,28,19,75,8,7.2257676072063814,11
219,37,25,106,11,7.224646363293314,14
220,63,28,48,10,7.208356975606329,18
221,11,15,109,6,7.174727842093128,9
222,93,12,84,4,7.171686286545099,8
223,63,12,79,4,7.1114844508040305,8
224,86,21,80,9,7.071945289109106,12
225,50,11,48,4,7.05821121395096,7
226,28,27,109,10,7.040709183184224,17
227,87,30,37,12,6.998523319274806,18
228,93,12,86,4,6.922029970425321,8
229,65,12,37,5,6.8663176912939194,7
230,80,22,63,8,6.843518885460648,14
231,11,11,80,4,6.802148460786961,7
232,48,10,108,3,6.749808304712147,7
233,93,19,8,8,6.747456325327523,11
234,54,37,70,16,6.740686016828507,21
235,25,25,114,12,6.737726761752367,13
236,96,22,70,11,6.734945499709392,11
237,37,19,25,8,6.728765858113135,11
238,46,10,2,4,6.670222065576344,6
239,8,12,100,4,6.642992983017225,8
240,54,14,51,6,6.622588079460444,8
241,85,12,96,4,6.610954135702339,8
242,74,34,96,13,6.609470333238453,21
243,54,11,76,4,6.60321190549357,7
244,74,27,84,12,6.529493156115414,15
245,37,35,86,14,6.511717567803917,21
246,14,17,28,6,6.462988674713604,11
247,50,10,18,5,6.440154509710169,5
248,109,15,8,7,6.403030229228608,8
249,28,20,102,9,6.358190744443443,11
250,34,11,106,4,6.348877012003049,7
251,86,76,96,30,6.329796370249291,46
252,5,12,95,4,6.3126647987715865,8
253,86,12,14,5,6.306786470454386,7
254,93,14,5,5,6.28136680821021,9
255,86,23,48,9,6.215181955253339,14
256,71,13,107,5,6.143176064124285,8
257,37,17,84,7,6.135362755463087,10
258,86,17,82,6,6.124344607685837,11
259,55,10,79,4,6.105260957218084,6
260,63,15,39,6,6.098512313477008,9
261,76,13,5,5,6.061052091280194,8
262,86,24,75,11,6.040483815268099,13
263,109,14,5,6,6.036864928691389,8
264,51,15,107,5,6.010709658258433,10
265,87,12,46,5,5.996729580761838,7
266,97,16,37,7,5.986043786502112,9
267,90,16,37,6,5.916633751479725,10
268,88,10,75,4,5.899399725245313,6
269,33,10,11,5,5.887923901561769,5
270,108,11,50,4,5.8529749166500435,7
271,30,12,96,5,5.827709187189812,7
272,39,14,11,4,5.821131817679595,10
273,16,12,108,5,5.770631208900039,7
274,104,25,28,9,5.749142721940425,16
275,84,14,39,6,5.735188058057851,8
276,84,12,9,5,5.723245457590759,7
277,63,20,55,8,5.717328262845937,12
278,90,13,74,4,5.698081091561145,9
279,5,16,70,7,5.663813747338574,9
280,5,10,2,4,5.655750547481818,6
281,95,17,86,6,5.641395768359863,11
282,38,11,84,5,5.627456024192355,6
283,65,16,106,6,5.613829651583314,10
284,9,12,50,4,5.578106204160814,8
285,20,23,106,9,5.5779625205249355,14
286,73,21,8,9,5.53991081191783,12
287,107,16,108,6,5.5146494473296634,10
288,91,20,107,8,5.505802548817647,12
289,2,11,88,4,5.477658376983315,7
290,46,20,107,7,5.461199830974728,13
291,63,34,96,13,5.39321635342965,21
292,33,11,20,5,5.296216349156301,6
293,16,16,51,8,5.285051160663565,8
294,34,12,74,4,5.2395412452934975,8
295,60,16,90,7,5.212709277781621,9
296,75,20,37,6,5.205769951831414,14
297,37,20,63,8,5.195954912202305,12
298,87,11,95,4,5.184870110841576,7
299,50,30,86,14,5.118847118423948,16
300,28,14,98,5,5.06757178016428,9
301,96,12,73,6,5.035390942293943,6
302,50,43,54,19,5.024203035146804,24
303,38,15,86,7,5.020597384796872,8
304,63,15,75,7,5.0013663141315385,8
305,96,21,88,10,4.971318653185928,11
306,8,41,63,18,4.964657756884515,23
307,86,13,35,6,4.963361102394037,7
308,74,13,108,6,4.9091054802012675,7
309,50,53,28,23,4.864862648856498,30
310,84,32,106,15,4.851744201560306,17
311,28,22,2,9,4.837290355461167,13
312,85,13,86,6,4.833314993475176,7
313,114,34,107,14,4.829411961485131,20
314,107,19,25,8,4.802339370319195,11
315,96,22,25,10,4.793774224103586,12
316,14,15,84,6,4.752366615638507,9
317,37,13,46,5,4.750466191949984,8
318,20,11,97,5,4.749793384228249,6
319,16,13,79,6,4.716412220610577,7
320,55,11,9,5,4.690967100580704,6
321,20,23,74,9,4.672235592214688,14
322,8,18,51,9,4.661922356757775,9
323,114,14,90,6,4.661067445952931,8
324,28,11,17,5,4.633008899903921,6
325,28,24,65,11,4.610707424918393,13
326,34,10,84,5,4.577710307306147,5
327,14,20,8,8,4.574516362462752,12
328,98,24,86,11,4.56301016412544,13
329,55,10,104,5,4.559676497393724,5
330,95,12,96,5,4.548367780459664,7
331,86,22,46,9,4.523509548369423,13
332,79,12,8,4,4.5233682313953745,8
333,28,42,84,18,4.506490158254307,24
334,87,10,91,4,4.489603676814871,6
335,107,40,37,17,4.444043436325734,23
336,33,10,96,6,4.401522257584364,4
337,107,42,20,19,4.400812570612914,23
338,76,10,98,5,4.379545503881031,5
339,106,25,107,10,4.361615918052929,15
340,87,24,74,10,4.3427999466192215,14
341,25,10,46,4,4.282271929171335,6
342,8,52,74,21,4.275689890777227,31
343,87,27,20,13,4.272216484330465,14
344,63,17,70,8,4.20425277286591,9
345,84,22,70,9,4.182188769343139,13
346,74,11,55,5,4.181300299067086,6
347,20,13,90,6,4.180220054862439,7
348,51,11,63,5,4.136590143565562,6
349,74,13,50,5,4.131400013417275,8
350,86,34,90,14,4.124931636943059,20
351,84,16,90,7,4.100528600599519,9
352,54,16,95,7,4.0788113560066686,9
353,11,13,79,7,4.047561716338114,6
354,28,14,95,6,4.040550234811001,8
355,74,34,106,15,4.0254743617919075,19
356,98,16,54,7,4.023186528647164,9
357,5,27,107,12,4.018272864211865,15
358,93,15,107,6,3.980650403089777,9
359,86,39,55,17,3.9547678901800314,22
360,76,18,28,7,3.937083310529341,11
361,20,13,70,6,3.9213437957377693,7
362,37,21,96,10,3.919945326141697,11
363,65,25,107,10,3.884732871922416,15
364,5,24,87,11,3.882697383473866,13
365,80,13,55,7,3.844743684805329,6
366,86,57,107,27,3.7647946280812086,30
367,114,10,73,5,3.7201211944929797,5
368,50,34,11,14,3.701800884418704,20
369,75,13,71,5,3.6847064190257015,8
370,55,15,5,7,3.6694993091099155,8
371,86,12,17,6,3.6688624062587594,6
372,8,25,84,10,3.6608734975068677,15
373,87,16,65,7,3.6538862860446715,9
374,86,19,114,9,3.5883432963993713,10
375,97,26,96,12,3.5743811494977495,14
376,37,11,91,5,3.5597807363329967,6
377,84,19,48,8,3.5357038968611265,11
378,114,10,65,5,3.507220051485649,5
379,91,15,84,7,3.506943767095505,8
380,28,45,54,19,3.5006765572633607,26
381,74,15,93,7,3.490032682611992,8
382,23,10,107,4,3.4694839628849055,6
383,54,20,109,8,3.4458657424157466,12
384,63,36,106,16,3.4206348963764044,20
385,9,14,8,5,3.40854125083978,9
386,55,20,28,7,3.3574009350442156,13
387,20,10,9,4,3.353443346624384,6
388,54,30,106,14,3.348177634825245,16
389,84,52,107,24,3.3336701512967966,28
390,63,61,86,25,3.3220512619028564,36
391,51,22,28,9,3.3101205733455643,13
392,28,26,97,11,3.3032475352202004,15
393,51,17,84,7,3.2832731192578755,10
394,65,20,96,9,3.2670140800116543,11
395,17,12,54,6,3.244378643466575,6
396,37,12,55,6,3.238139723142457,6
397,5,13,91,5,3.23458937129329,8
398,109,16,84,7,3.226616392220337,9
399,63,15,104,7,3.1901857927857544,8
400,88,11,114,5,3.179645345179107,6
401,54,15,114,8,3.167641305433156,7
402,88,10,97,4,3.158817314054268,6
403,84,21,54,9,3.1584774492637115,12
404,8,24,104,12,3.1496911934409026,12
405,76,13,20,5,3.130007006131113,8
406,8,20,48,8,3.119996469210726,12
407,97,16,106,8,3.111030579986816,8
408,20,36,37,17,3.1012371869037225,19
409,55,22,84,10,3.089338762612198,12
410,2,17,37,8,3.08113164671896,9
411,106,34,96,15,3.057483532267622,19
412,86,21,97,10,3.045973490025126,11
413,11,41,86,19,3.042531543148512,22
414,38,13,96,6,3.0422152322461717,7
415,90,10,65,5,3.027765344735429,5
416,88,11,90,5,3.0263742827452007,6
417,90,22,107,9,3.001867779560293,13
418,74,37,5,18,2.9829259953584533,19
419,33,13,28,7,2.9473995278098504,6
420,76,19,8,9,2.941917329794885,10
421,20,12,73,5,2.9374134598402435,7
422,8,31,5,15,2.937133177419759,16
423,86,11,9,6,2.904091823827273,5
424,86,61,84,30,2.8617834498479815,31
425,65,13,88,6,2.8256435057944165,7
426,87,10,80,4,2.824759591911268,6
427,96,31,55,14,2.8188234933181313,17
428,55,20,54,9,2.8062710008984633,11
429,28,12,89,5,2.801605415078669,7
430,79,15,50,6,2.7998338113931376,9
431,16,20,5,8,2.7741843563489925,12
432,86,20,30,9,2.7676142003206357,11
433,86,58,54,28,2.714028566095165,30
434,65,25,20,10,2.698521837368678,15
435,23,12,86,5,2.6913953048637516,7
436,5,32,37,13,2.6899643869314365,19
437,74,51,86,24,2.672164034898101,27
438,97,11,76,6,2.6606949198631935,5
439,88,15,11,7,2.660306622848361,8
440,2,25,50,12,2.654728105131012,13
441,75,17,96,6,2.629915777332828,11
442,28,48,106,21,2.5642902894537087,27
443,20,18,35,8,2.5627214829564173,10
444,96,12,108,6,2.55336363887327,6
445,39,11,50,4,2.5147259903046506,7
446,74,16,80,8,2.4851777101640504,8
447,96,50,54,25,2.4432934029688895,25
448,104,24,5,11,2.443148185181053,13
449,39,10,54,5,2.4307020889287747,5
450,90,18,87,9,2.418002381363687,9
451,20,10,30,5,2.410227197364593,5
452,65,19,63,8,2.4040693483855047,11
453,104,22,107,11,2.400881207254073,11
454,65,29,86,13,2.3928055133807304,16
455,54,46,20,20,2.3850057952750214,26
456,54,23,87,12,2.3775325060342167,11
457,8,12,57,5,2.3749438100452944,7
458,8,48,54,24,2.3460039178669154,24
459,8,49,96,22,2.333601925976549,27
460,50,18,16,9,2.3033473059646408,9
461,63,30,5,12,2.2835577331280907,18
462,11,13,35,6,2.2776751536044095,7
463,88,20,55,9,2.26494688861935,11
464,76,25,106,9,2.2347103608553742,16
465,97,15,55,7,2.195224664138417,8
466,96,11,14,5,2.19268862994012,6
467,107,13,38,6,2.179372128477191,7
468,84,13,65,6,2.1773880887408454,7
469,87,25,28,11,2.1378875510596975,14
470,50,11,65,6,2.121724673878297,5
471,96,19,90,8,2.0975196885604808,11
472,35,12,37,6,2.089032815390569,6
473,28,64,96,30,2.0558086605309875,34
474,8,37,16,17,2.039066649438008,20
475,63,11,38,5,2.0377552699599373,6
476,16,30,54,15,2.030734300537762,15
477,84,10,35,5,1.9965083140622215,5
478,63,36,107,16,1.9964318492105986,20
479,55,12,90,7,1.9940592194265985,5
480,11,27,63,14,1.9872168297368233,13
481,87,26,84,12,1.980727810420746,14
482,98,17,107,8,1.9696484412943798,9
483,11,20,74,9,1.9548228575807027,11
484,87,16,55,7,1.9404799216015798,9
485,63,22,74,10,1.937202025291982,12
486,5,23,54,9,1.932099814532289,14
487,87,41,107,19,1.9301722661331329,22
488,46,32,54,14,1.923818091292869,18
489,86,13,91,6,1.9050846765976825,7
490,62,10,28,5,1.893815032183228,5
491,8,34,70,16,1.8843474596478074,18
492,51,17,87,8,1.8833490464670963,9
493,107,12,34,6,1.8698580351185214,6
494,114,11,16,6,1.8504593104301856,5
495,104,19,74,8,1.8306349866865987,11
496,74,18,25,8,1.803393231029534,10
497,17,10,65,6,1.8006374195790151,4
498,86,73,28,34,1.7655146936915704,39
499,16,13,75,6,1.7465772324516469,7
500,8,12,80,5,1.7222815544039995,7
501,88,26,86,10,1.7220665197329303,16
502,85,13,54,6,1.7196059703411017,7
503,87,10,14,5,1.715650278366312,5
504,8,42,106,21,1.6938761092836299,21
505,48,12,55,5,1.6914768408443575,7
506,106,22,55,11,1.6908427299306483,11
507,28,29,37,14,1.687523313662891,15
508,74,16,97,8,1.6844832995900871,8
509,11,34,8,17,1.683632820533261,17
510,93,16,54,7,1.6533262101964188,9
511,62,12,86,6,1.6259353630377003,6
512,114,11,74,6,1.5941524456139655,5
513,54,24,74,12,1.5875526121873815,12
514,84,18,80,8,1.570942028221592,10
515,9,12,63,5,1.5537368197949128,7
516,86,57,20,27,1.5196619528562578,30
517,37,21,74,10,1.5078158562976989,11
518,8,31,90,14,1.5056548864922348,17
519,20,32,96,15,1.501779609081416,17
520,63,25,50,11,1.494996890500293,14
521,20,20,16,9,1.4827356605490611,11
522,16,44,28,22,1.477883439041638,22
523,54,41,107,19,1.4418605264190805,22
524,28,40,5,20,1.4108271325189057,20
525,102,16,54,7,1.4089469030692696,9
526,8,30,88,15,1.3894266518769611,15
527,20,38,28,17,1.377543749179071,21
528,109,11,73,6,1.3735030211742993,5
529,86,58,5,27,1.3699377395987506,31
530,80,23,28,11,1.3633599598332944,12
531,75,10,54,5,1.3596486355164763,5
532,79,17,28,8,1.3443965025775713,9
533,16,16,90,9,1.3115727036907034,7
534,50,29,37,14,1.3064966318612408,15
535,8,13,10,7,1.3056064594877734,6
536,106,16,48,8,1.2966873109190276,8
537,87,32,63,16,1.2889484863013154,16
538,8,34,20,16,1.252810472216638,18
539,75,11,84,5,1.2484479349865476,6
540,109,11,87,6,1.2284964497151856,5
541,2,19,86,8,1.2277524355686495,11
542,84,24,50,12,1.2273354450449643,12
543,54,18,80,8,1.2235928560664608,10
544,75,14,50,6,1.2201434901598596,8
545,50,10,34,5,1.2099513767481038,5
546,114,17,37,9,1.2082974621161622,8
547,82,11,28,6,1.1949949841809344,5
548,88,20,16,9,1.1914510987995774,11
549,86,35,16,18,1.1895001610717795,17
550,86,29,25,15,1.1828545779148447,14
551,109,12,96,6,1.1785332086119338,6
552,37,19,70,9,1.1674993437115007,10
553,54,18,65,9,1.1604082904646678,9
554,20,15,109,6,1.159846603781428,9
555,86,60,87,31,1.1327161641325862,29
556,8,53,28,24,1.1273193466024871,29
557,11,22,54,11,1.1238892188184868,11
558,38,12,37,6,1.1178231471077413,6
559,84,12,2,6,1.108389759283692,6
560,87,13,104,7,1.075409155748722,6
561,98,14,37,7,1.0716851609472713,7
562,97,12,70,5,1.0662872633837654,7
563,5,20,88,10,1.027044615892851,10
564,70,20,107,10,1.0170699004269221,10
565,102,12,74,6,1.014706286030215,6
566,28,11,39,6,0.9894043657226432,5
567,100,14,28,7,0.9692991305888411,7
568,106,35,11,16,0.960692232074152,19
569,63,22,97,11,0.9555568256913428,11
570,75,20,107,8,0.9435712438816874,12
571,107,14,102,7,0.9168684547097737,7
572,93,11,65,5,0.9124575382806671,6
573,70,17,65,8,0.9099362463379622,9
574,46,13,5,6,0.9003431843350302,7
575,86,10,44,5,0.8759680571555009,5
576,74,17,2,9,0.8667525886050844,8
577,8,14,39,8,0.8627591056111381,6
578,106,11,14,6,0.8292000189715029,5
579,88,22,84,11,0.8257033908889526,11
580,96,51,107,24,0.8072369681591718,27
581,104,11,51,5,0.806697135672842,6
582,54,14,97,7,0.8042932950440935,7
583,11,42,28,21,0.80002515389246,21
584,71,11,28,6,0.7906121882474628,5
585,37,18,76,10,0.7903669685641044,8
586,8,16,46,8,0.7818116965090103,8
587,11,20,46,10,0.7800389206995956,10
588,106,18,5,8,0.7754718845542204,10
589,65,16,55,7,0.7579567813833229,9
590,28,27,48,13,0.7484805696104432,14
591,74,16,75,9,0.7062400466029108,7
592,107,22,55,11,0.6732864832670306,11
593,11,19,48,9,0.6653817416079896,10
594,5,41,96,20,0.6566491427391816,21
595,106,11,73,5,0.6544320839177008,6
596,55,37,8,18,0.6531831879962213,19
597,8,49,86,23,0.6411662263135911,26
598,28,14,73,7,0.6101482668377957,7
599,37,17,16,8,0.5925325747961943,9
600,74,10,91,5,0.5863595626570582,5
601,74,10,76,6,0.5805497326470934,4
602,2,17,96,8,0.5793042045284421,9
603,104,13,76,6,0.5791952933362301,7
604,51,13,55,7,0.5521554244421191,6
605,84,36,96,19,0.5431287052497142,17
606,16,27,11,14,0.5076788856733216,13
607,5,18,25,8,0.49896982853571636,10
608,20,15,2,7,0.452147741715496,8
609,65,20,16,9,0.4261404500025613,11
610,87,19,88,10,0.42148790758658095,9
611,63,27,16,13,0.42109162793691096,14
612,84,14,79,8,0.41419542722796737,6
613,37,16,51,9,0.4038062444177477,7
614,76,16,87,8,0.39595996235299813,8
615,74,19,65,9,0.38764465464574593,10
616,28,52,107,27,0.3368468078409395,25
617,106,26,50,12,0.3301801033655424,14
618,55,13,75,8,0.2901701128736263,5
619,9,17,28,7,0.28857106564612295,10
620,100,12,86,7,0.28409428109562196,5
621,8,59,107,30,0.24987353680448204,29
622,8,28,2,14,0.24768095122823727,14
623,76,26,96,12,0.24225869633728628,14
624,80,22,20,11,0.23432520359835018,11
625,11,30,87,16,0.21064944652429082,14
626,106,33,87,16,0.18341830763527306,17
627,96,41,87,21,0.18114836506824772,20
628,106,27,88,12,0.17435430078847314,15
629,74,15,95,8,0.1737873975073595,7
630,48,13,20,7,0.17288062748629193,6
631,8,37,37,18,0.15511402803326843,19
632,88,10,76,4,0.14500962782709123,6
633,76,15,11,7,0.1376774645288651,8
634,8,20,50,8,0.10942463925612352,12
635,80,14,37,7,0.08688615194951728,7
636,11,11,51,6,0.07978822497443648,5
637,109,13,48,7,0.0675018600088535,6
638,35,12,28,6,0.0265085475018972,6
639,87,22,50,11,0.019819165908955615,11
640,50,22,87,11,-0.019819165908955293,11
641,28,12,35,6,-0.02650854750189661,6
642,48,13,109,6,-0.0675018600088535,7
643,51,11,11,5,-0.07978822497443616,6
644,37,14,80,7,-0.08688615194951765,7
645,50,20,8,12,-0.10942463925612404,8
646,76,10,88,6,-0.14500962782709123,4
647,37,37,8,19,-0.1551140280332713,18
648,20,13,48,6,-0.17288062748629165,7
649,95,15,74,7,-0.1737873975073588,8
650,88,27,106,15,-0.17435430078847286,12
651,87,41,96,20,-0.1811483650682465,21
652,87,33,106,17,-0.18341830763527264,16
653,87,30,11,14,-0.21064944652429057,16
654,20,22,80,11,-0.23432520359835107,11
655,96,26,76,14,-0.24225869633728683,12
656,2,28,8,14,-0.24768095122823564,14
657,107,59,8,29,-0.24987353680448193,30
658,86,12,100,5,-0.28409428109562046,7
659,28,17,9,10,-0.2885710656461217,7
660,75,13,55,5,-0.2901701128736252,8
661,50,26,106,14,-0.3301801033655417,12
662,107,52,28,25,-0.33684680784094073,27
663,65,19,74,10,-0.3876446546457469,9
664,51,16,37,7,-0.40380624441774726,9
665,107,41,74,20,-0.41308495791927813,21
666,79,14,84,6,-0.414195427227968,8
667,16,27,63,14,-0.4210916279369104,13
668,88,19,87,9,-0.4214879075865808,10
669,16,20,65,11,-0.4261404500025613,9
670,2,15,20,8,-0.4521477417154955,7
671,106,57,86,29,-0.48614464330034035,28
672,25,18,5,10,-0.49896982853571614,8
673,96,36,84,17,-0.5431287052497149,19
674,55,13,51,6,-0.5521554244421188,7
675,76,13,104,7,-0.5791952933362308,6
676,96,17,2,9,-0.5793042045284422,8
677,76,10,74,4,-0.5805497326470934,6
678,91,10,74,5,-0.5863595626570579,5
679,16,17,37,9,-0.5925325747961949,8
680,73,14,28,7,-0.6101482668377952,7
681,86,49,8,26,-0.6411662263135914,23
682,86,57,106,29,-0.646179460417099,28
683,8,37,55,19,-0.653183187996221,18
684,73,11,106,6,-0.6544320839177015,5
685,96,41,5,21,-0.6566491427391822,20
686,55,22,107,11,-0.6732864832670304,11
687,75,16,74,7,-0.7062400466029108,9
688,48,27,28,14,-0.7484805696104441,13
689,55,16,65,9,-0.7579567813833243,7
690,5,18,106,10,-0.7754718845542194,8
691,46,20,11,10,-0.7800389206995959,10
692,46,16,8,8,-0.781811696509011,8
693,76,18,37,8,-0.7903669685641046,10
694,28,11,71,5,-0.7906121882474615,6
695,28,42,11,21,-0.80002515389246,21
696,97,14,54,7,-0.8042932950440923,7
697,51,11,104,6,-0.8066971356728433,5
698,107,51,96,27,-0.8072369681591716,24
699,84,22,88,11,-0.825703390888953,11
700,14,11,106,5,-0.8292000189715015,6
701,107,30,11,15,-0.8440246169766226,15
702,39,14,8,6,-0.8627591056111378,8
703,2,17,74,8,-0.8667525886050853,9
704,44,10,86,5,-0.8759680571555013,5
705,88,21,20,12,-0.8894129451501082,9
706,5,13,46,7,-0.9003431843350307,6
707,65,17,70,9,-0.9099362463379616,8
708,65,11,93,6,-0.9124575382806671,5
709,107,20,75,12,-0.943571243881687,8
710,97,22,63,11,-0.9555568256913415,11
711,11,35,106,19,-0.9606922320741518,16
712,28,14,100,7,-0.9692991305888405,7
713,39,11,28,5,-0.9894043657226448,6
714,107,20,70,10,-1.017069900426923,10
715,88,20,5,10,-1.027044615892851,10
716,70,12,97,7,-1.0662872633837661,5
717,37,14,98,7,-1.0716851609472715,7
718,104,13,87,6,-1.0754091557487224,7
719,2,12,84,6,-1.1083897592836933,6
720,37,12,38,6,-1.11782314710774,6
721,54,22,11,11,-1.1238892188184872,11
722,28,53,8,29,-1.127319346602486,24
723,109,15,20,9,-1.1598466037814272,6
724,65,18,54,9,-1.1604082904646675,9
725,70,19,37,10,-1.1674993437115004,9
726,96,12,109,6,-1.1785332086119353,6
727,25,29,86,14,-1.182854577914844,15
728,16,35,86,17,-1.1895001610717801,18
729,16,20,88,11,-1.1914510987995772,9
730,28,11,82,5,-1.1949949841809342,6
731,37,17,114,8,-1.2082974621161633,9
732,34,10,50,5,-1.2099513767481056,5
733,50,14,75,8,-1.2201434901598602,6
734,80,18,54,10,-1.2235928560664604,8
735,50,24,84,12,-1.227335445044964,12
736,86,19,2,11,-1.2277524355686478,8
737,87,11,109,5,-1.2284964497151856,6
738,84,11,75,6,-1.2484479349865476,5
739,20,34,8,18,-1.252810472216638,16
740,63,32,87,16,-1.2889484863013152,16
741,10,13,8,6,-1.3056064594877719,7
742,37,29,50,15,-1.3064966318612408,14
743,11,30,107,16,-1.307391180086511,14
744,90,16,16,7,-1.3115727036907021,9
745,28,17,79,9,-1.3443965025775715,8
746,54,10,75,5,-1.3596486355164779,5
747,28,23,80,12,-1.3633599598332946,11
748,5,58,86,31,-1.369937739598751,27
749,73,11,109,5,-1.3735030211742982,6
750,28,38,20,21,-1.3775437491790712,17
751,88,30,8,15,-1.3894266518769602,15
752,54,16,102,9,-1.40894690306927,7
753,5,40,28,20,-1.4108271325189068,20
754,107,41,54,22,-1.4418605264190794,19
755,28,44,16,22,-1.477883439041638,22
756,16,20,20,11,-1.482735660549062,9
757,50,25,63,14,-1.4949968905002942,11
758,96,32,20,17,-1.5017796090814146,15
759,90,31,8,17,-1.5056548864922334,14
760,74,21,37,11,-1.5078158562977,10
761,20,57,86,30,-1.5196619528562578,27
762,63,12,9,7,-1.5537368197949135,5
763,80,18,84,10,-1.5709420282215925,8
764,74,24,54,12,-1.5875526121873813,12
765,74,11,114,5,-1.5941524456139655,6
766,74,41,107,22,-1.595917823605565,19
767,86,12,62,6,-1.6259353630376987,6
768,54,16,93,9,-1.6533262101964186,7
769,8,34,11,17,-1.6836328205332602,17
770,97,16,74,8,-1.684483299590087,8
771,37,29,28,15,-1.6875233136628907,14
772,55,22,106,11,-1.690842729930649,11
773,55,12,48,7,-1.6914768408443577,5
774,106,42,8,21,-1.6938761092836312,21
775,14,10,87,5,-1.7156502783663115,5
776,54,13,85,7,-1.719605970341104,6
777,86,26,88,16,-1.7220665197329301,10
778,80,12,8,7,-1.7222815544039987,5
779,75,13,16,7,-1.7465772324516466,6
780,28,73,86,39,-1.7655146936915704,34
781,65,10,17,4,-1.8006374195790151,6
782,25,18,74,10,-1.803393231029534,8
783,74,19,104,11,-1.8306349866865999,8
784,16,11,114,5,-1.8504593104301854,6
785,34,12,107,6,-1.869858035118521,6
786,87,17,51,9,-1.8833490464670963,8
787,70,34,8,18,-1.8843474596478085,16
788,28,10,62,5,-1.893815032183228,5
789,91,13,86,7,-1.905084676597684,6
790,54,32,46,18,-1.92381809129287,14
791,54,23,5,14,-1.9320998145322883,9
792,74,22,63,12,-1.9372020252919817,10
793,55,16,87,9,-1.9404799216015791,7
794,74,20,11,11,-1.954822857580702,9
795,107,17,98,9,-1.96964844129438,8
796,84,26,87,14,-1.9807278104207477,12
797,63,27,11,13,-1.987216829736823,14
798,90,12,55,5,-1.9940592194265978,7
799,107,36,63,20,-1.9964318492105986,16
800,35,10,84,5,-1.996508314062219,5
801,54,30,16,15,-2.0307343005377616,15
802,38,11,63,6,-2.0377552699599373,5
803,16,37,8,20,-2.0390666494380083,17
804,96,64,28,34,-2.055808660530986,30
805,37,12,35,6,-2.0890328153905666,6
806,90,19,96,11,-2.0975196885604803,8
807,65,11,50,5,-2.1217246738782976,6
808,28,25,87,14,-2.1378875510596966,11
809,65,13,84,7,-2.1773880887408454,6
810,38,13,107,7,-2.1793721284771914,6
811,14,11,96,6,-2.19268862994012,5
812,55,15,97,8,-2.1952246641384163,7
813,87,60,86,30,-2.208424062664152,30
814,55,20,88,11,-2.2649468886193502,9
815,35,13,11,7,-2.277675153604409,6
816,5,30,63,18,-2.2835577331280925,12
817,16,18,50,9,-2.303347305964641,9
818,96,49,8,27,-2.3336019259765495,22
819,54,48,8,24,-2.346003917866915,24
820,57,12,8,7,-2.3749438100452944,5
821,87,23,54,11,-2.3775325060342167,12
822,20,46,54,26,-2.385005795275022,20
823,86,29,65,16,-2.39280551338073,13
824,107,22,104,11,-2.4008812072540735,11
825,63,19,65,11,-2.404069348385506,8
826,87,18,90,9,-2.418002381363687,9
827,54,10,39,5,-2.4307020889287743,5
828,5,24,104,13,-2.443148185181053,11
829,54,50,96,25,-2.4432934029688886,25
830,80,16,74,8,-2.4851777101640518,8
831,50,11,39,7,-2.5147259903046506,4
832,108,12,96,6,-2.5533636388732703,6
833,35,18,20,10,-2.562721482956418,8
834,106,48,28,27,-2.5642902894537083,21
835,96,17,75,11,-2.629915777332827,6
836,50,25,2,13,-2.654728105131013,12
837,11,15,88,8,-2.660306622848362,7
838,76,11,97,5,-2.6606949198631926,6
839,86,51,74,27,-2.672164034898097,24
840,37,32,5,19,-2.689964386931435,13
841,86,12,23,7,-2.6913953048637516,5
842,20,25,65,15,-2.698521837368678,10
843,54,58,86,30,-2.7140285660951644,28
844,14,12,107,6,-2.752826564735613,6
845,30,20,86,11,-2.7676142003206357,9
846,5,20,16,12,-2.7741843563489916,8
847,50,15,79,9,-2.7998338113931363,6
848,89,12,28,7,-2.801605415078669,5
849,54,20,55,11,-2.8062710008984615,9
850,55,31,96,17,-2.8188234933181313,14
851,80,10,87,6,-2.824759591911268,4
852,88,13,65,7,-2.825643505794417,6
853,84,61,86,31,-2.861783449847982,30
854,11,27,16,14,-2.8981408824101362,13
855,9,11,86,5,-2.9040918238272733,6
856,5,31,8,16,-2.9371331774197604,15
857,73,12,20,7,-2.9374134598402435,5
858,8,19,76,10,-2.941917329794886,9
859,28,13,33,6,-2.947399527809851,7
860,5,37,74,19,-2.9829259953584537,18
861,90,11,88,6,-3.026374282745202,5
862,65,10,90,5,-3.027765344735429,5
863,20,21,88,10,-3.032925818779347,11
864,96,13,38,7,-3.0422152322461713,6
865,97,21,86,11,-3.045973490025126,10
866,96,34,106,19,-3.0574835322676215,15
867,37,17,2,9,-3.08113164671896,8
868,84,22,55,12,-3.089338762612198,10
869,37,36,20,19,-3.101237186903724,17
870,106,16,97,8,-3.1110305799868163,8
871,107,12,14,7,-3.1146710636183896,5
872,48,20,8,12,-3.119996469210726,8
873,20,13,76,8,-3.130007006131113,5
874,104,24,8,12,-3.149691193440905,12
875,54,21,84,12,-3.1584774492637115,9
876,97,10,88,6,-3.1588173140542675,4
877,114,15,54,7,-3.1676413054331563,8
878,114,11,88,6,-3.179645345179107,5
879,104,15,63,8,-3.190185792785754,7
880,84,16,109,9,-3.226616392220337,7
881,91,13,5,8,-3.2345893712932896,5
882,55,12,37,6,-3.2381397231424565,6
883,54,12,17,6,-3.2443786434665753,6
884,96,20,65,11,-3.2670140800116547,9
885,84,17,51,10,-3.283273119257878,7
886,97,26,28,15,-3.303247535220201,11
887,28,22,51,13,-3.310120573345564,9
888,86,61,63,36,-3.3220512619028586,25
889,107,52,84,28,-3.3336701512967966,24
890,106,30,54,16,-3.348177634825244,14
891,9,10,20,6,-3.353443346624384,4
892,28,20,55,13,-3.3574009350442124,7
893,8,14,9,9,-3.4085412508397837,5
894,106,36,63,20,-3.420634896376405,16
895,109,20,54,12,-3.4458657424157457,8
896,107,10,23,6,-3.4694839628849055,4
897,93,15,74,8,-3.4900326826119916,7
898,54,45,28,26,-3.5006765572633602,19
899,107,41,87,23,-3.504378946911036,18
900,84,15,91,8,-3.5069437670955055,7
901,65,10,114,5,-3.5072200514856506,5
902,48,19,84,11,-3.535703896861128,8
903,91,11,37,6,-3.5597807363329976,5
904,96,26,97,14,-3.5743811494977504,12
905,114,19,86,10,-3.5883432963993727,9
906,65,16,87,9,-3.6538862860446715,7
907,84,25,8,15,-3.6608734975068673,10
908,17,12,86,6,-3.6688624062587594,6
909,5,15,55,8,-3.669499309109916,7
910,71,13,75,8,-3.6847064190257015,5
911,11,34,50,20,-3.7018008844187023,14
912,73,10,114,5,-3.7201211944929797,5
913,107,57,86,30,-3.764794628081207,27
914,55,13,80,6,-3.8447436848053296,7
915,87,24,5,13,-3.8826973834738676,11
916,107,25,65,15,-3.8847328719224157,10
917,96,21,37,11,-3.919945326141697,10
918,70,13,20,7,-3.921343795737771,6
919,28,18,76,11,-3.937083310529341,7
920,55,39,86,22,-3.9547678901800305,17
921,107,27,5,15,-4.018272864211863,12
922,54,16,98,9,-4.023186528647163,7
923,106,34,74,19,-4.025474361791907,15
924,95,14,28,8,-4.040550234811,6
925,79,13,11,6,-4.047561716338114,7
926,48,19,11,11,-4.0623540527603055,8
927,95,16,54,9,-4.078811356006668,7
928,90,16,84,9,-4.100528600599519,7
929,90,34,86,20,-4.124931636943059,14
930,50,13,74,8,-4.1314000134172755,5
931,63,11,51,6,-4.13659014356556,5
932,55,11,74,6,-4.181300299067087,5
933,70,22,84,13,-4.182188769343141,9
934,70,17,63,9,-4.20425277286591,8
935,20,27,87,14,-4.27221648433046,13
936,74,52,8,31,-4.275689890777224,21
937,46,10,25,6,-4.282271929171334,4
938,74,24,87,14,-4.342799946619222,10
939,98,10,76,5,-4.379545503881031,5
940,20,42,107,23,-4.400812570612912,19
941,96,10,33,4,-4.401522257584364,6
942,87,16,76,9,-4.429864581846375,7
943,11,15,76,9,-4.440509058655133,6
944,37,40,107,23,-4.4440434363257335,17
945,91,10,87,6,-4.4896036768148715,4
946,84,42,28,24,-4.50649015825431,18
947,8,12,79,8,-4.523368231395376,4
948,46,22,86,13,-4.523509548369423,9
949,96,12,95,7,-4.548367780459663,5
950,104,10,55,5,-4.559676497393727,5
951,86,24,98,13,-4.5630101641254415,11
952,8,20,14,12,-4.5745163624627505,8
953,84,10,34,5,-4.5777103073061465,5
954,65,24,28,13,-4.610707424918392,11
955,86,41,11,23,-4.616738223926415,18
956,17,11,28,6,-4.63300889990392,5
957,90,14,114,8,-4.661067445952929,6
958,51,18,8,9,-4.661922356757775,9
959,9,11,55,6,-4.690967100580704,5
960,79,13,16,7,-4.716412220610577,6
961,97,11,20,6,-4.749793384228249,5
962,46,13,37,8,-4.750466191949984,5
963,84,15,14,9,-4.752366615638507,6
964,25,22,96,12,-4.7937742241035854,10
965,25,19,107,11,-4.802339370319193,8
966,106,25,76,17,-4.816409317331136,8
967,107,34,114,20,-4.829411961485131,14
968,86,13,85,7,-4.833314993475175,6
969,2,22,28,13,-4.837290355461167,9
970,106,32,84,17,-4.851744201560307,15
971,28,53,50,30,-4.864862648856498,23
972,108,13,74,7,-4.90910548020127,6
973,35,13,86,7,-4.963361102394038,6
974,63,41,8,23,-4.964657756884514,18
975,88,21,96,11,-4.971318653185927,10
976,75,15,63,8,-5.001366314131536,7
977,86,15,38,8,-5.020597384796871,7
978,54,43,50,24,-5.024203035146804,19
979,73,12,96,6,-5.035390942293941,6
980,98,14,28,9,-5.067571780164281,5
981,86,30,50,16,-5.118847118423947,14
982,95,11,87,7,-5.184870110841573,4
983,63,20,37,12,-5.195954912202305,8
984,37,20,75,14,-5.205769951831413,6
985,90,16,60,9,-5.212709277781622,7
986,74,12,34,8,-5.239541245293498,4
987,51,16,16,8,-5.285051160663567,8
988,20,11,33,6,-5.2962163491563015,5
989,48,16,106,9,-5.330591930412405,7
990,96,34,63,21,-5.39321635342965,13
991,107,20,46,13,-5.461199830974728,7
992,88,11,2,7,-5.477658376983314,4
993,107,20,91,12,-5.505802548817647,8
994,108,16,107,10,-5.514649447329664,6
995,102,14,107,8,-5.527045162702203,6
996,8,21,73,12,-5.539910811917831,9
997,106,23,20,14,-5.5779625205249355,9
998,50,12,9,8,-5.578106204160814,4
999,106,16,65,10,-5.613829651583315,6
1000,84,11,38,6,-5.627456024192355,5
1001,86,17,95,11,-5.641395768359862,6
1002,2,10,5,6,-5.6557505474818175,4
1003,70,16,5,9,-5.663813747338574,7
1004,74,13,90,9,-5.698081091561145,4
1005,55,20,63,12,-5.717328262845937,8
1006,9,12,84,7,-5.723245457590759,5
1007,39,14,84,8,-5.735188058057851,6
1008,28,25,104,16,-5.749142721940425,9
1009,108,12,16,7,-5.770631208900042,5
1010,11,14,39,10,-5.821131817679595,4
1011,96,12,30,7,-5.827709187189811,5
1012,50,11,108,7,-5.852974916650042,4
1013,11,10,33,5,-5.887923901561768,5
1014,75,10,88,6,-5.899399725245313,4
1015,37,16,90,10,-5.916633751479724,6
1016,37,16,97,9,-5.98604378650211,7
1017,46,12,87,7,-5.996729580761838,5
1018,107,15,51,10,-6.010709658258435,5
1019,5,14,109,8,-6.036864928691388,6
1020,75,24,86,13,-6.0404838152681,11
1021,5,13,76,8,-6.061052091280193,5
1022,39,15,63,9,-6.098512313477011,6
1023,79,10,55,6,-6.105260957218082,4
1024,82,17,86,11,-6.124344607685839,6
1025,84,17,37,10,-6.135362755463087,7
1026,107,13,71,8,-6.143176064124285,5
1027,48,23,86,14,-6.215181955253337,9
1028,5,14,93,9,-6.281366808210213,5
1029,95,12,5,8,-6.312664798771588,4
1030,96,76,86,46,-6.3297963702492925,30
1031,106,11,34,7,-6.348877012003049,4
1032,102,20,28,11,-6.3581907444434425,9
1033,8,15,109,8,-6.403030229228608,7
1034,18,10,50,5,-6.440154509710172,5
1035,28,17,14,11,-6.462988674713606,6
1036,86,35,37,21,-6.511717567803918,14
1037,84,27,74,15,-6.529493156115414,12
1038,76,11,54,7,-6.60321190549357,4
1039,96,34,74,21,-6.609470333238454,13
1040,96,12,85,8,-6.610954135702339,4
1041,51,14,54,8,-6.622588079460445,6
1042,100,12,8,8,-6.642992983017226,4
1043,2,10,46,6,-6.670222065576342,4
1044,25,19,37,11,-6.728765858113135,8
1045,70,22,96,11,-6.734945499709392,11
1046,114,25,25,13,-6.737726761752366,12
1047,70,37,54,21,-6.740686016828504,16
1048,107,22,90,14,-6.745918417856592,8
1049,8,19,93,11,-6.747456325327522,8
1050,108,10,48,7,-6.749808304712144,3
1051,80,11,11,7,-6.802148460786961,4
1052,63,22,80,14,-6.84351888546065,8
1053,37,12,65,7,-6.8663176912939194,5
1054,86,12,93,8,-6.922029970425322,4
1055,37,30,87,18,-6.998523319274807,12
1056,109,27,28,17,-7.040709183184225,10
1057,107,25,106,16,-7.050885664381847,9
1058,48,11,50,7,-7.058211213950958,4
1059,80,21,86,12,-7.071945289109108,9
1060,79,12,63,8,-7.1114844508040305,4
1061,84,12,93,8,-7.171686286545099,4
1062,109,15,11,9,-7.174727842093128,6
1063,48,28,63,18,-7.208356975606329,10
1064,106,25,37,14,-7.2246463632933136,11
1065,75,19,28,11,-7.22576760720638,8
1066,76,18,63,12,-7.244525780520105,6
1067,20,21,5,12,-7.290920498639451,9
1068,107,22,48,13,-7.3302788653741935,9
1069,25,15,102,10,-7.370724163994214,5
1070,8,16,102,10,-7.376211425683789,6
1071,25,11,63,7,-7.385187766970543,4
1072,46,23,74,15,-7.468438399345945,8
1073,84,17,16,10,-7.471140311704607,7
1074,88,24,54,14,-7.473458607651671,10
1075,84,10,30,7,-7.509917010745373,3
1076,70,19,28,11,-7.544208909658003,8
1077,90,20,54,12,-7.555902141837604,8
1078,54,10,25,6,-7.563966757535648,4
1079,107,10,85,6,-7.595499375056905,4
1080,75,12,46,8,-7.596466468990944,4
1081,46,12,63,8,-7.600674717701954,4
1082,97,14,2,9,-7.627801324727646,5
1083,80,22,96,14,-7.6325568595370585,8
1084,108,10,55,6,-7.6603824871739565,4
1085,70,14,76,9,-7.7067801731883225,5
1086,106,10,79,6,-7.723339908977311,4
1087,28,23,46,16,-7.750583309014615,7
1088,70,18,106,10,-7.764435141080128,8
1089,79,20,48,12,-7.7777328666170344,8
1090,74,12,102,7,-7.878799122906763,5
1091,96,14,114,9,-7.889762565328155,5
1092,70,13,88,8,-7.915858076944355,5
1093,106,24,80,15,-7.94893708145332,9
1094,34,12,96,8,-7.949755484984076,4
1095,25,20,8,13,-7.955817207245071,7
1096,107,17,76,11,-7.96185690932956,6
1097,104,18,86,10,-7.975989606379796,8
1098,28,13,93,9,-7.977780890104037,4
1099,104,15,96,9,-7.984287616150157,6
1100,96,19,102,12,-7.995631160966494,7
1101,91,18,28,11,-8.014570368036852,7
1102,74,20,73,13,-8.015220364277019,7
1103,48,14,16,8,-8.053586068768565,6
1104,88,20,63,12,-8.08784367057243,8
1105,5,21,114,13,-8.112945893634581,8
1106,65,14,80,9,-8.117894882236024,5
1107,95,11,20,7,-8.186467596031179,4
1108,108,12,86,7,-8.204205290543772,5
1109,44,11,20,7,-8.212958514210372,4
1110,20,20,11,14,-8.234400855107406,6
1111,74,23,20,15,-8.253501420150274,8
1112,86,13,69,8,-8.329501489122974,5
1113,25,14,20,9,-8.344789162642355,5
1114,25,10,88,6,-8.38577497515839,4
1115,114,13,50,8,-8.388183657848245,5
1116,70,26,86,15,-8.43107057555043,11
1117,5,12,102,7,-8.446024367020586,5
1118,88,17,50,10,-8.503859481033006,7
1119,5,22,90,15,-8.559685419611386,7
1120,87,40,8,26,-8.572049681412183,14
1121,104,23,37,14,-8.601891744395868,9
1122,87,10,102,7,-8.61362310955975,3
1123,104,17,106,11,-8.650515897387708,6
1124,28,23,88,15,-8.674081432323941,8
1125,91,14,8,9,-8.717379143115323,5
1126,91,11,106,8,-8.717801627050898,3
1127,51,27,86,16,-8.740860643352914,11
1128,96,11,7,8,-8.775501150402919,3
1129,62,11,74,7,-8.814812195756359,4
1130,114,20,28,11,-8.84184705741822,9
1131,114,14,102,10,-8.90517943820017,4
1132,5,21,50,12,-8.973488261087855,9
1133,107,12,57,7,-8.988403130065704,5
1134,28,38,63,25,-9.045203898145056,13
1135,96,26,50,17,-9.051096363617633,9
1136,28,11,30,7,-9.144215115290798,4
1137,8,15,30,10,-9.185211827951933,5
1138,16,10,2,7,-9.214178381730255,3
1139,50,14,76,10,-9.228465475536328,4
1140,104,13,114,7,-9.25838880894678,6
1141,65,11,2,8,-9.274625860779656,3
1142,63,14,108,9,-9.298531248541147,5
1143,80,13,90,9,-9.30675268400111,4
1144,20,25,63,15,-9.320091766955514,10
1145,107,25,2,17,-9.348454105798005,8
1146,51,16,20,9,-9.352748618003375,7
1147,2,18,63,11,-9.42432372295896,7
1148,2,13,87,8,-9.430732046556471,5
1149,50,17,90,11,-9.438413402091001,6
1150,107,15,93,10,-9.471924672591017,5
1151,8,13,95,8,-9.502751434643129,5
1152,87,12,79,9,-9.532024747647966,3
1153,106,10,95,6,-9.576212388563865,4
1154,107,28,50,18,-9.593575141846495,10
1155,106,14,2,9,-9.64617602466394,5
1156,102,13,50,7,-9.690108951217553,6
1157,106,14,98,9,-9.701360201061403,5
1158,70,16,74,9,-9.770873759550815,7
1159,84,22,20,16,-9.790302500691977,6
1160,96,24,98,15,-9.85522726903532,9
1161,79,23,86,15,-9.865377107457421,8
1162,96,17,51,11,-9.900170566840332,6
1163,76,20,86,13,-9.940010233613185,7
1164,50,10,104,7,-9.949311401554116,3
1165,63,16,98,10,-9.99737377528037,6
1166,25,19,28,13,-10.004409761163549,6
1167,75,14,106,7,-10.013304733371458,7
1168,102,11,109,7,-10.030166218885235,4
1169,55,19,16,13,-10.104969962268772,6
1170,70,12,55,8,-10.141434019068976,4
1171,5,14,73,9,-10.145620716643505,5
1172,107,24,16,17,-10.150129279172639,7
1173,18,11,28,7,-10.21986320292799,4
1174,93,14,87,9,-10.257204602761988,5
1175,96,37,16,26,-10.284315397893868,11
1176,96,22,48,15,-10.412031756955415,7
1177,106,19,90,13,-10.479311473888151,6
1178,90,13,20,8,-10.516305750440791,5
1179,84,21,5,14,-10.562529198843299,7
1180,30,10,20,6,-10.64713860161645,4
1181,98,11,50,8,-10.691401226426704,3
1182,20,26,50,17,-10.759663700123562,9
1183,16,13,30,9,-10.88272905219503,4
1184,5,16,97,11,-11.001465278853818,5
1185,104,16,16,10,-11.17912131651947,6
1186,109,11,50,8,-11.21767101593788,3
1187,107,26,88,18,-11.241329164111953,8
1188,87,18,48,12,-11.267245216521085,6
1189,11,19,5,12,-11.267343991372718,7
1190,107,16,97,10,-11.336758264943466,6
1191,84,19,11,13,-11.37372999446702,6
1192,37,18,11,13,-11.3827289769088,5
1193,114,14,8,10,-11.423698115816396,4
1194,98,10,91,7,-11.6111736728835,3
1195,107,15,80,12,-11.678062977381893,3
1196,14,12,86,8,-11.685325963112222,4
1197,8,16,75,12,-11.79422076295848,4
1198,55,10,76,8,-11.845869320079572,2
1199,104,12,88,8,-11.911529882206116,4
1200,87,10,30,7,-11.954020606538128,3
1201,86,20,102,15,-12.1034579806225,5
1202,25,12,11,9,-12.166771335730743,3
1203,109,18,86,14,-12.213282587444159,4
1204,104,12,54,9,-12.325395114514102,3
1205,96,38,11,26,-12.433764526276038,12
1206,54,39,63,27,-12.439421659836581,12
1207,107,17,73,11,-12.476279417058619,6
1208,39,10,86,6,-12.521968554365154,4
1209,54,27,37,18,-12.577195310341336,9
1210,87,10,98,7,-12.766560909926936,3
1211,37,14,17,9,-12.777771600020978,5
1212,98,10,20,8,-12.882632104752002,2
1213,96,10,78,7,-12.899686199305037,3
1214,73,16,86,10,-12.90546934044994,6
1215,8,13,97,9,-13.031573471749281,4
1216,107,10,17,7,-13.095515887019285,3
1217,14,10,80,6,-13.097202558791372,4
1218,54,19,48,13,-13.122325082638987,6
1219,84,10,97,8,-13.131531307588403,2
1220,97,11,90,7,-13.1785612401278,4
1221,76,10,84,7,-13.371791794476115,3
1222,109,14,63,10,-13.37185268786884,4
1223,28,11,69,7,-13.387342269628983,4
1224,11,25,55,19,-13.485189958967283,6
1225,74,12,51,9,-13.51982642182268,3
1226,25,12,97,8,-13.551137798789014,4
1227,91,11,16,8,-13.591952616906621,3
1228,46,24,88,18,-13.650052567359646,6
1229,70,15,87,10,-13.709203230326098,5
1230,5,10,75,7,-13.751440551521483,3
1231,20,12,91,8,-13.840742693250826,4
1232,84,12,46,9,-13.97403398222274,3
1233,8,13,71,9,-13.992705985768803,4
1234,48,10,90,7,-14.062301149493257,3
1235,28,12,34,9,-14.433851353414235,3
1236,107,11,95,8,-14.460264509685395,3
1237,35,14,107,11,-14.477847243885742,3
1238,63,11,14,7,-14.53302527333945,4
1239,84,33,63,23,-14.557123158417973,10
1240,35,11,80,8,-14.578551377058158,3
1241,87,34,16,24,-14.665355259552404,10
1242,65,11,8,8,-14.67711948639893,3
1243,96,16,46,10,-14.744941109171661,6
1244,88,11,95,8,-14.83873132426491,3
1245,50,12,80,10,-14.926124931290454,2
1246,54,14,100,10,-14.930697835147344,4
1247,96,12,91,9,-15.083901067533665,3
1248,90,14,73,10,-15.18129739743865,4
1249,70,16,2,11,-15.20234077608459,5
1250,20,15,114,12,-15.220589720677065,3
1251,37,11,73,7,-15.237735204111459,4
1252,106,30,16,23,-15.27216594275733,7
1253,28,24,74,18,-15.315195079920043,6
1254,11,10,93,8,-15.321419061771829,2
1255,16,11,102,7,-15.640576633612339,4
1256,9,11,48,8,-15.643745764186933,3
1257,98,11,8,9,-15.962593668325574,2
1258,23,10,106,7,-16.05394351537058,3
1259,70,13,11,10,-16.32604658673946,3
1260,46,12,16,9,-16.483729162085577,3
1261,109,12,114,10,-16.832451560804277,2
1262,63,12,90,9,-16.840668609829063,3
1263,54,10,73,8,-17.106743436572103,2
1264,106,10,35,7,-17.319051156851785,3
1265,87,11,34,8,-17.33811535027782,3
1266,74,22,16,17,-17.47013856072432,5
1267,106,11,114,8,-17.502347470464006,3
1268,86,13,41,11,-17.568343007541298,2
1269,98,12,11,9,-17.79113396344492,3
1270,28,23,90,18,-17.842079516061677,5
1271,57,10,88,7,-18.036088584555035,3
1272,98,11,16,8,-18.093280468518255,3
1273,91,17,63,13,-18.120595699414864,4
1274,70,10,16,8,-18.132036089559314,2
1275,70,10,50,7,-18.669208398142956,3
1276,2,12,104,9,-18.740094391311295,3
1277,112,14,28,11,-19.249826897720947,3
1278,54,13,2,11,-19.75997048475248,2
1279,66,10,107,8,-20.152222817707916,2
1280,55,18,50,14,-21.38404284403115,4
1281,96,13,93,11,-21.644278578741655,2
1282,51,10,34,9,-22.213174768846976,1
1283,109,14,88,13,-24.411419565336224,1
1284,35,13,76,10,-24.45415726080802,3
1285,35,10,48,9,-25.15519793083891,1
1286,54,11,30,10,-25.713620235434703,1
1287,37,12,88,11,-27.444768307289483,1
1288,98,11,5,10,-27.764706586499702,1
1289,107,12,30,11,-27.89865943808827,1
