,againstHero,games,hero,losses,shift,wins
0,64,10,65,1,31.455780164415444,9
1,46,10,30,1,30.066474719572692,9
2,55,10,89,1,28.65230905538118,9
3,91,10,43,0,27.34458455824453,10
4,103,15,86,2,23.967936503754764,13
5,57,12,41,2,23.379405756490282,10
6,26,10,10,2,22.77202326046866,8
7,84,10,94,1,22.762013140609877,9
8,20,11,85,2,22.58682017719025,9
9,107,11,73,2,22.13453383862815,9
10,17,11,44,2,22.072912946241175,9
11,111,25,70,6,21.76194128198864,19
12,87,29,109,6,21.22636324198765,23
13,74,14,110,3,20.875047711546735,11
14,37,10,104,2,20.681486856575926,8
15,28,10,71,1,20.618030954774138,9
16,64,10,9,2,20.434576500484816,8
17,110,12,109,2,20.16933250309851,10
18,87,11,85,2,19.84968427684578,9
19,41,13,10,2,19.737157878272868,11
20,5,10,9,2,19.535484203654335,8
21,55,12,75,2,19.502608543209234,10
22,110,12,29,2,19.248543702222978,10
23,62,13,50,3,19.2021134597274,10
24,62,12,71,1,19.04348733516107,11
25,26,11,88,3,18.785991491960512,8
26,70,15,86,4,18.585222369284793,11
27,88,15,75,3,18.461574020804573,12
28,79,13,7,3,18.404801500191937,10
29,18,10,37,2,18.37479944857912,8
30,106,12,20,4,18.311540077061185,8
31,58,11,87,2,18.229025747195358,9
32,51,11,98,3,18.11615896281521,8
33,55,10,85,3,18.05317512013182,7
34,90,11,76,4,18.0318690370992,7
35,63,13,70,3,17.959510637912523,10
36,41,10,110,1,17.607251464829996,9
37,57,19,28,4,17.559820084625652,15
38,63,13,76,2,17.535738224915978,11
39,88,19,49,4,17.532034552741443,15
40,87,17,46,5,17.514030324475865,12
41,37,10,89,2,17.418835616565147,8
42,26,11,49,4,17.344464565076983,7
43,106,11,87,2,17.088429536387807,9
44,26,13,54,5,16.93978716229654,8
45,43,14,38,5,16.91598228541753,9
46,38,12,15,3,16.880495720481193,9
47,63,13,28,3,16.83915101157232,10
48,73,16,109,4,16.722107664046142,12
49,57,13,76,3,16.71990929044005,10
50,30,13,85,3,16.38402642563884,10
51,63,11,10,3,16.316509167938314,8
52,62,13,103,4,16.29915650058687,9
53,59,11,103,3,16.266656443008642,8
54,90,12,91,4,16.098702445179015,8
55,55,16,109,4,15.902114621962271,12
56,46,15,79,5,15.695062063539163,10
57,17,15,38,4,15.678044683298898,11
58,29,12,73,3,15.669782329836798,9
59,16,10,59,4,15.561569445873218,6
60,70,13,88,3,15.44587119057327,10
61,74,11,112,3,15.445414304360199,8
62,90,11,18,3,15.206260273523743,8
63,90,17,88,5,15.203720699131468,12
64,84,14,40,5,15.139436492633184,9
65,57,15,37,4,15.067776643574769,11
66,73,14,23,4,15.06705739412856,10
67,14,10,65,2,15.014185877069243,8
68,30,23,65,6,14.922473908669254,17
69,26,24,38,7,14.873702675608982,17
70,93,11,17,3,14.792328082005683,8
71,93,25,38,8,14.706979782976543,17
72,49,11,62,4,14.691411076024671,7
73,90,11,93,4,14.682520064465667,7
74,88,14,13,6,14.6368480815469,8
75,62,19,20,5,14.584809923949425,14
76,110,11,50,3,14.531978974156038,8
77,111,30,62,9,14.365589379046465,21
78,63,16,79,5,14.33440781504391,11
79,28,10,66,4,14.329185091749263,6
80,86,12,17,3,14.311620358508236,9
81,46,11,91,3,14.304066831342244,8
82,84,10,44,3,14.273373064789189,7
83,106,10,28,2,14.267038541695133,8
84,60,10,8,3,14.262033464961128,7
85,50,12,109,4,14.261856398454313,8
86,110,16,8,4,14.09581292777676,12
87,17,13,37,5,14.003196529897787,8
88,57,20,9,5,13.952239963411898,15
89,70,12,109,3,13.902253335630233,9
90,93,14,48,3,13.897649300249865,11
91,26,33,107,8,13.875366782102597,25
92,55,22,2,7,13.871872112800908,15
93,87,14,5,4,13.851284632052465,10
94,54,26,109,8,13.824526520753494,18
95,38,16,73,6,13.771113964229547,10
96,63,15,9,5,13.731382825814709,10
97,111,16,109,5,13.722443192828694,11
98,37,10,13,3,13.710588735524032,7
99,63,12,86,3,13.68914564901756,9
100,26,13,69,4,13.66583811938565,9
101,84,17,13,6,13.614397809771186,11
102,37,12,5,3,13.593067112324485,9
103,13,15,73,5,13.471561712276639,10
104,107,26,62,9,13.41840886925082,17
105,70,12,74,3,13.332522800110311,9
106,30,12,62,4,13.325811773490166,8
107,18,13,2,4,13.31796160775977,9
108,89,12,73,4,13.292782754035754,8
109,58,10,89,3,13.242354787086834,7
110,20,11,48,3,13.215007868614988,8
111,64,16,86,5,13.126489420837816,11
112,3,11,8,3,12.917286316124727,8
113,6,14,66,4,12.900366001703459,10
114,69,10,41,4,12.786110356364535,6
115,73,11,90,3,12.699639901607053,8
116,46,21,9,8,12.65253338448702,13
117,28,28,109,9,12.60200219907949,19
118,18,16,84,5,12.53715723328449,11
119,93,22,62,7,12.439036445917942,15
120,20,18,23,5,12.419097927334024,13
121,9,11,97,4,12.349501112253755,7
122,30,22,9,6,12.347684941209279,16
123,93,12,26,4,12.342400061412198,8
124,55,21,62,8,12.32662089581423,13
125,107,26,6,8,12.322254797620149,18
126,93,17,50,6,12.303370496346986,11
127,2,20,76,7,12.297418547243822,13
128,84,17,62,6,12.256108525265194,11
129,51,15,48,4,12.237016972870082,11
130,74,20,48,7,12.230658480119438,13
131,10,23,23,9,12.202189639863427,14
132,93,20,41,5,12.152619394683915,15
133,58,11,103,3,12.093407699535737,8
134,79,11,112,3,12.089617166544242,8
135,38,15,10,4,12.029907406435383,11
136,98,15,11,5,11.975065250902471,10
137,104,16,98,6,11.93364499732059,10
138,93,10,76,3,11.9232506042626,7
139,18,13,17,5,11.905263091036245,8
140,48,17,111,5,11.902706300174232,12
141,43,14,109,5,11.866460109925438,9
142,23,15,62,4,11.828374088275869,11
143,15,10,79,3,11.756403792330063,7
144,70,13,62,5,11.719880801732709,8
145,87,28,6,9,11.670469918906115,19
146,107,14,70,5,11.658453467748302,9
147,98,17,15,6,11.628891195956703,11
148,65,16,18,5,11.593628436717697,11
149,16,18,13,6,11.568229122492738,12
150,65,16,102,6,11.565057266886955,10
151,38,22,109,7,11.561969316834697,15
152,109,15,6,5,11.553622356231047,10
153,41,31,109,7,11.540113156994366,24
154,17,20,41,5,11.462467383182338,15
155,63,19,54,7,11.360815568498154,12
156,2,22,103,6,11.358008021341288,16
157,55,21,30,8,11.351029418072518,13
158,13,13,41,5,11.285884419294261,8
159,98,12,71,4,11.256798740703502,8
160,93,14,1,4,11.222746146114876,10
161,85,16,37,4,11.183890538456172,12
162,15,10,28,3,11.176545961741331,7
163,26,13,46,5,11.17021351687407,8
164,93,19,37,6,11.135373057728058,13
165,98,12,110,4,11.026999619900328,8
166,20,19,10,6,11.010427213733353,13
167,38,14,6,4,11.005398790381081,10
168,30,10,43,3,10.958461383133036,7
169,87,17,51,6,10.954751209558498,11
170,98,48,41,18,10.835326353590219,30
171,37,13,63,5,10.805969524077794,8
172,30,25,103,8,10.782874613377906,17
173,17,16,23,5,10.781653305644484,11
174,93,37,9,12,10.753480854770812,25
175,50,10,37,4,10.742277179240864,6
176,8,13,66,4,10.73746092576915,9
177,28,22,89,8,10.724731089663779,14
178,91,10,85,5,10.702453755941072,5
179,37,14,41,5,10.694476243263011,9
180,107,16,109,6,10.668493285549742,10
181,75,16,16,5,10.668295124883429,11
182,38,13,58,4,10.642287291889902,9
183,98,37,88,11,10.639663528048942,26
184,65,10,101,4,10.616476001261294,6
185,86,12,109,5,10.607119538943415,7
186,103,14,109,4,10.579033749442829,10
187,70,15,65,5,10.573807897523746,10
188,98,32,76,12,10.566257306689167,20
189,46,10,86,3,10.519256341023809,7
190,30,20,54,7,10.51688523619003,13
191,20,17,49,6,10.413212284497671,11
192,29,10,17,3,10.395985227153457,7
193,93,12,75,5,10.370088912225684,7
194,2,11,75,4,10.369833561069749,7
195,8,14,89,5,10.313019177206716,9
196,2,16,73,6,10.299221262346556,10
197,54,14,104,5,10.225264066110721,9
198,70,22,84,8,10.2219111812329,14
199,2,32,86,10,10.192867967955026,22
200,65,12,96,5,10.190345361441286,7
201,60,10,38,4,10.186949801542621,6
202,74,17,18,6,10.161044876408575,11
203,109,14,84,5,10.149942855967595,9
204,10,18,1,6,10.049405294208206,12
205,37,14,34,5,10.040882054419713,9
206,65,14,59,6,10.036164804159641,8
207,88,11,30,5,10.02483572373662,6
208,111,43,54,15,9.999417272535721,28
209,76,17,34,6,9.994247540573088,11
210,11,11,86,5,9.99095041190771,6
211,34,14,91,5,9.98713094249012,9
212,29,10,70,3,9.97437186041017,7
213,111,24,38,9,9.966212518632439,15
214,10,17,55,7,9.95517779426481,10
215,93,11,70,4,9.928875321549775,7
216,87,13,17,5,9.922998390575081,8
217,10,14,50,5,9.907166966632534,9
218,107,30,41,12,9.880991735942342,18
219,32,22,109,8,9.859589833142886,14
220,28,10,64,4,9.858359509289869,6
221,9,11,51,4,9.848213738956359,7
222,55,24,54,7,9.845323433417098,17
223,111,20,37,8,9.840471570719451,12
224,84,28,10,10,9.802133639275013,18
225,6,34,44,13,9.768613303295998,21
226,73,21,111,8,9.713634051639158,13
227,29,32,38,11,9.681299801122258,21
228,88,11,85,4,9.65630194872786,7
229,98,26,62,10,9.641858129313677,16
230,23,22,89,8,9.576875474490599,14
231,60,21,65,8,9.571951123571171,13
232,32,14,88,4,9.505084521049728,10
233,43,16,28,5,9.500596764145225,11
234,6,11,58,4,9.489496457414935,7
235,103,11,19,4,9.481054864710421,7
236,65,17,44,7,9.443702457838901,10
237,28,14,11,5,9.441756332630208,9
238,57,11,10,4,9.43267475148189,7
239,34,16,74,6,9.430626027485216,10
240,46,17,8,6,9.405496106583277,11
241,49,17,86,8,9.34317243367324,9
242,23,15,55,6,9.33524063849589,9
243,28,13,112,5,9.317343463958052,8
244,50,17,23,7,9.300090532650529,10
245,38,20,86,6,9.280969369301586,14
246,43,14,50,5,9.27474781724881,9
247,54,37,41,13,9.187270230665858,24
248,55,47,87,16,9.141155465246936,31
249,50,15,48,6,9.13089598930206,9
250,93,29,103,11,9.099325117611023,18
251,26,12,32,5,9.09769401619869,7
252,106,13,109,5,9.062668099795829,8
253,91,16,50,5,9.044194652502608,11
254,74,35,76,12,9.02110943529627,23
255,107,20,110,8,8.933567921834609,12
256,10,20,86,7,8.92570532964782,13
257,112,11,50,4,8.921235906620762,7
258,13,20,8,7,8.90162940957447,13
259,49,15,16,6,8.832590137428085,9
260,30,15,16,5,8.816826919356291,10
261,10,11,85,5,8.810276618143424,6
262,30,17,70,6,8.802658687382808,11
263,32,17,107,5,8.731768023357226,12
264,79,16,75,5,8.729196308002653,11
265,54,26,37,8,8.701915458664551,18
266,23,23,37,8,8.700238300329007,15
267,34,18,109,7,8.662734980033562,11
268,54,10,71,3,8.658299695148918,7
269,13,25,28,8,8.6304861488093,17
270,46,18,54,6,8.62832740448409,12
271,37,40,86,16,8.603825624585157,24
272,54,24,76,10,8.571167297040505,14
273,41,18,62,7,8.537234992782361,11
274,32,25,9,9,8.53109215537152,16
275,16,25,70,8,8.490955297661813,17
276,93,31,84,11,8.465363334016377,20
277,84,26,85,12,8.43749111456715,14
278,98,21,1,7,8.436557583367685,14
279,73,21,10,7,8.419335562342072,14
280,43,17,87,6,8.417190390098328,11
281,93,16,91,6,8.415373132469666,10
282,90,11,89,4,8.396796914570167,7
283,90,19,23,7,8.394839451243378,12
284,23,23,93,10,8.387201678617911,13
285,48,12,38,4,8.376240779730173,8
286,20,10,70,3,8.374580328727138,7
287,77,12,8,4,8.373441110755328,8
288,84,20,63,8,8.347628578121027,12
289,104,11,84,4,8.339235828654417,7
290,8,10,35,4,8.335806667410798,6
291,76,18,41,7,8.284971187696902,11
292,65,12,58,6,8.279172093518044,6
293,20,33,9,11,8.272596506781882,22
294,111,14,17,6,8.239799794462428,8
295,26,10,16,4,8.231874067384071,6
296,28,13,94,5,8.222371266039163,8
297,8,19,71,8,8.209507898321064,11
298,17,29,8,11,8.17510581548791,18
299,32,24,41,10,8.170536046764159,14
300,26,44,87,17,8.146474895568335,27
301,76,15,62,8,8.13160872872303,7
302,30,22,87,8,8.119510877690908,14
303,19,14,9,6,8.117304295019109,8
304,93,32,54,10,8.106367720057328,22
305,79,28,107,10,8.08896000624074,18
306,30,15,10,5,8.08039942607508,10
307,6,12,13,5,8.074590184679876,7
308,76,37,28,15,8.031633541184371,22
309,1,11,86,4,8.004187715591307,7
310,98,58,65,22,8.003844385049874,36
311,90,15,41,6,7.997737246515682,9
312,32,14,86,6,7.973587175462614,8
313,109,12,37,5,7.972273664149992,7
314,55,18,76,7,7.950732428839994,11
315,65,17,68,7,7.944869327403054,10
316,49,14,13,6,7.890029815709072,8
317,109,30,9,12,7.889736540676636,18
318,74,11,12,5,7.8813359238936185,6
319,17,26,9,10,7.831275179780669,16
320,76,32,37,11,7.820497576953577,21
321,8,22,57,9,7.7994321657351655,13
322,65,20,50,8,7.794013777008706,12
323,2,40,65,14,7.773153242011129,26
324,29,13,109,5,7.7648215544268036,8
325,11,11,8,4,7.745411048760352,7
326,55,26,38,11,7.745065833950479,15
327,111,14,85,5,7.729378570457984,9
328,79,36,48,15,7.72102968531053,21
329,23,11,59,4,7.703199044299857,7
330,16,23,85,9,7.699328173457129,14
331,88,40,76,17,7.693645081601592,23
332,49,22,65,9,7.648203777845676,13
333,74,29,86,11,7.646930643556198,18
334,84,43,48,18,7.630223766084296,25
335,111,26,86,11,7.59951633000359,15
336,91,21,76,8,7.53854735511653,13
337,28,40,54,15,7.533969917846796,25
338,79,17,70,8,7.531628680674288,9
339,46,15,88,5,7.530723715486483,10
340,29,20,107,7,7.525530619454996,13
341,34,10,38,4,7.513274255260262,6
342,28,53,41,23,7.494799478271726,30
343,16,68,86,26,7.459847425476161,42
344,10,29,28,10,7.458178088618777,19
345,17,14,48,6,7.444960593591361,8
346,87,31,50,12,7.429484842498573,19
347,98,14,68,4,7.427653338623123,10
348,103,29,74,10,7.419118005067162,19
349,88,29,54,12,7.418874182686383,17
350,41,13,49,4,7.406139067429071,9
351,98,15,5,6,7.40308817440165,9
352,43,14,65,6,7.3477742435965085,8
353,73,35,9,14,7.317625242616718,21
354,54,21,10,8,7.316914939103651,13
355,50,11,68,4,7.299975074722132,7
356,13,13,20,4,7.287197108459041,9
357,23,15,70,6,7.277989111704888,9
358,30,10,73,4,7.27524129591905,6
359,88,14,38,6,7.257573306252311,8
360,84,24,88,9,7.256956915758401,15
361,55,41,98,16,7.2398162826998345,25
362,30,13,49,5,7.228582193886499,8
363,10,19,76,8,7.223608714939963,11
364,87,10,56,4,7.222698791088141,6
365,30,23,86,6,7.211631009876047,17
366,111,13,34,6,7.201437198359541,7
367,8,51,76,20,7.184483601143028,31
368,5,11,6,4,7.175117705775805,7
369,16,16,89,6,7.102664218068734,10
370,104,14,62,5,7.094567188746601,9
371,10,10,13,5,7.081545477709261,5
372,87,15,34,6,7.057985714791884,9
373,74,52,65,20,7.057974081058533,32
374,91,37,28,14,7.047707205955762,23
375,59,19,79,8,7.0352036880537865,11
376,111,20,6,8,7.01838566892247,12
377,104,13,87,4,7.011123913755368,9
378,51,10,6,3,7.003530037614207,7
379,90,19,6,8,7.0034906221582,11
380,79,21,104,7,7.001432407845644,14
381,79,11,101,5,6.9908614259308735,6
382,107,27,50,10,6.978239572703387,17
383,73,10,68,4,6.95394987102174,6
384,55,15,37,6,6.9376912240904405,9
385,90,14,17,6,6.930186835428711,8
386,57,12,74,4,6.9176042424257504,8
387,8,36,38,14,6.910326910265974,22
388,41,45,103,15,6.896034695840802,30
389,89,11,87,4,6.890327484533061,7
390,15,11,16,4,6.875773988595895,7
391,88,10,63,4,6.87340914266048,6
392,87,45,79,19,6.859799779773055,26
393,87,13,14,5,6.836219880263254,8
394,32,26,79,10,6.821690929992381,16
395,104,23,28,8,6.811415227948635,15
396,88,21,6,8,6.808639243885847,13
397,8,47,93,18,6.803263671135738,29
398,91,35,41,13,6.801656465480552,22
399,93,34,87,13,6.796283419516629,21
400,93,14,43,5,6.79067137162001,9
401,55,35,20,15,6.786443158254519,20
402,26,24,109,9,6.785414157125367,15
403,87,46,28,18,6.771264575755612,28
404,93,27,74,9,6.758416234659334,18
405,98,36,50,16,6.748525889961953,20
406,73,13,93,5,6.746815708884676,8
407,111,42,41,18,6.742879314894578,24
408,65,24,32,10,6.740147619373068,14
409,2,19,34,8,6.729658072634226,11
410,111,29,32,13,6.714992004730652,16
411,89,11,74,5,6.7140175484003635,6
412,79,18,62,8,6.70668334197217,10
413,28,19,85,8,6.70566330304257,11
414,88,16,57,7,6.698470388803919,9
415,20,34,79,13,6.674702669544552,21
416,18,24,9,10,6.669379438735331,14
417,74,16,49,7,6.669033870592301,9
418,98,23,34,8,6.66465867049253,15
419,17,15,49,6,6.655321673670165,9
420,70,23,87,9,6.643543273052479,14
421,86,14,85,7,6.640232602185862,7
422,23,14,18,5,6.63118753114106,9
423,34,14,65,6,6.615174326051721,8
424,107,20,76,8,6.611819543573891,12
425,16,21,18,8,6.609959415609469,13
426,55,15,91,5,6.584228246945671,10
427,84,12,66,5,6.578044154096627,7
428,74,23,38,10,6.562267688513878,13
429,87,34,86,14,6.549812552171538,20
430,74,26,88,9,6.515151171646331,17
431,28,71,9,30,6.5117663057869315,41
432,17,13,62,5,6.51109228837904,8
433,87,25,18,9,6.500921078177537,16
434,23,11,48,5,6.485113687277626,6
435,17,10,10,4,6.479497194252798,6
436,65,32,48,13,6.477954122109943,19
437,20,16,88,6,6.450213485704791,10
438,63,46,65,19,6.445671399527154,27
439,90,10,62,4,6.441503246890602,6
440,12,14,28,5,6.429365216940004,9
441,28,24,70,11,6.387367877038986,13
442,30,22,37,8,6.384018768768751,14
443,15,14,84,5,6.375647385580588,9
444,103,22,88,8,6.368772240906124,14
445,31,10,28,4,6.368565836830035,6
446,20,30,84,11,6.362668081835638,19
447,86,18,73,7,6.340120760849839,11
448,55,26,41,12,6.334267485528576,14
449,20,80,65,31,6.318535384282401,49
450,16,57,65,24,6.310296262259337,33
451,8,33,109,14,6.3077294568861335,19
452,90,16,54,7,6.290244829620479,9
453,16,70,9,26,6.286769666830934,44
454,111,15,44,6,6.282001615200402,9
455,55,32,9,11,6.253306035745026,21
456,23,40,8,16,6.243153204885935,24
457,75,12,9,4,6.239095019020707,8
458,2,35,41,13,6.231438093089566,22
459,16,14,34,6,6.229556768499603,8
460,2,11,66,4,6.205381429919993,7
461,86,16,20,7,6.172725546534345,9
462,87,23,88,8,6.146478682205598,15
463,111,11,56,4,6.133528731729061,7
464,73,15,88,6,6.130278796806204,9
465,111,70,65,32,6.128152820402619,38
466,54,34,38,13,6.117390645115775,21
467,93,15,30,6,6.056393100709427,9
468,63,13,98,6,6.056134732306893,7
469,107,42,20,18,6.045287678462957,24
470,8,36,62,15,6.033809520555299,21
471,1,14,107,6,6.012748941227003,8
472,98,48,91,22,6.010481139866045,26
473,49,10,77,5,6.002993751357126,5
474,74,25,6,10,5.973570320498578,15
475,17,10,34,4,5.97086385916694,6
476,20,33,103,11,5.96431634987825,22
477,86,10,62,6,5.9629944894743,4
478,8,23,49,10,5.962799116224744,13
479,89,25,10,10,5.961935346068015,15
480,87,28,91,11,5.954439761122977,17
481,70,20,76,8,5.93646339837733,12
482,98,49,103,19,5.894528502030377,30
483,17,17,16,7,5.868342075872022,10
484,107,10,48,4,5.863597775104664,6
485,2,10,44,4,5.82972376449153,6
486,13,21,79,7,5.816978385717296,14
487,6,39,28,16,5.814794559366384,23
488,87,44,41,20,5.804454173879385,24
489,17,19,84,8,5.7860858723157875,11
490,15,23,76,9,5.782831260117769,14
491,32,18,54,7,5.782610489553489,11
492,51,14,79,6,5.7725066910082035,8
493,49,24,9,9,5.76893486693949,15
494,75,15,28,7,5.767432508412387,8
495,38,29,9,13,5.756435186772363,16
496,90,20,37,8,5.742590617036877,12
497,89,23,65,10,5.729458742490648,13
498,37,15,20,6,5.70608951477605,9
499,18,11,51,5,5.697627847770078,6
500,43,13,9,6,5.682535108763634,7
501,63,16,91,7,5.669548453730623,9
502,8,13,56,5,5.662090518526135,8
503,74,18,109,8,5.655848733560979,10
504,9,37,86,16,5.645458360024604,21
505,41,45,9,17,5.6439057397283525,28
506,2,16,48,8,5.635246627200363,8
507,54,16,51,7,5.634722358696406,9
508,26,22,29,8,5.630548836449718,14
509,86,11,57,5,5.628641785626694,6
510,55,11,90,4,5.610328015034917,7
511,74,35,91,15,5.590543375115505,20
512,28,25,17,10,5.573169674184406,15
513,8,75,79,34,5.572148440361378,41
514,49,14,48,7,5.572044813615615,7
515,49,29,98,13,5.553486162622288,16
516,28,11,97,6,5.54697078214519,5
517,34,22,79,10,5.544717629215146,12
518,6,35,48,15,5.544547995709246,20
519,46,10,2,4,5.541906116456113,6
520,111,36,103,15,5.530917867453256,21
521,23,40,98,16,5.527481430978805,24
522,107,16,34,7,5.514558906998724,9
523,74,21,73,9,5.496437468937688,12
524,65,15,15,7,5.468158414216742,8
525,90,20,87,7,5.46489906820686,13
526,14,10,9,3,5.463439437022661,7
527,30,15,50,7,5.456889712897822,8
528,49,27,87,13,5.451792030762737,14
529,84,39,76,19,5.438513858870126,20
530,109,16,23,6,5.438260955948294,10
531,94,18,20,7,5.424401699040207,11
532,20,26,38,11,5.422962328602487,15
533,37,23,88,9,5.420331892037574,14
534,43,11,103,5,5.4056340195812504,6
535,19,10,28,4,5.405282356849322,6
536,110,23,65,9,5.3850619906564345,14
537,8,66,41,30,5.38335326188138,36
538,8,15,106,7,5.356587228673996,8
539,87,47,9,20,5.350758253257082,27
540,29,21,84,9,5.3406675655013585,12
541,90,23,8,9,5.338168133162711,14
542,86,20,55,10,5.332288648397899,10
543,63,15,85,7,5.266282773446653,8
544,74,22,29,10,5.260819792223967,12
545,50,12,89,5,5.253704218444142,7
546,1,10,111,5,5.238983537325087,5
547,8,47,48,20,5.235832639480808,27
548,55,14,18,6,5.21003106995447,8
549,54,48,9,20,5.195140805756249,28
550,111,10,57,4,5.186942618450884,6
551,107,34,9,16,5.177997873535454,18
552,16,15,57,7,5.174682414292543,8
553,26,38,20,16,5.156160372920298,22
554,98,10,52,5,5.141825899051737,5
555,54,12,17,5,5.132650672697678,7
556,41,29,89,12,5.128070897369617,17
557,103,21,18,9,5.1172633080953505,12
558,28,21,49,8,5.11072806296806,13
559,107,28,2,12,5.101731059055636,16
560,9,11,1,5,5.096238795529086,6
561,16,20,73,9,5.070658783374491,11
562,84,26,34,10,5.0345191207409545,16
563,65,58,54,26,5.034371936668327,32
564,89,15,84,5,5.015269353437395,10
565,55,20,32,8,5.0109481732467795,12
566,62,17,54,7,5.001633115691913,10
567,93,42,28,18,4.991965722669563,24
568,26,30,65,13,4.98261857456072,17
569,54,39,6,14,4.982016121026187,25
570,50,18,73,9,4.9783134285735455,9
571,89,10,20,4,4.976403038151212,6
572,18,23,79,11,4.97103956030986,12
573,41,20,86,9,4.96812288725616,11
574,10,10,59,5,4.967497448599417,5
575,46,11,103,5,4.9349144398730305,6
576,65,11,5,5,4.90161537792141,6
577,87,26,76,11,4.892551999966175,15
578,104,13,76,6,4.853899950951066,7
579,89,11,109,5,4.829014520032646,6
580,55,29,6,10,4.803715742468646,19
581,90,11,70,4,4.801865378344786,7
582,86,11,18,5,4.795064637153174,6
583,17,11,30,5,4.793161472453948,6
584,34,10,103,3,4.7904730345691835,7
585,111,10,104,4,4.785383853867563,6
586,8,97,9,43,4.769438593781652,54
587,98,17,94,7,4.761676089313327,10
588,6,12,32,5,4.741771241477238,7
589,28,63,16,27,4.723377175911021,36
590,90,30,9,13,4.71783274464291,17
591,109,19,93,8,4.710552248323453,11
592,87,35,29,15,4.710088352572669,20
593,26,16,6,6,4.685058896386023,10
594,41,53,20,21,4.672832095577478,32
595,86,10,15,5,4.60305467364883,5
596,2,31,6,13,4.57536971568475,18
597,46,13,37,6,4.568700097838744,7
598,9,20,89,7,4.555028073124964,13
599,87,15,57,7,4.5524099729129395,8
600,2,10,51,5,4.541060117126738,5
601,26,45,8,21,4.5356979974590255,24
602,74,24,23,11,4.530539923458648,13
603,65,26,109,13,4.522732343847645,13
604,91,36,9,16,4.519475424395421,20
605,111,29,93,14,4.510765206652466,15
606,38,38,28,17,4.506160175549613,21
607,9,17,59,7,4.5029610514141964,10
608,29,11,62,5,4.502398822563124,6
609,111,29,91,14,4.500138929465921,15
610,29,21,93,9,4.4989593922467,12
611,16,37,88,14,4.497133728227466,23
612,6,26,20,13,4.4865728866559484,13
613,111,21,29,11,4.484029622528672,10
614,111,25,15,10,4.472513123100842,15
615,73,23,84,8,4.463513313785126,15
616,84,32,2,14,4.438454989875698,18
617,90,10,13,5,4.435057658973358,5
618,84,36,41,14,4.405400183867787,22
619,111,38,74,17,4.395421398955392,21
620,75,11,50,4,4.392668801200932,7
621,1,14,65,6,4.384642024421804,8
622,107,15,104,6,4.384096889948018,9
623,54,13,89,5,4.375934710162813,8
624,87,11,94,5,4.375015437142173,6
625,70,17,2,6,4.37241029305553,11
626,79,13,44,6,4.35641543376227,7
627,38,23,87,10,4.353892826033056,13
628,93,71,65,31,4.339245718156344,40
629,54,17,3,8,4.336905078418527,9
630,41,20,1,7,4.310885836842606,13
631,57,22,84,9,4.3073427304627385,13
632,85,15,48,6,4.3053632687921874,9
633,103,34,28,15,4.283445470085917,19
634,79,18,106,9,4.260883343518002,9
635,58,11,9,4,4.244957448818405,7
636,18,13,49,6,4.243576516469453,7
637,97,11,8,4,4.238412616249588,7
638,29,26,20,11,4.235090000321542,15
639,65,106,9,47,4.223360140775499,59
640,104,24,8,9,4.217796324401939,15
641,16,37,37,14,4.211147077007781,23
642,26,24,103,11,4.2106057067079385,13
643,62,26,9,11,4.200068098711877,15
644,17,22,79,10,4.186747232119098,12
645,2,16,32,7,4.169077635966495,9
646,16,27,6,13,4.159304128363459,14
647,86,41,76,19,4.152074940350926,22
648,65,23,91,12,4.150101209000142,11
649,37,15,2,7,4.147220527730259,8
650,103,28,54,13,4.131111544590628,15
651,23,14,30,7,4.121797276586662,7
652,37,39,98,17,4.116775978907109,22
653,14,19,84,6,4.105576202233764,13
654,54,19,29,7,4.092788521879803,12
655,32,15,38,6,4.090422340111541,9
656,2,36,9,17,4.083891693569189,19
657,55,32,88,12,4.06388955003286,20
658,84,15,71,7,4.0469973544528735,8
659,98,16,85,8,4.042048861968958,8
660,10,11,109,5,4.004247407956422,6
661,50,37,79,17,4.001295763010438,20
662,87,26,37,13,3.9965570187790034,13
663,104,13,10,6,3.98234198179897,7
664,26,26,28,11,3.9790441547640487,15
665,16,29,74,12,3.974341734686631,17
666,1,16,8,8,3.972443483770406,8
667,91,40,8,19,3.961945852137986,21
668,93,18,10,7,3.9549788743691674,11
669,23,39,84,18,3.9529498437083554,21
670,6,22,73,11,3.947699618921396,11
671,79,36,74,14,3.925115604285722,22
672,94,16,54,8,3.8978006398785645,8
673,98,47,84,21,3.890833745652655,26
674,55,11,17,5,3.8840410393606315,6
675,20,25,109,9,3.878585285280937,16
676,20,10,50,4,3.866423191070092,6
677,51,20,86,9,3.863362217006627,11
678,38,14,49,7,3.855128614080598,7
679,106,10,9,4,3.8491129304664526,6
680,23,40,9,18,3.825851357048053,22
681,32,14,91,7,3.8253106560348464,7
682,93,15,18,7,3.8000555745474087,8
683,110,12,103,5,3.7849274590311146,7
684,26,11,110,6,3.7814954576991564,5
685,79,15,73,7,3.7804037585321275,8
686,9,27,88,12,3.7770456470577694,15
687,74,19,55,10,3.7670610658889934,9
688,98,26,18,12,3.7616966957049445,14
689,57,12,18,4,3.7525453734501917,8
690,14,11,28,4,3.751404981402921,7
691,37,37,8,17,3.7513378121907266,20
692,10,20,74,8,3.741560720435788,12
693,48,12,30,5,3.734389945168223,7
694,8,76,107,35,3.7286403952706766,41
695,48,16,41,7,3.7233952099256955,9
696,84,22,38,9,3.7215580721113755,13
697,60,10,87,5,3.716219490276845,5
698,32,14,10,5,3.709056496740225,9
699,91,15,62,7,3.7079997693755615,8
700,32,35,8,16,3.704344714378896,19
701,50,23,86,9,3.6667450797174457,14
702,48,14,89,6,3.6638704916482574,8
703,106,12,65,5,3.663753693390408,7
704,57,17,65,6,3.66200460796526,11
705,55,74,8,31,3.6502480696377546,43
706,98,10,112,5,3.634369737429613,5
707,55,33,16,14,3.6300886086666324,19
708,10,12,18,4,3.6042571144804363,8
709,111,18,46,8,3.5931850168327952,10
710,29,12,46,5,3.5756011188612877,7
711,50,25,38,11,3.5687465201033057,14
712,73,28,8,11,3.5539511566695987,17
713,65,13,94,6,3.5056909876146594,7
714,79,41,76,17,3.500613863685392,24
715,16,32,87,14,3.499918220649479,18
716,51,10,55,4,3.4788515156123396,6
717,1,14,55,6,3.472860068937084,8
718,111,21,76,11,3.468863949107616,10
719,48,12,91,5,3.4664297594725237,7
720,23,15,26,7,3.459704667443896,8
721,51,18,8,8,3.4518310636103333,10
722,98,34,86,14,3.4263911267965415,20
723,5,10,91,6,3.4255398118724356,4
724,98,31,10,14,3.404355165617583,17
725,57,12,6,4,3.4000169565132325,8
726,48,32,37,15,3.3973368766785685,17
727,79,57,37,24,3.3937774135660375,33
728,87,51,20,23,3.3933610070267357,28
729,57,14,91,5,3.387917143764696,9
730,76,14,13,7,3.383197454645703,7
731,2,14,85,7,3.3798876085075156,7
732,30,25,8,10,3.3727132212093225,15
733,6,26,91,12,3.3700663593758144,14
734,49,18,6,8,3.361990920437635,10
735,29,26,8,12,3.3557915076756846,14
736,8,11,5,6,3.3403788275926294,5
737,46,20,76,8,3.328448797754116,12
738,32,24,98,11,3.2868277404205144,13
739,54,14,85,7,3.2754567018254073,7
740,59,11,98,5,3.2664563544762513,6
741,74,61,8,28,3.2583668403481756,33
742,30,21,29,10,3.244422511134119,11
743,76,15,18,6,3.2371919896499475,9
744,49,11,85,5,3.2340490592317157,6
745,23,19,86,9,3.2169168727971016,10
746,16,60,84,27,3.209856234252974,33
747,32,25,16,11,3.2091711041875453,14
748,88,17,41,8,3.1907658333962803,9
749,91,13,37,6,3.1893915884876662,7
750,50,19,16,9,3.1594632722429505,10
751,13,14,111,6,3.137242431792204,8
752,106,10,98,4,3.1299996913347945,6
753,8,65,16,28,3.1129988884588533,37
754,54,27,50,11,3.10751627479821,16
755,50,33,103,15,3.0926951561661493,18
756,8,19,75,9,3.0842682640793213,10
757,63,17,48,8,3.0841106882866245,9
758,111,49,9,24,3.075459194725251,25
759,26,17,43,7,3.0481873322386313,10
760,9,14,44,8,3.0418979222799787,6
761,38,18,16,9,3.0174584469144032,9
762,26,16,89,8,3.0015441091670585,8
763,79,12,96,6,2.9733424562785395,6
764,18,18,48,8,2.9186933860892363,10
765,68,10,87,5,2.9185962554972145,5
766,8,24,68,11,2.912062784717025,13
767,63,14,8,6,2.911233669474754,8
768,2,41,10,18,2.8955248222440733,23
769,90,30,111,13,2.8905447130543305,17
770,30,19,6,7,2.8896247906630976,12
771,46,15,28,7,2.8691534505866247,8
772,55,11,13,5,2.867532212513362,6
773,98,31,29,15,2.8666453310461617,16
774,13,27,9,11,2.849893927277836,16
775,103,26,91,14,2.81795550429567,12
776,38,55,65,25,2.8065899103574585,30
777,63,15,107,6,2.8021473545431568,9
778,29,17,34,9,2.8011697136542724,8
779,16,35,76,17,2.796519432980327,18
780,17,30,103,13,2.786263791329437,17
781,41,40,23,18,2.767380745524291,22
782,2,18,23,9,2.7670043698876174,9
783,34,21,28,9,2.734662710408205,12
784,23,14,29,6,2.7325720738957853,8
785,79,25,89,10,2.7323432784581803,15
786,26,14,30,9,2.729526864464305,5
787,62,25,87,11,2.7185367714166633,14
788,103,24,55,11,2.703742749314949,13
789,46,10,18,4,2.6832650728648453,6
790,88,19,93,11,2.677402138703953,8
791,65,69,28,31,2.66126583420825,38
792,30,25,38,13,2.6609022960305304,12
793,86,20,88,8,2.659869775460948,12
794,15,14,8,7,2.659395326985167,7
795,87,27,54,13,2.65183749405934,14
796,8,42,103,17,2.6366758249260935,25
797,30,13,107,5,2.6326975250966647,8
798,70,11,50,6,2.626702900417426,5
799,111,23,50,10,2.6260965282140734,13
800,9,16,94,8,2.620832608628453,8
801,38,20,112,9,2.5875581099779743,11
802,2,25,109,10,2.564163534371064,15
803,23,11,34,6,2.5306742696464357,5
804,98,52,54,26,2.529015499138276,26
805,50,19,29,8,2.5251415163545525,11
806,16,50,98,22,2.5197213230509203,28
807,87,27,48,13,2.519174410816004,14
808,16,17,62,8,2.48847406843989,9
809,65,50,103,21,2.4835688434443703,29
810,74,29,107,13,2.4812045730116683,16
811,37,15,62,7,2.478947668963917,8
812,26,27,98,15,2.4699465773486544,12
813,16,13,93,6,2.460583316835962,7
814,104,10,55,5,2.457362117291275,5
815,41,40,38,19,2.4535603181412866,21
816,28,55,18,26,2.451529125268619,29
817,18,16,50,8,2.435107533000617,8
818,76,18,35,7,2.4023433325283063,11
819,43,22,74,10,2.3993639128069244,12
820,18,18,6,8,2.3903639022739704,10
821,55,12,34,5,2.3742853226893694,7
822,16,21,107,10,2.371918332267291,11
823,63,14,16,7,2.3500753449010623,7
824,41,56,79,27,2.337441224056112,29
825,104,11,86,5,2.3312767847407874,6
826,65,39,29,16,2.326033904196744,23
827,65,10,39,5,2.3211966169516858,5
828,84,50,86,24,2.31416637970619,26
829,86,15,93,7,2.2774286696835606,8
830,20,13,32,6,2.2751108005385445,7
831,62,18,32,9,2.263686769900323,9
832,37,40,9,18,2.2628015576501816,22
833,103,26,87,12,2.244435120608379,14
834,84,30,55,14,2.243237050292714,16
835,48,37,16,18,2.2417008310695548,19
836,8,11,58,6,2.225895511877211,5
837,48,11,35,5,2.219982032607504,6
838,14,14,8,6,2.218960260374273,8
839,79,28,93,15,2.2181833550633505,13
840,73,15,54,7,2.217586045542856,8
841,16,48,2,22,2.1896216594714466,26
842,73,35,41,16,2.1896111209660925,19
843,70,12,55,6,2.187109058776332,6
844,93,14,49,7,2.185400146226671,7
845,44,19,28,7,2.1816767204067147,12
846,74,45,9,20,2.167006985909848,25
847,111,54,28,25,2.1618622413747612,29
848,98,40,107,18,2.1579093706359807,22
849,9,11,15,5,2.1575516880448644,6
850,18,10,32,5,2.157224109221358,5
851,16,49,41,24,2.1541831229994863,25
852,84,44,111,19,2.142252654485593,25
853,111,33,26,15,2.137133581510591,18
854,98,63,2,30,2.135100922237145,33
855,84,11,1,5,2.1264466771262907,6
856,76,31,48,14,2.1194903112888834,17
857,55,14,73,7,2.1000754331910327,7
858,28,37,50,17,2.0963190245572716,20
859,75,18,84,8,2.093719925532618,10
860,8,61,54,29,2.087632711663482,32
861,13,19,48,7,2.077711897708858,12
862,8,67,87,30,2.0754588268226266,37
863,9,16,104,7,2.074620642084027,9
864,91,11,18,5,2.068864434806556,6
865,32,19,84,8,2.06215086903803,11
866,91,18,10,8,2.053920396033922,10
867,30,25,98,10,2.050620342220537,15
868,38,52,98,24,2.0498657703552294,28
869,23,30,87,13,2.01719025247438,17
870,59,14,8,7,2.010238389237962,7
871,98,55,74,27,2.0085674767082775,28
872,37,10,71,4,1.989603705819686,6
873,103,13,37,6,1.9837820518429876,7
874,6,47,79,22,1.9831957209831137,25
875,79,60,111,27,1.9806558598524882,33
876,23,41,65,20,1.9794334553560233,21
877,49,11,29,4,1.9792119029563418,7
878,16,22,91,10,1.976694704305867,12
879,54,18,23,8,1.9726565822582194,10
880,107,45,28,23,1.9602174500144183,22
881,37,33,65,15,1.948336028419335,18
882,28,37,37,17,1.9409348825611596,20
883,76,24,6,12,1.937944044447951,12
884,10,13,29,6,1.9268740097605626,7
885,65,20,13,11,1.923636761815708,9
886,87,22,73,11,1.9187809773134352,11
887,6,22,37,11,1.9187411338779805,11
888,76,10,17,4,1.904894860536603,6
889,41,11,61,5,1.903478014849791,6
890,104,11,51,5,1.896724728424177,6
891,65,79,88,36,1.890300628616431,43
892,91,18,88,8,1.8878660605312687,10
893,74,21,30,11,1.8748715955653132,10
894,54,17,112,8,1.871566293788823,9
895,79,59,16,27,1.8600350533574108,32
896,73,19,98,9,1.8513717297876215,10
897,6,39,98,18,1.8448936378969205,21
898,90,23,107,12,1.8399920811097459,11
899,35,12,79,5,1.8379035956261764,7
900,2,30,111,14,1.8367449192872438,16
901,90,19,84,9,1.8307456952070562,10
902,8,48,18,22,1.8210825548731258,26
903,54,28,70,14,1.820361310163525,14
904,20,22,73,11,1.8197178736344486,11
905,8,54,86,25,1.8051722643740717,29
906,85,13,76,5,1.8000085206097032,8
907,29,20,79,10,1.7978517128942393,10
908,94,10,41,5,1.7939224836809728,5
909,57,10,109,4,1.7866317267766754,6
910,107,35,38,17,1.7434138897292857,18
911,71,18,65,9,1.7385086790308775,9
912,32,32,28,15,1.7383561900488511,17
913,16,29,103,14,1.7358551004647216,15
914,87,13,75,7,1.7332300811803307,6
915,76,10,45,5,1.7263356630732685,5
916,54,38,84,17,1.7047651310078138,21
917,38,11,76,5,1.699907222636557,6
918,34,15,20,6,1.6974281353522305,9
919,84,76,9,34,1.6558854462221757,42
920,103,26,6,11,1.6275337563735748,15
921,20,18,68,9,1.616802764124798,9
922,10,18,90,8,1.612631742744166,10
923,54,37,16,18,1.6100995822446789,19
924,17,13,50,6,1.587542514822458,7
925,90,16,48,8,1.5828630197509534,8
926,73,28,65,13,1.5729902907968396,15
927,106,12,41,6,1.5589796315432007,6
928,34,21,9,10,1.5583973947761134,11
929,50,33,2,15,1.5483452933241444,18
930,79,47,86,22,1.544351219468049,25
931,107,26,86,12,1.542374498402116,14
932,85,12,38,6,1.5317416798467223,6
933,79,36,55,19,1.505344149974161,17
934,103,12,85,5,1.5052357650596415,7
935,55,18,43,9,1.4993353058682126,9
936,41,18,18,8,1.4488156792449156,10
937,50,36,41,18,1.4450486751473977,18
938,103,10,57,6,1.4334929374709406,4
939,30,20,84,10,1.4310903292079917,10
940,109,11,112,5,1.4303792106135154,6
941,62,24,28,10,1.430081518616343,14
942,111,14,75,8,1.4265352540751042,6
943,65,10,3,5,1.425825292351592,5
944,13,11,2,4,1.4221213524937664,7
945,88,31,111,14,1.4213124620809892,17
946,8,47,20,22,1.420582435666663,25
947,2,24,38,13,1.4146987667991204,11
948,34,10,48,5,1.412318598449887,5
949,54,18,15,9,1.4023674366161885,9
950,65,34,10,16,1.3889990791790807,18
951,44,13,8,5,1.382360749568672,8
952,16,32,10,15,1.3769942516048166,17
953,23,14,32,8,1.36299015760623,6
954,84,70,65,35,1.3269531130271417,35
955,48,22,55,10,1.3259791997893802,12
956,98,13,57,7,1.3243405021868635,6
957,87,15,110,7,1.3076573931351647,8
958,87,43,107,19,1.3071600665172027,24
959,54,39,20,18,1.273425394676017,21
960,90,30,28,14,1.2709224006180286,16
961,87,36,84,17,1.2473160473972962,19
962,20,43,98,20,1.2404189901414024,23
963,51,20,84,9,1.23384352612348,11
964,23,37,28,18,1.232835357364572,19
965,74,24,46,13,1.2274275532310792,11
966,49,24,55,14,1.212014442669993,10
967,29,31,28,15,1.2120053417862238,16
968,6,48,65,26,1.2017589825018333,22
969,103,10,1,6,1.178228962480731,4
970,109,23,98,11,1.1685291459099245,12
971,9,34,6,16,1.164779086663607,18
972,70,51,8,26,1.1578481792601099,25
973,79,76,9,37,1.156057079763386,39
974,50,18,34,10,1.148352191382895,8
975,20,35,28,15,1.1457491902348163,20
976,79,36,38,17,1.1399672014475488,19
977,2,20,88,9,1.1196863075510504,11
978,23,22,88,10,1.1194514842315597,12
979,55,27,50,12,1.1136011471986094,15
980,88,20,62,10,1.1096322170107622,10
981,16,10,56,4,1.1063673005412145,6
982,73,16,28,9,1.102601583168376,7
983,6,42,84,20,1.1025381642551553,22
984,88,17,48,10,1.0903379635464523,7
985,28,29,88,13,1.0651097674029193,16
986,76,15,103,6,1.064891024931597,9
987,50,40,84,20,1.0619383636321533,20
988,84,64,28,31,1.0495091480081127,33
989,74,16,62,9,1.038357756374001,7
990,9,28,76,14,1.0341615578112182,14
991,13,23,98,9,1.0334282765850014,14
992,74,44,54,23,1.0319640649256887,21
993,30,38,28,18,1.030841837554723,20
994,90,20,16,10,1.030661051555181,10
995,107,39,65,17,1.0164693815500512,22
996,8,43,88,20,1.010049703687452,23
997,58,11,2,5,1.0060883991850635,6
998,87,31,98,14,1.0052207296323061,17
999,79,11,94,5,0.999869198006996,6
1000,87,62,65,29,0.9969072233617808,33
1001,32,15,74,7,0.9878312338208298,8
1002,41,16,30,8,0.9850557086879019,8
1003,111,16,68,7,0.9831903657030904,9
1004,91,20,23,10,0.9792678927031672,10
1005,103,44,9,24,0.9734466854109779,20
1006,68,10,16,5,0.9723777343104946,5
1007,10,11,15,6,0.9620268464624092,5
1008,84,28,49,14,0.9573548536710029,14
1009,88,13,50,6,0.9566497736445121,7
1010,93,23,107,11,0.9535678875740131,12
1011,23,35,16,17,0.937387264272767,18
1012,85,19,9,8,0.9266510351352133,11
1013,13,11,74,5,0.9258529887550367,6
1014,51,16,16,7,0.9254181289183436,9
1015,103,12,89,5,0.9245541578032253,7
1016,79,29,88,12,0.9179800734687579,17
1017,60,11,9,6,0.9156618531106675,5
1018,79,39,90,17,0.8969827248841548,22
1019,62,21,65,9,0.8755953834255741,12
1020,76,10,30,5,0.8754609075341488,5
1021,29,12,18,7,0.8741742779448103,5
1022,16,34,111,18,0.8706079983684201,16
1023,5,12,79,7,0.8638337222987199,5
1024,55,52,65,22,0.8552133427187645,30
1025,98,67,8,32,0.8537292484745975,35
1026,103,16,32,7,0.8405021181328091,9
1027,111,44,87,22,0.837629282060696,22
1028,57,11,55,6,0.8315236951519526,5
1029,87,23,10,10,0.8212452099335941,13
1030,70,47,98,23,0.8130313901104028,24
1031,85,21,65,9,0.7821322420670122,12
1032,29,25,9,13,0.7771037627191238,12
1033,16,19,104,9,0.7751562090941384,10
1034,112,17,87,9,0.7591685884445001,8
1035,23,24,6,12,0.757380072902326,12
1036,76,37,65,17,0.7568795201651481,20
1037,74,46,84,22,0.7518721095348239,24
1038,90,10,104,6,0.7461340238107435,4
1039,37,11,73,5,0.7437455399697707,6
1040,8,60,10,30,0.7407705754471612,30
1041,107,23,23,11,0.7397315330825384,12
1042,46,12,10,6,0.7362386600396065,6
1043,104,31,65,13,0.7351510467171646,18
1044,50,17,74,8,0.7251672527310546,9
1045,87,24,32,13,0.7236548346311565,11
1046,51,12,65,6,0.7082823610974588,6
1047,28,16,5,7,0.7047026546051012,9
1048,9,21,70,11,0.6947320940904104,10
1049,41,23,43,11,0.6921842337130496,12
1050,54,11,57,5,0.6838901102259136,6
1051,44,12,16,7,0.6740631728235357,5
1052,111,44,55,23,0.671535328999238,21
1053,91,23,86,11,0.6661452371009022,12
1054,76,13,20,7,0.6610311160325412,6
1055,65,79,79,40,0.6544923516921638,39
1056,32,10,30,5,0.6490824873820774,5
1057,74,39,41,21,0.6406425090111565,18
1058,16,17,1,9,0.638053866963686,8
1059,10,21,48,11,0.6314146317442502,10
1060,74,13,63,6,0.6231938435062159,7
1061,91,18,44,8,0.6160976329615543,10
1062,54,27,107,13,0.609465585304671,14
1063,55,22,29,12,0.608123085968795,10
1064,111,37,20,19,0.6068837109506102,18
1065,79,18,49,8,0.6053065369071557,10
1066,62,18,38,9,0.6043816495722358,9
1067,28,49,86,26,0.6040031697342564,23
1068,98,20,101,11,0.594870864776421,9
1069,48,18,103,9,0.5903706399248485,9
1070,54,26,91,15,0.570268898485947,11
1071,15,14,2,7,0.5683026145731128,7
1072,89,17,111,9,0.5563633904658294,8
1073,90,18,2,9,0.5540783404275302,9
1074,10,18,37,8,0.5468156041706492,10
1075,2,22,62,10,0.5462872756743675,12
1076,66,13,41,7,0.534743534153649,6
1077,84,57,37,29,0.5278479910499358,28
1078,6,20,46,9,0.5265084587872956,11
1079,91,13,73,5,0.5133686150476426,8
1080,54,32,2,15,0.4972568733461067,17
1081,46,13,98,6,0.4949016763373522,7
1082,16,16,20,9,0.49084719994134707,7
1083,88,12,18,6,0.48640028582812594,6
1084,32,10,94,5,0.48339556643762405,5
1085,26,39,41,23,0.4754162497584248,16
1086,37,20,70,10,0.4662788439936151,10
1087,98,16,58,9,0.4540736471862188,7
1088,23,37,103,19,0.4333042786770578,18
1089,26,11,50,6,0.4324180875363617,5
1090,9,37,48,20,0.4321373711267582,17
1091,98,33,93,16,0.4249481440030074,17
1092,9,41,98,18,0.424424835693392,23
1093,109,14,79,7,0.42130275303052095,7
1094,54,38,86,19,0.4122039961290734,19
1095,98,66,79,35,0.4098187288682279,31
1096,93,16,55,8,0.39897461255756417,8
1097,41,13,85,6,0.3897097634286919,7
1098,38,16,106,8,0.37697952067664864,8
1099,44,10,50,5,0.37049181398411835,5
1100,48,28,98,14,0.36404245012326253,14
1101,86,19,6,9,0.36002907163374875,10
1102,8,88,65,40,0.3554432736460405,48
1103,49,17,91,9,0.3285488305810779,8
1104,98,31,90,16,0.30813626797031257,15
1105,19,14,41,8,0.30768619148938015,6
1106,8,63,2,33,0.305565686771248,30
1107,50,33,9,16,0.2983246140265216,17
1108,2,23,30,12,0.29321348863964647,11
1109,65,32,86,16,0.2921614298707558,16
1110,107,25,88,13,0.27765323546080284,12
1111,98,58,28,30,0.2696965888382482,28
1112,91,22,30,12,0.24988148097298304,10
1113,103,28,38,14,0.2481523476415201,14
1114,6,42,8,20,0.24656830276662894,22
1115,2,31,74,16,0.2426189207787665,15
1116,66,20,9,10,0.23945533670543603,10
1117,85,10,66,5,0.23847533791686767,5
1118,87,11,71,6,0.21156446783375316,5
1119,29,36,41,18,0.19641039337775912,18
1120,30,18,18,8,0.18809198027763627,10
1121,98,17,89,9,0.18632662325222404,8
1122,30,32,20,17,0.18006835825975015,15
1123,18,25,54,13,0.17269825689702856,12
1124,26,19,2,10,0.15549736717273138,9
1125,48,28,86,14,0.15223022852221899,14
1126,28,60,79,33,0.14588481387288166,27
1127,32,18,50,10,0.14361277931057495,8
1128,107,35,103,17,0.13970070555149355,18
1129,74,20,37,10,0.1351513012183972,10
1130,13,11,87,6,0.13022005589559751,5
1131,6,29,41,15,0.0941275477253323,14
1132,54,32,79,16,0.08087038354446646,16
1133,38,15,110,8,0.07451058664372948,7
1134,8,18,85,10,0.0557982015995376,8
1135,28,63,2,32,0.0455058748352281,31
1136,48,24,54,10,0.041669516523568685,14
1137,23,26,111,12,0.03864525196535908,14
1138,85,24,79,13,0.034805559038930234,11
1139,40,14,65,6,0.022138801901295854,8
1140,8,38,50,20,0.0026780543899767614,18
1141,37,15,38,8,0.0011031238349569132,7
1142,38,15,37,7,-0.0011031238349578606,8
1143,65,14,40,8,-0.022138801901296672,6
1144,13,13,107,6,-0.03566165788038671,7
1145,79,50,103,24,-0.05775390300531491,26
1146,2,25,20,13,-0.06141520142574363,12
1147,110,15,38,7,-0.07451058664372871,8
1148,87,42,74,20,-0.07958529470361445,22
1149,84,47,103,22,-0.09369403051445593,25
1150,41,29,6,14,-0.09412754772533327,15
1151,55,49,28,22,-0.0957768140175183,27
1152,43,19,20,10,-0.09655439021695145,9
1153,87,11,13,5,-0.13022005589559688,6
1154,8,23,43,12,-0.13486260335750042,11
1155,37,20,74,10,-0.135151301218397,10
1156,111,25,30,13,-0.14558741487159338,12
1157,86,28,48,14,-0.15223022852221899,14
1158,54,25,18,12,-0.1726982568970277,13
1159,28,50,74,24,-0.17793202645056747,26
1160,20,32,30,15,-0.1800683582597512,17
1161,17,19,74,10,-0.18384205614173943,9
1162,89,17,98,8,-0.18632662325222404,9
1163,18,18,30,10,-0.18809198027763716,8
1164,71,11,87,5,-0.21156446783375446,6
1165,91,21,84,10,-0.22598499748931863,11
1166,66,10,85,5,-0.23847533791686928,5
1167,9,20,66,10,-0.23945533670543603,10
1168,38,28,103,14,-0.24815234764151944,14
1169,79,63,84,32,-0.26207961273964153,31
1170,86,32,65,16,-0.29216142987075866,16
1171,30,23,2,11,-0.29321348863964564,12
1172,28,37,48,20,-0.3045575028463844,17
1173,41,14,19,6,-0.30768619148938214,8
1174,10,27,111,13,-0.3114645815059003,14
1175,91,17,49,8,-0.32854883058107764,9
1176,43,16,98,8,-0.334919329248079,8
1177,6,19,86,10,-0.36002907163374687,9
1178,98,28,48,14,-0.36404245012326253,14
1179,50,10,44,5,-0.37049181398411835,5
1180,106,16,38,8,-0.3769795206766502,8
1181,90,30,65,14,-0.37730681884186645,16
1182,2,33,87,16,-0.3826308025892905,17
1183,85,13,41,7,-0.3897097634286919,6
1184,8,69,111,33,-0.39678371929634243,36
1185,55,16,93,8,-0.3989746125575646,8
1186,86,38,54,19,-0.4122039961290728,19
1187,79,14,109,7,-0.42130275303052045,7
1188,98,41,9,23,-0.42442483569339234,18
1189,93,33,98,17,-0.42494814400300696,16
1190,48,37,9,17,-0.43213737112675804,20
1191,51,22,28,11,-0.44446843006512377,11
1192,70,20,37,10,-0.46627884399361397,10
1193,94,10,32,5,-0.4833955664376234,5
1194,18,12,88,6,-0.4864002858281247,6
1195,55,25,107,12,-0.49082237211228164,13
1196,84,63,79,32,-0.49430559748022673,31
1197,98,13,46,7,-0.494901676337354,6
1198,2,32,54,17,-0.4972568733461067,15
1199,73,13,91,8,-0.5133686150476421,5
1200,20,23,110,11,-0.5195268671329448,12
1201,84,64,8,32,-0.522707927820123,32
1202,86,18,90,8,-0.530984332272809,10
1203,41,13,66,6,-0.5347435341536495,7
1204,49,22,107,12,-0.5403853948936642,10
1205,62,22,2,12,-0.5462872756743683,10
1206,37,18,10,10,-0.5468156041706485,8
1207,111,17,89,8,-0.556363390465831,9
1208,91,26,54,11,-0.5702688984859479,15
1209,103,18,48,9,-0.590370639924845,9
1210,101,20,98,9,-0.5948708647764195,11
1211,23,33,79,18,-0.5991196107820859,15
1212,86,49,28,23,-0.6040031697342569,26
1213,38,18,62,9,-0.6043816495722345,9
1214,29,22,55,10,-0.6081230859687949,12
1215,107,27,54,14,-0.6094655853046702,13
1216,44,18,91,10,-0.6160976329615553,8
1217,63,13,74,7,-0.6231938435062153,6
1218,48,21,10,10,-0.6314146317442528,11
1219,41,39,74,18,-0.640642509011156,21
1220,30,10,32,5,-0.6490824873820789,5
1221,29,20,103,10,-0.6578144863835312,10
1222,20,13,76,6,-0.6610311160325401,7
1223,93,24,6,12,-0.662762996898009,12
1224,86,23,91,12,-0.6661452371009026,11
1225,16,12,44,5,-0.6740631728235359,7
1226,101,15,23,7,-0.6750621504160544,8
1227,8,64,84,33,-0.6829085676002623,31
1228,57,11,54,6,-0.683890110225914,5
1229,70,21,9,10,-0.6947320940904097,11
1230,5,16,28,9,-0.7047026546051018,7
1231,65,12,51,6,-0.7082823610974588,6
1232,32,24,87,11,-0.723654834631157,13
1233,74,42,87,23,-0.7245745938864455,19
1234,8,74,28,38,-0.7247337736161,36
1235,74,17,50,9,-0.7251672527310556,8
1236,62,18,6,8,-0.7348526325115939,10
1237,65,31,104,18,-0.7351510467171638,13
1238,10,12,46,6,-0.7362386600396065,6
1239,23,23,107,12,-0.7397315330825399,11
1240,73,11,37,6,-0.7437455399697719,5
1241,104,10,90,4,-0.7461340238107453,6
1242,84,46,74,24,-0.7518721095348248,22
1243,87,17,112,8,-0.7591685884445006,9
1244,104,19,16,10,-0.7751562090941393,9
1245,65,21,85,12,-0.7821322420670123,9
1246,74,17,85,9,-0.8095598497605868,8
1247,98,47,70,24,-0.8130313901104015,23
1248,10,23,87,13,-0.8212452099335924,10
1249,55,11,57,5,-0.8315236951519509,6
1250,91,21,29,10,-0.8357535316372816,11
1251,32,17,49,9,-0.8453605230907211,8
1252,38,18,91,10,-0.8605561818804589,8
1253,79,12,5,5,-0.8638337222987221,7
1254,30,27,79,13,-0.8682684018403974,14
1255,18,12,29,5,-0.8741742779448094,7
1256,30,10,76,5,-0.8754609075341481,5
1257,65,21,62,12,-0.8755953834255741,9
1258,98,42,17,22,-0.896764910757158,20
1259,93,30,20,17,-0.8968767950978295,13
1260,111,29,18,15,-0.9151185639276579,14
1261,9,11,60,5,-0.9156618531106686,6
1262,89,12,103,7,-0.9245541578032253,5
1263,16,16,51,9,-0.9254181289183445,7
1264,9,19,85,11,-0.9266510351352133,8
1265,107,23,93,12,-0.9535678875740138,11
1266,50,13,88,7,-0.9566497736445115,6
1267,49,28,84,14,-0.9573548536710035,14
1268,15,11,10,5,-0.9620268464624092,6
1269,16,10,68,5,-0.9723777343104946,5
1270,68,16,111,9,-0.9831903657030906,7
1271,30,16,41,8,-0.9850557086879017,8
1272,91,23,20,11,-0.9903622576025491,12
1273,94,11,79,6,-0.9998691980069959,5
1274,41,33,70,17,-1.0073100144887814,16
1275,88,43,8,23,-1.0100497036874514,20
1276,41,13,75,7,-1.0160682715228835,6
1277,28,38,30,20,-1.0308418375547221,18
1278,76,28,9,14,-1.034161557811218,14
1279,103,10,75,5,-1.035188460357086,5
1280,112,10,8,5,-1.0357746876565699,5
1281,62,16,74,7,-1.0383577563740003,9
1282,91,13,17,7,-1.0470112494613972,6
1283,89,13,6,6,-1.0487640819634654,7
1284,28,64,84,33,-1.0495091480081138,31
1285,79,66,98,32,-1.0629583697982146,34
1286,103,15,76,9,-1.0648910249315973,6
1287,88,29,28,16,-1.0651097674029202,13
1288,73,20,103,10,-1.0728746625988024,10
1289,6,22,112,11,-1.0749917782912326,11
1290,48,17,88,7,-1.090337963546454,10
1291,84,42,6,22,-1.1025381642551555,20
1292,28,16,73,7,-1.102601583168377,9
1293,56,10,16,6,-1.1063673005412131,4
1294,62,20,88,10,-1.1096322170107622,10
1295,88,22,23,12,-1.1194514842315604,10
1296,88,20,2,11,-1.1196863075510506,9
1297,34,18,50,8,-1.1483521913828947,10
1298,8,51,70,25,-1.157848179260109,26
1299,41,80,65,38,-1.162711714387654,42
1300,6,34,9,18,-1.1647790866636063,16
1301,1,10,103,4,-1.178228962480731,6
1302,63,10,111,5,-1.1830016075807657,5
1303,84,31,107,16,-1.1883174819228042,15
1304,111,49,98,25,-1.1971941446177512,24
1305,107,36,111,18,-1.1978257080625474,18
1306,28,31,29,16,-1.2120053417862247,15
1307,55,24,49,10,-1.2120144426699921,14
1308,107,31,84,16,-1.2210869288992972,15
1309,87,33,2,18,-1.222629885484021,15
1310,84,20,51,11,-1.2338435261234795,9
1311,91,28,107,14,-1.2435079650119625,14
1312,84,36,87,19,-1.2473160473972953,17
1313,65,30,17,15,-1.2597701896564553,15
1314,28,30,90,16,-1.270922400618029,14
1315,79,79,65,40,-1.27335297823569,39
1316,79,39,91,21,-1.2807830144337706,18
1317,107,18,10,10,-1.302641998274499,8
1318,110,15,87,8,-1.307657393135164,7
1319,74,31,20,16,-1.3078088890253396,15
1320,103,47,84,26,-1.3117535282727075,21
1321,57,13,98,6,-1.3243405021868624,7
1322,55,22,48,12,-1.3259791997893813,10
1323,28,74,8,38,-1.3260475837033556,36
1324,65,70,84,35,-1.3269531130271437,35
1325,32,14,23,6,-1.3629901576062295,8
1326,59,16,41,9,-1.3704315284875221,7
1327,23,15,76,7,-1.3791825091008199,8
1328,8,13,44,8,-1.3823607495686732,5
1329,15,18,54,9,-1.402367436616189,9
1330,111,31,88,17,-1.4213124620809878,14
1331,3,10,65,5,-1.425825292351591,5
1332,65,80,41,44,-1.4259190406310245,36
1333,75,14,111,6,-1.4265352540751037,8
1334,107,23,18,13,-1.4296389206294247,10
1335,28,24,62,14,-1.4300815186163431,10
1336,112,11,109,6,-1.4303792106135154,5
1337,84,20,30,10,-1.4310903292079922,10
1338,57,10,103,4,-1.43349293747094,6
1339,20,13,90,6,-1.4684862703100507,7
1340,85,12,103,7,-1.505235765059642,5
1341,6,14,50,8,-1.5219443856325081,6
1342,74,50,28,27,-1.5230965628089277,23
1343,38,12,85,6,-1.5317416798467212,6
1344,6,18,62,11,-1.5340589440321593,7
1345,86,26,107,14,-1.5423744984021162,12
1346,86,47,79,25,-1.5443512194680482,22
1347,41,12,106,6,-1.558979631543201,6
1348,8,24,34,11,-1.5596726153138405,13
1349,94,11,2,6,-1.566847919784111,5
1350,65,28,73,15,-1.57299029079684,13
1351,29,16,16,9,-1.5836522711307057,7
1352,16,37,54,19,-1.6100995822446793,18
1353,90,18,10,10,-1.612631742744166,8
1354,79,16,57,9,-1.6225267683647033,7
1355,87,44,111,23,-1.641789170650758,21
1356,10,50,79,29,-1.6576142605157707,21
1357,23,18,57,10,-1.6948872060166507,8
1358,2,50,79,27,-1.6951484119487967,23
1359,18,13,20,7,-1.69876804268239,6
1360,76,11,38,6,-1.6999072226365548,5
1361,84,38,54,21,-1.7047651310078138,17
1362,79,27,30,15,-1.7226479429249024,12
1363,45,10,76,5,-1.7263356630732685,5
1364,16,16,29,8,-1.7271978980205005,8
1365,75,13,87,6,-1.7332300811803312,7
1366,103,29,16,15,-1.735855100464721,14
1367,65,18,71,9,-1.7385086790308772,9
1368,38,35,107,18,-1.7434138897292857,17
1369,109,10,57,6,-1.7866317267766754,4
1370,41,10,94,5,-1.7939224836809735,5
1371,76,13,85,8,-1.8000085206097036,5
1372,86,54,8,29,-1.805172264374073,25
1373,18,11,85,7,-1.8067340182792189,4
1374,70,28,54,14,-1.8203613101635243,14
1375,84,19,90,10,-1.8307456952070555,9
1376,79,12,35,7,-1.8379035956261767,5
1377,107,23,90,11,-1.8399920811097439,12
1378,98,19,73,10,-1.851371729787623,9
1379,8,67,98,36,-1.8537292484745975,31
1380,37,57,84,29,-1.861625432755028,28
1381,112,17,54,9,-1.8715662937888236,8
1382,30,21,74,10,-1.8748715955653132,11
1383,88,18,91,10,-1.8878660605312692,8
1384,51,11,104,6,-1.8967247284241764,5
1385,103,14,70,8,-1.9027941936339994,6
1386,61,11,41,6,-1.9034780148497894,5
1387,17,10,76,6,-1.9048948605366014,4
1388,37,22,6,11,-1.9187411338779805,11
1389,73,22,87,11,-1.9187809773134346,11
1390,13,20,65,9,-1.9236367618157104,11
1391,6,24,76,12,-1.937944044447951,12
1392,37,37,28,20,-1.9409348825611594,17
1393,65,33,37,18,-1.9483360284193356,15
1394,23,18,54,10,-1.9726565822582198,8
1395,91,22,16,12,-1.9766947043058665,10
1396,29,11,49,7,-1.9792119029563418,4
1397,37,13,103,7,-1.9837820518429876,6
1398,41,16,34,9,-1.9846654519938336,7
1399,71,10,37,6,-1.9896037058196856,4
1400,74,55,98,28,-2.008567476708278,27
1401,48,37,28,18,-2.0107314103123723,19
1402,9,30,10,15,-2.0135222581265264,15
1403,87,30,23,17,-2.017190252474381,13
1404,74,17,90,9,-2.030135359930969,8
1405,26,14,73,8,-2.0368384601286986,6
1406,98,52,38,28,-2.0498657703552294,24
1407,26,30,9,17,-2.052887996849143,13
1408,10,18,91,10,-2.0539203960339205,8
1409,34,15,6,7,-2.0594698658943718,8
1410,84,19,32,11,-2.0621508690380304,8
1411,65,48,6,23,-2.0707038416036956,25
1412,104,16,9,9,-2.0746206420840276,7
1413,48,19,13,12,-2.0777118977088573,7
1414,90,17,74,9,-2.0848494229315673,8
1415,84,18,75,10,-2.0937199255326187,8
1416,73,14,55,7,-2.100075433191031,7
1417,48,31,76,17,-2.1194903112888834,14
1418,1,11,84,6,-2.126446677126287,5
1419,1,15,87,7,-2.138632690920939,8
1420,111,44,84,25,-2.1422526544855915,19
1421,17,42,98,22,-2.1560402623618153,20
1422,32,10,18,5,-2.1572241092213575,5
1423,15,11,9,6,-2.1575516880448644,5
1424,107,40,98,22,-2.1579093706359798,18
1425,28,19,44,12,-2.1816767204067156,7
1426,49,14,93,7,-2.185400146226671,7
1427,55,12,70,6,-2.187109058776333,6
1428,79,50,2,26,-2.19000865291695,24
1429,65,62,87,34,-2.2105235873065796,28
1430,65,30,90,17,-2.2173212695918445,13
1431,54,15,73,8,-2.217586045542855,7
1432,8,14,14,8,-2.2189602603742733,6
1433,35,11,48,6,-2.2199820326075046,5
1434,58,11,8,5,-2.2258955118772117,6
1435,8,42,6,23,-2.2311016569027053,19
1436,16,37,48,19,-2.241700831069552,18
1437,55,30,84,16,-2.2432370502927133,14
1438,20,15,17,7,-2.251306099354639,8
1439,50,14,6,7,-2.2618843791117285,7
1440,9,40,37,22,-2.262801557650182,18
1441,32,18,62,9,-2.2636867699003225,9
1442,32,13,20,7,-2.2751108005385445,6
1443,93,15,86,8,-2.27742866968356,7
1444,103,37,23,19,-2.3239729626949814,18
1445,29,39,65,23,-2.326033904196744,16
1446,86,11,104,6,-2.3312767847407865,5
1447,91,39,79,20,-2.3358480667678583,19
1448,16,14,63,7,-2.3500753449010636,7
1449,111,69,8,39,-2.351715592504463,30
1450,43,23,41,13,-2.3652994967791563,10
1451,107,21,16,11,-2.3719183322672905,10
1452,35,18,76,11,-2.4023433325283063,7
1453,57,16,79,8,-2.4270888358529543,8
1454,65,88,8,50,-2.4296314593857904,38
1455,50,16,18,8,-2.4351075330006164,8
1456,79,24,85,12,-2.448715961670296,12
1457,38,40,41,21,-2.4535603181412866,19
1458,55,10,104,5,-2.4573621172912743,5
1459,29,27,6,14,-2.45903121181426,13
1460,93,13,16,7,-2.460583316835962,6
1461,9,44,103,21,-2.4769487250437585,23
1462,29,20,2,11,-2.477941203005181,9
1463,62,15,37,8,-2.4789476689639174,7
1464,107,29,74,16,-2.481204573011676,13
1465,62,17,16,9,-2.4884740684398885,8
1466,48,27,87,14,-2.5191744108160026,13
1467,98,50,16,28,-2.5197213230509203,22
1468,29,19,50,11,-2.525141516354553,8
1469,54,52,98,26,-2.529015499138276,26
1470,70,33,41,17,-2.5290882561404504,16
1471,34,11,23,5,-2.5306742696464353,6
1472,111,27,10,15,-2.561286831397376,12
1473,109,25,2,15,-2.5641635343710636,10
1474,49,22,54,13,-2.5713540483950825,9
1475,107,25,55,15,-2.584454892774184,10
1476,65,37,76,21,-2.585450948736576,16
1477,112,20,38,11,-2.5875581099779774,9
1478,50,11,70,5,-2.626702900417428,6
1479,111,26,23,15,-2.6303992386646597,11
1480,107,13,30,8,-2.632697525096665,5
1481,107,12,85,8,-2.6471438550645616,4
1482,30,25,111,13,-2.6528736151948067,12
1483,65,39,107,23,-2.657495022575693,16
1484,8,14,15,7,-2.6593953269851673,7
1485,88,20,86,12,-2.6598697754609466,8
1486,98,49,111,27,-2.661784450073085,22
1487,111,13,43,8,-2.669621436422116,5
1488,43,17,107,9,-2.670387525820163,8
1489,93,19,88,8,-2.677402138703952,11
1490,84,40,50,21,-2.678203056237392,19
1491,90,39,79,23,-2.6906940404909006,16
1492,20,39,54,22,-2.705144386741404,17
1493,88,79,65,44,-2.710813449129251,35
1494,50,38,8,20,-2.7166843374091876,18
1495,87,25,62,14,-2.7185367714166615,11
1496,10,30,9,17,-2.725511572413539,13
1497,30,14,26,5,-2.7295268644643054,9
1498,29,14,23,8,-2.732572073895786,6
1499,28,21,34,12,-2.734662710408204,9
1500,90,31,98,16,-2.735368995859913,15
1501,79,50,10,24,-2.746120922049544,26
1502,65,52,55,32,-2.7542384607166874,20
1503,10,11,88,6,-2.7587208354368746,5
1504,79,32,54,17,-2.7695929923739913,15
1505,12,11,8,6,-2.8009343879230215,5
1506,34,17,29,8,-2.8011697136542715,9
1507,107,15,63,9,-2.8021473545431568,6
1508,65,55,38,30,-2.806589910357459,25
1509,17,30,65,17,-2.836779237291186,13
1510,16,35,23,19,-2.843088725081075,16
1511,18,29,111,16,-2.859497108899379,13
1512,29,31,98,16,-2.8666453310461617,15
1513,13,11,55,6,-2.867532212513363,5
1514,28,15,46,8,-2.8691534505866247,7
1515,111,30,90,17,-2.89054471305433,13
1516,8,14,63,8,-2.911233669474753,6
1517,20,23,91,13,-2.91310351812833,10
1518,87,10,68,5,-2.918596255497213,5
1519,48,18,18,10,-2.9186933860892377,8
1520,41,36,29,19,-2.9244119186735795,17
1521,54,44,74,22,-2.926291357510124,22
1522,107,22,49,11,-2.938323040228233,11
1523,76,15,23,9,-2.940407468731348,6
1524,16,59,79,33,-2.9582358951791488,26
1525,96,12,79,6,-2.973342456278541,6
1526,98,23,13,15,-2.9928471993749595,8
1527,89,16,26,8,-3.0015441091670585,8
1528,8,11,12,6,-3.0172474302587955,5
1529,16,18,38,9,-3.0174584469144037,9
1530,44,14,9,6,-3.0418979222799787,8
1531,10,18,107,9,-3.050193716172087,9
1532,55,36,79,18,-3.061173945532678,18
1533,87,67,8,38,-3.0622559373249376,29
1534,48,17,63,9,-3.0841106882866245,8
1535,75,19,8,10,-3.0842682640793213,9
1536,79,56,41,30,-3.1072129437235954,26
1537,50,27,54,16,-3.107516274798209,11
1538,17,15,20,9,-3.1232806552580437,6
1539,88,29,79,18,-3.124876625192895,11
1540,98,10,106,6,-3.1299996913347967,4
1541,38,36,79,20,-3.1386740959807797,16
1542,90,10,1,5,-3.14882035881255,5
1543,16,19,50,10,-3.1594632722429505,9
1544,46,20,6,12,-3.1751885941082603,8
1545,37,13,91,7,-3.1893915884876662,6
1546,41,17,88,9,-3.1907658333962816,8
1547,86,19,23,10,-3.216916872797102,9
1548,26,37,79,21,-3.2224103393223973,16
1549,85,11,49,6,-3.234049059231714,5
1550,87,15,1,9,-3.235954063691745,6
1551,18,15,76,9,-3.237191989649946,6
1552,6,24,93,13,-3.240702778832872,11
1553,88,25,107,13,-3.2653147048802107,12
1554,98,11,59,6,-3.2664563544762517,5
1555,85,18,8,9,-3.274345405108027,9
1556,85,14,54,7,-3.275456701825405,7
1557,85,17,74,9,-3.280838878179328,8
1558,9,76,84,44,-3.28713617928,32
1559,74,27,26,15,-3.318872656585847,12
1560,28,49,55,29,-3.3237508282969777,20
1561,18,23,107,12,-3.3296591016307526,11
1562,84,21,91,12,-3.3334541794661074,9
1563,5,11,8,5,-3.340378827592629,6
1564,28,22,51,12,-3.3441861551037495,10
1565,8,26,29,14,-3.3557915076756832,12
1566,23,20,91,11,-3.3618813048957485,9
1567,6,18,49,10,-3.361990920437636,8
1568,8,25,30,15,-3.372713221209324,10
1569,85,14,2,7,-3.3798876085075156,7
1570,13,14,76,7,-3.383197454645703,7
1571,91,14,57,9,-3.387917143764696,5
1572,37,57,79,33,-3.393777413566036,24
1573,28,32,32,18,-3.3937812746244553,14
1574,37,32,48,17,-3.3973368766785703,15
1575,6,12,57,8,-3.4000169565132334,4
1576,28,54,111,30,-3.413874283084288,24
1577,91,10,5,4,-3.4255398118724374,6
1578,86,34,98,20,-3.4263911267965415,14
1579,8,18,51,10,-3.451831063610333,8
1580,20,31,74,17,-3.4627659895235983,14
1581,91,12,48,7,-3.4664297594725237,5
1582,76,21,111,10,-3.4688639491076154,11
1583,107,28,91,16,-3.470162400396327,12
1584,55,14,1,8,-3.472860068937083,6
1585,55,10,51,6,-3.4788515156123387,4
1586,28,35,20,21,-3.497130895377864,14
1587,41,49,16,26,-3.501070366837183,23
1588,10,60,8,32,-3.5040882588587823,28
1589,18,55,28,30,-3.5048718464168536,25
1590,94,13,65,7,-3.505690987614661,6
1591,54,24,48,15,-3.5146028862617045,9
1592,26,33,111,19,-3.5276889460712058,14
1593,49,18,79,11,-3.5482844650415624,7
1594,8,28,73,17,-3.5539511566695987,11
1595,38,25,50,14,-3.5687465201033057,11
1596,23,15,101,9,-3.591604516250614,6
1597,18,12,10,8,-3.6042571144804363,4
1598,112,10,98,5,-3.634369737429611,5
1599,73,22,20,12,-3.6521774474687554,10
1600,65,17,57,11,-3.66200460796526,6
1601,65,12,106,7,-3.6637536933904076,5
1602,89,14,48,8,-3.663870491648256,6
1603,86,23,50,14,-3.666745079717447,9
1604,54,61,8,33,-3.6956578516121175,28
1605,62,15,91,8,-3.707999769375562,7
1606,10,14,32,9,-3.709056496740224,5
1607,87,10,60,5,-3.716219490276847,5
1608,38,22,84,13,-3.721558072111377,9
1609,41,16,48,9,-3.723395209925695,7
1610,30,12,48,7,-3.7343899451682225,5
1611,10,34,65,19,-3.7403807843221304,15
1612,28,11,14,7,-3.7514049814029207,4
1613,28,69,65,39,-3.7517616974629986,30
1614,18,12,57,8,-3.7525453734501912,4
1615,73,15,79,8,-3.780403758532128,7
1616,110,11,26,5,-3.781495457699158,6
1617,103,12,110,7,-3.784927459031115,5
1618,18,15,93,8,-3.8000555745474087,7
1619,98,16,43,9,-3.8123705589147328,7
1620,91,14,32,7,-3.8253106560348464,7
1621,79,60,28,30,-3.8255911798624993,30
1622,29,21,91,12,-3.840820511726981,9
1623,18,18,41,11,-3.84366102932153,7
1624,9,10,106,6,-3.8491129304664526,4
1625,49,14,38,7,-3.8551286140805963,7
1626,86,20,51,11,-3.863362217006626,9
1627,50,10,20,6,-3.866423191070092,4
1628,17,11,55,6,-3.8840410393606315,5
1629,84,47,98,26,-3.8908337456526567,21
1630,2,26,91,15,-3.8971597312680113,11
1631,54,16,94,8,-3.897800639878564,8
1632,9,30,26,15,-3.917115924375875,15
1633,74,22,43,13,-3.9345782455697673,9
1634,112,10,91,5,-3.946754868280294,5
1635,2,63,28,35,-3.947282027853599,28
1636,73,22,6,11,-3.9476996189213933,11
1637,9,33,50,19,-3.9547022002179157,14
1638,8,40,91,21,-3.961945852137986,19
1639,20,20,112,10,-3.9655619093439842,10
1640,74,29,16,17,-3.974341734686631,12
1641,26,14,55,8,-3.9805474058369166,6
1642,10,13,104,7,-3.982341981798969,6
1643,37,26,87,13,-3.9965570187790043,13
1644,79,37,50,20,-4.0012957630104395,17
1645,79,33,23,17,-4.005580416521516,16
1646,86,50,84,27,-4.025784157753964,23
1647,103,50,79,29,-4.028559233170849,21
1648,28,58,98,31,-4.030600698284184,27
1649,88,11,10,6,-4.0314188677890535,5
1650,2,19,26,10,-4.041871884320681,9
1651,85,16,98,8,-4.042048861968959,8
1652,98,23,109,13,-4.0431120330253485,10
1653,71,15,84,8,-4.046997354452872,7
1654,10,32,16,18,-4.051397029804468,14
1655,10,41,2,24,-4.057775267216063,17
1656,88,32,55,20,-4.0638895500328625,12
1657,2,63,8,33,-4.075797689905299,30
1658,9,36,2,19,-4.08389169356919,17
1659,2,63,98,35,-4.0864521676034835,28
1660,84,19,14,13,-4.105576202233761,6
1661,98,39,37,22,-4.11677597890711,17
1662,10,16,103,9,-4.145748166667432,7
1663,2,15,37,8,-4.14722052773026,7
1664,54,22,49,11,-4.1489680408498595,11
1665,91,23,65,11,-4.15010120900014,12
1666,50,37,28,21,-4.164740256251371,16
1667,32,16,2,9,-4.169077635966493,7
1668,9,26,62,15,-4.200068098711876,11
1669,37,37,16,23,-4.21114707700778,14
1670,91,14,109,7,-4.213752581267606,7
1671,8,24,104,15,-4.217796324401938,9
1672,90,18,86,11,-4.223509495637682,7
1673,6,24,23,13,-4.230313442640459,11
1674,79,47,6,27,-4.237391580830745,20
1675,8,11,97,7,-4.238412616249588,4
1676,49,13,18,7,-4.243576516469454,6
1677,98,39,6,23,-4.250381101594533,16
1678,46,24,74,12,-4.250765743447537,12
1679,55,44,111,24,-4.253083069824154,20
1680,103,35,107,20,-4.274205878998454,15
1681,48,15,85,9,-4.305363268792187,6
1682,84,22,57,13,-4.307342730462738,9
1683,41,39,26,18,-4.308213459712551,21
1684,1,20,41,13,-4.310885836842604,7
1685,90,13,20,8,-4.319530234657456,5
1686,26,27,74,15,-4.321080857814067,12
1687,74,31,2,17,-4.326298290158694,14
1688,30,22,91,11,-4.330777519237086,11
1689,3,17,54,9,-4.336905078418528,8
1690,44,13,79,7,-4.356415433762269,6
1691,2,11,57,7,-4.360321050424336,4
1692,107,43,87,26,-4.366588065151469,17
1693,94,11,87,6,-4.375015437142172,5
1694,1,10,90,6,-4.375601097645208,4
1695,89,13,54,8,-4.375934710162814,5
1696,104,15,107,9,-4.384096889948017,6
1697,41,36,50,20,-4.39168406813968,16
1698,50,11,75,7,-4.392668801200932,4
1699,41,36,84,22,-4.405400183867785,14
1700,20,19,43,10,-4.407702920435093,9
1701,103,20,73,11,-4.408542656876506,9
1702,13,10,90,5,-4.435057658973358,5
1703,2,18,90,10,-4.440452857575481,8
1704,79,20,29,11,-4.446531848215205,9
1705,58,16,98,8,-4.454073647186219,8
1706,84,23,73,15,-4.463513313785124,8
1707,110,23,20,13,-4.46357978693552,10
1708,15,25,111,15,-4.472513123100842,10
1709,29,21,111,10,-4.484029622528673,11
1710,20,26,6,13,-4.48657288665595,13
1711,93,21,29,12,-4.498959392246701,9
1712,62,11,29,6,-4.502398822563125,5
1713,6,27,29,15,-4.503478704943507,12
1714,93,28,79,14,-4.503897640777635,14
1715,23,40,41,23,-4.507259861409941,17
1716,93,29,111,15,-4.510765206652467,14
1717,85,11,18,5,-4.514791288537011,6
1718,74,15,32,9,-4.519404747582117,6
1719,109,26,65,13,-4.522732343847644,13
1720,23,24,74,13,-4.530539923458647,11
1721,51,10,2,5,-4.541060117126738,5
1722,98,43,20,25,-4.552220105497898,18
1723,57,15,87,8,-4.5524099729129395,7
1724,89,20,9,13,-4.555028073124964,7
1725,37,13,46,7,-4.568700097838745,6
1726,15,10,86,5,-4.603054673648832,5
1727,54,27,87,15,-4.613822779482278,12
1728,9,49,111,26,-4.631532876714527,23
1729,2,20,29,11,-4.659724574406296,9
1730,9,76,79,43,-4.699969329384482,33
1731,29,35,87,20,-4.710088352572669,15
1732,93,19,109,11,-4.710552248323455,8
1733,9,30,90,17,-4.717832744642908,13
1734,65,41,23,23,-4.770740161452314,18
1735,28,37,23,21,-4.773448036217731,16
1736,104,10,111,6,-4.78538385386756,4
1737,103,33,50,19,-4.789964024048163,14
1738,30,11,17,6,-4.793161472453949,5
1739,18,11,86,6,-4.795064637153174,5
1740,109,11,89,6,-4.829014520032646,5
1741,13,13,103,7,-4.835710066696813,6
1742,111,60,79,36,-4.845673626000181,24
1743,98,25,30,16,-4.849081372286935,9
1744,76,13,104,7,-4.853899950951066,6
1745,8,61,74,35,-4.861231025934779,26
1746,76,26,87,15,-4.892551999966174,11
1747,20,30,93,15,-4.900735470483163,15
1748,5,11,65,6,-4.901615377921411,5
1749,20,51,87,29,-4.928957222630361,22
1750,6,15,34,9,-4.930033055320858,6
1751,103,11,46,6,-4.934914439873031,5
1752,20,37,111,20,-4.9479559141790075,17
1753,111,36,107,21,-4.95140635788508,15
1754,59,10,10,5,-4.967497448599415,5
1755,86,20,41,11,-4.968122887256159,9
1756,20,10,89,6,-4.97640303815121,4
1757,54,17,62,10,-5.001633115691913,7
1758,32,20,55,12,-5.0109481732467795,8
1759,84,15,89,10,-5.0152693534373975,5
1760,1,17,16,9,-5.031673674933401,8
1761,43,13,111,7,-5.0327903736846205,6
1762,54,58,65,32,-5.034371936668328,26
1763,73,20,16,11,-5.0706587833744905,9
1764,41,16,59,9,-5.075333393683101,7
1765,49,17,32,9,-5.084232180469871,8
1766,2,28,107,16,-5.101731059055636,12
1767,49,21,28,13,-5.11072806296806,8
1768,18,21,103,12,-5.117263308095348,9
1769,89,29,41,17,-5.128070897369619,12
1770,17,12,54,7,-5.132650672697679,5
1771,20,47,8,28,-5.13696712403145,19
1772,87,26,103,15,-5.13844337309213,11
1773,52,10,98,5,-5.141825899051739,5
1774,87,32,16,19,-5.155343305225084,13
1775,57,15,16,8,-5.174682414292543,7
1776,84,39,23,22,-5.174802875601986,17
1777,57,10,111,6,-5.186942618450885,4
1778,9,106,65,61,-5.210618625384625,45
1779,48,47,8,27,-5.2358326394808055,20
1780,111,10,1,5,-5.238983537325088,5
1781,76,35,16,19,-5.241687687334296,16
1782,65,71,93,41,-5.253531432442059,30
1783,89,12,50,7,-5.253704218444141,5
1784,85,15,63,8,-5.266282773446651,7
1785,2,33,50,20,-5.273652216296242,13
1786,103,30,17,18,-5.294404276815358,12
1787,16,20,90,11,-5.309705496674622,9
1788,55,20,86,10,-5.332288648397898,10
1789,8,23,90,14,-5.338168133162711,9
1790,84,21,29,12,-5.340667565501357,9
1791,9,47,87,27,-5.350758253257081,20
1792,106,15,8,8,-5.356587228673996,7
1793,6,13,89,8,-5.362805216014631,5
1794,41,66,8,36,-5.383353261881381,30
1795,28,10,19,6,-5.405282356849322,4
1796,41,35,73,20,-5.413974250069213,15
1797,38,26,20,15,-5.422962328602488,11
1798,20,18,94,11,-5.424401699040208,7
1799,23,16,109,10,-5.438260955948294,6
1800,76,39,84,20,-5.438513858870126,19
1801,9,27,13,17,-5.440810272043136,10
1802,87,27,49,14,-5.451792030762737,13
1803,38,25,30,13,-5.45936332609693,12
1804,9,10,14,7,-5.463439437022661,3
1805,87,20,90,13,-5.4648990682068606,7
1806,15,15,65,8,-5.468158414216741,7
1807,73,21,74,12,-5.49643746893769,9
1808,85,12,107,5,-5.501246863309672,7
1809,34,16,107,9,-5.514558906998724,7
1810,2,10,46,6,-5.541906116456114,4
1811,48,35,6,20,-5.544547995709246,15
1812,55,19,74,10,-5.544677661719653,9
1813,97,11,28,5,-5.54697078214519,6
1814,98,31,87,19,-5.565208502801091,12
1815,48,14,49,7,-5.572044813615613,7
1816,55,24,103,14,-5.588813975862993,10
1817,57,11,86,6,-5.628641785626694,5
1818,29,22,26,14,-5.630548836449718,8
1819,48,16,2,8,-5.635246627200363,8
1820,9,45,41,28,-5.6439057397283525,17
1821,86,37,9,21,-5.6454583600246036,16
1822,6,26,103,16,-5.659939287843899,10
1823,50,13,17,8,-5.662435030700867,5
1824,91,29,111,16,-5.664784285354977,13
1825,91,16,63,9,-5.6695484537306235,7
1826,9,13,43,7,-5.682535108763632,6
1827,51,11,18,6,-5.697627847770079,5
1828,20,15,37,9,-5.706089514776047,6
1829,65,23,89,13,-5.729458742490648,10
1830,55,14,26,8,-5.738748859328644,6
1831,37,20,90,12,-5.742590617036875,8
1832,9,29,38,16,-5.756435186772364,13
1833,28,15,75,8,-5.767432508412389,7
1834,9,24,49,15,-5.768934866939488,9
1835,79,14,51,8,-5.772506691008202,6
1836,50,27,55,17,-5.779208495041811,10
1837,54,18,32,11,-5.782610489553489,7
1838,73,14,26,7,-5.793757710550314,7
1839,94,12,8,7,-5.79404543544707,5
1840,87,23,38,14,-5.822358709545341,9
1841,8,37,37,21,-5.826102721509761,16
1842,44,10,2,6,-5.829723764491529,4
1843,10,31,98,18,-5.831587893507183,13
1844,48,10,107,6,-5.863597775104665,4
1845,16,17,17,10,-5.868342075872026,7
1846,16,33,55,20,-5.8951862667291755,13
1847,9,45,74,27,-5.903246001506488,18
1848,2,32,84,19,-5.92758837249606,13
1849,112,20,20,12,-5.92853113025916,8
1850,16,63,28,37,-5.938164248493271,26
1851,91,28,87,17,-5.954439761122977,11
1852,48,16,90,9,-5.9550343515423965,7
1853,10,25,89,15,-5.961935346068012,10
1854,49,23,8,13,-5.962799116224744,10
1855,62,10,86,4,-5.9629944894743,6
1856,34,10,17,6,-5.970863859166942,4
1857,23,18,2,10,-5.985551573396107,8
1858,107,76,8,44,-5.997933185484727,32
1859,77,10,49,5,-6.002993751357126,5
1860,91,18,38,10,-6.003578716041363,8
1861,2,11,94,6,-6.010461250553638,5
1862,91,48,98,26,-6.010481139866049,22
1863,98,27,26,14,-6.028495429489334,13
1864,62,36,8,21,-6.033809520555298,15
1865,98,13,63,7,-6.056134732306893,6
1866,89,25,79,16,-6.066359313406789,9
1867,74,38,111,22,-6.079631925271179,16
1868,38,34,54,21,-6.117390645115775,13
1869,56,11,111,7,-6.133528731729063,4
1870,88,23,87,15,-6.146478682205597,8
1871,20,16,86,9,-6.1727255465343465,7
1872,66,11,2,7,-6.205381429919995,4
1873,34,14,16,8,-6.229556768499603,6
1874,41,35,2,22,-6.231438093089563,13
1875,9,12,75,8,-6.239095019020707,4
1876,76,41,86,23,-6.239413694067728,18
1877,9,32,55,21,-6.253306035745025,11
1878,16,25,32,15,-6.270434527094816,10
1879,50,23,111,14,-6.270457745960824,9
1880,44,15,111,9,-6.2820016152004,6
1881,54,16,90,9,-6.290244829620479,7
1882,16,65,8,40,-6.3026234838834965,25
1883,111,30,2,18,-6.328590766591992,12
1884,73,18,86,11,-6.340120760849839,7
1885,84,30,20,19,-6.362668081835638,11
1886,28,10,31,6,-6.368565836830035,4
1887,88,22,103,14,-6.368772240906126,8
1888,6,39,54,26,-6.376058297510907,13
1889,37,22,30,14,-6.384018768768752,8
1890,8,74,55,46,-6.38460226074644,28
1891,70,24,28,13,-6.387367877038982,11
1892,39,10,65,6,-6.40523745473044,4
1893,74,36,79,23,-6.418996516558229,13
1894,28,14,12,9,-6.429365216940005,5
1895,8,10,112,6,-6.439047583949824,4
1896,62,10,90,6,-6.4415032468905995,4
1897,88,16,20,10,-6.450213485704791,6
1898,48,32,65,19,-6.477954122109943,13
1899,48,11,23,6,-6.485113687277626,5
1900,8,35,32,20,-6.494741280760348,15
1901,28,34,103,20,-6.496510604338202,14
1902,18,25,87,16,-6.500921078177539,9
1903,62,13,17,8,-6.51109228837904,5
1904,88,26,74,17,-6.515151171646331,9
1905,88,37,16,24,-6.515823910267607,13
1906,70,14,103,7,-6.530155528635705,7
1907,57,18,23,10,-6.535348935161005,8
1908,88,27,9,16,-6.543398859483147,11
1909,86,34,87,20,-6.549812552171537,14
1910,6,19,30,13,-6.571810356539939,6
1911,66,12,84,7,-6.578044154096628,5
1912,79,22,17,13,-6.594638264229067,9
1913,18,48,8,29,-6.594687381789504,19
1914,18,21,16,13,-6.6099594156094685,8
1915,76,20,107,12,-6.61181954357389,8
1916,85,14,86,7,-6.640232602185863,7
1917,76,41,79,26,-6.641927270209355,15
1918,87,23,70,14,-6.643543273052479,9
1919,49,15,17,9,-6.655321673670166,6
1920,34,23,98,15,-6.664658670492527,8
1921,49,16,74,9,-6.6690338705923,7
1922,9,24,18,14,-6.669379438735331,10
1923,2,14,15,8,-6.68122325045803,6
1924,79,75,8,42,-6.683487118677582,33
1925,57,16,88,9,-6.698470388803919,7
1926,62,18,79,10,-6.706683341972167,8
1927,9,25,29,14,-6.70933512946719,11
1928,74,11,89,6,-6.714017548400364,5
1929,9,97,8,57,-6.714131985933656,40
1930,111,14,13,9,-6.729510456907126,5
1931,34,19,2,11,-6.729658072634228,8
1932,32,24,65,14,-6.740147619373065,10
1933,41,42,111,24,-6.742879314894576,18
1934,50,36,98,20,-6.748525889961948,16
1935,28,46,87,28,-6.771264575755612,18
1936,20,25,2,14,-6.800156386602417,11
1937,41,35,91,22,-6.801656465480553,13
1938,93,47,8,29,-6.803263671135738,18
1939,6,21,88,13,-6.808639243885848,8
1940,28,23,104,15,-6.811415227948639,8
1941,91,26,6,15,-6.823132237906975,11
1942,14,13,87,8,-6.836219880263253,5
1943,28,38,38,22,-6.8687841977025155,16
1944,63,10,88,6,-6.87340914266048,4
1945,16,11,15,7,-6.875773988595896,4
1946,87,11,89,7,-6.89032748453306,4
1947,74,12,57,8,-6.91760424242575,4
1948,17,14,90,8,-6.930186835428714,6
1949,37,15,55,9,-6.937691224090444,6
1950,68,10,73,6,-6.95394987102174,4
1951,50,27,107,17,-6.978239572703387,10
1952,101,11,79,6,-6.990861425930873,5
1953,104,21,79,14,-7.001432407845643,7
1954,6,19,90,11,-7.0034906221582,8
1955,6,10,51,7,-7.0035300376142064,3
1956,87,13,104,9,-7.011123913755369,4
1957,91,26,103,13,-7.011657257024809,13
1958,6,20,111,12,-7.01838566892247,8
1959,9,40,23,24,-7.023066131343451,16
1960,79,19,59,11,-7.0352036880537865,8
1961,34,12,55,8,-7.041774709364912,4
1962,9,48,54,29,-7.047371936283251,19
1963,28,37,91,23,-7.04770720595576,14
1964,34,15,87,9,-7.057985714791882,6
1965,13,10,10,5,-7.08154547770926,5
1966,62,14,104,9,-7.094567188746597,5
1967,89,16,16,10,-7.102664218068734,6
1968,103,20,29,12,-7.147753101442872,8
1969,32,16,103,10,-7.165401001930772,6
1970,28,39,6,24,-7.173092064659189,15
1971,6,11,5,7,-7.175117705775805,4
1972,98,40,23,25,-7.180366591070175,15
1973,34,13,111,7,-7.201437198359538,6
1974,29,19,54,13,-7.2088827987279975,6
1975,9,70,16,45,-7.210349491176785,25
1976,86,23,30,17,-7.211631009876049,6
1977,6,29,55,20,-7.216182147698299,9
1978,76,19,10,11,-7.223608714939963,8
1979,49,13,30,8,-7.228582193886497,5
1980,73,18,50,10,-7.241939960957099,8
1981,103,49,98,31,-7.248745608369252,18
1982,88,24,84,15,-7.256956915758404,9
1983,38,14,88,8,-7.257573306252311,6
1984,73,10,30,6,-7.2752412959190496,4
1985,70,15,23,9,-7.277989111704888,6
1986,68,24,8,14,-7.280502110476545,10
1987,94,16,9,9,-7.284482029205993,7
1988,20,13,13,9,-7.287197108459042,4
1989,41,44,87,25,-7.307077046689725,19
1990,28,45,107,25,-7.308415503431697,20
1991,10,21,54,13,-7.316914939103655,8
1992,9,35,73,21,-7.31762524261672,14
1993,28,42,93,25,-7.320077356490772,17
1994,103,16,10,9,-7.341759223830171,7
1995,65,14,43,8,-7.3477742435965085,6
1996,111,10,63,6,-7.375087282658117,4
1997,8,12,94,7,-7.380839863701195,5
1998,65,80,20,50,-7.401837775451882,30
1999,5,15,98,9,-7.40308817440165,6
2000,49,13,41,9,-7.40613906742907,4
2001,75,13,41,7,-7.41688145074682,6
2002,54,29,88,17,-7.418874182686384,12
2003,68,14,98,10,-7.427653338623123,4
2004,50,31,87,19,-7.429484842498572,12
2005,48,14,17,8,-7.444960593591363,6
2006,28,29,10,19,-7.458178088618773,10
2007,86,68,16,42,-7.459847425476164,26
2008,8,16,1,9,-7.473060523777063,7
2009,9,34,107,19,-7.482440310595418,15
2010,79,23,18,13,-7.489902589142591,10
2011,41,53,28,30,-7.494799478271726,23
2012,38,24,2,13,-7.498014725943601,11
2013,38,10,34,6,-7.513274255260262,4
2014,54,28,103,16,-7.519450232339535,12
2015,34,26,84,17,-7.521080186287478,9
2016,107,20,29,13,-7.525530619454991,7
2017,70,17,79,9,-7.531628680674292,8
2018,54,40,28,25,-7.5339699178468,15
2019,76,21,91,13,-7.538547355116531,8
2020,86,26,111,15,-7.599516330003592,11
2021,48,43,84,25,-7.630223766084297,18
2022,86,29,74,18,-7.646930643556196,11
2023,74,20,10,13,-7.659112863437717,7
2024,65,70,111,40,-7.692935034996462,30
2025,76,40,88,23,-7.693645081601591,17
2026,59,11,23,7,-7.703199044299859,4
2027,48,36,79,21,-7.721029685310526,15
2028,85,14,111,9,-7.729378570457982,5
2029,8,11,11,7,-7.7454110487603565,4
2030,74,19,17,11,-7.746897696537681,8
2031,109,13,29,8,-7.7648215544268036,5
2032,2,11,58,7,-7.801381373372695,4
2033,109,25,20,17,-7.80690748170692,8
2034,37,32,76,21,-7.820497576953574,11
2035,9,26,17,16,-7.831275179780667,10
2036,38,36,8,23,-7.848513446954377,13
2037,12,11,74,6,-7.881335923893619,5
2038,9,30,109,18,-7.889736540676633,12
2039,13,14,49,8,-7.890029815709072,6
2040,68,17,65,10,-7.94486932740305,7
2041,76,18,55,11,-7.9507324288399905,7
2042,29,13,10,8,-7.953877306686606,5
2043,18,26,98,16,-7.97184494616587,10
2044,37,12,109,7,-7.972273664149992,5
2045,86,14,32,8,-7.973587175462616,6
2046,8,40,23,25,-7.983032320771588,15
2047,34,16,41,9,-7.985588983079854,7
2048,46,12,29,8,-7.990068011062898,4
2049,41,15,90,9,-7.997737246515682,6
2050,86,11,1,7,-8.004187715591307,4
2051,28,37,76,22,-8.031633541184373,15
2052,79,45,87,27,-8.036990951026816,18
2053,111,34,16,19,-8.046487125961022,15
2054,74,11,13,7,-8.04867506694036,4
2055,13,12,6,7,-8.074590184679874,5
2056,10,15,30,10,-8.08039942607508,5
2057,54,32,93,22,-8.106367720057326,10
2058,9,14,19,8,-8.117304295019109,6
2059,87,22,30,14,-8.119510877690912,8
2060,62,15,76,7,-8.131608728723029,8
2061,43,23,8,14,-8.14423209940399,9
2062,106,18,79,10,-8.147257860665952,8
2063,20,16,16,9,-8.147746017528714,7
2064,8,29,17,18,-8.17510581548791,11
2065,98,29,49,17,-8.192506354783728,12
2066,84,60,16,37,-8.204376835222098,23
2067,94,13,28,8,-8.222371266039165,5
2068,16,10,26,6,-8.231874067384071,4
2069,17,14,111,8,-8.239799794462428,6
2070,9,33,20,22,-8.272596506781884,11
2071,58,12,65,6,-8.279172093518044,6
2072,41,18,76,11,-8.284971187696902,7
2073,65,52,74,33,-8.288743311827762,19
2074,84,19,17,12,-8.294099990413244,7
2075,59,17,9,11,-8.305936798720639,6
2076,65,46,63,28,-8.306125506100823,18
2077,109,33,8,20,-8.311226620633244,13
2078,112,22,6,13,-8.324396609331753,9
2079,2,48,16,30,-8.328366235740484,18
2080,103,45,41,31,-8.332714422601015,14
2081,35,10,8,6,-8.335806667410798,4
2082,9,36,91,22,-8.337030454552696,14
2083,84,11,104,7,-8.339235828654417,4
2084,63,20,84,12,-8.347628578121029,8
2085,70,10,20,7,-8.374580328727138,3
2086,65,14,1,9,-8.38534721300084,5
2087,93,23,23,13,-8.387201678617911,10
2088,23,19,90,12,-8.394839451243376,7
2089,89,11,90,7,-8.396796914570167,4
2090,91,16,93,10,-8.415373132469666,6
2091,87,17,43,11,-8.41719039009833,6
2092,10,21,73,14,-8.419335562342074,7
2093,1,21,98,14,-8.436557583367687,7
2094,85,26,84,14,-8.437491114567154,12
2095,76,51,8,32,-8.454951241681899,19
2096,84,31,93,20,-8.465363334016377,11
2097,56,13,8,9,-8.47665012859135,4
2098,70,25,16,17,-8.490955297661811,8
2099,103,24,26,14,-8.523036763842914,10
2100,9,25,32,16,-8.53109215537152,9
2101,62,18,41,11,-8.537234992782361,7
2102,10,18,93,12,-8.563863748489084,6
2103,76,24,54,14,-8.571167297040507,10
2104,86,40,37,24,-8.603825624585157,16
2105,54,18,46,12,-8.62832740448409,6
2106,28,25,13,17,-8.630486148809299,8
2107,71,10,54,7,-8.658299695148916,3
2108,109,18,34,11,-8.66273498003356,7
2109,88,23,37,15,-8.667790010971713,8
2110,20,15,34,10,-8.68693105656746,5
2111,6,27,16,16,-8.696725649896711,11
2112,37,23,23,15,-8.700238300329007,8
2113,37,26,54,18,-8.701915458664551,8
2114,75,16,79,11,-8.729196308002651,5
2115,20,35,55,21,-8.738108987978196,14
2116,38,15,32,10,-8.75452405688887,5
2117,91,26,2,15,-8.783750173530157,11
2118,20,53,41,35,-8.79255140026366,18
2119,70,17,30,11,-8.80265868738281,6
2120,85,11,10,6,-8.810276618143424,5
2121,16,15,30,10,-8.81682691935629,5
2122,79,26,32,17,-8.859137187931584,9
2123,94,17,98,11,-8.877059957058028,6
2124,8,20,13,13,-8.901629409574467,7
2125,50,11,112,7,-8.921235906620762,4
2126,86,20,10,13,-8.925705329647823,7
2127,110,20,107,12,-8.933567921834605,8
2128,65,40,2,27,-8.964459948107422,13
2129,107,17,43,11,-8.971497306643272,6
2130,20,10,46,5,-8.988887305938196,5
2131,76,35,74,23,-9.021109435296268,12
2132,65,57,16,35,-9.041777655106586,22
2133,50,16,91,11,-9.044194652502608,5
2134,109,13,106,8,-9.06266809979583,5
2135,46,10,20,7,-9.077995926942414,3
2136,32,12,26,7,-9.09769401619869,5
2137,57,11,2,6,-9.107338089684553,5
2138,30,14,23,8,-9.118564512919738,6
2139,91,35,74,22,-9.120669894046731,13
2140,65,58,98,37,-9.126651402593732,21
2141,48,15,50,9,-9.13089598930206,6
2142,50,14,43,9,-9.27474781724881,5
2143,86,20,38,14,-9.280969369301586,6
2144,23,17,50,10,-9.300090532650529,7
2145,32,29,111,17,-9.306159625162506,12
2146,107,13,13,9,-9.307281354536356,4
2147,112,13,28,8,-9.317343463958052,5
2148,79,22,34,13,-9.33337221438402,9
2149,55,15,23,9,-9.335240638495891,6
2150,29,22,74,13,-9.341715830488068,9
2151,86,17,49,9,-9.343172433673239,8
2152,8,14,59,9,-9.376826871718674,5
2153,8,17,46,11,-9.405496106583279,6
2154,10,11,57,7,-9.432674751481889,4
2155,11,14,28,9,-9.441756332630208,5
2156,44,17,65,10,-9.443702457838898,7
2157,34,24,8,16,-9.455603000494804,8
2158,19,11,103,7,-9.481054864710421,4
2159,58,11,6,7,-9.489496457414932,4
2160,28,16,43,11,-9.500596764145225,5
2161,76,23,15,15,-9.503739473265108,8
2162,88,14,32,10,-9.505084521049728,4
2163,8,45,26,27,-9.507536225083523,18
2164,17,13,91,8,-9.524679603281824,5
2165,79,21,13,15,-9.547980426671515,6
2166,65,21,60,13,-9.571951123571171,8
2167,89,22,23,14,-9.576875474490599,8
2168,68,18,20,11,-9.579258034610845,7
2169,107,28,79,19,-9.628503445575708,9
2170,18,10,46,7,-9.6369429103627,3
2171,62,26,98,16,-9.641858129313675,10
2172,85,11,88,7,-9.656301948727862,4
2173,87,34,93,22,-9.672186026001654,12
2174,38,32,29,21,-9.681299801122256,11
2175,2,17,70,12,-9.721215849454834,5
2176,48,10,34,6,-9.747358685821412,4
2177,103,36,111,23,-9.751404731703087,13
2178,85,19,28,12,-9.754813285313771,7
2179,103,42,8,29,-9.755203687685839,13
2180,76,20,46,14,-9.768141281128242,6
2181,44,34,6,21,-9.768613303295997,13
2182,54,24,55,17,-9.845323433417095,7
2183,51,11,9,7,-9.848213738956357,4
2184,64,10,28,6,-9.858359509289869,4
2185,50,14,10,9,-9.907166966632534,5
2186,17,13,87,8,-9.92299839057508,5
2187,75,10,103,6,-9.92764617859353,4
2188,70,11,93,7,-9.928875321549777,4
2189,18,14,55,9,-9.949790942140542,5
2190,55,17,10,10,-9.95517779426481,7
2191,38,24,111,15,-9.966212518632437,9
2192,70,10,29,7,-9.97437186041017,3
2193,86,11,11,6,-9.99095041190771,5
2194,34,17,76,11,-9.994247540573088,6
2195,54,43,111,28,-9.999417272535721,15
2196,30,11,88,6,-10.024835723736619,5
2197,34,14,37,9,-10.040882054419711,5
2198,74,29,103,20,-10.120878103689181,9
2199,50,15,30,9,-10.12099142967515,6
2200,84,14,109,9,-10.149942855967593,5
2201,65,23,110,15,-10.151511833678441,8
2202,18,17,74,11,-10.161044876408573,6
2203,38,10,60,6,-10.186949801542625,4
2204,96,12,65,7,-10.190345361441285,5
2205,74,27,93,19,-10.211482113190499,8
2206,104,14,54,9,-10.225264066110721,5
2207,6,16,26,11,-10.241752287967037,5
2208,109,14,91,9,-10.246844938152377,5
2209,73,16,2,10,-10.299221262346556,6
2210,89,14,8,9,-10.313019177206712,5
2211,75,11,2,7,-10.369833561069749,4
2212,75,12,93,7,-10.370088912225684,5
2213,17,10,29,7,-10.39598522715346,3
2214,88,15,73,10,-10.39694546347287,5
2215,49,17,20,11,-10.413212284497675,6
2216,9,71,28,45,-10.43734703286482,26
2217,76,20,70,13,-10.440720709029375,7
2218,79,37,26,23,-10.48182801922156,14
2219,54,20,30,13,-10.516885236190031,7
2220,86,10,46,7,-10.519256341023809,3
2221,79,34,20,23,-10.53719224502861,11
2222,76,32,98,20,-10.566257306689163,12
2223,32,12,6,8,-10.5718983874489,4
2224,65,15,70,10,-10.573807897523746,5
2225,109,14,103,10,-10.579033749442829,4
2226,109,12,86,7,-10.607119538943413,5
2227,101,10,65,6,-10.616476001261296,4
2228,88,37,98,26,-10.63966352804894,11
2229,58,13,38,9,-10.642287291889899,4
2230,109,18,74,11,-10.643610558105994,7
2231,16,16,75,11,-10.668295124883427,5
2232,109,16,107,10,-10.668493285549742,6
2233,41,14,37,9,-10.69447624326301,5
2234,103,50,65,34,-10.69843242130798,16
2235,85,10,91,5,-10.702453755941068,5
2236,41,26,55,16,-10.703172393729925,10
2237,85,23,16,15,-10.722666363673586,8
2238,66,13,8,9,-10.737460925769152,4
2239,37,10,50,6,-10.742277179240862,4
2240,46,18,111,12,-10.748398887248491,6
2241,18,14,23,10,-10.769319649937687,4
2242,23,16,17,11,-10.781653305644483,5
2243,103,25,30,17,-10.782874613377903,8
2244,68,11,50,8,-10.798306988405807,3
2245,63,13,37,8,-10.805969524077794,5
2246,41,48,98,30,-10.835326353590224,18
2247,51,16,54,10,-10.84412241330361,6
2248,65,30,26,19,-10.898269254189744,11
2249,20,38,26,25,-10.94603615247926,13
2250,2,11,13,8,-10.953261699605443,3
2251,51,17,87,11,-10.954751209558498,6
2252,43,10,30,7,-10.958461383133036,3
2253,56,10,87,7,-10.97544493784176,3
2254,6,14,38,10,-11.005398790381081,4
2255,50,20,65,13,-11.026543162219186,7
2256,110,12,98,8,-11.026999619900332,4
2257,103,13,13,8,-11.054952217566056,5
2258,6,25,74,17,-11.078169532223491,8
2259,37,19,93,13,-11.13537305772806,6
2260,46,13,26,8,-11.170213516874066,5
2261,28,10,15,7,-11.176545961741331,3
2262,37,16,85,12,-11.18389053845617,4
2263,87,47,55,32,-11.221595648661637,15
2264,1,14,93,10,-11.222746146114872,4
2265,50,18,32,11,-11.225096892130631,7
2266,29,21,30,13,-11.231145218657787,8
2267,65,14,34,9,-11.233073447780972,5
2268,71,12,98,8,-11.256798740703502,4
2269,9,21,34,14,-11.27320030992046,7
2270,30,21,55,13,-11.351029418072514,8
2271,103,22,2,16,-11.358008021341288,6
2272,54,19,63,12,-11.360815568498154,7
2273,41,20,17,15,-11.462467383182341,5
2274,109,22,38,15,-11.561969316834697,7
2275,102,16,65,10,-11.565057266886953,6
2276,91,15,55,11,-11.567443094683266,4
2277,13,18,16,12,-11.568229122492735,6
2278,18,16,65,11,-11.593628436717696,5
2279,18,11,91,7,-11.600004781918232,4
2280,15,17,98,11,-11.628891195956705,6
2281,70,14,107,9,-11.658453467748302,5
2282,93,13,73,9,-11.6698926319616,4
2283,6,28,87,19,-11.670469918906115,9
2284,20,13,18,8,-11.715025972179685,5
2285,62,13,70,8,-11.719880801732709,5
2286,26,15,23,10,-11.729655071897735,5
2287,79,10,15,7,-11.756403792330063,3
2288,107,14,1,9,-11.758251767033554,5
2289,88,15,46,11,-11.79739038215315,4
2290,103,29,93,19,-11.801085216233043,10
2291,9,11,58,8,-11.82226661915616,3
2292,41,37,54,25,-11.822644765581678,12
2293,62,15,23,11,-11.828374088275872,4
2294,109,14,43,9,-11.866460109925436,5
2295,87,44,26,29,-11.871386146117102,15
2296,1,11,9,7,-11.88637849875501,4
2297,111,17,48,12,-11.90270630017423,5
2298,17,13,18,8,-11.905263091036245,5
2299,76,10,93,7,-11.923250604262599,3
2300,98,16,104,10,-11.93364499732059,6
2301,98,24,32,16,-11.959293567844906,8
2302,65,22,49,14,-11.960634834980652,8
2303,90,11,55,8,-11.96984995218611,3
2304,20,42,107,27,-11.97006172678718,15
2305,11,15,98,10,-11.975065250902471,5
2306,30,15,93,10,-12.041707290163442,5
2307,6,18,18,12,-12.078104024118801,6
2308,112,11,79,8,-12.089617166544242,3
2309,103,11,58,8,-12.093407699535737,3
2310,41,20,93,15,-12.152619394683914,5
2311,109,11,10,7,-12.166039484484626,4
2312,48,20,74,13,-12.23065848011944,7
2313,48,15,51,11,-12.237016972870084,4
2314,62,17,84,11,-12.256108525265194,6
2315,41,24,32,15,-12.295470101415006,9
2316,50,17,93,11,-12.303370496346982,6
2317,26,12,93,8,-12.342400061412198,4
2318,9,22,30,16,-12.347684941209279,6
2319,97,11,9,7,-12.349501112253755,4
2320,23,18,20,13,-12.419097927334022,5
2321,62,22,93,15,-12.439036445917942,7
2322,10,28,84,19,-12.4696885226852,9
2323,84,14,15,10,-12.488568021465507,4
2324,84,16,18,11,-12.537157233284487,5
2325,70,11,90,8,-12.581946187652864,3
2326,98,41,55,29,-12.606268888418896,12
2327,9,21,46,13,-12.652533384487015,8
2328,103,33,20,24,-12.666531668869954,9
2329,90,11,73,8,-12.699639901607055,3
2330,71,19,8,12,-12.71376520897311,7
2331,111,21,73,14,-12.761253099258202,7
2332,86,32,2,23,-12.867270746154679,9
2333,9,37,93,26,-12.871076607744827,11
2334,8,11,3,8,-12.917286316124729,3
2335,43,18,55,12,-13.012921035450152,6
2336,86,16,64,11,-13.126489420837816,5
2337,41,30,107,19,-13.154593566297324,11
2338,103,11,43,7,-13.18571482888933,4
2339,17,25,28,18,-13.189393025867652,7
2340,48,11,20,8,-13.215007868614993,3
2341,107,17,32,13,-13.233625998220862,4
2342,89,10,58,7,-13.242354787086834,3
2343,109,24,26,17,-13.281044125686407,7
2344,73,12,89,8,-13.292782754035754,4
2345,62,12,30,8,-13.325811773490164,4
2346,74,12,70,9,-13.332522800110311,3
2347,109,22,32,15,-13.338298268264783,7
2348,91,10,112,7,-13.34887289439105,3
2349,62,26,107,17,-13.418408869250822,9
2350,73,15,13,10,-13.471561712276635,5
2351,38,23,74,15,-13.50724395592576,8
2352,37,20,111,13,-13.57504840749371,7
2353,5,12,37,9,-13.593067112324485,3
2354,43,17,26,13,-13.59933768355571,4
2355,13,17,84,11,-13.614397809771184,6
2356,86,12,63,9,-13.689145649017556,3
2357,13,10,37,7,-13.71058873552403,3
2358,9,15,63,10,-13.731382825814709,5
2359,73,16,38,10,-13.771113964229546,6
2360,8,12,77,9,-13.772928583045534,3
2361,43,14,93,10,-13.775006273083642,4
2362,109,26,54,18,-13.82452652075349,8
2363,50,11,26,8,-13.83833866908602,3
2364,5,14,87,10,-13.851284632052463,4
2365,2,22,55,15,-13.871872112800904,7
2366,48,14,93,11,-13.897649300249867,3
2367,109,12,70,9,-13.902253335630233,3
2368,9,20,57,15,-13.952239963411907,5
2369,37,13,17,8,-14.00319652989779,5
2370,8,16,110,12,-14.095812927776763,4
2371,38,12,48,9,-14.205802555452095,3
2372,109,12,50,8,-14.261856398454313,4
2373,8,10,60,7,-14.262033464961128,3
2374,28,10,106,8,-14.267038541695133,2
2375,62,21,55,14,-14.271402247137448,7
2376,44,10,84,7,-14.273373064789189,3
2377,84,22,70,15,-14.297191605156181,7
2378,91,11,46,8,-14.304066831342237,3
2379,17,12,86,9,-14.311620358508238,3
2380,66,10,28,6,-14.329185091749263,4
2381,79,16,63,11,-14.33440781504391,5
2382,23,23,10,15,-14.368201832765767,8
2383,38,26,55,18,-14.425488233223774,8
2384,20,26,29,18,-14.478890408494554,8
2385,89,22,28,15,-14.513385674832648,7
2386,50,11,110,8,-14.531978974156036,3
2387,57,22,8,15,-14.533261735789608,7
2388,20,19,62,14,-14.584809923949425,5
2389,13,14,88,8,-14.636848081546901,6
2390,74,16,34,11,-14.640026082092419,5
2391,59,14,65,9,-14.654063925888893,5
2392,93,11,90,7,-14.682520064465665,4
2393,62,11,49,7,-14.691411076024673,4
2394,38,25,93,17,-14.706979782976546,8
2395,17,11,93,8,-14.792328082005685,3
2396,41,13,13,9,-14.878152444409187,4
2397,65,23,30,17,-14.922473908669254,6
2398,65,10,14,8,-15.014185877069242,2
2399,37,15,57,11,-15.067776643574774,4
2400,40,14,84,9,-15.139436492633186,5
2401,107,33,26,26,-15.181646063962567,7
2402,88,17,90,12,-15.203720699131468,5
2403,18,11,90,8,-15.206260273523743,3
2404,28,26,26,19,-15.211295764909368,7
2405,6,31,2,22,-15.303923962237263,9
2406,88,13,70,10,-15.445871190573264,3
2407,76,20,2,14,-15.53711103061795,6
2408,59,10,16,6,-15.561569445873218,4
2409,73,12,29,9,-15.669782329836792,3
2410,38,15,17,11,-15.678044683298898,4
2411,79,15,46,10,-15.695062063539162,5
2412,62,30,111,22,-15.726936324972716,8
2413,66,14,6,11,-15.817538028688281,3
2414,109,16,55,12,-15.902114621962273,4
2415,91,12,90,8,-16.09870244517901,4
2416,6,26,107,19,-16.099487678798972,7
2417,103,11,59,8,-16.266656443008642,3
2418,103,13,62,9,-16.299156500586875,4
2419,85,13,30,10,-16.38402642563884,3
2420,69,13,26,10,-16.625965123271836,3
2421,41,10,69,7,-16.634275461416582,3
2422,76,13,57,10,-16.71990929044005,3
2423,109,16,73,12,-16.722107664046142,4
2424,28,13,63,10,-16.83915101157232,3
2425,109,31,41,26,-16.84086997358483,5
2426,15,12,38,9,-16.880495720481193,3
2427,54,13,26,8,-16.93978716229654,5
2428,87,11,106,9,-17.088429536387807,2
2429,89,10,37,8,-17.418835616565143,2
2430,91,14,34,10,-17.47588407236358,4
2431,49,19,88,15,-17.53203455274144,4
2432,76,13,63,11,-17.535738224915978,2
2433,28,19,57,15,-17.55982008462565,4
2434,110,10,41,9,-17.607251464829996,1
2435,70,13,63,10,-17.959510637912523,3
2436,10,15,38,12,-18.015221595889397,3
2437,76,11,90,7,-18.0318690370992,4
2438,16,15,49,11,-18.082960728792447,4
2439,98,11,51,8,-18.116158962815213,3
2440,87,11,58,9,-18.229025747195358,2
2441,20,12,106,8,-18.31154007706119,4
2442,37,10,18,8,-18.374799448579125,2
2443,1,18,10,14,-18.3791692553228,4
2444,7,13,79,10,-18.40480150019194,3
2445,75,15,88,12,-18.46157402080457,3
2446,6,15,109,11,-18.568483421277442,4
2447,86,15,70,11,-18.585222369284796,4
2448,38,24,26,18,-18.614524044017738,6
2449,2,13,18,10,-18.666944559681195,3
2450,109,28,28,21,-18.76167991813475,7
2451,88,11,26,8,-18.785991491960512,3
2452,109,16,111,12,-18.82454889767414,4
2453,71,12,62,11,-19.04348733516107,1
2454,50,13,62,10,-19.2021134597274,3
2455,29,12,110,10,-19.248543702222975,2
2456,38,14,43,10,-19.328461951187712,4
2457,10,19,20,15,-19.474906343573682,4
2458,75,12,55,10,-19.502608543209234,2
2459,9,10,5,8,-19.535484203654338,2
2460,23,14,73,11,-19.638485965557127,3
2461,10,13,41,11,-19.737157878272868,2
2462,85,11,87,9,-19.849684276845778,2
2463,103,10,34,9,-19.87880862427678,1
2464,109,12,110,10,-20.16933250309851,2
2465,10,10,17,8,-20.222695302818984,2
2466,9,10,64,8,-20.43457650048482,2
2467,71,10,28,9,-20.618030954774138,1
2468,104,10,37,8,-20.681486856575923,2
2469,46,17,87,13,-20.82488049362707,4
2470,110,14,74,11,-20.875047711546735,3
2471,109,29,87,23,-21.22636324198766,6
2472,70,25,111,19,-21.761941281988644,6
2473,44,11,17,9,-22.072912946241182,2
2474,73,11,107,9,-22.13453383862815,2
2475,85,11,20,9,-22.58682017719025,2
2476,94,10,84,9,-22.762013140609877,1
2477,10,10,26,8,-22.77202326046866,2
2478,41,12,57,10,-23.379405756490275,2
2479,86,15,103,13,-23.967936503754764,2
2480,10,11,63,9,-24.09658997724639,2
2481,112,11,74,9,-24.423385588541223,2
2482,49,11,26,8,-26.831812890773925,3
2483,43,10,91,10,-27.34458455824453,0
2484,85,10,55,8,-27.8312439821809,2
2485,89,10,55,9,-28.65230905538118,1
2486,30,10,46,9,-30.066474719572692,1
2487,65,10,64,9,-31.455780164415454,1
