,againstHero,games,hero,losses,shift,wins
0,90,11,23,1,28.300961743533684,10
1,44,10,37,0,28.253477074224726,10
2,75,15,77,2,25.509874365270075,13
3,49,10,112,1,24.460078908180627,9
4,19,10,107,0,24.226623453768696,10
5,73,12,97,3,24.10757303293757,9
6,27,11,69,2,23.96512545131146,9
7,71,12,112,2,23.507799276651657,10
8,78,15,112,3,23.267034993174565,12
9,4,11,8,1,23.177905083651492,10
10,27,21,9,4,23.07230652184508,17
11,10,10,28,1,23.03135332069283,9
12,55,10,47,2,22.558686434869564,8
13,100,25,65,3,22.417652768002984,22
14,34,11,51,2,22.213174768846972,9
15,91,12,97,2,22.175648770183788,10
16,75,14,3,2,21.94698136707857,12
17,20,15,112,2,21.822113913104296,13
18,62,12,31,3,21.79094106777599,9
19,86,15,58,3,21.50384076763655,12
20,41,15,4,5,21.480590173913868,10
21,34,10,97,2,21.449947297008155,8
22,25,13,4,2,21.42004260246313,11
23,104,16,91,1,21.319718278752113,15
24,90,17,51,2,21.316832661511135,15
25,7,10,84,2,21.17364400986741,8
26,55,11,38,2,20.87506721402826,9
27,30,10,79,2,20.824119521738705,8
28,87,10,112,2,20.648609256164324,8
29,49,12,81,3,20.596347227570796,9
30,48,11,35,2,20.438098241934792,9
31,43,12,91,2,20.29321965959792,10
32,2,15,51,4,20.284269757170094,11
33,30,18,36,2,20.033620464488322,16
34,111,11,75,3,20.02641187481709,8
35,95,12,32,2,19.760326388824463,10
36,90,10,68,2,19.75244962865367,8
37,101,10,51,2,19.538804927619935,8
38,16,16,77,3,19.494965112936953,13
39,27,11,12,2,19.43334632488541,9
40,99,14,18,3,19.290873438644514,11
41,4,16,54,2,19.2440876038421,14
42,31,10,57,3,19.217116599721326,7
43,47,10,112,3,19.05098189885603,7
44,98,13,4,2,18.936498509144613,11
45,2,10,11,2,18.923084797888755,8
46,87,15,81,5,18.824930184196745,10
47,99,17,28,4,18.754584808369174,13
48,106,15,31,4,18.52908676481624,11
49,65,14,33,3,18.51276218041885,11
50,5,10,18,2,18.464269170029823,8
51,109,10,103,3,18.37872283171988,7
52,55,15,43,2,18.330276358916958,13
53,55,10,19,3,18.123273148174388,7
54,44,11,55,3,18.073593929874914,8
55,55,18,33,4,17.969879843551904,14
56,95,21,68,3,17.962668451083438,18
57,69,11,57,2,17.903713317642495,9
58,111,11,114,3,17.846918134233796,8
59,32,17,88,4,17.82459413467382,13
60,69,10,8,2,17.824588271872045,8
61,30,18,5,3,17.81053305502534,15
62,30,14,69,4,17.765258614983445,10
63,5,11,3,4,17.694163901939547,7
64,15,14,9,4,17.660327773109124,10
65,13,19,83,4,17.652916390105933,15
66,90,27,28,6,17.576354024280796,21
67,110,11,83,2,17.575104905290946,9
68,23,14,18,4,17.468338798211544,10
69,51,19,81,6,17.43897437062157,13
70,45,10,43,3,17.339723268429022,7
71,45,10,39,3,17.32115834390289,7
72,35,10,106,3,17.319051156851785,7
73,100,13,68,4,17.287141142351707,9
74,63,12,35,3,17.190706154289504,9
75,27,22,5,6,17.18696709990766,16
76,49,14,69,4,17.144708838601282,10
77,51,13,10,3,17.10096027286803,10
78,114,25,109,5,17.093936819354333,20
79,53,18,50,5,17.001925465006988,13
80,112,14,68,4,16.9896861687312,10
81,34,12,87,3,16.987810368259346,9
82,77,16,50,3,16.97319460562341,13
83,38,10,31,4,16.97274158238424,6
84,38,14,97,3,16.838290194315167,11
85,95,14,30,4,16.836817117204568,10
86,1,10,76,3,16.815372977495876,7
87,50,13,68,4,16.739560938672486,9
88,95,15,71,5,16.72675418994599,10
89,30,12,41,4,16.67014747818193,8
90,101,10,36,2,16.6279467044195,8
91,104,12,79,4,16.610032165830475,8
92,14,15,55,3,16.464885141480416,12
93,11,25,25,5,16.429746187224733,20
94,78,19,51,6,16.249500683193986,13
95,53,21,69,6,16.247322250303586,15
96,65,18,58,5,16.230092308358206,13
97,86,17,52,4,16.226058333370403,13
98,23,15,17,4,16.142798996109963,11
99,28,15,112,4,16.11349662694645,11
100,41,18,5,6,16.05037708250146,12
101,98,16,31,5,16.004000710168853,11
102,14,13,63,4,15.961958621197992,9
103,80,13,70,2,15.901333417895936,11
104,53,30,9,8,15.894615033798411,22
105,76,11,91,2,15.872477419459232,9
106,99,18,39,4,15.84878961626863,14
107,48,10,70,3,15.796496446665468,7
108,8,16,77,4,15.792942369486319,12
109,15,10,37,2,15.78269510258246,8
110,62,17,63,5,15.764032245306241,12
111,75,10,35,2,15.755761764469415,8
112,93,16,96,4,15.733194627661211,12
113,37,14,77,4,15.73169378416834,10
114,80,12,35,3,15.72406211872363,9
115,75,13,80,3,15.718052052365534,10
116,8,13,1,3,15.702434313684373,10
117,80,16,88,5,15.676196886577953,11
118,90,13,97,4,15.621888085765939,9
119,106,11,85,3,15.60573196351404,8
120,4,14,45,4,15.600891470448106,10
121,16,44,31,12,15.592889476070622,32
122,23,20,5,5,15.563915929412016,15
123,104,12,31,4,15.561592201078605,8
124,25,11,14,2,15.536643242754739,9
125,89,10,106,4,15.508251121091039,6
126,104,18,2,6,15.503443707499333,12
127,69,15,31,5,15.502962092044205,10
128,100,13,60,3,15.468043250681323,10
129,81,16,94,6,15.463781780556559,10
130,73,25,107,8,15.460672720698525,17
131,49,14,25,4,15.43786379260084,10
132,11,10,71,3,15.386871545741162,7
133,107,18,99,5,15.347683777553831,13
134,61,15,68,4,15.24709195978541,11
135,41,14,12,4,15.231681493254909,10
136,41,17,71,4,15.16238863659133,13
137,27,11,35,3,15.129282720135883,8
138,48,12,9,3,15.097519161061681,9
139,19,11,13,3,15.079444977391654,8
140,63,17,3,3,15.071396371833838,14
141,61,15,7,5,15.062720453324896,10
142,25,18,99,5,15.014737107768298,13
143,45,10,75,2,15.003649946946844,8
144,95,21,17,5,14.970865650802967,16
145,9,16,104,5,14.915937256999364,11
146,8,10,108,2,14.883275708091887,8
147,30,17,91,4,14.854653528597783,13
148,55,11,85,3,14.836765173492136,8
149,18,12,37,3,14.803594606441186,9
150,32,14,106,3,14.741977351969275,11
151,114,19,83,5,14.712530964906872,14
152,14,11,97,2,14.634263785488013,9
153,15,11,55,2,14.630800697849656,9
154,30,10,102,3,14.616177341977675,7
155,50,12,99,4,14.581629542155014,8
156,73,12,37,4,14.533349572792922,8
157,13,12,2,4,14.516038794033767,8
158,54,12,58,4,14.495793177234157,8
159,45,18,51,5,14.493324057948724,13
160,34,12,25,3,14.468789684868277,9
161,73,10,2,3,14.457830254043136,7
162,44,12,5,3,14.447481002517355,9
163,80,11,14,4,14.435345395194508,7
164,40,10,83,2,14.347262135245902,8
165,77,22,51,7,14.34162590555927,15
166,7,27,77,8,14.33556677589385,19
167,80,18,50,4,14.309192739594003,14
168,46,11,102,3,14.30749471315205,8
169,34,12,37,3,14.30057126443514,9
170,30,11,11,3,14.29951613613078,8
171,74,21,60,7,14.268042080973931,14
172,16,21,94,6,14.265495530226408,15
173,30,15,77,4,14.240898393688356,11
174,91,28,60,9,14.219487017087326,19
175,63,11,66,3,14.209916362631539,8
176,41,11,80,3,14.18671629223256,8
177,71,18,54,6,14.183245475418028,12
178,91,10,71,3,14.063234581200414,7
179,40,29,77,8,14.048771071022596,21
180,58,15,68,4,13.9590141666954,11
181,40,24,71,7,13.948125771645659,17
182,75,19,69,5,13.942304484906579,14
183,34,11,57,3,13.937862830072245,8
184,23,11,83,3,13.9232349355535,8
185,2,16,54,4,13.913344645570438,12
186,30,23,13,8,13.875626061777945,15
187,11,13,83,3,13.863860744018647,10
188,34,17,8,5,13.86043374096048,12
189,49,11,27,3,13.828388035620172,8
190,57,16,63,6,13.810752926681854,10
191,97,11,112,2,13.794615799527321,9
192,63,14,33,4,13.733555706081617,10
193,63,25,31,7,13.714594813504092,18
194,104,14,44,4,13.703910249073422,10
195,7,19,57,7,13.697105013999773,12
196,92,16,86,5,13.67676060817369,11
197,93,12,46,3,13.65474091099076,9
198,37,10,10,4,13.538762623915124,6
199,74,11,103,3,13.53565105452587,8
200,78,10,1,3,13.511302040012387,7
201,41,23,9,7,13.50679727117336,16
202,88,17,29,5,13.50604761671226,12
203,34,10,70,3,13.500624883981928,7
204,98,11,46,4,13.482621473195683,7
205,15,24,39,6,13.462922167583548,18
206,93,10,90,3,13.452391800759148,7
207,102,17,55,5,13.448934349992445,12
208,25,12,32,5,13.427877456338663,7
209,75,15,53,5,13.423496737137006,10
210,74,18,62,5,13.411803700884374,13
211,55,11,32,4,13.36363963009391,7
212,16,18,83,5,13.351235477213141,13
213,15,11,3,4,13.349088796326875,7
214,100,12,112,4,13.302851040311163,8
215,64,19,106,6,13.295192075566398,13
216,7,12,99,4,13.274517260788409,8
217,102,31,5,10,13.269431869962297,21
218,95,23,11,6,13.26328800508424,17
219,11,39,96,12,13.25258237771624,27
220,95,36,88,11,13.24512473637818,25
221,8,16,41,4,13.244566662838952,12
222,108,13,60,4,13.225499906177388,9
223,50,16,46,6,13.220197801431311,10
224,27,25,60,6,13.218976933527705,19
225,48,26,54,8,13.218100464174018,18
226,36,18,54,6,13.217744798273172,12
227,41,13,28,4,13.19117071449606,9
228,95,28,37,7,13.149042342745604,21
229,53,15,77,5,13.125923769197524,10
230,51,13,112,4,13.12503322058542,9
231,83,10,70,4,13.118339150755117,6
232,71,12,38,3,13.11375866950239,9
233,2,10,38,4,13.106587736027677,6
234,30,29,39,9,13.10113473228172,20
235,69,17,28,6,13.091770978065746,11
236,104,38,46,12,13.083570903140268,26
237,27,26,36,9,13.042063327238692,17
238,58,12,39,3,13.038608389876652,9
239,27,29,65,9,13.035250514579241,20
240,27,12,114,4,13.009570993376595,8
241,108,11,39,4,12.95101632457721,7
242,41,13,92,4,12.929503950347241,9
243,98,12,75,4,12.900340980932176,8
244,104,14,38,5,12.882056867121559,9
245,27,19,109,7,12.854514856980066,12
246,2,20,65,5,12.841827331353704,15
247,108,10,9,4,12.825707088631287,6
248,60,14,112,4,12.81898673092263,10
249,49,20,104,6,12.812277987885736,14
250,104,20,27,5,12.796343894614777,15
251,54,12,81,4,12.757047966098476,8
252,95,10,36,3,12.746346244298937,7
253,33,14,106,4,12.736963404825662,10
254,8,16,36,5,12.721597845881664,11
255,111,16,88,4,12.710530076381987,12
256,30,11,52,3,12.667026316194523,8
257,48,14,5,4,12.657719903594751,10
258,75,33,54,11,12.657132724468571,22
259,80,14,13,5,12.596651210163868,9
260,80,34,63,10,12.572385685987726,24
261,57,27,5,8,12.572003913811171,19
262,15,15,51,5,12.562268876837926,10
263,13,71,31,23,12.537286324138337,48
264,75,27,5,10,12.535083552437033,17
265,104,11,35,4,12.510382448223591,7
266,53,40,88,12,12.503961998215976,28
267,36,17,50,7,12.423703215189779,10
268,43,16,53,4,12.41343484704957,12
269,78,13,8,3,12.411635409020537,10
270,64,23,9,6,12.391246669177535,17
271,67,12,97,3,12.35346782744064,9
272,49,20,60,6,12.352144520803872,14
273,87,13,33,4,12.350753088118475,9
274,100,22,54,7,12.349967715760691,15
275,75,11,12,4,12.349857549218326,7
276,111,13,51,4,12.302448210462586,9
277,28,10,108,4,12.299856976610261,6
278,107,23,35,6,12.292793992800663,17
279,87,10,35,4,12.264853365777977,6
280,91,23,39,7,12.232573714352018,16
281,11,21,70,6,12.22505126846703,15
282,74,32,28,10,12.211034505860946,22
283,78,11,106,3,12.210243252742755,8
284,7,18,76,7,12.19661731578168,11
285,112,10,84,3,12.19652421867294,7
286,2,22,70,8,12.153236389251056,14
287,34,13,30,4,12.147427118368974,9
288,92,12,63,5,12.136993324985582,7
289,98,27,96,9,12.125771968912133,18
290,34,14,20,4,12.080633416209027,10
291,1,12,104,4,12.020108292717422,8
292,95,27,18,9,11.951490678023532,18
293,46,23,106,9,11.922619928802634,14
294,93,13,11,3,11.901577910299338,10
295,90,18,104,6,11.89837391797068,12
296,8,21,40,6,11.791921402372775,15
297,44,10,54,3,11.791894285038754,7
298,91,12,65,4,11.784658313781675,8
299,104,19,71,7,11.784281392964672,12
300,55,37,1,11,11.76903355576794,26
301,16,11,67,3,11.761532223804268,8
302,108,23,70,7,11.716508786473797,16
303,91,13,96,4,11.692854193124042,9
304,53,12,46,4,11.691208139075002,8
305,18,12,1,3,11.656493402808342,9
306,17,15,9,5,11.65247341465449,10
307,78,17,107,5,11.64562231980435,12
308,55,11,103,3,11.639657223031874,8
309,7,19,19,5,11.638604289638174,14
310,7,14,10,5,11.631959119868696,9
311,13,65,88,21,11.593746975603075,44
312,53,15,17,5,11.579207502470611,10
313,33,15,50,5,11.568332857311571,10
314,36,16,104,6,11.564722196156039,10
315,111,10,71,3,11.563837134119533,7
316,49,10,15,3,11.54727068179138,7
317,74,15,76,6,11.544600382799558,9
318,86,12,94,4,11.54407414297375,8
319,37,44,54,14,11.514339123049963,30
320,69,10,91,4,11.501202941557144,6
321,84,10,78,3,11.490007761865318,7
322,65,12,57,4,11.482165332996512,8
323,47,14,81,4,11.445134927289029,10
324,98,10,88,3,11.438021992981463,7
325,76,14,60,3,11.431632032165167,11
326,64,17,104,5,11.423286049235612,12
327,114,39,106,13,11.417874917507987,26
328,29,10,95,3,11.401888238693152,7
329,76,23,35,8,11.396918545348738,15
330,4,11,38,3,11.395009854616484,8
331,60,13,29,5,11.371173035745986,8
332,18,10,46,3,11.344187759634409,7
333,16,25,69,9,11.33284394516166,16
334,69,12,18,4,11.324568934723304,8
335,48,23,96,7,11.32304165734682,16
336,47,23,60,7,11.313305625779169,16
337,63,46,28,14,11.30701920844641,32
338,80,10,79,4,11.30670069299901,6
339,30,15,70,6,11.30291408800561,9
340,7,25,96,7,11.300422106484014,18
341,80,10,5,3,11.295210617596885,7
342,29,10,86,3,11.288307199014056,7
343,64,10,20,2,11.273683916826545,8
344,86,14,103,5,11.266539954551964,9
345,26,20,86,6,11.252422321391004,14
346,90,12,48,4,11.252381363492233,8
347,87,29,70,11,11.250414739740135,18
348,107,16,83,5,11.249585120390279,11
349,40,13,81,4,11.249205674756393,9
350,86,18,72,6,11.245438259267337,12
351,95,28,51,8,11.244919045567018,20
352,75,17,109,5,11.242273446455997,12
353,87,11,19,4,11.236119998263332,7
354,46,20,96,8,11.223825219116966,12
355,73,13,51,4,11.219804453521853,9
356,98,18,106,6,11.217270403208776,12
357,79,13,87,3,11.211504341364096,10
358,89,11,1,4,11.209011069389932,7
359,114,45,65,16,11.207925536927627,29
360,6,12,61,4,11.200388242698187,8
361,91,10,109,3,11.192740070217315,7
362,30,15,46,5,11.187097177578687,10
363,43,16,4,6,11.162760468553993,10
364,57,27,107,9,11.1598963332473,18
365,74,13,32,4,11.101664191982366,9
366,78,13,80,4,11.097915766170063,9
367,12,10,87,3,11.056786464431308,7
368,99,11,11,4,11.04788337752713,7
369,87,26,114,10,11.046799663049546,16
370,32,12,114,4,11.045874107216177,8
371,45,12,68,4,11.024019728389067,8
372,15,13,71,4,11.00914391321026,9
373,56,13,107,5,11.000292497508868,8
374,50,37,88,13,10.986958086725295,24
375,9,15,47,5,10.968614103246173,10
376,15,10,53,3,10.953947902365101,7
377,23,12,91,5,10.949067409142136,7
378,89,10,13,4,10.939542022741618,6
379,27,14,64,4,10.925557497140753,10
380,78,10,31,4,10.912809716780329,6
381,73,17,5,6,10.907383059794872,11
382,100,11,46,4,10.904685887838546,7
383,63,41,88,12,10.89220871689106,29
384,111,21,41,8,10.875724405637953,13
385,71,16,77,5,10.872072685026803,11
386,98,25,87,8,10.830753925226269,17
387,15,20,18,6,10.81146794442466,14
388,104,27,77,9,10.795670361212093,18
389,55,25,91,7,10.791612827626562,18
390,36,14,35,4,10.78250796990051,10
391,47,11,15,4,10.775485769989336,7
392,59,11,7,3,10.771239818059199,8
393,23,13,45,4,10.7635908991577,9
394,41,22,53,7,10.750334109299274,15
395,23,20,39,7,10.742827162036496,13
396,37,15,60,6,10.721994289598655,9
397,54,11,111,3,10.714143810197228,8
398,43,13,36,5,10.713552025008548,8
399,51,25,74,7,10.704030149650722,18
400,34,20,28,6,10.703466452032457,14
401,15,18,107,5,10.69151788090047,13
402,23,14,12,5,10.685853401881314,9
403,40,23,17,7,10.673939896309559,16
404,5,25,98,9,10.66291868554062,16
405,30,20,64,7,10.642272986004784,13
406,98,18,71,6,10.627953776602759,12
407,16,12,101,4,10.622717697482882,8
408,7,31,91,9,10.609100286101588,22
409,75,15,38,4,10.597530026810052,11
410,75,51,7,17,10.587695481592943,34
411,95,15,9,6,10.569002592922953,9
412,11,24,84,8,10.563882323195871,16
413,86,16,56,5,10.543126647721753,11
414,7,10,66,4,10.534532214717435,6
415,71,19,97,6,10.5235339621969,13
416,102,10,17,3,10.521913643472294,7
417,89,14,37,6,10.519274673853001,8
418,114,12,12,5,10.50495457801322,7
419,75,13,102,4,10.50135368794083,9
420,67,11,107,3,10.497709880226342,8
421,23,12,77,4,10.472073733658851,8
422,6,10,31,4,10.459894630543896,6
423,49,10,62,3,10.4539945527009,7
424,34,11,60,3,10.444545857082172,8
425,44,16,39,6,10.434810009571377,10
426,70,18,57,8,10.42994298882783,10
427,95,19,114,7,10.422604339796184,12
428,110,11,7,5,10.422576579231729,6
429,78,11,16,4,10.397637170720277,7
430,100,32,51,14,10.389410054532464,18
431,106,16,93,6,10.37915501513517,10
432,16,23,1,6,10.375674453583683,17
433,63,24,109,9,10.36151391797182,15
434,104,13,81,6,10.361322759461329,7
435,86,24,79,8,10.35909536994434,16
436,1,17,63,7,10.344681903521664,10
437,37,13,1,5,10.342164269053148,8
438,7,14,81,6,10.32158298772756,8
439,60,24,69,10,10.299447344288492,14
440,40,13,78,3,10.282455211399137,10
441,71,10,84,3,10.279461085413814,7
442,97,11,35,3,10.275101346884464,8
443,34,12,104,4,10.27427919250402,8
444,77,12,99,3,10.252199704478638,9
445,67,16,106,6,10.252161434234207,10
446,7,43,25,14,10.249875265637385,29
447,100,18,88,6,10.248815429425127,12
448,20,19,41,7,10.239156920032366,12
449,64,20,112,6,10.224123936701867,14
450,30,17,31,7,10.214096274935343,10
451,25,24,68,8,10.211790433098953,16
452,11,36,37,12,10.20717474941383,24
453,98,15,2,6,10.198603389321667,9
454,71,13,33,4,10.195530501937561,9
455,97,41,37,14,10.190687502541845,27
456,20,27,51,11,10.189653965671816,16
457,89,13,104,5,10.17868688184359,8
458,40,11,69,3,10.175676528085834,8
459,96,11,23,4,10.143008283174426,7
460,53,37,31,14,10.136338371296793,23
461,92,10,109,3,10.132066653367776,7
462,46,14,70,5,10.128652016947743,9
463,8,20,15,8,10.121581558030638,12
464,8,10,35,3,10.118762046100299,7
465,50,20,102,8,10.118106239071224,12
466,53,36,36,11,10.114732824687987,25
467,18,24,8,7,10.103008591242306,17
468,89,11,74,4,10.093150392265771,7
469,79,12,106,4,10.079963228120917,8
470,110,10,28,4,10.06674072061994,6
471,54,12,57,3,10.066024134547122,9
472,44,10,38,3,10.048373138060269,7
473,70,12,29,5,10.037060199943541,7
474,11,14,18,5,10.031989827572826,9
475,43,13,9,5,10.011482215577137,8
476,75,12,57,4,10.001839571130395,8
477,95,25,65,9,9.987438820754939,16
478,34,11,48,4,9.987399142382838,7
479,107,13,10,5,9.987353405179212,8
480,87,13,52,5,9.984852518055051,8
481,73,18,88,6,9.974203425238965,12
482,37,15,27,5,9.960774411821365,10
483,50,20,18,8,9.960321484724407,12
484,38,10,17,4,9.957251396991316,6
485,95,10,2,3,9.920312629990502,7
486,25,14,3,5,9.907996037168818,9
487,17,15,71,6,9.874078720771614,9
488,46,21,39,9,9.870396281158962,12
489,114,12,81,5,9.869667650649568,7
490,63,34,91,11,9.863803572303501,23
491,76,12,18,4,9.847622493503502,8
492,30,16,63,6,9.842696842263113,10
493,53,10,98,4,9.839111782848335,6
494,104,25,75,9,9.822163907084754,16
495,90,14,39,5,9.813134332006268,9
496,62,10,93,4,9.798162399200404,6
497,37,24,83,9,9.783726366978417,15
498,16,42,18,14,9.75454627994462,28
499,20,27,84,8,9.752482123804997,19
500,100,19,39,7,9.73316298515931,12
501,16,16,32,6,9.72172092201369,10
502,58,14,13,4,9.687344315616338,10
503,100,19,87,8,9.686243494464469,11
504,17,17,109,6,9.672922776879656,11
505,53,12,38,4,9.664145468055217,8
506,100,12,71,4,9.66068752031631,8
507,87,30,9,12,9.657202776782617,18
508,111,16,63,6,9.656549842780759,10
509,65,22,29,9,9.643319235535328,13
510,100,17,63,7,9.628829836647935,10
511,70,17,109,6,9.623350653501726,11
512,76,16,9,5,9.621504571842449,11
513,50,36,20,12,9.619543641365508,24
514,99,14,8,6,9.61106559286031,8
515,20,17,9,6,9.610959353403572,11
516,55,19,68,6,9.598434976526491,13
517,8,13,53,4,9.596286006275326,9
518,80,14,39,5,9.589468521855673,9
519,58,15,69,6,9.58014802435262,9
520,30,24,54,8,9.570998833719647,16
521,64,44,60,14,9.569439655645416,30
522,100,14,43,6,9.569290027183786,8
523,13,24,97,9,9.567486234498416,15
524,16,61,106,20,9.564448025087364,41
525,81,13,63,5,9.541818568077552,8
526,106,13,108,4,9.535201707134298,9
527,1,22,31,9,9.525804060927038,13
528,20,32,25,11,9.520523686179052,21
529,90,14,80,4,9.509239360264802,10
530,114,13,2,5,9.509158562417847,8
531,37,22,99,7,9.502759058160713,15
532,75,17,43,5,9.501415277619836,12
533,37,29,7,11,9.500511382222342,18
534,18,38,39,13,9.47779982850871,25
535,107,17,66,6,9.469730190602778,11
536,76,28,68,7,9.459920139276978,21
537,32,11,63,4,9.44232166344675,7
538,78,12,53,5,9.436495389192622,7
539,64,14,92,7,9.432471863302014,7
540,15,10,1,3,9.421594860471428,7
541,38,11,112,3,9.41394016209822,8
542,86,37,76,13,9.404159373470087,24
543,109,11,36,3,9.390936468630548,8
544,84,10,3,4,9.385748847208339,6
545,76,17,39,5,9.374915521858481,12
546,28,15,111,5,9.365771514395545,10
547,35,13,45,6,9.365578608940048,7
548,109,16,39,4,9.356347251836707,12
549,23,12,50,3,9.354699302165745,9
550,16,70,39,26,9.353086991063584,44
551,98,10,48,3,9.346073134818257,7
552,16,46,96,14,9.342765312407817,32
553,16,22,76,10,9.339094465816046,12
554,50,17,70,7,9.316243790355681,10
555,27,26,31,11,9.313550400018611,15
556,75,34,8,11,9.310281336500847,23
557,110,12,107,4,9.307853181235298,8
558,86,15,67,6,9.30654184494345,9
559,2,13,55,5,9.306518823595622,8
560,109,11,22,4,9.30323095736105,7
561,63,19,77,6,9.291814452323939,13
562,80,14,51,5,9.288063840727721,9
563,39,19,38,7,9.2800617682445,12
564,75,13,93,5,9.279825087560205,8
565,53,17,12,7,9.27312011933641,10
566,65,13,66,4,9.24629898792323,9
567,60,29,50,12,9.2413218599569,17
568,15,10,76,4,9.241288842836553,6
569,2,31,107,11,9.235597195463594,20
570,64,15,37,5,9.227089681457187,10
571,27,15,4,6,9.214915067697104,9
572,54,15,76,5,9.21434337052745,10
573,11,17,57,7,9.206442600524502,10
574,2,12,40,4,9.204153353273352,8
575,73,17,40,6,9.199997222971483,11
576,15,30,88,9,9.176202112652083,21
577,39,16,112,6,9.17506097605606,10
578,41,39,86,13,9.172157333193887,26
579,41,15,49,6,9.171912615870818,9
580,40,15,102,6,9.171373555966685,9
581,92,15,40,5,9.168940871834318,10
582,27,12,30,5,9.159316291712274,7
583,50,43,5,17,9.156049369840707,26
584,86,25,1,9,9.12482621931439,16
585,104,18,17,7,9.118260519592532,11
586,109,15,31,5,9.11388757240418,10
587,63,41,84,16,9.103134071079266,25
588,48,11,51,5,9.079697327016948,6
589,95,34,8,13,9.079209474058969,21
590,44,29,86,10,9.073857704921485,19
591,20,15,98,5,9.068391127675763,10
592,28,34,75,12,9.068390514566694,22
593,2,23,106,9,9.061321745571256,14
594,58,10,112,4,9.041979275484929,6
595,48,26,107,10,9.037134061886896,16
596,48,23,87,8,9.021568034700334,15
597,5,15,36,6,9.008614310253613,9
598,62,10,69,4,9.007065239439928,6
599,17,17,60,6,8.995312545980157,11
600,7,13,79,5,8.987188867047667,8
601,47,20,114,8,8.969382880850322,12
602,28,11,32,4,8.963821007682872,7
603,69,17,68,7,8.951691444155669,10
604,11,13,80,5,8.941133144462878,8
605,73,12,31,4,8.938919570135752,8
606,30,38,107,14,8.938338387407445,24
607,39,24,43,10,8.934327178088363,14
608,104,14,84,6,8.932998314387538,8
609,11,10,91,3,8.923724837318142,7
610,16,101,88,35,8.918867116206172,66
611,110,19,25,6,8.917701672558222,13
612,109,32,8,13,8.913990428825272,19
613,89,15,107,5,8.908975430626485,10
614,7,20,109,7,8.9080321410632,13
615,27,14,53,4,8.906298436748038,10
616,69,12,97,4,8.888377862411462,8
617,87,26,91,9,8.88711273267609,17
618,28,16,40,7,8.877350715587877,9
619,28,30,114,12,8.875783073761175,18
620,32,15,87,5,8.84415502943487,10
621,49,13,77,4,8.842593838828115,9
622,63,19,36,7,8.822881427312195,12
623,63,28,76,9,8.821395394022662,19
624,36,18,47,6,8.810892372607714,12
625,106,10,42,3,8.802546839644418,7
626,45,30,7,11,8.801229657293113,19
627,107,28,31,13,8.798674063671836,15
628,7,19,46,6,8.788211094177631,13
629,106,23,18,8,8.778191080978742,15
630,38,14,106,7,8.74501943352997,7
631,104,23,11,8,8.742484307216115,15
632,39,35,88,13,8.74018182363142,22
633,58,10,45,4,8.721721801464442,6
634,63,15,102,6,8.710165699989911,9
635,96,10,3,4,8.709326138906567,6
636,30,10,2,4,8.704387763563812,6
637,110,14,39,4,8.694421097429624,10
638,3,10,18,3,8.681798681010822,7
639,77,16,88,6,8.678317130754186,10
640,102,32,86,11,8.651776846078937,21
641,41,19,97,7,8.638943706099205,12
642,13,16,6,6,8.62792533539333,10
643,90,22,50,8,8.598522697494,14
644,40,15,49,6,8.588514005098899,9
645,95,23,55,8,8.575006509864881,15
646,78,19,7,8,8.565348954184037,11
647,78,11,36,4,8.552435160203329,7
648,114,13,62,5,8.54955618000272,8
649,28,13,94,4,8.536990091746684,9
650,18,12,20,4,8.532272478061662,8
651,12,13,106,4,8.530975907772834,9
652,62,23,88,9,8.512625127129992,14
653,63,17,69,5,8.506537399631053,12
654,91,10,45,4,8.504304930616431,6
655,61,14,60,6,8.502669551258707,8
656,64,28,40,10,8.496071624321134,18
657,94,10,37,3,8.495177713557318,7
658,30,18,18,7,8.488638483548714,11
659,75,16,1,5,8.487454866261048,11
660,75,56,68,19,8.48370722934506,37
661,60,20,12,10,8.478087405935288,10
662,85,10,16,3,8.463981088255792,7
663,95,14,96,5,8.45037398259218,9
664,80,30,107,10,8.450019757222567,20
665,8,32,114,11,8.446067232393613,21
666,96,24,70,11,8.437417991026262,13
667,1,19,54,7,8.434556866218063,12
668,55,20,114,7,8.432483182241098,13
669,73,19,90,7,8.424101991862472,12
670,48,21,79,8,8.423308200700252,13
671,64,20,8,7,8.418575329228204,13
672,68,24,91,10,8.412577437061728,14
673,86,85,51,35,8.410737442922485,50
674,91,19,20,8,8.407006886407046,11
675,109,18,34,7,8.4009207796274,11
676,28,19,68,6,8.40041770505836,13
677,67,10,104,4,8.393331116483226,6
678,6,10,46,4,8.386722378353735,6
679,28,14,52,6,8.38312541721312,8
680,45,21,107,8,8.374668953212842,13
681,11,11,9,4,8.359525570926444,7
682,7,22,5,8,8.357081514884824,14
683,65,34,93,14,8.350774120379102,20
684,13,18,98,6,8.341994513785483,12
685,13,45,36,16,8.340727615472174,29
686,76,25,50,8,8.328303760573554,17
687,30,13,90,5,8.325698662002965,8
688,13,38,18,15,8.311558918244636,23
689,102,17,88,5,8.307899790454732,12
690,28,11,53,4,8.30735230376955,7
691,18,22,97,8,8.29806548281246,14
692,90,31,106,10,8.283845461248372,21
693,41,18,91,6,8.276671952774393,12
694,100,15,55,7,8.275270908208638,8
695,75,12,76,5,8.269580351796622,7
696,50,34,55,14,8.268886532039616,20
697,37,12,14,5,8.266467835075433,7
698,86,27,48,10,8.264848391369249,17
699,40,49,55,18,8.264830770768937,31
700,20,13,68,5,8.256565992860326,8
701,89,12,16,5,8.242329112388783,7
702,68,14,19,6,8.240798182078716,8
703,106,16,81,7,8.234635443757194,9
704,69,21,106,8,8.230262561693124,13
705,102,10,39,4,8.224547128845817,6
706,91,15,54,6,8.224193238953289,9
707,40,24,3,8,8.21009163331203,16
708,8,25,57,9,8.20914757769532,16
709,11,24,109,8,8.196422948591085,16
710,107,10,61,4,8.19056957850756,6
711,104,35,60,10,8.183651908443375,25
712,98,25,63,10,8.180008105424527,15
713,108,13,98,5,8.179403178791242,8
714,16,19,47,7,8.178952833737183,12
715,68,11,33,4,8.166895131198165,7
716,75,12,29,5,8.144839094845086,7
717,51,14,91,5,8.141325110005308,9
718,81,15,16,5,8.120114808218235,10
719,114,14,57,5,8.115945976762234,9
720,23,33,60,12,8.110771933628392,21
721,51,46,63,19,8.098442592455974,27
722,8,61,5,24,8.080732178020162,37
723,110,16,97,6,8.077466293642946,10
724,87,25,53,11,8.07726427006638,14
725,93,24,28,8,8.070916880531737,16
726,85,11,88,4,8.068264760243629,7
727,9,30,31,11,8.059796732295995,19
728,9,11,12,4,8.058955245687951,7
729,73,19,7,8,8.049715087137763,11
730,57,18,39,7,8.042964198775268,11
731,75,41,50,14,8.02466935745211,27
732,76,38,51,13,8.013014238505109,25
733,48,12,25,5,8.01244102921806,7
734,43,18,31,10,8.011472574516002,8
735,102,19,96,7,7.9956311609664965,12
736,13,16,70,6,7.990308468406848,10
737,15,14,87,6,7.9871826221688895,8
738,5,28,84,11,7.986435375626319,17
739,12,12,4,4,7.976222296376225,8
740,65,25,5,10,7.967561696591304,15
741,29,10,51,4,7.954085942877761,6
742,89,12,53,5,7.9499730264780055,7
743,73,17,87,5,7.942207150258419,12
744,27,13,77,5,7.939137496569419,8
745,54,14,43,6,7.938994815987671,8
746,29,18,87,6,7.938305879679427,12
747,18,10,34,3,7.934073113605032,7
748,13,59,106,22,7.9288935651218875,37
749,77,12,64,6,7.9282827223690555,6
750,33,16,20,6,7.928062438364485,10
751,88,10,82,4,7.912578083642496,6
752,38,12,18,5,7.9056762271381755,7
753,76,11,108,4,7.890267325318871,7
754,70,15,69,5,7.8892362038055985,10
755,15,17,104,6,7.875168892784026,11
756,55,17,23,8,7.871570609888838,9
757,114,25,90,10,7.8701656835045455,15
758,44,12,35,5,7.859665557157517,7
759,106,26,91,9,7.859341034872018,17
760,114,41,13,18,7.855529583445475,23
761,53,19,109,7,7.841205358929896,12
762,74,22,39,9,7.838396655748869,13
763,63,57,54,21,7.834983225160246,36
764,8,17,98,6,7.8322640771965775,11
765,25,46,46,19,7.8204011950255445,27
766,60,23,81,9,7.817127893520488,14
767,75,21,49,8,7.802050873504809,13
768,114,12,110,4,7.80031681097971,8
769,50,15,48,5,7.798532000224024,10
770,86,48,39,20,7.785751888070247,28
771,92,14,114,4,7.774797164908212,10
772,10,14,86,6,7.764445720347282,8
773,53,11,73,4,7.756297558195456,7
774,37,49,25,20,7.755599308877524,29
775,40,63,68,22,7.752246342623857,41
776,84,24,39,9,7.748470893977124,15
777,73,13,54,5,7.746921178252216,8
778,44,11,84,5,7.741464370739849,6
779,63,10,52,4,7.736846011905835,6
780,28,28,2,10,7.726967938716942,18
781,57,19,102,8,7.725209435984633,11
782,63,34,20,14,7.718497083313473,20
783,69,10,109,4,7.709222479752556,6
784,46,13,64,5,7.701785189637151,8
785,41,15,77,5,7.700447698799743,10
786,40,39,104,14,7.699889638025223,25
787,53,17,108,8,7.691782047867256,9
788,1,10,112,5,7.690624824586812,5
789,111,25,7,10,7.69032342577198,15
790,5,32,11,12,7.687442157533876,20
791,37,24,96,10,7.665844925696509,14
792,33,13,31,6,7.647223417443057,7
793,70,11,60,4,7.6464357490262,7
794,16,35,9,12,7.644783932906991,23
795,108,20,88,7,7.642505031143237,13
796,97,29,5,10,7.639418302115124,19
797,96,22,80,8,7.6325568595370585,14
798,18,20,36,8,7.5949028785012285,12
799,20,15,90,6,7.5926874674698235,9
800,58,18,88,7,7.5880987725104365,11
801,41,14,81,5,7.584350575630448,9
802,7,18,112,7,7.5793334476505265,11
803,46,12,77,5,7.574271980014295,7
804,34,14,5,4,7.5706698448560905,10
805,43,23,86,8,7.565521202755194,15
806,33,11,23,4,7.562255793226968,7
807,12,16,107,5,7.554377135078079,11
808,51,20,33,6,7.54115209621082,14
809,64,31,51,12,7.527516454843379,19
810,6,11,55,3,7.526848268362216,8
811,53,16,3,6,7.523939046153444,10
812,55,18,77,7,7.520653437888106,11
813,91,29,98,11,7.486111931896227,18
814,16,27,27,10,7.481407495599662,17
815,41,11,96,3,7.480521636982391,8
816,48,10,89,3,7.476757612743907,7
817,70,14,36,6,7.476080415111229,8
818,108,15,63,6,7.475559971035058,9
819,64,37,31,14,7.4738922265185375,23
820,94,14,54,5,7.465192097558689,9
821,45,12,53,5,7.463487107897495,7
822,37,21,110,9,7.457046552670356,12
823,86,53,97,21,7.453774682156136,32
824,112,18,76,8,7.4528102438630635,10
825,75,17,100,8,7.449782688238093,9
826,46,30,75,12,7.449361290092638,18
827,16,62,63,25,7.448491338619516,37
828,70,13,71,6,7.447387393345601,7
829,8,28,84,10,7.447150756775401,18
830,18,11,112,3,7.442617961192051,8
831,63,23,18,8,7.424434558796218,15
832,8,19,91,7,7.416456742894205,12
833,36,34,41,16,7.412500474371832,18
834,13,27,69,10,7.410798113719347,17
835,16,65,55,23,7.4088914596986175,42
836,37,41,46,14,7.398384968299374,27
837,1,10,5,4,7.391988711274886,6
838,27,31,51,11,7.390169773800458,20
839,73,10,71,4,7.37323406519455,6
840,30,12,4,5,7.371580414746788,7
841,87,26,41,10,7.368765436268466,16
842,34,15,74,5,7.367415754617591,10
843,25,16,33,5,7.36592627296452,11
844,77,10,114,4,7.3654772203978025,6
845,49,12,64,5,7.364918196286091,7
846,49,13,23,5,7.360298065336568,8
847,73,25,8,10,7.35879002547718,15
848,92,14,68,5,7.338682351737513,9
849,86,25,81,8,7.333013220803049,17
850,70,42,5,17,7.323141246130927,25
851,1,23,65,10,7.319832649719675,13
852,109,26,55,12,7.3182997081126135,14
853,39,24,106,10,7.31226919998241,14
854,16,41,91,14,7.309347152714904,27
855,97,17,36,7,7.301788222671786,10
856,87,21,49,10,7.287852583518847,11
857,65,42,20,15,7.275621933808215,27
858,106,13,57,6,7.272492874678534,7
859,62,10,96,3,7.268496266352443,7
860,110,16,70,6,7.267896542251015,10
861,41,31,31,12,7.267301725174954,19
862,75,19,81,7,7.259552889264539,12
863,4,29,65,11,7.258642786898055,18
864,38,11,54,4,7.25460278530091,7
865,98,12,93,5,7.2513528092711335,7
866,46,13,90,5,7.250761878801304,8
867,31,14,5,5,7.246607645789562,9
868,54,32,40,13,7.243609732204195,19
869,20,10,75,4,7.241047227766171,6
870,35,20,40,7,7.2238461178978355,13
871,53,17,61,6,7.205087339517602,11
872,27,20,63,9,7.19472225275396,11
873,23,12,47,4,7.180906240191946,8
874,54,72,88,29,7.171089550335251,43
875,84,12,60,3,7.1701831921763475,9
876,64,16,43,7,7.166853133398249,9
877,87,23,93,9,7.164798687762667,14
878,5,17,60,6,7.144002600647477,11
879,18,39,75,16,7.143872456900073,23
880,13,51,87,18,7.1394100338356346,33
881,75,57,107,18,7.131800392099847,39
882,4,21,17,7,7.131209049726907,14
883,63,32,48,12,7.1299692009467925,20
884,88,11,67,3,7.127393540580368,8
885,88,23,3,9,7.12663205785296,14
886,86,28,83,9,7.1046405351353314,19
887,51,16,110,6,7.1045865219974775,10
888,19,11,39,5,7.101501058499141,6
889,44,16,13,6,7.100478256103446,10
890,90,19,13,7,7.099319512939565,12
891,36,20,3,7,7.093052097907007,13
892,81,29,13,11,7.090406449020689,18
893,28,35,70,14,7.078735797739843,21
894,107,19,102,8,7.0774996579991125,11
895,102,14,98,6,7.075813129571894,8
896,63,21,38,7,7.07127755522525,14
897,50,14,49,6,7.064134383315743,8
898,100,21,25,9,7.062312436550092,12
899,44,13,64,5,7.05920038211248,8
900,30,39,65,15,7.0585708403802245,24
901,68,27,18,11,7.0575085592620574,16
902,65,16,73,6,7.056062739811479,10
903,64,10,11,3,7.044290994994302,7
904,37,28,38,11,7.0413163805665135,17
905,7,22,58,10,7.035143698213466,12
906,3,24,87,9,7.028655258681693,15
907,13,29,54,10,7.026908366399236,19
908,100,16,18,7,7.026565168419708,9
909,95,15,40,6,7.026458120737083,9
910,45,14,86,6,7.001591160951405,8
911,80,13,48,4,6.99747900943173,9
912,62,15,5,6,6.992708759597391,9
913,114,19,1,7,6.990089974683044,12
914,111,23,13,10,6.988942249892523,13
915,17,20,55,9,6.987444025974705,11
916,55,12,94,5,6.987298934898079,7
917,97,21,51,7,6.980039097404115,14
918,83,15,84,7,6.963483843011809,8
919,16,34,36,13,6.9623095532486845,21
920,32,18,104,6,6.95922508638955,12
921,47,12,18,4,6.958091333768663,8
922,15,11,50,4,6.950752908185209,7
923,41,14,17,5,6.944180159767115,9
924,63,27,2,11,6.942761121987027,16
925,99,12,88,5,6.93913123202866,7
926,75,19,30,8,6.923427737676235,11
927,16,38,46,15,6.9206390826160336,23
928,104,36,55,14,6.909075624793388,22
929,49,10,53,4,6.907813000954768,6
930,76,16,88,7,6.891817282335726,9
931,90,22,65,10,6.887045978873851,12
932,114,47,5,19,6.885144276646171,28
933,106,15,99,5,6.882359612487447,10
934,54,21,18,9,6.880495431858326,12
935,57,12,36,4,6.873476463690229,8
936,7,48,87,18,6.866073104845454,30
937,60,43,4,19,6.864343045215706,24
938,75,17,11,7,6.860129083231025,10
939,16,39,71,14,6.8596933376667515,25
940,114,19,96,7,6.8573207383282995,12
941,13,29,95,12,6.852052215706936,17
942,16,17,14,7,6.836744613344807,10
943,78,14,96,5,6.830515928543477,9
944,95,25,106,9,6.830338155584792,16
945,68,69,31,28,6.821634358561019,41
946,65,10,52,3,6.817085213239555,7
947,25,14,9,5,6.810304163725227,9
948,51,20,96,8,6.809158319794973,12
949,100,16,114,6,6.806713890734189,10
950,60,18,45,8,6.8022482279138705,10
951,108,25,13,9,6.801707995205209,16
952,16,14,93,6,6.800404971341561,8
953,49,10,71,4,6.800377692667283,6
954,55,10,31,4,6.798197972656263,6
955,6,14,27,6,6.780540737481572,8
956,33,23,107,10,6.763493299081546,13
957,53,13,90,5,6.752088210585151,8
958,86,79,96,31,6.7509941858211375,48
959,102,15,51,6,6.74947281728566,9
960,29,10,38,4,6.744621955429496,6
961,52,11,20,4,6.739976324437407,7
962,54,43,109,16,6.737418170690638,27
963,74,38,96,14,6.731828732252355,24
964,14,13,95,5,6.731405281187272,8
965,100,11,95,5,6.722166987268522,6
966,97,11,32,4,6.722008536715331,7
967,65,10,32,4,6.718474357729474,6
968,28,35,97,13,6.716635909782017,22
969,97,23,68,9,6.713141190342428,14
970,6,10,40,4,6.705680107058635,6
971,83,15,74,7,6.703298030488857,8
972,15,12,91,6,6.697476716978323,6
973,111,11,106,3,6.697425895741327,8
974,29,10,37,4,6.680734619445758,6
975,107,20,47,8,6.679988416533418,12
976,68,51,53,20,6.67704695789799,31
977,49,14,70,6,6.672966411521808,8
978,27,36,88,16,6.672694825026893,20
979,14,13,13,4,6.663851771345142,9
980,83,11,71,5,6.656205380333864,6
981,71,19,37,8,6.653996053488669,11
982,76,15,114,5,6.6539119931134865,10
983,16,28,64,10,6.6466026985544655,18
984,25,48,5,19,6.626414170343125,29
985,16,30,100,11,6.617449381235235,19
986,71,18,81,7,6.61709770119633,11
987,80,18,37,7,6.595363149795721,11
988,65,28,96,12,6.593487230396348,16
989,30,25,60,8,6.5923697926317155,17
990,40,26,1,10,6.58137324665705,16
991,53,26,114,11,6.571088082289226,15
992,104,37,25,16,6.567754121461538,21
993,41,11,3,3,6.560880189791295,8
994,77,21,18,7,6.545250800191177,14
995,49,10,55,4,6.541972088163769,6
996,109,14,38,5,6.539620107256842,9
997,35,15,28,7,6.525585250622975,8
998,56,12,4,6,6.509885274579445,6
999,90,10,102,5,6.502237322589002,5
1000,41,27,104,12,6.500266163182682,15
1001,48,10,104,4,6.493358473776671,6
1002,86,25,78,10,6.489118177332069,15
1003,28,20,17,8,6.478742661851245,12
1004,12,15,39,6,6.475459814124786,9
1005,107,26,43,10,6.466098586244284,16
1006,90,25,87,10,6.4548524533916245,15
1007,27,30,86,11,6.453315924089684,19
1008,6,10,28,4,6.452419128804086,6
1009,4,20,87,7,6.445923142452618,13
1010,75,49,16,20,6.443913435512626,29
1011,86,39,36,16,6.439394441072944,23
1012,86,50,75,22,6.43422204324356,28
1013,41,20,109,7,6.432688342356182,13
1014,40,16,33,5,6.427211772717694,11
1015,107,19,77,8,6.416947048354687,11
1016,106,13,77,6,6.407119934187455,7
1017,74,13,77,5,6.38427445953612,8
1018,16,18,108,7,6.383719600885128,11
1019,50,27,71,11,6.379934345675859,16
1020,74,32,84,15,6.379678119893638,17
1021,7,21,56,9,6.361794853449644,12
1022,28,12,44,6,6.357970575228094,6
1023,92,13,27,6,6.356396578041118,7
1024,30,12,84,4,6.354899474173294,8
1025,11,20,98,9,6.338677652860182,11
1026,63,18,4,7,6.33309005279508,11
1027,54,14,112,5,6.3267118256224935,9
1028,76,11,57,4,6.324386635638288,7
1029,32,25,5,10,6.322230990899957,15
1030,53,26,30,11,6.311098789496547,15
1031,29,13,55,5,6.301089833667023,8
1032,39,16,83,6,6.297771796270439,10
1033,23,17,114,6,6.291790840234864,11
1034,65,56,88,21,6.287559020425311,35
1035,70,16,64,5,6.286009204558742,11
1036,16,12,92,3,6.284475222709882,9
1037,41,11,102,4,6.282861273718874,7
1038,86,21,4,8,6.2794844995496994,13
1039,39,28,20,13,6.273682118106888,15
1040,15,12,95,5,6.265255655621163,7
1041,92,22,39,10,6.263991845659126,12
1042,86,83,88,34,6.254550732132806,49
1043,43,17,5,7,6.250727481432205,10
1044,107,41,53,16,6.250695932210899,25
1045,58,24,107,9,6.246057958192936,15
1046,54,15,62,6,6.240490314200175,9
1047,28,32,9,14,6.237351159402921,18
1048,7,97,51,37,6.231180255750105,60
1049,104,41,50,16,6.230364171354915,25
1050,80,31,55,14,6.225846961531592,17
1051,38,21,65,10,6.225284615552252,11
1052,74,28,70,13,6.203999405338755,15
1053,38,15,84,7,6.186656588515757,8
1054,55,14,35,6,6.181710197353361,8
1055,28,54,84,22,6.1786789402149065,32
1056,97,23,76,10,6.171425808149794,13
1057,68,41,87,17,6.166464303817792,24
1058,63,10,89,3,6.159771716986653,7
1059,16,13,58,5,6.156802466115244,8
1060,85,11,20,5,6.150943417431858,6
1061,31,15,112,5,6.149641402394961,10
1062,40,48,39,19,6.1478732659202615,29
1063,78,16,63,8,6.142144937717797,8
1064,109,14,46,6,6.137839688733693,8
1065,23,10,48,4,6.136507124451633,6
1066,31,13,80,4,6.13276887148396,9
1067,55,24,97,9,6.128965912516967,15
1068,25,35,88,12,6.123879676950231,23
1069,81,13,31,4,6.117159791325403,9
1070,90,12,7,5,6.108519045195328,7
1071,55,10,79,4,6.105260957218084,6
1072,102,12,60,5,6.102540677846686,7
1073,23,40,88,14,6.098802854801483,26
1074,98,39,86,17,6.096402500191193,22
1075,71,10,44,4,6.091140056693274,6
1076,111,23,107,11,6.08814286411973,12
1077,20,44,5,17,6.084413199436967,27
1078,60,25,41,11,6.080070950949513,14
1079,74,14,48,7,6.068043245358376,7
1080,23,27,41,11,6.068042449918637,16
1081,23,18,28,8,6.06620277166243,10
1082,35,10,9,5,6.055687068848652,5
1083,90,19,63,8,6.053395439788756,11
1084,16,48,68,18,6.053036366464971,30
1085,8,16,32,7,6.041444852098721,9
1086,7,24,98,9,6.0336860037819795,15
1087,75,31,31,14,6.033482134287373,17
1088,69,29,86,12,6.032202467444129,17
1089,78,12,57,5,6.03107487711256,7
1090,91,17,50,6,6.027790824025911,11
1091,95,20,46,8,6.027785407812038,12
1092,30,31,71,13,6.024215205048038,18
1093,99,10,17,4,6.0116233289389776,6
1094,54,57,70,23,6.000249372764343,34
1095,114,25,31,11,5.991876520395493,14
1096,74,12,27,6,5.991317096712259,6
1097,97,18,40,7,5.966918416140386,11
1098,97,12,10,6,5.950831581917705,6
1099,39,12,14,5,5.947548147792332,7
1100,33,15,7,7,5.9471342175078945,8
1101,37,45,63,18,5.933785173114154,27
1102,73,20,114,8,5.924435121305103,12
1103,47,26,13,11,5.922014718305201,15
1104,28,47,109,18,5.9213170604434575,29
1105,93,10,63,4,5.9175632502755855,6
1106,41,15,45,5,5.9144627061547626,10
1107,100,33,107,16,5.907266287901798,17
1108,93,16,25,7,5.904464695396421,9
1109,28,18,36,8,5.898399783819157,10
1110,46,12,36,5,5.882094180819339,7
1111,7,34,3,13,5.87756648772805,21
1112,104,49,28,21,5.869912935195163,28
1113,54,36,95,16,5.865979569344106,20
1114,51,52,65,20,5.865717524678075,32
1115,34,17,7,7,5.863504951401833,10
1116,74,37,46,14,5.850135921281393,23
1117,64,29,65,13,5.843001839077046,16
1118,108,16,87,6,5.840502938250502,10
1119,62,14,51,6,5.8401093038711664,8
1120,107,42,9,18,5.825633505220706,24
1121,40,16,5,7,5.820527251695649,9
1122,100,10,49,5,5.813425744151518,5
1123,80,28,106,11,5.812470547213421,17
1124,7,45,64,20,5.801061458968774,25
1125,74,28,55,12,5.797157459674129,16
1126,64,37,86,16,5.796824578298752,21
1127,18,23,9,8,5.785477096919834,15
1128,64,30,71,11,5.764884814228726,19
1129,100,11,62,5,5.764834126315438,6
1130,65,10,92,4,5.758565875475845,6
1131,58,13,53,7,5.756559382638666,6
1132,39,73,51,31,5.7559747310891485,42
1133,86,17,34,7,5.754838058234217,10
1134,36,12,77,5,5.751140829309578,7
1135,25,42,106,16,5.73768822242091,26
1136,13,14,112,6,5.733766605814065,8
1137,13,48,25,22,5.729332953997915,26
1138,45,14,9,5,5.727853500458987,9
1139,25,26,51,11,5.72613511284895,15
1140,41,18,37,7,5.716493275276269,11
1141,23,10,102,4,5.7160538226538815,6
1142,114,26,40,9,5.715670519906256,17
1143,29,11,54,5,5.709851331879876,6
1144,51,26,69,10,5.708510695737555,16
1145,29,10,53,3,5.706367610412568,7
1146,8,40,46,18,5.695904868807617,22
1147,70,10,32,5,5.692479372096213,5
1148,23,10,43,4,5.689859175567734,6
1149,106,46,5,18,5.689619439430471,28
1150,30,25,55,10,5.686463879094618,15
1151,102,10,95,4,5.685319962340818,6
1152,47,18,68,7,5.681623794437403,11
1153,94,10,25,5,5.671887186214519,5
1154,75,39,37,14,5.670197882049105,25
1155,16,31,99,13,5.665818337043021,18
1156,16,48,37,20,5.664774565241773,28
1157,54,11,82,4,5.664278302313932,7
1158,9,13,61,5,5.652969843590383,8
1159,4,10,97,4,5.649870700339136,6
1160,39,13,97,5,5.649731064357227,8
1161,73,23,74,9,5.649045009007229,14
1162,109,11,77,5,5.645459503468274,6
1163,55,44,60,19,5.644771934395871,25
1164,76,12,36,3,5.641487589296995,9
1165,86,28,73,13,5.62531345595925,15
1166,5,21,17,7,5.625033929201379,14
1167,95,26,50,11,5.619957219349123,15
1168,16,48,50,20,5.617696720442929,28
1169,114,22,3,8,5.616945915532873,14
1170,6,10,50,4,5.6169206992817635,6
1171,100,15,50,6,5.612526049660052,9
1172,27,14,43,7,5.609839390205427,7
1173,79,10,20,4,5.6068676923155305,6
1174,13,41,23,19,5.602560116244982,22
1175,99,11,63,5,5.595807733799709,6
1176,87,32,25,14,5.592843725263717,18
1177,62,21,68,9,5.591004045591886,12
1178,87,19,97,7,5.581011131648731,12
1179,12,17,71,7,5.57619075244912,10
1180,13,43,64,20,5.572520889749911,23
1181,71,12,47,5,5.571212302193355,7
1182,11,31,54,13,5.5650490652973295,18
1183,37,60,104,24,5.563475261062019,36
1184,3,24,60,10,5.560495932377157,14
1185,63,11,10,4,5.56040496031845,7
1186,31,10,95,4,5.5581891593402775,6
1187,76,14,102,6,5.556814882908007,8
1188,46,11,4,5,5.55622187464566,6
1189,34,14,84,7,5.552893968465004,7
1190,8,41,25,16,5.550067480025434,25
1191,36,53,31,23,5.548564460468652,30
1192,25,18,84,7,5.5466876181289715,11
1193,75,16,84,7,5.542746956131477,9
1194,28,36,18,16,5.538955354420103,20
1195,106,31,23,15,5.535479536227778,16
1196,28,14,3,5,5.5268606730952,9
1197,16,95,51,40,5.526230461835626,55
1198,30,23,88,11,5.525413582454542,12
1199,33,14,102,6,5.525239013163607,8
1200,27,20,75,9,5.525223821089192,11
1201,88,24,57,11,5.524909922819241,13
1202,62,10,20,4,5.517288163699186,6
1203,13,49,46,20,5.516940275245686,29
1204,87,59,37,24,5.516733087496062,35
1205,95,19,83,7,5.510188596504647,12
1206,32,13,109,6,5.5080518973086185,7
1207,67,10,102,4,5.49724656177184,6
1208,62,20,40,10,5.493314127309687,10
1209,18,10,62,4,5.493140482819633,6
1210,15,20,54,9,5.4915266593547525,11
1211,46,10,1,5,5.488587081929579,5
1212,65,49,40,21,5.488110460552834,28
1213,86,25,112,11,5.486758411271889,14
1214,7,20,38,9,5.485899453240417,11
1215,114,23,70,9,5.484820175107314,14
1216,14,10,75,4,5.479308338136782,6
1217,99,17,36,6,5.4766719172319,11
1218,43,15,50,5,5.476388636923783,10
1219,80,11,68,4,5.466227321340817,7
1220,75,43,71,16,5.454468163058883,27
1221,97,18,57,8,5.45235309786646,10
1222,54,27,60,11,5.432461791262124,16
1223,38,10,40,5,5.415692699604588,5
1224,51,15,83,5,5.415397349279681,10
1225,49,11,37,5,5.40579366661915,6
1226,9,11,66,5,5.404825557202403,6
1227,54,52,106,24,5.400574012233974,28
1228,54,31,90,13,5.397442007333916,18
1229,93,24,54,9,5.392828840599427,15
1230,100,24,7,10,5.390746304293862,14
1231,107,24,109,9,5.374789076628488,15
1232,75,30,63,13,5.362343223381901,17
1233,98,12,17,6,5.361440435561062,6
1234,106,13,112,6,5.358449059964543,7
1235,7,35,97,16,5.356987360153851,19
1236,104,43,51,16,5.354494200185867,27
1237,30,33,87,14,5.350349764034888,19
1238,62,18,65,8,5.34575502328806,10
1239,87,25,57,10,5.341931643339133,15
1240,97,14,102,5,5.335160623731844,9
1241,86,29,38,12,5.322940889897509,17
1242,8,62,87,26,5.318451472857016,36
1243,87,62,65,25,5.311793490232524,37
1244,111,25,55,10,5.307717141421055,15
1245,49,28,86,12,5.300994125698592,16
1246,30,11,35,5,5.293385259461386,6
1247,14,19,28,7,5.288795345484194,12
1248,56,11,88,5,5.280224334897691,6
1249,28,11,92,4,5.26619903758234,7
1250,103,13,16,5,5.257274881217922,8
1251,25,26,40,11,5.242222631716463,15
1252,98,15,40,7,5.239271076053035,8
1253,65,15,14,7,5.239230657167624,8
1254,91,21,25,9,5.236778929543691,12
1255,71,47,13,21,5.235216499316668,26
1256,35,11,5,5,5.226534281744142,6
1257,40,22,37,10,5.2189812618502875,12
1258,16,76,87,33,5.21755307104735,43
1259,33,12,91,6,5.213867650447791,6
1260,34,18,55,8,5.202160532736089,10
1261,13,11,84,4,5.198171285112244,7
1262,40,13,113,5,5.193726392686624,8
1263,91,25,13,11,5.1844258161997425,14
1264,4,24,51,9,5.183921696313047,15
1265,75,26,47,9,5.17693162231529,17
1266,2,40,50,17,5.160264368077373,23
1267,91,11,56,5,5.1601828143932735,6
1268,67,12,5,5,5.159840528973067,7
1269,111,14,39,6,5.158992286191915,8
1270,8,54,63,24,5.156454172512435,30
1271,16,96,7,42,5.155701242136665,54
1272,87,46,50,21,5.1516202521080965,25
1273,63,13,79,5,5.150156389678723,8
1274,106,24,9,10,5.150083731218861,14
1275,44,15,88,7,5.148664566159752,8
1276,107,56,20,24,5.141425460852389,32
1277,109,12,4,5,5.135069245647407,7
1278,40,30,58,14,5.133397385337812,16
1279,114,28,39,13,5.125505730553986,15
1280,55,23,70,10,5.1032220329288345,13
1281,53,25,104,11,5.0942603831986055,14
1282,89,12,86,6,5.092829255018564,6
1283,87,11,110,4,5.0925904586002675,7
1284,16,27,43,10,5.089727697712367,17
1285,60,24,95,10,5.089480392621887,14
1286,60,14,58,6,5.085584297125204,8
1287,107,61,104,25,5.0845878069653105,36
1288,7,17,62,7,5.083532766636536,10
1289,32,10,20,3,5.082163415292109,7
1290,92,10,17,4,5.07288490506961,6
1291,90,13,33,5,5.072843762888294,8
1292,46,17,65,6,5.066104910854949,11
1293,55,29,63,13,5.056066807562624,16
1294,9,16,34,7,5.022861202196314,9
1295,7,63,53,27,5.016298274373607,36
1296,107,21,49,10,5.010733066245022,11
1297,93,26,5,10,5.004460526821323,16
1298,7,41,106,20,5.003800212982272,21
1299,16,16,35,6,4.995780437282775,10
1300,32,12,68,4,4.994599728673895,8
1301,104,30,63,13,4.993963037729944,17
1302,74,15,71,7,4.993812181109021,8
1303,27,25,39,12,4.989393098929608,13
1304,37,71,86,31,4.984756436647984,40
1305,23,17,15,7,4.9841342107101605,10
1306,55,55,65,24,4.97482433256795,31
1307,14,18,51,6,4.969794868699566,12
1308,1,15,87,7,4.968031301569397,8
1309,40,49,107,19,4.964616090179718,30
1310,62,12,8,4,4.9642207369004785,8
1311,96,23,90,9,4.963939687748078,14
1312,39,18,77,8,4.961640817784317,10
1313,20,36,96,15,4.958331873160826,21
1314,13,32,8,13,4.955794878282507,19
1315,51,39,46,16,4.954472518494825,23
1316,16,89,107,34,4.95056317827842,55
1317,56,19,68,9,4.94813216675333,10
1318,76,12,49,5,4.943121216792114,7
1319,77,14,87,6,4.942401920251487,8
1320,37,11,108,5,4.94147061612662,6
1321,45,21,65,10,4.938797125414042,11
1322,20,21,55,9,4.931554548881413,12
1323,114,22,9,7,4.931319071415342,15
1324,17,11,87,5,4.927367867706464,6
1325,74,56,106,24,4.924754963776778,32
1326,65,31,17,11,4.917244641739984,20
1327,54,12,108,4,4.909695920764135,8
1328,46,48,54,20,4.906943181154001,28
1329,84,34,106,16,4.903872752933781,18
1330,76,27,55,10,4.8923898677809445,17
1331,8,16,33,6,4.890943290835164,10
1332,83,39,5,18,4.890865835189014,21
1333,60,20,96,6,4.889401556049959,14
1334,8,12,3,7,4.88781937501622,5
1335,69,11,95,4,4.882909765417961,7
1336,30,11,114,5,4.8820710984651585,6
1337,51,11,38,4,4.8736842084361065,7
1338,88,10,110,5,4.870544753091405,5
1339,37,54,106,25,4.865641247327302,29
1340,5,10,89,3,4.86246564090175,7
1341,13,17,94,7,4.855238762429886,10
1342,104,23,100,9,4.850527098250832,14
1343,5,30,51,11,4.841333405150811,19
1344,83,20,64,9,4.840996077098241,11
1345,41,14,89,6,4.840368821573814,8
1346,75,39,39,18,4.835166255544909,21
1347,8,15,67,6,4.831909846155583,9
1348,31,19,25,9,4.823839301099763,10
1349,63,17,43,7,4.821038820338602,10
1350,14,15,54,5,4.820525855929132,10
1351,75,17,4,7,4.813951260599897,10
1352,6,12,106,5,4.810944704219048,7
1353,100,13,17,4,4.805895298432701,9
1354,96,13,108,6,4.805162668071275,7
1355,83,28,8,13,4.804749965348905,15
1356,110,16,16,7,4.801952356665634,9
1357,75,22,96,7,4.801381492311931,15
1358,111,11,25,5,4.797175922879397,6
1359,8,29,9,15,4.796436219845455,14
1360,60,20,1,8,4.7956289157103855,12
1361,9,17,1,9,4.794059502939978,8
1362,76,33,5,14,4.788314400539968,19
1363,9,12,5,5,4.777710715122403,7
1364,107,27,38,11,4.773718137979072,16
1365,90,13,70,6,4.771084444295362,7
1366,12,15,31,7,4.770632464521183,8
1367,60,16,97,8,4.770560692259114,8
1368,93,16,50,6,4.755526241513054,10
1369,90,30,5,12,4.752640516818983,18
1370,74,38,63,17,4.748458787006123,21
1371,25,16,77,7,4.745845616411638,9
1372,70,16,98,6,4.745137974355768,10
1373,114,42,68,18,4.745053261523827,24
1374,97,11,3,4,4.740273088979023,7
1375,64,10,81,4,4.73660561378694,6
1376,84,23,48,9,4.73502315242232,14
1377,85,16,54,6,4.730021736475019,10
1378,15,14,75,5,4.729161606780822,9
1379,47,17,86,7,4.720142586161402,10
1380,28,32,7,13,4.719931163726005,19
1381,39,51,68,23,4.718369396030296,28
1382,11,38,88,16,4.710454574435891,22
1383,13,67,107,30,4.69916256230774,37
1384,39,10,98,4,4.691177704712753,6
1385,71,16,5,7,4.686451238703377,9
1386,62,16,9,7,4.679077909097035,9
1387,53,22,81,9,4.67351225402936,13
1388,52,12,8,5,4.669562642233978,7
1389,16,18,79,8,4.6647981879631075,10
1390,55,14,98,5,4.662824671110214,9
1391,25,15,47,7,4.655390231832646,8
1392,64,27,63,12,4.655022536417097,15
1393,27,15,25,7,4.649655011418165,8
1394,73,14,13,6,4.642713338622983,8
1395,73,19,109,8,4.637139105733967,11
1396,43,24,88,10,4.636555985964769,14
1397,60,22,25,10,4.636282806493916,12
1398,102,19,74,8,4.634614725478841,11
1399,3,25,39,10,4.631897665167821,15
1400,32,11,51,5,4.6285064285954,6
1401,28,10,29,4,4.612981141001359,6
1402,7,42,55,17,4.609551229914398,25
1403,23,11,30,5,4.601908928188203,6
1404,77,13,95,6,4.60149322445291,7
1405,55,20,64,7,4.598509710106534,13
1406,50,32,96,14,4.592653394244439,18
1407,71,24,87,11,4.583143708944138,13
1408,100,12,30,5,4.575260966636385,7
1409,99,14,95,6,4.572737764013027,8
1410,30,21,104,10,4.571829941100375,11
1411,99,16,104,8,4.5627492392393,8
1412,70,15,23,7,4.554568026577778,8
1413,109,13,67,7,4.5540965230597985,6
1414,74,10,112,4,4.553694289700708,6
1415,83,15,46,7,4.551826612706301,8
1416,1,11,39,6,4.548291694643937,5
1417,23,24,76,11,4.537606040144393,13
1418,88,51,9,22,4.537426821075463,29
1419,8,24,102,11,4.537070383836359,13
1420,71,28,68,11,4.532265816801447,17
1421,106,23,75,11,4.532198108241345,12
1422,57,16,51,7,4.5192137684835405,9
1423,37,43,55,20,4.516821858156878,23
1424,28,52,54,22,4.514030967957707,30
1425,62,10,104,3,4.50664568251795,7
1426,7,93,88,42,4.5053270586483745,51
1427,16,26,84,12,4.50433575733427,14
1428,75,20,112,8,4.4989690721071325,12
1429,102,24,54,10,4.497323538158562,14
1430,20,59,54,28,4.494429121899646,31
1431,93,15,37,6,4.493445665639034,9
1432,64,15,3,6,4.492765978443915,9
1433,75,45,51,20,4.490318359114665,25
1434,55,11,27,5,4.4890470852362,6
1435,36,15,112,6,4.481804787740811,9
1436,88,29,70,12,4.478319588858416,17
1437,30,40,16,17,4.476195567754862,23
1438,95,33,107,15,4.475609109265348,18
1439,51,12,92,6,4.473927143910237,6
1440,96,31,25,14,4.4728328775528,17
1441,97,33,16,15,4.472648646474977,18
1442,88,30,18,14,4.470121317889942,16
1443,98,16,84,6,4.468561917829734,10
1444,91,10,57,5,4.468260927215541,5
1445,109,14,9,7,4.467532481839809,7
1446,37,18,32,8,4.466542082918521,10
1447,77,11,97,4,4.4549011553839994,7
1448,50,12,73,4,4.454782630059153,8
1449,86,32,17,16,4.4541076848822705,16
1450,95,44,16,20,4.453378575583387,24
1451,7,67,31,29,4.4532123702344615,38
1452,13,33,37,14,4.448467961015427,19
1453,106,25,53,12,4.4447759925456225,13
1454,95,15,109,6,4.444131433700797,9
1455,45,11,88,4,4.4416566980945715,7
1456,13,32,50,14,4.432840638378546,18
1457,16,35,53,14,4.432680586189367,21
1458,86,115,5,49,4.430772584334587,66
1459,107,35,64,16,4.429693624174908,19
1460,102,20,87,8,4.423994697827657,12
1461,46,18,9,8,4.423884935946225,10
1462,99,30,13,13,4.420966828834258,17
1463,13,12,76,5,4.417032905676177,7
1464,114,20,64,8,4.407773657880817,12
1465,17,24,54,11,4.405567288972997,13
1466,13,37,43,18,4.400642517704952,19
1467,111,20,86,8,4.3910837466552355,12
1468,65,23,76,9,4.385586505985178,14
1469,13,10,102,3,4.383909812807431,7
1470,94,13,43,5,4.383571822547892,8
1471,11,63,86,28,4.377353463167258,35
1472,63,38,96,15,4.376849709142971,23
1473,74,13,9,5,4.37578055371931,8
1474,39,14,81,6,4.374351069268694,8
1475,60,13,98,6,4.372454949323835,7
1476,55,24,9,10,4.371040618945099,14
1477,13,26,77,11,4.37009974510294,15
1478,55,13,58,6,4.369004483506264,7
1479,40,23,23,10,4.368423326803309,13
1480,33,13,11,7,4.365968233102095,6
1481,58,10,87,4,4.362695393524183,6
1482,104,31,54,14,4.355933806560286,17
1483,47,24,88,11,4.347102674354304,13
1484,60,12,22,5,4.334241842742782,7
1485,95,19,41,8,4.332143979792177,11
1486,15,19,86,8,4.320856963962771,11
1487,4,22,40,10,4.316643149060896,12
1488,17,19,20,8,4.3112321942034,11
1489,50,10,52,5,4.308197298973349,5
1490,20,22,109,8,4.302333411252667,14
1491,25,28,54,12,4.300413553073274,16
1492,20,21,44,9,4.299103845073809,12
1493,11,17,35,7,4.299025397751417,10
1494,53,25,112,13,4.294359182673499,12
1495,85,14,96,5,4.283571776810651,9
1496,33,12,96,7,4.271042933020869,5
1497,6,26,7,14,4.269618286715636,12
1498,13,53,39,24,4.2610832635027345,29
1499,80,11,60,5,4.259959127961849,6
1500,104,17,80,8,4.256665633473226,9
1501,20,22,46,8,4.241307956001942,14
1502,31,12,74,5,4.240578281890586,7
1503,30,20,28,8,4.226225794824841,12
1504,39,18,37,8,4.2244562944231046,10
1505,39,24,5,11,4.222693276685166,13
1506,27,11,112,5,4.214543381192911,6
1507,46,20,17,9,4.208745383811279,11
1508,43,26,60,11,4.207805100047994,15
1509,65,56,36,24,4.205692860728479,32
1510,78,15,54,6,4.204577974310618,9
1511,23,18,100,7,4.197161790157007,11
1512,7,14,48,7,4.194687020035504,7
1513,40,55,88,24,4.188882138376305,31
1514,23,27,25,12,4.182190113226028,15
1515,70,19,9,7,4.17870836598717,12
1516,13,74,51,34,4.175645973323164,40
1517,40,22,50,8,4.17370334148128,14
1518,53,15,62,7,4.1594095703321505,8
1519,60,10,62,4,4.155747625311636,6
1520,74,21,109,8,4.146368967750308,13
1521,20,13,73,5,4.146065391689569,8
1522,53,47,71,20,4.141303557057986,27
1523,100,18,74,8,4.138016461047893,10
1524,23,11,29,5,4.138000210796417,6
1525,11,11,69,4,4.13792149131312,7
1526,76,32,104,13,4.1357118218948905,19
1527,6,14,107,6,4.134287277974907,8
1528,64,19,18,8,4.124127361254889,11
1529,29,11,106,5,4.122686341567239,6
1530,27,16,87,7,4.120246149042717,9
1531,12,14,68,6,4.108669111305504,8
1532,114,21,46,9,4.104107153511736,12
1533,93,14,109,6,4.103558953267082,8
1534,83,20,93,9,4.100880722204593,11
1535,87,26,64,12,4.098181725889203,14
1536,36,11,19,5,4.088590218421688,6
1537,74,22,50,10,4.086243740312162,12
1538,68,20,38,8,4.069118441023081,12
1539,43,12,109,5,4.068059286395715,7
1540,60,57,40,25,4.067256254892929,32
1541,68,31,1,13,4.065789317113102,18
1542,9,29,63,13,4.065325398742935,16
1543,43,10,95,4,4.063398320607949,6
1544,16,28,80,12,4.056076921695064,16
1545,107,23,62,12,4.0504669700597535,11
1546,41,40,68,18,4.050286581746884,22
1547,32,10,40,5,4.050021677419869,5
1548,11,13,79,7,4.047561716338114,6
1549,7,21,50,10,4.045740478776832,11
1550,13,23,3,8,4.045454302839317,15
1551,1,10,43,5,4.038976715758721,5
1552,96,30,88,14,4.030096740212507,16
1553,104,16,3,7,4.020656220421076,9
1554,102,28,114,12,4.017120825737178,16
1555,8,20,110,8,4.013172679497404,12
1556,55,36,54,17,4.011039158800403,19
1557,99,20,86,8,4.0098912228328505,12
1558,66,12,31,5,4.008754872558654,7
1559,58,10,51,4,3.9912030401078082,6
1560,97,32,65,14,3.9859775040058776,18
1561,34,17,17,7,3.985705258546001,10
1562,41,14,43,6,3.977377796491963,8
1563,96,12,14,5,3.975747798085754,7
1564,104,72,65,33,3.97064919727685,39
1565,74,24,93,11,3.9601017688790825,13
1566,88,50,104,21,3.9536343834384886,29
1567,34,12,76,6,3.9517678907570333,6
1568,37,17,100,7,3.9481789557688414,10
1569,87,32,40,15,3.9412626429874287,17
1570,80,10,97,4,3.9365866928471034,6
1571,102,10,83,4,3.9358085201394095,6
1572,64,13,15,7,3.9332029302911167,6
1573,16,20,3,8,3.933123710020239,12
1574,16,20,38,7,3.9302083923805924,13
1575,57,11,50,4,3.9290278222481443,7
1576,100,21,13,9,3.928732330408649,12
1577,5,28,2,12,3.923277825320168,16
1578,37,38,70,16,3.9227382855891664,22
1579,50,48,107,22,3.915403186530734,26
1580,98,19,49,9,3.906322793569991,10
1581,102,26,37,11,3.9015784283610255,15
1582,7,29,47,12,3.897446682675393,17
1583,17,16,63,7,3.896935952486399,9
1584,41,13,112,6,3.8951638477899233,7
1585,55,44,11,18,3.8920841591670343,26
1586,76,13,62,6,3.8913968956310088,7
1587,11,15,17,7,3.886158778436342,8
1588,65,73,107,32,3.8798906813939733,41
1589,18,13,98,7,3.8754830902904014,6
1590,16,46,70,19,3.872285837038859,27
1591,95,36,87,16,3.86940077356921,20
1592,108,11,68,5,3.868849039567309,6
1593,11,16,51,8,3.8660778701548058,8
1594,91,17,18,7,3.863168888646893,10
1595,41,25,114,12,3.854494902198664,13
1596,65,14,6,6,3.853639209419111,8
1597,54,28,68,12,3.8524478248196368,16
1598,65,34,111,14,3.8475275648066685,20
1599,93,19,86,8,3.841500133967818,11
1600,60,25,9,9,3.8302277634578608,16
1601,70,30,51,14,3.8297117807076555,16
1602,44,16,87,7,3.8267549460576484,9
1603,60,12,66,4,3.826632219817407,8
1604,55,21,4,10,3.821660634263142,11
1605,49,10,3,4,3.8208441036339096,6
1606,91,18,31,7,3.8197018311679423,11
1607,20,46,28,20,3.8165416775061547,26
1608,110,16,5,7,3.8138584796050923,9
1609,39,12,78,6,3.805891795343841,6
1610,20,13,104,5,3.7974160411444706,8
1611,44,19,6,7,3.787510949793907,12
1612,28,12,49,6,3.781572164594755,6
1613,112,19,65,9,3.778140966593066,10
1614,104,13,92,7,3.7768187223532306,6
1615,88,16,6,7,3.757051253043465,9
1616,65,43,9,18,3.756511153961385,25
1617,15,21,65,9,3.7445792583431645,12
1618,53,42,40,19,3.7429391558119995,23
1619,1,13,4,5,3.736039087851971,8
1620,86,65,25,30,3.735239092039536,35
1621,75,42,88,18,3.726903391628384,24
1622,91,10,80,4,3.7198935399827406,6
1623,15,21,5,8,3.714734226349825,13
1624,3,30,68,13,3.7122120868876887,17
1625,106,17,43,8,3.7068539679712273,9
1626,28,28,102,13,3.6997830630198973,15
1627,13,68,40,31,3.690363085789059,37
1628,46,20,84,8,3.686829488531013,12
1629,101,14,68,5,3.6742625668258913,9
1630,71,12,27,5,3.672482180614424,7
1631,20,25,80,11,3.67142842734406,14
1632,51,43,41,19,3.670366887504243,24
1633,102,16,65,8,3.6702036238670748,8
1634,62,10,50,4,3.6657345895143245,6
1635,19,10,88,5,3.6656067392732057,5
1636,86,53,104,24,3.66553549979236,29
1637,100,28,86,14,3.6578232778165285,14
1638,97,33,96,16,3.657438935158263,17
1639,53,11,100,5,3.656950058764998,6
1640,63,22,23,9,3.656375723040438,13
1641,90,10,71,5,3.6561036030201253,5
1642,107,21,32,10,3.6546977761524686,11
1643,76,35,107,13,3.6519592132431544,22
1644,23,47,65,22,3.6506323242088645,25
1645,27,13,50,5,3.6503401008022798,8
1646,16,19,2,8,3.6499962386684337,11
1647,30,20,37,8,3.640395609700316,12
1648,88,60,5,28,3.63799769202775,32
1649,75,14,108,6,3.6340908116173014,8
1650,48,11,108,4,3.6336145248971845,7
1651,43,19,18,10,3.6267699505365183,9
1652,87,27,109,11,3.6214670850147486,16
1653,13,63,60,26,3.6198276441550075,37
1654,86,51,46,20,3.616596365260086,31
1655,28,16,62,7,3.6140960069707964,9
1656,18,29,60,13,3.5981861482906186,16
1657,108,24,51,11,3.591871830422868,13
1658,114,35,51,17,3.589681659955981,18
1659,97,10,95,4,3.58943247133478,6
1660,69,11,20,5,3.5870175414258565,6
1661,63,14,45,6,3.582850982463552,8
1662,63,10,85,5,3.5623843213347812,5
1663,64,11,33,4,3.5581108018586245,7
1664,23,13,57,6,3.554408044637193,7
1665,16,31,49,14,3.5542822347062724,17
1666,40,65,36,28,3.5400829247343655,37
1667,44,15,7,7,3.5352660207554516,8
1668,20,17,76,9,3.5278207011714735,8
1669,43,11,68,5,3.5239997356866324,6
1670,112,11,17,5,3.5191492672023625,6
1671,97,22,17,10,3.51760245978497,12
1672,16,34,62,14,3.517446163588128,20
1673,8,38,104,17,3.50734140656749,21
1674,91,15,84,7,3.506943767095505,8
1675,49,10,33,4,3.5057518320537766,6
1676,74,16,23,7,3.505315761927058,9
1677,85,14,68,5,3.5027894631624408,9
1678,50,26,9,11,3.4989626487903873,15
1679,97,36,114,16,3.4948097299506915,20
1680,17,26,39,11,3.4929964025106597,15
1681,109,15,65,5,3.4929763691198916,10
1682,62,13,36,6,3.489528327052378,7
1683,25,20,70,9,3.484518115943736,11
1684,55,16,18,8,3.4810467173744706,8
1685,70,28,65,11,3.478419403846195,17
1686,50,69,28,30,3.4770086085643532,39
1687,96,57,54,28,3.4766133859583515,29
1688,23,10,81,4,3.474530372802633,6
1689,73,14,16,7,3.4738693799097953,7
1690,74,60,5,28,3.469996146708342,32
1691,9,26,54,12,3.4668855776458427,14
1692,30,19,106,9,3.463995690702536,10
1693,13,32,1,13,3.4629329225242813,19
1694,20,46,37,21,3.4576214767552655,25
1695,106,49,51,22,3.457607975311814,27
1696,33,23,5,11,3.454327509177194,12
1697,23,26,68,13,3.4540478778402126,13
1698,37,21,23,10,3.453043705748743,11
1699,93,10,114,4,3.4434774013838236,6
1700,102,31,25,14,3.4382241991917164,17
1701,57,31,16,14,3.4276208989375307,17
1702,4,12,37,5,3.421871703775507,7
1703,68,21,46,10,3.4173658858402485,11
1704,104,26,98,14,3.4091853213510754,12
1705,18,54,53,25,3.397966382939779,29
1706,4,13,28,6,3.3940824912486867,7
1707,43,28,40,13,3.3929222536074835,15
1708,73,10,104,4,3.391491099464731,6
1709,39,48,55,21,3.389422612270981,27
1710,20,34,16,13,3.388923725368007,21
1711,36,28,55,13,3.383336577257353,15
1712,73,15,98,7,3.380055365181917,8
1713,107,56,55,26,3.3696189355898034,30
1714,40,17,20,7,3.3649339637959645,10
1715,54,25,97,12,3.3648153427656755,13
1716,14,23,8,10,3.3634201583462158,13
1717,28,22,71,9,3.3619344486700466,13
1718,7,48,27,22,3.361741499616722,26
1719,88,15,112,6,3.3574409261865963,9
1720,54,12,3,6,3.355227899021248,6
1721,87,18,47,8,3.351186620999735,10
1722,83,10,20,5,3.3478898251644025,5
1723,40,15,91,7,3.345577169162442,8
1724,75,13,33,5,3.342736023465548,8
1725,54,20,98,9,3.3414082574982986,11
1726,68,13,5,6,3.3380294056441144,7
1727,71,13,76,7,3.3359186512389036,6
1728,64,30,39,13,3.324524230733537,17
1729,60,29,8,14,3.3236661751594205,15
1730,64,10,57,4,3.3215297930391765,6
1731,97,16,84,6,3.316428205809935,10
1732,60,31,75,14,3.3139158628036856,17
1733,86,11,66,5,3.3092941516234364,6
1734,13,110,7,50,3.3089382778797347,60
1735,86,80,84,40,3.306900749327819,40
1736,104,60,5,28,3.3007473735225052,32
1737,64,14,108,7,3.2970856020365416,7
1738,41,17,50,7,3.2946411387183265,10
1739,81,14,18,6,3.285175513857385,8
1740,16,18,45,7,3.276855643218357,11
1741,114,13,67,6,3.2746706512348434,7
1742,102,11,91,5,3.2738070744638943,6
1743,70,14,93,6,3.271451863431868,8
1744,98,23,76,10,3.2651133620022033,13
1745,109,25,13,11,3.261500174975238,14
1746,76,14,95,6,3.2576515088397957,8
1747,7,24,74,9,3.257493143792888,15
1748,84,14,95,6,3.2568961944145873,8
1749,114,47,25,20,3.2540864225169766,27
1750,94,15,107,5,3.253497352477997,10
1751,11,25,20,10,3.2452743370759327,15
1752,107,49,36,23,3.234838704648264,26
1753,56,10,97,5,3.231426212036921,5
1754,4,21,16,11,3.2239938149007976,10
1755,23,55,7,25,3.2229283053761675,30
1756,97,29,63,13,3.2191950537106915,16
1757,55,39,28,16,3.2184704312839787,23
1758,64,19,23,9,3.212372911598019,10
1759,50,19,97,8,3.210625734622642,11
1760,60,47,31,24,3.2094707274879264,23
1761,44,12,76,5,3.2019945343572473,7
1762,36,41,39,18,3.1998605067578225,23
1763,55,49,5,22,3.1989531771818034,27
1764,68,14,81,6,3.1985312995714845,8
1765,65,38,71,16,3.190433336986385,22
1766,37,54,50,26,3.188335276013606,28
1767,83,25,65,12,3.1850517665827933,13
1768,47,11,69,5,3.1775295332798312,6
1769,88,56,68,25,3.171688752257409,31
1770,106,25,60,10,3.171261503808182,15
1771,110,16,86,7,3.1694821197260503,9
1772,90,14,74,5,3.1680613510289204,9
1773,13,17,62,8,3.1612952767397977,9
1774,23,32,87,13,3.1607512154600745,19
1775,86,21,82,9,3.1586560919846263,12
1776,87,31,84,14,3.1565105897665346,17
1777,46,21,63,11,3.15628045747171,10
1778,75,23,23,12,3.1487336010920157,11
1779,86,20,32,9,3.136567451220029,11
1780,16,70,8,31,3.1304849607513625,39
1781,51,64,107,26,3.1254338730064406,38
1782,88,52,28,22,3.125246672673828,30
1783,5,27,91,11,3.121858390948631,16
1784,36,11,80,5,3.115857421175661,6
1785,53,29,55,13,3.115426410914569,16
1786,25,25,17,11,3.1106502600539105,14
1787,50,24,4,12,3.110559237136959,12
1788,109,25,106,12,3.1028448270841773,13
1789,92,15,60,6,3.101629065738582,9
1790,99,14,68,6,3.1001036150844663,8
1791,64,10,91,4,3.0993479020870796,6
1792,6,20,16,10,3.089484314971671,10
1793,45,14,87,6,3.0862202973256596,8
1794,98,22,37,10,3.078006071981288,12
1795,74,11,41,6,3.0735662157516845,5
1796,75,30,25,13,3.069551733540898,17
1797,60,40,114,22,3.0670908685799034,18
1798,97,24,46,11,3.066170643508983,13
1799,71,18,25,8,3.0644100067848146,10
1800,48,14,55,6,3.06362691776684,8
1801,38,13,96,6,3.0422152322461717,7
1802,25,39,65,16,3.0368934823131175,23
1803,98,18,51,8,3.0331574033151076,10
1804,41,16,47,7,3.031406429138557,9
1805,35,13,84,6,3.030499439916225,7
1806,78,10,55,5,3.027993385213423,5
1807,27,21,41,10,3.0118100527811418,11
1808,4,17,18,7,3.005461987416452,10
1809,50,16,30,7,3.004950949655304,9
1810,38,21,13,11,3.00372637969711,10
1811,88,19,38,7,3.0023329742590956,12
1812,96,14,34,6,3.0017630147825622,8
1813,31,21,58,10,2.9999355657905133,11
1814,4,11,69,5,2.999484176661719,6
1815,11,46,107,21,2.9990181027783187,25
1816,64,28,41,11,2.9985462284656723,17
1817,27,10,18,5,2.996654278290002,5
1818,65,37,37,18,2.9918797859979525,19
1819,74,10,30,5,2.9862406732405895,5
1820,15,23,7,12,2.98132244522486,11
1821,95,27,53,10,2.9811343498680327,17
1822,10,12,84,5,2.980259678929738,7
1823,87,35,60,17,2.9762532182299,18
1824,36,32,4,13,2.9739066740354185,19
1825,18,33,51,16,2.9698165149321127,17
1826,2,21,37,10,2.9697580112694486,11
1827,47,11,53,5,2.9672181618537916,6
1828,29,10,36,4,2.96671622803696,6
1829,7,89,86,38,2.9562630867796154,51
1830,80,16,8,8,2.9519293865537115,8
1831,86,78,8,38,2.9505503650201574,40
1832,86,105,87,52,2.9421188588877047,53
1833,86,73,54,34,2.938346211941294,39
1834,30,17,76,7,2.9372015853586086,10
1835,36,20,87,8,2.935573250897663,12
1836,49,11,97,4,2.9318959143747887,7
1837,99,15,65,7,2.9253489592007305,8
1838,102,19,106,10,2.9207255392565097,9
1839,25,12,108,5,2.9132670669268244,7
1840,7,104,68,47,2.9094827437647193,57
1841,91,19,37,9,2.9050960547005245,10
1842,71,13,108,6,2.8992906212622866,7
1843,107,44,23,21,2.8979165012177974,23
1844,44,10,70,5,2.8975248911261433,5
1845,12,13,3,5,2.89161361518273,8
1846,75,24,74,10,2.8903655619324433,14
1847,43,31,7,13,2.8869337290340304,18
1848,69,17,87,8,2.88624107715955,9
1849,107,25,3,13,2.8816945157688134,12
1850,94,17,87,8,2.8778163111812196,9
1851,107,50,60,22,2.8774264827145735,28
1852,63,23,60,10,2.8746236800640075,13
1853,70,25,20,11,2.859987655566424,14
1854,51,18,99,9,2.853477797374065,9
1855,74,20,18,10,2.84961422222247,10
1856,97,13,33,6,2.8486496222061595,7
1857,23,13,104,5,2.8445076862849494,8
1858,16,100,86,45,2.8435049478583028,55
1859,3,14,50,7,2.8431293488179508,7
1860,36,32,9,14,2.842981887107707,18
1861,95,19,23,9,2.8404436396815522,10
1862,89,12,60,6,2.839673113881044,6
1863,30,20,68,10,2.8393809182025875,10
1864,77,18,65,9,2.836180648453274,9
1865,104,33,74,14,2.8329598216365466,19
1866,18,13,71,6,2.821320109059578,7
1867,64,13,47,5,2.8212403790572256,8
1868,76,28,87,12,2.81900529826996,16
1869,99,17,15,7,2.8189668514207984,10
1870,68,33,106,15,2.8127952198562456,18
1871,18,35,107,14,2.8126640539885583,21
1872,86,73,20,33,2.812574705202228,40
1873,99,15,41,7,2.8081672918617278,8
1874,71,40,86,19,2.801854185507108,21
1875,4,25,114,12,2.797376255941943,13
1876,7,26,1,12,2.7932054952385035,14
1877,100,13,36,6,2.7923934619121087,7
1878,86,19,108,10,2.7920033870005008,9
1879,97,37,107,18,2.790784506784008,19
1880,9,15,97,8,2.7891659901703596,7
1881,88,67,107,29,2.788634980843412,38
1882,9,14,38,7,2.77647152671147,7
1883,96,15,13,7,2.773454366126087,8
1884,5,11,10,6,2.7716738654503197,5
1885,86,92,28,41,2.7696595786946703,51
1886,13,85,65,38,2.7590429387625766,47
1887,53,42,64,19,2.759026680292717,23
1888,87,81,107,37,2.7417805805813034,44
1889,97,22,104,11,2.7396377781056174,11
1890,107,29,4,14,2.73852865052638,15
1891,65,50,106,23,2.735321183024918,27
1892,98,26,107,12,2.7337807533135248,14
1893,75,12,34,6,2.7327928404854553,6
1894,87,40,20,19,2.7281534933615226,21
1895,104,31,70,14,2.720810924975006,17
1896,95,11,80,5,2.7197438471090796,6
1897,16,21,33,8,2.7169085795346413,13
1898,107,57,37,26,2.7122377942768776,31
1899,43,27,65,14,2.704466819899112,13
1900,28,53,65,24,2.7033251524777993,29
1901,2,20,87,9,2.6997368834124105,11
1902,88,32,109,14,2.698492977632003,18
1903,68,78,13,35,2.6939178558824075,43
1904,90,17,17,9,2.680753861205159,8
1905,25,17,44,8,2.673535476281759,9
1906,95,18,75,8,2.672802736686619,10
1907,94,11,68,4,2.6704707014810847,7
1908,114,25,74,12,2.666972342657447,13
1909,51,31,109,12,2.6658568783873675,19
1910,47,10,76,7,2.6595736051653853,3
1911,74,13,91,6,2.658254293210725,7
1912,53,38,51,18,2.6567672529233444,20
1913,92,29,88,13,2.6541256559252315,16
1914,53,48,65,23,2.651912649859134,25
1915,30,24,8,11,2.6514132136935467,13
1916,47,22,51,11,2.649428689191073,11
1917,17,41,51,20,2.64917403943342,21
1918,23,43,86,20,2.6484576158238533,23
1919,62,23,71,11,2.646301685866918,12
1920,60,56,88,25,2.645544371153806,31
1921,16,34,17,14,2.6438423092128276,20
1922,16,60,5,25,2.6435184456824317,35
1923,86,28,62,13,2.642237041880456,15
1924,33,14,95,6,2.641545389608455,8
1925,86,31,18,13,2.6381646032412545,18
1926,68,13,8,6,2.636586364754952,7
1927,54,28,114,14,2.6355280322257,14
1928,71,33,39,15,2.629192013747391,18
1929,41,44,16,22,2.6236346308099385,22
1930,11,12,41,4,2.61594797809933,8
1931,7,25,17,11,2.6142771621918555,14
1932,76,13,2,5,2.6134640032331116,8
1933,57,17,13,9,2.6131890409516005,8
1934,109,29,16,14,2.610188033474427,15
1935,36,23,91,10,2.600483205457648,13
1936,15,15,57,7,2.596980169377469,8
1937,40,19,27,11,2.5947052105553365,8
1938,39,23,31,10,2.5934090452929373,13
1939,80,32,54,16,2.5928190955886388,16
1940,87,21,62,10,2.586304566496697,11
1941,104,50,7,23,2.5854072339864183,27
1942,87,55,88,28,2.583232804809496,27
1943,57,11,20,5,2.572722724988935,6
1944,47,11,91,5,2.565831417578021,6
1945,91,28,107,12,2.5653431282322665,16
1946,92,13,87,6,2.565186954563254,7
1947,83,10,63,6,2.557624644664858,4
1948,86,14,14,7,2.5565201304900333,7
1949,55,52,88,22,2.5540628419606892,30
1950,73,19,1,8,2.55342910039073,11
1951,13,26,20,11,2.5463784696778813,15
1952,52,13,16,6,2.542332195506542,7
1953,91,34,86,16,2.5421304216054588,18
1954,64,38,88,17,2.5413991674458067,21
1955,63,35,11,14,2.539597707853179,21
1956,111,11,60,4,2.535604443502029,7
1957,16,83,65,38,2.5324454922464295,45
1958,39,18,4,8,2.5267698999647226,10
1959,11,13,68,6,2.5250619833588033,7
1960,39,32,50,15,2.5245695496572065,17
1961,60,44,86,20,2.5193623407260137,24
1962,12,15,36,7,2.516319942513749,8
1963,62,18,39,9,2.5162035004252656,9
1964,63,30,13,14,2.513355364840314,16
1965,74,81,86,39,2.5025770549212383,42
1966,37,18,109,8,2.501013404341532,10
1967,11,20,48,9,2.499763597895506,11
1968,65,20,3,9,2.497136850038322,11
1969,87,20,31,10,2.492676559594957,10
1970,18,11,111,5,2.4899108726358863,6
1971,95,30,39,14,2.481130681096554,16
1972,16,79,13,36,2.481046846177394,43
1973,7,61,9,30,2.475604646115282,31
1974,36,28,51,13,2.4708671287104758,15
1975,46,50,5,22,2.4690859933319382,28
1976,4,17,81,7,2.4678124777063273,10
1977,87,40,74,18,2.4671563114027473,22
1978,54,10,27,5,2.4638694969344774,5
1979,107,18,85,8,2.4579163644894475,10
1980,39,46,53,21,2.4451604588200344,25
1981,32,10,50,6,2.444054190716271,4
1982,9,37,51,18,2.442051118378038,19
1983,55,39,106,17,2.438139246666604,22
1984,87,21,99,9,2.4324110326808843,12
1985,91,20,75,13,2.432369433261267,7
1986,13,66,55,31,2.4199750349971696,35
1987,109,11,99,5,2.4195174025010595,6
1988,107,46,25,22,2.4187485647838765,24
1989,8,33,93,16,2.4111455321691304,17
1990,86,19,77,8,2.4096878419842773,11
1991,56,10,8,4,2.40008605471798,6
1992,85,10,7,4,2.393255933560983,6
1993,83,22,87,11,2.390357141943488,11
1994,111,12,8,6,2.390343846489095,6
1995,104,40,95,18,2.3890342183876085,22
1996,4,21,71,8,2.3871750117365993,13
1997,96,25,104,11,2.3866419839158346,14
1998,75,13,56,5,2.3840139649043497,8
1999,54,18,49,9,2.382044302967445,9
2000,55,28,84,13,2.379086300412449,15
2001,54,46,51,22,2.3757346140076483,24
2002,69,10,96,4,2.3715807543077463,6
2003,8,55,96,25,2.371439357092425,30
2004,7,19,70,7,2.364945757295021,12
2005,104,37,106,18,2.363471674556246,19
2006,99,23,5,11,2.3616219022642833,12
2007,96,14,109,6,2.3566759619593642,8
2008,4,36,31,15,2.3535355966794667,21
2009,13,15,12,9,2.3425974502134457,6
2010,49,20,51,9,2.337593611464387,11
2011,104,17,4,7,2.3357072159096575,10
2012,25,28,53,14,2.3301510854690854,14
2013,50,23,64,11,2.3285304422785047,12
2014,104,21,102,11,2.320627297470276,10
2015,63,87,86,37,2.32018364824965,50
2016,65,24,69,11,2.3193082814773094,13
2017,34,28,107,12,2.319293954101742,16
2018,84,13,57,7,2.317662899604203,6
2019,9,23,3,11,2.3162904113567784,12
2020,107,18,69,8,2.3046147553707854,10
2021,23,13,109,6,2.301790643179129,7
2022,9,22,58,10,2.299181283311467,12
2023,68,16,109,6,2.2985123206238915,10
2024,106,36,96,16,2.2984565902488905,20
2025,100,24,5,11,2.2932427434044684,13
2026,114,18,45,8,2.292094813707232,10
2027,94,10,114,4,2.2912532605689226,6
2028,68,19,78,9,2.2881985924711277,10
2029,106,13,4,7,2.287883468044352,6
2030,50,21,31,10,2.283882121200706,11
2031,37,46,74,22,2.283869095408045,24
2032,80,16,71,8,2.275392383804814,8
2033,61,10,31,5,2.2696136748473603,5
2034,28,66,96,31,2.267406944603933,35
2035,60,24,46,11,2.2638066641840875,13
2036,51,50,60,21,2.256280048678221,29
2037,95,30,25,14,2.25397314365567,16
2038,41,14,54,7,2.251101436056138,7
2039,20,25,7,12,2.2510516710421498,13
2040,87,43,28,21,2.245948853463187,22
2041,88,38,4,18,2.2459217004175493,20
2042,87,35,104,18,2.2393020839894087,17
2043,81,14,3,6,2.2358028798300924,8
2044,68,25,70,12,2.2334926025833988,13
2045,90,16,25,7,2.2261576936837058,9
2046,28,16,100,7,2.2255414738387724,9
2047,88,11,33,6,2.22422094342155,5
2048,1,22,51,11,2.2233051744545986,11
2049,11,11,114,6,2.222333602098374,5
2050,98,13,99,7,2.2212581677933785,6
2051,104,11,69,4,2.217479448350339,7
2052,112,11,8,6,2.2144684353504553,5
2053,28,38,51,19,2.2134732604167904,19
2054,5,50,96,22,2.2114271922507607,28
2055,112,12,40,6,2.2105918484505556,6
2056,57,19,55,10,2.2104060039233278,9
2057,49,51,13,25,2.209069641169752,26
2058,107,50,106,24,2.1993074270722803,26
2059,60,57,16,27,2.197502548183127,30
2060,51,31,84,14,2.1892581830667415,17
2061,8,64,74,28,2.186622040651489,36
2062,63,26,70,12,2.1813121472430437,14
2063,39,45,49,20,2.1782029000103345,25
2064,33,11,39,5,2.170155887452032,6
2065,11,22,13,11,2.1659141415387677,11
2066,88,14,74,5,2.165363961250821,9
2067,17,12,84,6,2.1646737051112885,6
2068,88,65,51,33,2.1624171882527143,32
2069,49,16,9,8,2.159298612128284,8
2070,20,16,48,7,2.152557944212157,9
2071,80,17,7,7,2.151623343669696,10
2072,87,27,46,14,2.1507851989480726,13
2073,49,21,17,8,2.1421419201328824,13
2074,11,49,28,24,2.139899963041059,25
2075,15,17,68,7,2.1350807224391315,10
2076,28,18,57,8,2.12876321997401,10
2077,72,14,16,7,2.1283970579297695,7
2078,28,30,91,14,2.1280361219889317,16
2079,53,11,70,5,2.117480208536356,6
2080,1,20,64,10,2.1164326209593654,10
2081,11,15,40,7,2.115832802221001,8
2082,48,13,30,7,2.114145406665778,6
2083,74,12,33,6,2.113811361820999,6
2084,81,18,88,9,2.113043846902455,9
2085,97,21,70,9,2.1100037608471256,12
2086,8,23,100,10,2.1093275750438316,13
2087,20,23,35,10,2.103616009688827,13
2088,99,24,60,11,2.100940382067205,13
2089,28,62,5,30,2.1003743399505708,32
2090,109,22,84,10,2.0978150302320926,12
2091,83,34,55,17,2.0962093979720215,17
2092,16,15,29,8,2.0960967700074415,7
2093,97,22,8,11,2.094799206270941,11
2094,7,73,36,34,2.0934963107077063,39
2095,41,23,69,9,2.083110319413397,14
2096,98,13,114,6,2.082503686116617,7
2097,109,50,5,25,2.0811517758308082,25
2098,82,10,63,5,2.077975861296688,5
2099,77,52,60,24,2.0764857415563522,28
2100,46,36,28,15,2.067281553252178,21
2101,50,23,114,10,2.0649465321872778,13
2102,68,16,49,8,2.0637805548779458,8
2103,13,22,45,10,2.063714442075686,12
2104,3,25,31,13,2.0628076616728963,12
2105,86,33,3,15,2.0568330726615542,18
2106,84,17,9,8,2.0546690063899433,9
2107,65,31,80,15,2.0509198465423397,16
2108,23,17,54,8,2.0401263588538048,9
2109,90,24,60,10,2.0397275719261816,14
2110,89,14,88,7,2.0354634990614118,7
2111,58,12,63,7,2.0345686518653676,5
2112,8,42,20,20,2.032934980330156,22
2113,91,14,114,7,2.0312426341433967,7
2114,38,10,80,4,2.0310395723254193,6
2115,55,12,73,6,2.0248295643907164,6
2116,75,30,87,14,2.0247725005088753,16
2117,29,18,107,7,2.0238382608603613,11
2118,8,36,90,16,2.0194647820717804,20
2119,4,10,58,4,2.0168974614800463,6
2120,9,44,40,20,2.013131078746107,24
2121,12,20,51,9,2.003059252583365,11
2122,65,57,68,26,2.0015768761708967,31
2123,64,14,17,7,1.997717670710987,7
2124,69,24,7,12,1.9945381002011566,12
2125,104,15,112,7,1.99393597279257,8
2126,50,11,58,5,1.9915314759076346,6
2127,53,19,4,9,1.987694792892671,10
2128,48,13,13,6,1.9848220769452258,7
2129,28,38,25,16,1.9833898911599184,22
2130,72,13,7,6,1.9828862428029772,7
2131,88,33,37,15,1.9799898753785308,18
2132,75,16,97,7,1.9718298395799765,9
2133,86,62,55,29,1.9647331960922174,33
2134,78,15,87,8,1.9606966739631158,7
2135,50,11,35,5,1.9581460146246747,6
2136,60,10,94,5,1.9558814631865946,5
2137,78,12,71,6,1.95458083263832,6
2138,36,34,64,17,1.9485056781764598,17
2139,25,20,55,9,1.9429576796619945,11
2140,23,14,31,6,1.9392936999416424,8
2141,110,13,104,5,1.9388474450810558,8
2142,23,14,97,7,1.9330528734436567,7
2143,18,22,31,11,1.9306740719340916,11
2144,70,19,40,8,1.9276789997691202,11
2145,114,21,18,10,1.923577249757446,11
2146,80,25,28,12,1.9225523112040792,13
2147,70,21,41,11,1.919847111480952,10
2148,99,11,76,6,1.9173589523208343,5
2149,97,32,106,16,1.9159665785715099,16
2150,43,16,87,8,1.9112996055903815,8
2151,63,37,114,15,1.9099176429878706,22
2152,14,13,88,6,1.902096229341471,7
2153,106,26,17,11,1.8975243648116562,15
2154,20,35,106,16,1.890590591428699,19
2155,25,23,64,11,1.8857238852847684,12
2156,7,76,41,37,1.885480468158321,39
2157,2,41,8,20,1.8848654476169697,21
2158,8,14,79,8,1.8787453444383122,6
2159,60,16,83,7,1.8774619090517453,9
2160,87,49,54,22,1.875214789525944,27
2161,37,95,5,46,1.8654288703425719,49
2162,64,28,54,14,1.8650724062797466,14
2163,75,38,9,17,1.8631746984569542,21
2164,6,13,87,6,1.861104979629091,7
2165,87,61,106,30,1.856632619724249,31
2166,6,11,86,5,1.8539951054916266,6
2167,46,22,76,10,1.8507100299988166,12
2168,28,21,98,8,1.8460912305825183,13
2169,40,59,51,28,1.8453671538115297,31
2170,26,16,13,7,1.8451876959015547,9
2171,68,40,63,20,1.8432100569925858,20
2172,84,38,96,19,1.8356486827006797,19
2173,46,17,41,7,1.829610386306841,10
2174,7,14,29,8,1.8294106613069705,6
2175,74,29,13,14,1.8278354237299064,15
2176,44,13,114,6,1.8263733365516701,7
2177,69,18,114,10,1.822927242545525,8
2178,69,13,43,6,1.8213131651346808,7
2179,102,13,99,6,1.8212893413036875,7
2180,71,11,109,5,1.8196417828202216,6
2181,68,19,17,8,1.8171968616213476,11
2182,53,20,44,8,1.8141360189660767,12
2183,79,18,28,8,1.8130893193426152,10
2184,80,12,64,6,1.8118137894523878,6
2185,86,24,85,12,1.811803291410693,12
2186,84,21,80,9,1.8116947476965417,12
2187,40,18,111,9,1.8104998545748818,9
2188,36,22,25,11,1.8071440138268557,11
2189,8,65,28,30,1.8060421386611976,35
2190,7,56,18,28,1.7918330409813674,28
2191,86,44,90,20,1.789317395866341,24
2192,1,25,41,13,1.7850851573908948,12
2193,37,25,90,12,1.7816453937181782,13
2194,7,16,30,9,1.7803956295895678,7
2195,102,13,84,6,1.779322402529277,7
2196,71,10,20,4,1.778650300459979,6
2197,104,62,16,29,1.778027708852634,33
2198,49,15,8,6,1.7678498041146895,9
2199,84,26,70,12,1.7530345342228948,14
2200,4,31,68,15,1.751066192618154,16
2201,76,25,11,11,1.745006286070099,14
2202,3,28,51,16,1.744216757975369,12
2203,60,33,36,16,1.7416473627060747,17
2204,18,11,6,5,1.7414584600944751,6
2205,104,22,18,9,1.7410989710262748,13
2206,8,26,23,13,1.7400762718841152,13
2207,36,37,88,16,1.7392851936744347,21
2208,70,19,75,10,1.7314858975507377,9
2209,60,14,11,7,1.72978393860355,7
2210,50,13,12,8,1.7279667161947851,5
2211,83,11,50,6,1.7272952536822097,5
2212,8,49,11,22,1.725678638141755,27
2213,40,18,45,8,1.7249973927231157,10
2214,74,10,85,5,1.7134982697618455,5
2215,84,13,76,6,1.710890300241341,7
2216,51,22,43,11,1.7055396893146841,11
2217,48,10,37,5,1.7035937503192145,5
2218,41,33,63,16,1.6996369290219266,17
2219,20,16,102,8,1.6989391239814933,8
2220,36,15,23,9,1.6972875274185721,6
2221,20,20,2,9,1.6960385797633861,11
2222,96,11,67,6,1.6933647660310183,5
2223,28,10,31,5,1.6925325756046274,5
2224,43,19,114,10,1.6919225072028674,9
2225,51,56,68,29,1.6875805796494086,27
2226,9,40,86,18,1.6864437776494565,22
2227,75,14,2,7,1.68604849673709,7
2228,86,31,80,15,1.6766961831131937,16
2229,63,45,39,18,1.6729604614700202,27
2230,45,28,31,13,1.6710870406691087,15
2231,37,49,51,26,1.6543448329472816,23
2232,17,11,91,5,1.6541099131819834,6
2233,36,23,68,11,1.6511686348202657,12
2234,16,50,74,23,1.6504828930462028,27
2235,13,13,72,7,1.6496378216821228,6
2236,95,10,57,6,1.6443605111684718,4
2237,106,44,88,19,1.6421661548035555,25
2238,39,19,96,8,1.6315253594413592,11
2239,60,23,109,11,1.6294478610779166,12
2240,48,14,39,7,1.6162453840006812,7
2241,65,42,60,17,1.6141246546544779,25
2242,7,17,11,8,1.6096082788053923,9
2243,114,28,20,13,1.609390659763289,15
2244,79,11,54,4,1.607153398950684,7
2245,70,13,43,6,1.6071210379776917,7
2246,99,18,30,8,1.5949338139614577,10
2247,1,30,36,16,1.5919918411390332,14
2248,27,15,47,8,1.5911619270297648,7
2249,7,73,40,33,1.5888049712895005,40
2250,2,15,25,8,1.5845186001024008,7
2251,55,22,90,12,1.578656952498874,10
2252,84,61,107,29,1.563165104726148,32
2253,9,14,111,7,1.5621342613374551,7
2254,40,17,61,8,1.5607473214395389,9
2255,97,12,100,6,1.5601199386945834,6
2256,104,23,83,10,1.5563880557352996,13
2257,7,84,65,43,1.5543231245397546,41
2258,106,15,14,8,1.5523885439078582,7
2259,11,26,74,12,1.5483769164487977,14
2260,65,12,61,5,1.5448114274450557,7
2261,41,61,13,30,1.5422223527057684,31
2262,71,30,106,14,1.5367748054190211,16
2263,70,54,86,25,1.5265643039354155,29
2264,1,34,88,17,1.5234508852206479,17
2265,35,14,37,7,1.523131742310598,7
2266,43,12,8,6,1.5194230889621367,6
2267,98,11,78,5,1.5190069892875968,6
2268,46,12,55,5,1.5148590180899557,7
2269,84,30,50,15,1.5145533767727444,15
2270,13,40,28,19,1.496905145589235,21
2271,73,15,63,8,1.4760785674332926,7
2272,12,35,65,16,1.473980369401417,19
2273,11,17,32,9,1.4729852723414754,8
2274,86,32,2,16,1.4682447143488935,16
2275,49,15,30,7,1.4667608883534216,8
2276,63,89,65,43,1.4663105199346151,46
2277,114,57,88,28,1.462842245541163,29
2278,110,11,54,5,1.4614008940578211,6
2279,31,21,47,10,1.4606130980712668,11
2280,25,23,83,10,1.4597201880554966,13
2281,8,16,38,8,1.4562520429495758,8
2282,50,16,89,7,1.4560158637801317,9
2283,106,55,63,27,1.4485566818099482,28
2284,20,21,97,11,1.439527960881874,10
2285,50,28,25,14,1.4391705454909012,14
2286,68,13,57,7,1.4301339738569725,6
2287,76,27,70,12,1.4264215948460301,15
2288,106,14,110,7,1.4258595725562953,7
2289,36,35,45,19,1.423273124508123,16
2290,80,23,87,11,1.4202226913102636,12
2291,13,28,15,14,1.4143705369608406,14
2292,41,30,40,15,1.4126537270823982,15
2293,102,15,11,6,1.4114820984859568,9
2294,70,17,95,9,1.4011695857654913,8
2295,75,12,44,5,1.399837377533035,7
2296,16,10,56,4,1.3984899579645478,6
2297,20,19,95,9,1.3957034121223277,10
2298,91,13,9,6,1.3946381880594532,7
2299,7,15,83,6,1.3943529604549396,9
2300,100,25,106,13,1.3941621457208537,12
2301,44,25,16,13,1.3924747988210242,12
2302,17,15,74,7,1.3910983775391357,8
2303,88,17,35,8,1.3903417931875612,9
2304,69,15,9,7,1.3894868657900228,8
2305,15,15,114,7,1.385848653276297,8
2306,50,41,11,19,1.3816262941644981,22
2307,95,31,7,14,1.3809406634768675,17
2308,106,30,41,15,1.3806292559177733,15
2309,75,10,48,5,1.3711471542080278,5
2310,90,11,76,6,1.3711097869836062,5
2311,27,13,23,7,1.3665703255989456,6
2312,30,23,40,11,1.3656919842952282,12
2313,30,21,51,10,1.3637471878402043,11
2314,25,26,30,14,1.363384718034577,12
2315,68,31,104,16,1.3616459533032328,15
2316,53,44,60,20,1.3503746570549047,24
2317,97,37,88,18,1.349074362930903,19
2318,84,17,90,8,1.3434141546201468,9
2319,71,27,114,13,1.3431780041778802,14
2320,30,11,109,5,1.3395989531940025,6
2321,71,48,7,25,1.3388864417450883,23
2322,8,44,51,21,1.3380278840989286,23
2323,52,10,107,4,1.3362132651907572,6
2324,8,66,37,32,1.3357403383797626,34
2325,64,39,68,17,1.3356994520331131,22
2326,86,10,113,4,1.3345354513988568,6
2327,102,22,16,11,1.329260322482268,11
2328,107,73,28,34,1.3259515494671585,39
2329,61,13,3,7,1.3229217896944439,6
2330,74,18,80,9,1.3199661328668575,9
2331,46,60,88,30,1.317189159463411,30
2332,63,16,47,6,1.3162850335917953,10
2333,10,16,8,7,1.3145513780375315,9
2334,70,11,102,7,1.3043211125718095,4
2335,5,44,13,21,1.302350985374302,23
2336,65,69,41,31,1.2958844955738493,38
2337,2,22,74,10,1.2925512141562505,12
2338,97,20,109,10,1.283406905257821,10
2339,65,15,49,7,1.2832734530229162,8
2340,97,13,29,6,1.2800501845598786,7
2341,50,30,51,15,1.277023353905357,15
2342,47,12,28,6,1.2743522419217488,6
2343,8,82,55,42,1.2721684605222603,40
2344,107,37,70,19,1.271004560619494,18
2345,9,48,13,25,1.2661488409130515,23
2346,50,27,65,13,1.2644687002361983,14
2347,75,42,55,18,1.2635366494506202,24
2348,55,26,99,12,1.2605449554949548,14
2349,13,16,78,7,1.2552499756193611,9
2350,53,21,97,10,1.2490073902396577,11
2351,65,10,89,5,1.246766687204138,5
2352,104,12,43,5,1.2430962980218274,7
2353,107,18,112,8,1.2381580832699428,10
2354,71,25,31,12,1.2380158081615504,13
2355,63,16,95,8,1.233969730193377,8
2356,13,14,61,6,1.2296565256158196,8
2357,71,26,9,12,1.2262156519313812,14
2358,87,50,55,24,1.2223891795427406,26
2359,50,62,54,30,1.2219864026222231,32
2360,98,11,74,5,1.2137114800422117,6
2361,38,12,46,5,1.2117798317776198,7
2362,25,33,97,16,1.211209753293348,17
2363,58,12,71,6,1.2066349158549279,6
2364,37,25,84,12,1.200224547121566,13
2365,41,45,107,20,1.1979139523122342,25
2366,25,25,109,12,1.1927554377225935,13
2367,39,45,60,23,1.1851129417013597,22
2368,88,34,31,17,1.1836541894089576,17
2369,76,24,28,11,1.171307704252366,13
2370,48,28,16,13,1.1700437405112523,15
2371,65,16,48,7,1.1655305065337143,9
2372,27,38,68,17,1.1654046230648216,21
2373,86,47,30,24,1.1570405179503076,23
2374,9,34,39,18,1.1514145806091243,16
2375,8,43,65,21,1.1481048077830958,22
2376,60,73,71,35,1.1360670304013205,38
2377,88,31,91,15,1.1352768006015477,16
2378,63,16,49,8,1.135191913675407,8
2379,42,10,69,5,1.134758835620745,5
2380,48,15,109,7,1.133812900706227,8
2381,23,47,16,22,1.133588423461974,25
2382,53,27,86,15,1.1324157389121354,12
2383,36,26,106,13,1.1307287364062801,13
2384,81,19,107,10,1.1293503192154635,9
2385,33,13,114,7,1.1286658148323794,6
2386,61,18,88,10,1.1254133453483963,8
2387,25,17,57,8,1.1122394350713356,9
2388,23,14,112,7,1.1091414019210022,7
2389,63,47,40,22,1.1085655861732644,25
2390,96,18,2,9,1.1039761816908797,9
2391,54,16,33,7,1.1000953180608282,9
2392,27,16,106,9,1.0992702168895798,7
2393,54,70,107,35,1.0956537339891796,35
2394,39,36,28,18,1.0952634452451104,18
2395,14,16,11,7,1.0923565448715802,9
2396,40,13,74,6,1.0901529369074687,7
2397,65,46,39,20,1.089267893981286,26
2398,43,13,71,7,1.0882014078273523,6
2399,64,19,97,9,1.0748997556854092,10
2400,107,29,1,14,1.072552937399315,15
2401,67,20,37,9,1.0707700527635258,11
2402,106,12,66,5,1.070759127853136,7
2403,104,30,109,15,1.0638658496000608,15
2404,86,51,109,25,1.063455196646584,26
2405,18,35,87,16,1.0595333397572304,19
2406,16,32,90,17,1.0440460762774686,15
2407,90,21,88,11,1.0373159148886417,10
2408,45,14,3,7,1.0349134798027078,7
2409,71,34,88,15,1.0311330418182323,19
2410,35,22,7,11,1.0299988339542105,11
2411,112,17,9,8,1.0274983646093445,9
2412,8,21,17,11,1.026318191087208,10
2413,63,20,44,9,1.0233184771026502,11
2414,70,10,33,5,1.0222975969230632,5
2415,107,53,39,25,1.0139341154699544,28
2416,93,20,88,9,1.0138818382921346,11
2417,13,43,75,20,1.005364432264769,23
2418,68,14,6,6,1.005162162800652,8
2419,114,39,7,18,1.0047894280060632,21
2420,8,40,39,20,0.9993368710228037,20
2421,106,67,28,32,0.9916026418837893,35
2422,23,17,111,10,0.9902411232186314,7
2423,64,14,100,6,0.9873146869937531,8
2424,84,18,65,8,0.9824722158055605,10
2425,51,33,31,14,0.9782499075201472,19
2426,107,65,5,32,0.9748363761521144,33
2427,79,11,88,5,0.9736004729947267,6
2428,54,39,7,19,0.9734500394951369,20
2429,14,16,87,7,0.9719183858987279,9
2430,65,49,75,23,0.9671493682311952,26
2431,14,14,5,6,0.9561035605846475,8
2432,7,20,8,9,0.9446580951337806,11
2433,112,13,114,7,0.9421647262329379,6
2434,33,17,86,9,0.9246066959077469,8
2435,39,33,104,16,0.9243967556000993,17
2436,69,17,50,7,0.9188452019230828,10
2437,13,20,33,10,0.918120505460343,10
2438,106,100,86,49,0.9173221659807225,51
2439,86,59,13,30,0.9107558957716039,29
2440,36,35,75,19,0.9076169876586753,16
2441,23,13,3,6,0.9036934098771335,7
2442,107,65,63,35,0.9004862155219548,30
2443,68,17,74,7,0.9001065237726507,10
2444,8,24,48,11,0.8990865709573224,13
2445,71,38,107,17,0.8981755151573065,21
2446,107,31,46,16,0.8942764168819464,15
2447,3,10,106,5,0.8904989515497614,5
2448,77,21,4,10,0.8810684428976758,11
2449,74,45,65,23,0.8800404347092065,22
2450,111,47,68,24,0.8746288393374696,23
2451,7,27,49,15,0.8744069756975954,12
2452,86,43,68,20,0.8663708281809832,23
2453,55,21,71,9,0.863684832703073,12
2454,10,10,114,4,0.8617397018011257,6
2455,34,17,16,8,0.8560019455164203,9
2456,8,73,88,36,0.8508025087607854,37
2457,71,28,63,13,0.8479499084443569,15
2458,54,40,74,20,0.8415267564978521,20
2459,2,16,46,8,0.8285194662826778,8
2460,55,12,62,5,0.8240244688504355,7
2461,11,23,65,10,0.8217152797009966,13
2462,4,58,13,27,0.8162535782673928,31
2463,96,58,107,27,0.8081270899904945,31
2464,56,14,40,7,0.8062835825274064,7
2465,79,17,50,8,0.8036407520519759,9
2466,12,17,86,8,0.8013363403706056,9
2467,2,22,88,11,0.7956469041111237,11
2468,68,19,77,9,0.792948245018335,10
2469,5,16,77,8,0.7908065895997609,8
2470,16,36,40,17,0.7902451728478602,19
2471,28,11,78,6,0.7898078034632366,5
2472,11,28,39,14,0.7894372385849194,14
2473,18,19,65,10,0.7868157298210118,9
2474,32,10,13,5,0.783536384760421,5
2475,104,45,114,21,0.7777920700848383,24
2476,16,24,15,11,0.7772765056505548,13
2477,97,20,93,10,0.7717644600090583,10
2478,33,15,104,8,0.7704375614853092,7
2479,75,27,64,13,0.7678085379778312,14
2480,65,17,47,8,0.763886252367048,9
2481,28,27,48,13,0.7484805696104432,14
2482,3,20,71,10,0.744611540631482,10
2483,36,13,74,5,0.7437175733038444,8
2484,43,10,3,5,0.7421030202391293,5
2485,40,77,86,36,0.7352757671814381,41
2486,95,41,5,21,0.731606653431554,20
2487,15,23,25,10,0.7267013492378231,13
2488,69,12,3,5,0.7220114611067269,7
2489,57,20,41,9,0.716314492681499,11
2490,82,13,28,7,0.7153587234866209,6
2491,93,15,84,7,0.7145615095611303,8
2492,54,85,65,41,0.7126472318729192,44
2493,107,12,79,7,0.7098533031414666,5
2494,76,17,41,7,0.7098418871900407,10
2495,76,25,8,13,0.7077738529790866,12
2496,71,13,69,6,0.6992249594892737,7
2497,38,18,64,9,0.6972961224720624,9
2498,27,11,99,6,0.6941577039356042,5
2499,88,35,20,18,0.6826700796677485,17
2500,18,19,25,10,0.6816652439852776,9
2501,37,40,114,18,0.6680388190804037,22
2502,17,27,50,14,0.6674798453134683,13
2503,63,43,87,20,0.6645353122982498,23
2504,63,38,50,18,0.6599709375930062,20
2505,7,70,39,35,0.65708225310988,35
2506,16,26,98,13,0.6567917996699292,13
2507,39,38,41,20,0.6524626848349436,18
2508,60,49,68,23,0.6520217462577715,26
2509,98,16,50,8,0.6426219058041094,8
2510,62,16,37,6,0.6397394147846427,10
2511,25,25,41,14,0.6394054706376684,11
2512,111,17,36,8,0.6365354853619557,9
2513,114,54,86,27,0.6322094644097674,27
2514,4,28,64,13,0.6316212138641686,15
2515,11,11,97,6,0.6269874474505769,5
2516,27,10,11,4,0.6266769775986689,6
2517,36,33,71,17,0.6241330409639582,16
2518,37,46,28,22,0.6233491488996546,24
2519,51,58,55,29,0.6228899757373463,29
2520,109,13,40,7,0.6223424064374103,6
2521,76,30,96,14,0.6223340675935091,16
2522,39,12,29,6,0.6210417076734439,6
2523,34,13,13,7,0.6173280890452295,6
2524,51,24,23,12,0.6158723359304594,12
2525,91,16,70,7,0.6063303701253773,9
2526,16,60,54,28,0.6012047197573598,32
2527,63,15,34,7,0.6010869874219945,8
2528,50,55,86,29,0.5948795299571148,26
2529,96,45,87,23,0.5775655020876899,22
2530,11,51,16,22,0.5759421625629789,29
2531,23,12,53,6,0.5700661218932129,6
2532,28,17,60,7,0.5655437404205501,10
2533,97,31,2,15,0.5614740846174435,16
2534,87,50,39,24,0.5610049144101693,26
2535,83,10,2,5,0.5594397265150824,5
2536,3,10,4,5,0.5556184418282119,5
2537,5,49,54,23,0.5526115688513309,26
2538,92,17,7,7,0.5480230211986101,10
2539,104,55,13,27,0.5474902747445213,28
2540,106,10,1,5,0.539652861011431,5
2541,63,43,7,18,0.5381341307781913,25
2542,28,19,33,8,0.5377400393884932,11
2543,63,19,53,9,0.5367176376371676,10
2544,46,16,57,8,0.5297057406629254,8
2545,73,19,28,10,0.5214155246375574,9
2546,43,17,25,10,0.5197036131496171,7
2547,41,11,90,6,0.513841479320257,5
2548,114,11,38,6,0.5127819422302534,5
2549,4,18,9,9,0.5118055197130339,9
2550,51,22,71,11,0.5066228412969123,11
2551,23,10,9,5,0.5053397207394539,5
2552,13,49,53,22,0.5049824040631401,27
2553,90,13,91,6,0.5003235284827323,7
2554,70,19,39,10,0.49953189293951183,9
2555,5,59,87,29,0.4991669720547012,30
2556,5,39,63,22,0.49187190353271276,17
2557,57,14,104,5,0.4845128262229356,9
2558,17,10,18,6,0.4807393003672915,4
2559,95,28,74,13,0.47842550860281996,15
2560,25,51,39,26,0.4759465051184244,25
2561,37,13,69,6,0.4741041536564538,7
2562,31,53,65,27,0.47237439181628066,26
2563,45,18,64,9,0.47078973461046125,9
2564,106,13,34,7,0.4683662704449505,6
2565,100,12,44,6,0.4671750406191804,6
2566,87,16,111,8,0.45897322341286445,8
2567,88,41,49,20,0.4529990219368629,21
2568,80,11,9,7,0.4439834453330457,4
2569,86,83,65,43,0.4411076558908754,40
2570,90,15,11,7,0.4409004522210816,8
2571,35,23,86,10,0.4354843809424514,13
2572,12,13,18,6,0.4352920108827378,7
2573,40,43,31,22,0.429627197462679,21
2574,33,11,99,6,0.42486651226142574,5
2575,37,36,17,16,0.42335569980871807,20
2576,5,14,38,7,0.4168378546295618,7
2577,54,40,39,19,0.41386352460636466,21
2578,57,11,40,5,0.40892721771307644,6
2579,15,10,81,5,0.40598881161956657,5
2580,46,40,11,19,0.4001450319361854,21
2581,7,75,60,37,0.39378844407947994,38
2582,88,13,78,6,0.3934639813104847,7
2583,55,16,41,8,0.3929137359889599,8
2584,3,15,55,7,0.39115052061440836,8
2585,8,13,44,6,0.3904420875790005,7
2586,51,51,87,25,0.38566064440595554,26
2587,70,38,106,20,0.38322439183367313,18
2588,8,35,50,16,0.38293825667797665,19
2589,14,18,84,8,0.37783903496494214,10
2590,16,39,114,18,0.3744778890921723,21
2591,40,16,108,7,0.373845897515691,9
2592,114,26,75,13,0.3719126663008889,13
2593,16,76,28,37,0.3704534163978425,39
2594,40,21,75,10,0.36863713867004627,11
2595,95,26,28,12,0.36814720179538635,14
2596,25,30,63,16,0.3669879376751877,14
2597,92,18,13,7,0.36521745881563183,11
2598,17,12,1,6,0.3644523251464431,6
2599,107,67,114,34,0.3636753253095943,33
2600,107,79,8,36,0.3489627757682446,43
2601,68,45,107,23,0.3439870818796496,22
2602,81,12,9,6,0.34088913473212457,6
2603,114,13,84,6,0.3321803924883228,7
2604,83,20,106,11,0.33164456490941063,9
2605,15,20,60,9,0.3311042630925631,11
2606,49,14,114,6,0.32751436291229447,8
2607,83,25,28,14,0.3193130867023741,11
2608,50,18,112,8,0.31747188429243445,10
2609,88,15,48,6,0.2955612335778544,9
2610,17,28,107,14,0.2941106702859755,14
2611,73,15,96,7,0.29259461070533327,8
2612,13,42,27,22,0.2905119523861549,20
2613,17,25,114,14,0.28496362892659627,11
2614,97,21,83,9,0.284664584172639,12
2615,67,12,25,6,0.2816428039469064,6
2616,68,46,9,22,0.2811754401691433,24
2617,53,18,5,8,0.2778213329671456,10
2618,36,11,38,4,0.26679215079866997,7
2619,31,10,35,5,0.2664857773065452,5
2620,57,21,86,11,0.26341057299343335,10
2621,37,22,76,12,0.2606095394442829,10
2622,30,11,9,6,0.25964021517278035,5
2623,40,25,47,14,0.24655985846699452,11
2624,38,15,60,7,0.24623826312842922,8
2625,86,32,31,15,0.24444323577164595,17
2626,83,20,88,11,0.24121558114701722,9
2627,30,10,108,5,0.24117256366227835,5
2628,37,12,43,5,0.23624251310573877,7
2629,16,26,111,12,0.2324255478959678,14
2630,11,40,87,22,0.22473431916089695,18
2631,107,59,74,28,0.21255364694604195,31
2632,74,16,69,9,0.2118793093368751,7
2633,28,11,66,5,0.2056598644516812,6
2634,84,26,54,12,0.20394258489876999,14
2635,44,14,107,7,0.20330478165271706,7
2636,46,16,71,7,0.19894184736909315,9
2637,8,66,54,35,0.1986057005994308,31
2638,17,10,85,5,0.19249328996870893,5
2639,35,12,70,7,0.18631436457958764,5
2640,44,15,65,6,0.18351226600640885,9
2641,71,33,8,17,0.17759312635004623,16
2642,96,37,55,19,0.17732770674363885,18
2643,88,53,41,27,0.17567237068802208,26
2644,11,47,106,26,0.17225906773687616,21
2645,17,28,13,14,0.1676823988018485,14
2646,57,20,37,10,0.16220303080862575,10
2647,7,51,4,26,0.16136746029798088,25
2648,62,12,106,6,0.1584669634691407,6
2649,94,10,39,5,0.15532018609088852,5
2650,69,29,36,15,0.1524943306378237,14
2651,86,97,107,49,0.14762470290526133,48
2652,18,28,41,15,0.14547306255424425,13
2653,12,15,40,8,0.14369807725415834,7
2654,70,54,8,27,0.1404751949417945,27
2655,50,17,109,8,0.13868989752014263,9
2656,73,10,25,5,0.1328731236438802,5
2657,51,13,44,8,0.13191763257362837,5
2658,112,26,16,14,0.128618354669528,12
2659,27,40,107,20,0.1259702465930359,20
2660,47,32,39,16,0.12147928795004093,16
2661,75,30,41,14,0.11880942701957935,16
2662,108,16,50,7,0.11486075029930842,9
2663,40,28,18,16,0.11377047107058737,12
2664,98,13,97,7,0.11020600858990875,6
2665,2,18,84,9,0.10504403066305398,9
2666,68,13,44,7,0.10451112471006771,6
2667,88,24,69,11,0.1024062201336718,13
2668,84,33,88,15,0.10026530043554462,18
2669,74,39,25,20,0.09563368284676016,19
2670,25,65,16,32,0.09364645449744402,33
2671,30,15,96,8,0.09214636377364425,7
2672,114,29,36,13,0.09213128587786307,16
2673,95,52,86,24,0.08956033992826938,28
2674,107,94,7,42,0.07975391090501975,52
2675,97,36,74,17,0.07931920932357782,19
2676,76,20,109,9,0.07505370430495735,11
2677,55,15,108,8,0.07480659095217349,7
2678,106,21,40,10,0.06808253080226546,11
2679,20,12,23,6,0.06562707953631779,6
2680,108,15,74,7,0.06305457719799344,8
2681,20,18,30,9,0.05385247642414745,9
2682,8,70,106,37,0.05212763279076112,33
2683,8,16,27,7,0.051328614148521634,9
2684,34,19,50,10,0.05002588679712766,9
2685,73,16,106,8,0.04700386219362951,8
2686,112,19,63,9,0.04656981650604271,10
2687,31,11,97,5,0.04256244744109723,6
2688,45,17,71,7,0.03389797077786283,10
2689,106,42,50,20,0.025298087208634697,22
2690,79,16,84,7,0.019079910408303924,9
2691,89,15,28,8,0.018607611913672883,7
2692,107,25,108,12,0.013698196737241802,13
2693,109,17,83,7,0.00972932964701334,10
2694,78,18,60,10,0.007255307961538825,8
2695,109,20,102,10,0.0026602667859183526,10
2696,102,20,109,10,-0.0026602667859165763,10
2697,60,18,78,8,-0.007255307961539614,10
2698,83,17,109,10,-0.009729329647013785,7
2699,108,25,107,13,-0.013698196737241517,12
2700,28,15,89,7,-0.018607611913672648,8
2701,84,16,79,9,-0.0190799104083047,7
2702,50,42,106,22,-0.02529808720863334,20
2703,71,17,45,10,-0.03389797077786216,7
2704,97,11,31,6,-0.042562447441096586,5
2705,63,19,112,10,-0.04656981650604271,9
2706,106,16,73,8,-0.0470038621936304,8
2707,50,19,34,9,-0.05002588679712785,10
2708,27,16,8,9,-0.051328614148522966,7
2709,106,70,8,33,-0.05212763279076128,37
2710,74,15,108,8,-0.06305457719799369,7
2711,23,12,20,6,-0.06562707953631748,6
2712,40,21,106,11,-0.0680825308022658,10
2713,108,15,55,7,-0.07480659095217229,8
2714,109,20,76,11,-0.07505370430495617,9
2715,74,36,97,19,-0.07931920932357782,17
2716,7,94,107,52,-0.0797539109050192,42
2717,86,52,95,28,-0.08956033992827091,24
2718,36,29,114,16,-0.09213128587786189,13
2719,96,15,30,7,-0.09214636377364507,8
2720,16,65,25,33,-0.09364645449744435,32
2721,25,39,74,19,-0.0956336828467596,20
2722,88,33,84,18,-0.10026530043554559,15
2723,69,24,88,13,-0.10240622013367166,11
2724,44,13,68,6,-0.10451112471006657,7
2725,84,18,2,9,-0.10504403066305477,9
2726,97,13,98,6,-0.11020600858990862,7
2727,18,28,40,12,-0.11377047107058744,16
2728,50,16,108,9,-0.11486075029930998,7
2729,41,30,75,16,-0.11880942701957935,14
2730,39,32,47,16,-0.12147928795004115,16
2731,107,40,27,20,-0.1259702465930358,20
2732,16,26,112,12,-0.1286183546695278,14
2733,44,13,51,5,-0.1319176325736292,8
2734,25,10,73,5,-0.1328731236438802,5
2735,109,17,50,9,-0.1386898975201418,8
2736,8,54,70,27,-0.14047519494179392,27
2737,40,15,12,7,-0.14369807725415834,8
2738,41,28,18,13,-0.14547306255424347,15
2739,107,97,86,48,-0.14762470290526128,49
2740,36,29,69,14,-0.15249433063782128,15
2741,39,10,94,5,-0.1553201860908871,5
2742,106,12,62,6,-0.15846696346914188,6
2743,4,51,7,25,-0.16136746029798163,26
2744,37,20,57,10,-0.162203030808627,10
2745,13,28,17,14,-0.16768239880184893,14
2746,106,47,11,21,-0.17225906773687602,26
2747,41,53,88,26,-0.17567237068802258,27
2748,55,37,96,18,-0.17732770674364082,19
2749,8,33,71,16,-0.17759312635004632,17
2750,65,15,44,9,-0.1835122660064091,6
2751,70,12,35,5,-0.18631436457958692,7
2752,85,10,17,5,-0.19249328996870857,5
2753,54,66,8,31,-0.19860570059943058,35
2754,71,16,46,9,-0.19894184736909182,7
2755,107,14,44,7,-0.20330478165271787,7
2756,54,26,84,14,-0.2039425848987681,12
2757,66,11,28,6,-0.20565986445168055,5
2758,69,16,74,7,-0.21187930933687607,9
2759,87,40,11,18,-0.22473431916089676,22
2760,111,26,16,14,-0.23242554789596853,12
2761,43,12,37,7,-0.23624251310573818,5
2762,108,10,30,5,-0.24117256366227763,5
2763,88,20,83,9,-0.24121558114701463,11
2764,31,32,86,17,-0.24444323577164873,15
2765,60,15,38,8,-0.24623826312843025,7
2766,47,25,40,11,-0.24655985846699366,14
2767,9,11,30,5,-0.25964021517278013,6
2768,76,22,37,10,-0.26060953944428406,12
2769,86,21,57,10,-0.26341057299343423,11
2770,35,10,31,5,-0.2664857773065439,5
2771,38,11,36,7,-0.26679215079866964,4
2772,5,18,53,10,-0.277821332967146,8
2773,9,46,68,24,-0.28117544016914503,22
2774,25,12,67,6,-0.2816428039469064,6
2775,83,21,97,12,-0.28466458417263885,9
2776,114,25,17,11,-0.2849636289265948,14
2777,27,42,13,20,-0.29051195238615496,22
2778,96,15,73,8,-0.29259461070533327,7
2779,107,28,17,14,-0.2941106702859755,14
2780,48,15,88,9,-0.29556123357785347,6
2781,112,18,50,10,-0.31747188429243345,8
2782,28,25,83,11,-0.3193130867023753,14
2783,114,14,49,8,-0.32751436291229385,6
2784,60,20,15,11,-0.33110426309256197,9
2785,106,20,83,9,-0.3316445649094112,11
2786,84,13,114,7,-0.33218039248832254,6
2787,9,12,81,6,-0.3408891347321238,6
2788,107,45,68,22,-0.3439870818796496,23
2789,8,79,107,43,-0.3489627757682449,36
2790,114,67,107,33,-0.36367532530959656,34
2791,1,12,17,6,-0.36445232514644194,6
2792,13,18,92,11,-0.3652174588156323,7
2793,63,30,25,14,-0.3669879376751877,16
2794,28,26,95,14,-0.36814720179538646,12
2795,75,21,40,11,-0.3686371386700461,10
2796,28,76,16,39,-0.370453416397842,37
2797,75,26,114,13,-0.37191266630088854,13
2798,108,16,40,9,-0.3738458975156912,7
2799,114,39,16,21,-0.3744778890921726,18
2800,84,18,14,10,-0.37783903496494253,8
2801,50,35,8,19,-0.3829382566779763,16
2802,106,38,70,18,-0.383224391833672,20
2803,87,51,51,26,-0.38566064440595466,25
2804,44,13,8,7,-0.3904420875789997,6
2805,55,15,3,8,-0.391150520614408,7
2806,41,16,55,8,-0.39291373598895946,8
2807,78,13,88,7,-0.3934639813104835,6
2808,60,75,7,38,-0.39378844407947877,37
2809,11,40,46,21,-0.40014503193618634,19
2810,81,10,15,5,-0.40598881161956585,5
2811,40,11,57,6,-0.4089272177130761,5
2812,39,40,54,21,-0.4138635246063635,19
2813,38,14,5,7,-0.4168378546295618,7
2814,17,36,37,20,-0.42335569980871945,16
2815,99,11,33,5,-0.4248665122614248,6
2816,31,43,40,21,-0.4296271974626791,22
2817,18,13,12,7,-0.4352920108827394,6
2818,86,23,35,13,-0.43548438094245046,10
2819,11,15,90,8,-0.4409004522210813,7
2820,65,83,86,40,-0.44110765589087725,43
2821,9,11,80,4,-0.4439834453330448,7
2822,49,41,88,21,-0.45299902193686364,20
2823,111,16,87,8,-0.45897322341286373,8
2824,44,12,100,6,-0.46717504061918014,6
2825,34,13,106,6,-0.46836627044495166,7
2826,64,18,45,9,-0.47078973461046025,9
2827,65,53,31,26,-0.47237439181628094,27
2828,69,13,37,7,-0.47410415365645314,6
2829,39,51,25,25,-0.4759465051184236,26
2830,74,28,95,15,-0.4784255086028221,13
2831,18,10,17,4,-0.48073930036729234,6
2832,104,14,57,9,-0.4845128262229359,5
2833,63,39,5,17,-0.4918719035327135,22
2834,87,59,5,30,-0.49916697205470045,29
2835,39,19,70,9,-0.49953189293951067,10
2836,91,13,90,7,-0.5003235284827329,6
2837,53,49,13,27,-0.5049824040631402,22
2838,9,10,23,5,-0.5053397207394532,5
2839,71,22,51,11,-0.5066228412969127,11
2840,9,18,4,9,-0.5118055197130339,9
2841,38,11,114,5,-0.5127819422302561,6
2842,90,11,41,5,-0.513841479320257,6
2843,25,17,43,7,-0.5197036131496168,10
2844,28,19,73,9,-0.5214155246375576,10
2845,57,16,46,8,-0.5297057406629241,8
2846,53,19,63,10,-0.5367176376371671,9
2847,33,19,28,11,-0.5377400393884936,8
2848,7,43,63,25,-0.5381341307781913,18
2849,1,10,106,5,-0.5396528610114302,5
2850,13,55,104,28,-0.5474902747445204,27
2851,7,17,92,10,-0.5480230211986107,7
2852,54,49,5,26,-0.5526115688513301,23
2853,4,10,3,5,-0.5556184418282125,5
2854,2,10,83,5,-0.559439726515081,5
2855,39,50,87,26,-0.5610049144101691,24
2856,2,31,97,16,-0.5614740846174444,15
2857,107,36,90,19,-0.5646498466658356,17
2858,60,17,28,10,-0.5655437404205489,7
2859,53,12,23,6,-0.5700661218932138,6
2860,87,45,96,22,-0.57756550208769,23
2861,86,55,50,26,-0.5948795299571146,29
2862,34,15,63,8,-0.6010869874219955,7
2863,54,60,16,32,-0.6012047197573586,28
2864,70,16,91,9,-0.6063303701253777,7
2865,23,24,51,12,-0.6158723359304604,12
2866,13,13,34,6,-0.6173280890452298,7
2867,29,12,39,6,-0.6210417076734448,6
2868,96,30,76,16,-0.6223340675935105,14
2869,40,13,109,6,-0.6223424064374109,7
2870,55,58,51,29,-0.622889975737348,29
2871,106,45,76,25,-0.6229200096733949,20
2872,28,46,37,24,-0.6233491488996554,22
2873,71,33,36,16,-0.6241330409639598,17
2874,11,10,27,6,-0.6266769775986694,4
2875,97,11,11,5,-0.626987447450576,6
2876,64,28,4,15,-0.6316212138641698,13
2877,86,54,114,27,-0.6322094644097658,27
2878,36,17,111,9,-0.6365354853619557,8
2879,41,25,25,11,-0.6394054706376676,14
2880,37,16,62,10,-0.6397394147846429,6
2881,50,16,98,8,-0.6426219058041119,8
2882,68,49,60,26,-0.6520217462577712,23
2883,41,38,39,18,-0.6524626848349437,20
2884,98,26,16,13,-0.6567917996699305,13
2885,39,70,7,35,-0.6570822531098801,35
2886,50,38,63,20,-0.6599709375930077,18
2887,87,43,63,23,-0.6645353122982502,20
2888,50,27,17,13,-0.6674798453134673,14
2889,114,40,37,22,-0.6680388190804033,18
2890,25,19,18,9,-0.6816652439852758,10
2891,99,11,27,5,-0.6941577039356038,6
2892,64,18,38,9,-0.6972961224720612,9
2893,69,13,71,7,-0.6992249594892732,6
2894,8,25,76,12,-0.7077738529790857,13
2895,41,17,76,10,-0.7098418871900418,7
2896,79,12,107,5,-0.7098533031414676,7
2897,65,85,54,44,-0.7126472318729195,41
2898,84,15,93,8,-0.7145615095611293,7
2899,28,13,82,6,-0.7153587234866207,7
2900,41,20,57,11,-0.7163144926814985,9
2901,3,12,69,7,-0.7220114611067269,5
2902,25,23,15,13,-0.7267013492378236,10
2903,5,41,95,20,-0.7316066534315533,21
2904,86,77,40,41,-0.7352757671814375,36
2905,3,10,43,5,-0.74210302023913,5
2906,74,13,36,8,-0.743717573303844,5
2907,71,20,3,10,-0.7446115406314829,10
2908,48,27,28,14,-0.7484805696104441,13
2909,47,17,65,9,-0.7638862523670515,8
2910,64,27,75,14,-0.7678085379778318,13
2911,104,15,33,7,-0.7704375614853106,8
2912,93,20,97,10,-0.7717644600090567,10
2913,15,24,16,13,-0.777276505650555,11
2914,114,45,104,24,-0.7777920700848373,21
2915,13,10,32,5,-0.7835363847604213,5
2916,65,19,18,9,-0.7868157298210114,10
2917,39,28,11,14,-0.7894372385849192,14
2918,78,11,28,5,-0.7898078034632366,6
2919,40,36,16,19,-0.7902451728478608,17
2920,77,16,5,8,-0.7908065895997605,8
2921,77,19,68,10,-0.7929482450183345,9
2922,88,22,2,11,-0.7956469041111237,11
2923,86,17,12,9,-0.8013363403706052,8
2924,50,17,79,9,-0.8036407520519754,8
2925,40,14,56,7,-0.8062835825274064,7
2926,107,58,96,31,-0.8081270899904945,27
2927,76,45,106,21,-0.8113571883686943,24
2928,13,58,4,31,-0.8162535782673945,27
2929,20,27,74,13,-0.8203305748765273,14
2930,65,23,11,13,-0.8217152797009972,10
2931,62,12,55,7,-0.8240244688504365,5
2932,46,16,2,8,-0.8285194662826783,8
2933,93,19,107,9,-0.8317061972633653,10
2934,74,40,54,20,-0.8415267564978521,20
2935,63,28,71,15,-0.8479499084443569,13
2936,88,73,8,37,-0.8508025087607838,36
2937,16,17,34,9,-0.8560019455164201,8
2938,114,10,10,6,-0.8617397018011254,4
2939,71,21,55,12,-0.8636848327030733,9
2940,68,43,86,23,-0.8663708281809832,20
2941,49,27,7,12,-0.8744069756975955,15
2942,68,47,111,23,-0.87462883933747,24
2943,65,45,74,22,-0.8800404347092061,23
2944,4,21,77,11,-0.8810684428976734,10
2945,106,10,3,5,-0.8904989515497619,5
2946,46,31,107,15,-0.8942764168819444,16
2947,107,38,71,21,-0.8981755151573054,17
2948,48,24,8,13,-0.8990865709573216,11
2949,74,17,68,10,-0.9001065237726515,7
2950,63,65,107,30,-0.9004862155219557,35
2951,3,13,23,7,-0.9036934098771321,6
2952,75,35,36,16,-0.9076169876586756,19
2953,13,59,86,29,-0.9107558957716031,30
2954,33,20,13,10,-0.9181205054603415,10
2955,50,17,69,10,-0.918845201923083,7
2956,104,33,39,17,-0.924396755600099,16
2957,86,17,33,8,-0.9246066959077452,9
2958,114,13,112,6,-0.9421647262329372,7
2959,8,20,7,11,-0.9446580951337818,9
2960,5,14,14,8,-0.9561035605846475,6
2961,75,49,65,26,-0.967149368231196,23
2962,87,16,14,9,-0.9719183858987275,7
2963,7,39,54,20,-0.9734500394951365,19
2964,88,11,79,6,-0.973600472994728,5
2965,5,65,107,33,-0.9748363761521153,32
2966,31,33,51,19,-0.9782499075201476,14
2967,65,18,84,10,-0.9824722158055605,8
2968,100,14,64,8,-0.9873146869937529,6
2969,111,17,23,7,-0.9902411232186308,10
2970,28,67,106,35,-0.9916026418837889,32
2971,39,40,8,20,-0.9993368710228037,20
2972,7,39,114,21,-1.0047894280060643,18
2973,6,14,68,8,-1.005162162800652,6
2974,75,43,13,23,-1.0053644322647692,20
2975,88,20,93,11,-1.013881838292134,9
2976,39,53,107,28,-1.0139341154699524,25
2977,33,10,70,5,-1.0222975969230645,5
2978,44,20,63,11,-1.0233184771026504,9
2979,17,21,8,10,-1.026318191087207,11
2980,9,17,112,9,-1.0274983646093443,8
2981,7,22,35,11,-1.02999883395421,11
2982,88,34,71,19,-1.0311330418182334,15
2983,3,14,45,7,-1.0349134798027073,7
2984,88,21,90,10,-1.0373159148886413,11
2985,90,32,16,15,-1.044046076277467,17
2986,87,35,18,19,-1.059533339757231,16
2987,109,51,86,26,-1.0634551966465833,25
2988,109,30,104,15,-1.063865849600061,15
2989,66,12,106,7,-1.0707591278531368,5
2990,37,20,67,11,-1.0707700527635244,9
2991,1,29,107,15,-1.0725529373993175,14
2992,97,19,64,10,-1.0748997556854094,9
2993,71,13,43,6,-1.0882014078273534,7
2994,39,46,65,26,-1.0892678939812854,20
2995,74,13,40,7,-1.0901529369074696,6
2996,11,16,14,9,-1.0923565448715815,7
2997,28,36,39,18,-1.0952634452451109,18
2998,107,70,54,35,-1.0956537339891796,35
2999,106,16,27,7,-1.0992702168895803,9
3000,33,16,54,9,-1.1000953180608284,7
3001,2,18,96,9,-1.1039761816908782,9
3002,40,47,63,25,-1.1085655861732648,22
3003,112,14,23,7,-1.1091414019210037,7
3004,57,17,25,9,-1.1122394350713356,8
3005,88,18,61,8,-1.1254133453483963,10
3006,114,13,33,6,-1.1286658148323805,7
3007,107,19,81,9,-1.1293503192154632,10
3008,106,26,36,13,-1.1307287364062808,13
3009,86,27,53,12,-1.132415738912135,15
3010,16,47,23,25,-1.1335884234619735,22
3011,109,15,48,8,-1.1338129007062274,7
3012,69,10,42,5,-1.1347588356207454,5
3013,49,16,63,8,-1.1351919136754067,8
3014,91,31,88,16,-1.1352768006015461,15
3015,71,73,60,38,-1.1360670304013198,35
3016,65,43,8,22,-1.1481048077830944,21
3017,39,34,9,16,-1.1514145806091254,18
3018,30,47,86,23,-1.1570405179503085,24
3019,68,38,27,21,-1.1654046230648214,17
3020,48,16,65,9,-1.1655305065337136,7
3021,16,28,48,15,-1.1700437405112516,13
3022,28,24,76,13,-1.1713077042523665,11
3023,31,34,88,17,-1.1836541894089585,17
3024,60,45,39,22,-1.1851129417013602,23
3025,109,25,25,13,-1.1927554377225942,12
3026,107,45,41,25,-1.1979139523122333,20
3027,84,25,37,13,-1.2002245471215662,12
3028,71,12,58,6,-1.2066349158549279,6
3029,97,33,25,17,-1.2112097532933461,16
3030,46,12,38,7,-1.2117798317776216,5
3031,74,11,98,6,-1.2137114800422124,5
3032,54,62,50,32,-1.2219864026222214,30
3033,55,50,87,26,-1.2223891795427406,24
3034,9,26,71,14,-1.2262156519313807,12
3035,61,14,13,8,-1.2296565256158196,6
3036,95,16,63,8,-1.233969730193377,8
3037,31,25,71,13,-1.2380158081615502,12
3038,112,18,107,10,-1.2381580832699435,8
3039,43,12,104,7,-1.2430962980218272,5
3040,89,10,65,5,-1.2467666872041385,5
3041,97,21,53,11,-1.249007390239658,10
3042,78,16,13,9,-1.2552499756193614,7
3043,99,26,55,14,-1.260544955494955,12
3044,14,15,107,7,-1.262180496300674,8
3045,55,42,75,24,-1.263536649450621,18
3046,65,27,50,14,-1.2644687002361992,13
3047,13,48,9,23,-1.2661488409130504,25
3048,70,37,107,18,-1.2710045606194935,19
3049,55,82,8,40,-1.2721684605222614,42
3050,28,12,47,6,-1.2743522419217495,6
3051,51,30,50,15,-1.277023353905357,15
3052,29,13,97,7,-1.2800501845598784,6
3053,49,15,65,8,-1.283273453022916,7
3054,109,20,97,10,-1.2834069052578214,10
3055,74,22,2,12,-1.2925512141562505,10
3056,41,69,65,38,-1.2958844955738493,31
3057,13,44,5,23,-1.3023509853743016,21
3058,102,11,70,4,-1.3043211125718082,7
3059,8,16,10,9,-1.3145513780375313,7
3060,47,16,63,10,-1.3162850335917957,6
3061,88,60,46,30,-1.3171891594634109,30
3062,80,18,74,9,-1.3199661328668575,9
3063,3,13,61,6,-1.3229217896944443,7
3064,28,73,107,39,-1.325951549467158,34
3065,113,10,86,6,-1.334535451398856,4
3066,68,39,64,22,-1.3356994520331136,17
3067,37,66,8,34,-1.3357403383797612,32
3068,107,10,52,6,-1.3362132651907583,4
3069,51,44,8,23,-1.3380278840989295,21
3070,7,48,71,23,-1.3388864417450879,25
3071,114,27,71,14,-1.3431780041778798,13
3072,90,17,84,9,-1.3434141546201466,8
3073,88,37,97,19,-1.3490743629309028,18
3074,60,44,53,24,-1.3503746570549038,20
3075,104,31,68,15,-1.3616459533032323,16
3076,30,26,25,12,-1.3633847180345777,14
3077,51,21,30,11,-1.3637471878402048,10
3078,40,23,30,12,-1.3656919842952278,11
3079,23,13,27,6,-1.3665703255989474,7
3080,76,11,90,5,-1.371109786983603,6
3081,48,10,75,5,-1.3711471542080287,5
3082,41,30,106,15,-1.3806292559177735,15
3083,7,31,95,17,-1.3809406634768695,14
3084,11,41,50,22,-1.3816262941644981,19
3085,114,15,15,8,-1.3858486532762986,7
3086,9,15,69,8,-1.3894868657900223,7
3087,35,17,88,9,-1.3903417931875626,8
3088,74,15,17,8,-1.3910983775391348,7
3089,16,25,44,12,-1.3924747988210244,13
3090,106,25,100,12,-1.3941621457208517,13
3091,83,15,7,9,-1.3943529604549403,6
3092,9,13,91,7,-1.3946381880594534,6
3093,95,19,20,10,-1.3957034121223266,9
3094,56,10,16,6,-1.398489957964547,4
3095,44,12,75,7,-1.3998373775330364,5
3096,95,17,70,8,-1.4011695857654913,9
3097,11,15,102,9,-1.4114820984859553,6
3098,40,30,41,15,-1.4126537270823987,15
3099,15,28,13,14,-1.4143705369608408,14
3100,87,23,80,12,-1.4202226913102634,11
3101,45,35,36,16,-1.4232731245081227,19
3102,110,14,106,7,-1.425859572556296,7
3103,70,27,76,15,-1.4264215948460301,12
3104,57,13,68,6,-1.4301339738569718,7
3105,25,28,50,14,-1.4391705454909016,14
3106,97,21,20,10,-1.4395279608818727,11
3107,63,55,106,28,-1.4485566818099482,27
3108,89,16,50,9,-1.4560158637801313,7
3109,38,16,8,8,-1.4562520429495762,8
3110,83,23,25,13,-1.459720188055496,10
3111,47,21,31,11,-1.4606130980712662,10
3112,54,11,110,6,-1.4614008940578218,5
3113,88,57,114,29,-1.4628422455411638,28
3114,65,89,63,46,-1.4663105199346156,43
3115,30,15,49,8,-1.4667608883534202,7
3116,2,32,86,16,-1.4682447143488924,16
3117,32,17,11,8,-1.4729852723414758,9
3118,65,35,12,19,-1.4739803694014177,16
3119,63,15,73,7,-1.4760785674332912,8
3120,12,16,88,8,-1.492888142675182,8
3121,28,40,13,21,-1.4969051455892366,19
3122,50,30,84,15,-1.5145533767727424,15
3123,55,12,46,7,-1.514859018089955,5
3124,78,11,98,6,-1.5190069892875961,5
3125,8,12,43,6,-1.5194230889621378,6
3126,37,14,35,7,-1.523131742310598,7
3127,88,34,1,17,-1.5234508852206479,17
3128,86,54,70,29,-1.5265643039354164,25
3129,106,30,71,16,-1.5367748054190216,14
3130,13,61,41,31,-1.5422223527057688,30
3131,61,12,65,7,-1.5448114274450557,5
3132,74,26,11,14,-1.5483769164487973,12
3133,14,15,106,7,-1.552388543907857,8
3134,65,84,7,41,-1.5543231245397562,43
3135,83,23,104,13,-1.5563880557352991,10
3136,100,12,97,6,-1.5601199386945845,6
3137,61,17,40,9,-1.5607473214395375,8
3138,111,14,9,7,-1.5621342613374538,7
3139,107,61,84,32,-1.5631651047261477,29
3140,86,100,106,52,-1.5692663469089445,48
3141,90,22,55,10,-1.578656952498874,12
3142,25,15,2,7,-1.5845186001024019,8
3143,40,73,7,40,-1.588804971289502,33
3144,47,15,27,7,-1.591161927029764,8
3145,36,30,1,14,-1.5919918411390328,16
3146,30,18,99,10,-1.5949338139614573,8
3147,43,13,70,7,-1.6071210379776915,6
3148,54,11,79,7,-1.6071533989506848,4
3149,74,59,107,32,-1.6086403256327972,27
3150,20,28,114,15,-1.6093906597632899,13
3151,11,17,7,9,-1.6096082788053911,8
3152,60,42,65,25,-1.6141246546544767,17
3153,39,14,48,7,-1.6162453840006812,7
3154,109,23,60,12,-1.629447861077916,11
3155,96,19,39,11,-1.6315253594413601,8
3156,88,44,106,25,-1.6421661548035542,19
3157,57,10,95,4,-1.6443605111684718,6
3158,72,13,13,6,-1.6496378216821217,7
3159,74,50,16,27,-1.6504828930462023,23
3160,68,23,36,12,-1.6511686348202665,11
3161,91,11,17,6,-1.6541099131819836,5
3162,51,49,37,23,-1.6543448329472816,26
3163,48,19,106,10,-1.6634533717988316,9
3164,31,28,45,15,-1.6710870406691087,13
3165,39,45,63,27,-1.672960461470019,18
3166,80,31,86,16,-1.6766961831131946,15
3167,2,14,75,7,-1.6860484967370888,7
3168,86,40,9,22,-1.6864437776494567,18
3169,68,56,51,27,-1.6875805796494077,29
3170,114,19,43,9,-1.6919225072028663,10
3171,31,10,28,5,-1.6925325756046283,5
3172,67,11,96,5,-1.6933647660310176,6
3173,2,20,20,11,-1.696038579763385,9
3174,23,15,36,6,-1.6972875274185715,9
3175,102,16,20,8,-1.6989391239814924,8
3176,63,33,41,17,-1.6996369290219266,16
3177,37,10,48,5,-1.703593750319215,5
3178,43,22,51,11,-1.7055396893146837,11
3179,76,13,84,7,-1.710890300241341,6
3180,85,10,74,5,-1.7134982697618457,5
3181,90,36,107,18,-1.723381098959678,18
3182,45,18,40,10,-1.7249973927231157,8
3183,11,49,8,27,-1.7256786381417557,22
3184,50,11,83,5,-1.7272952536822093,6
3185,12,13,50,5,-1.7279667161947843,8
3186,11,14,60,7,-1.729783938603551,7
3187,75,19,70,9,-1.7314858975507368,10
3188,106,19,48,10,-1.7335189393534853,9
3189,88,37,36,21,-1.7392851936744331,16
3190,23,26,8,13,-1.7400762718841147,13
3191,18,22,104,13,-1.7410989710262754,9
3192,6,11,18,6,-1.7414584600944745,5
3193,36,33,60,17,-1.7416473627060742,16
3194,51,28,3,12,-1.7442167579753678,16
3195,68,31,4,16,-1.7510661926181545,15
3196,70,26,84,14,-1.7530345342228948,12
3197,8,15,49,9,-1.7678498041146895,6
3198,16,62,104,33,-1.7780277088526335,29
3199,20,10,71,6,-1.7786503004599794,4
3200,84,13,102,7,-1.7793224025292758,6
3201,30,16,7,7,-1.7803956295895682,9
3202,90,25,37,13,-1.7816453937181784,12
3203,41,25,1,12,-1.7850851573908935,13
3204,90,44,86,24,-1.7893173958663402,20
3205,18,56,7,28,-1.7918330409813668,28
3206,28,65,8,35,-1.8060421386611965,30
3207,25,22,36,11,-1.8071440138268584,11
3208,111,18,40,9,-1.8104998545748818,9
3209,80,21,84,12,-1.8116947476965408,9
3210,85,24,86,12,-1.8118032914106936,12
3211,64,12,80,6,-1.8118137894523876,6
3212,28,18,79,10,-1.8130893193426156,8
3213,44,20,53,12,-1.8141360189660758,8
3214,17,19,68,11,-1.8171968616213465,8
3215,109,11,71,6,-1.819641782820222,5
3216,99,13,102,7,-1.8212893413036864,6
3217,43,13,69,7,-1.8213131651346812,6
3218,114,18,69,8,-1.8229272425455245,10
3219,114,13,44,7,-1.8263733365516708,6
3220,13,29,74,15,-1.8278354237299068,14
3221,29,14,7,6,-1.8294106613069705,8
3222,41,17,46,10,-1.8296103863068403,7
3223,96,38,84,19,-1.835648682700679,19
3224,63,40,68,20,-1.8432100569925869,20
3225,13,16,26,9,-1.8451876959015554,7
3226,51,59,40,31,-1.8453671538115306,28
3227,98,21,28,13,-1.8460912305825197,8
3228,76,22,46,12,-1.8507100299988153,10
3229,86,11,6,6,-1.8539951054916275,5
3230,106,61,87,31,-1.8566326197242504,30
3231,87,13,6,7,-1.8611049796290908,6
3232,9,38,75,21,-1.8631746984569548,17
3233,54,28,64,14,-1.8650724062797466,14
3234,5,95,37,49,-1.865428870342572,46
3235,54,49,87,27,-1.875214789525944,22
3236,83,16,60,9,-1.8774619090517453,7
3237,79,14,8,6,-1.8787453444383126,8
3238,8,41,2,21,-1.8848654476169693,20
3239,41,76,7,39,-1.885480468158321,37
3240,64,23,25,12,-1.8857238852847689,11
3241,106,35,20,19,-1.890590591428699,16
3242,16,51,11,30,-1.8931355077036744,21
3243,17,26,106,15,-1.8975243648116566,11
3244,88,13,14,7,-1.902096229341472,6
3245,114,37,63,22,-1.909917642987871,15
3246,87,16,43,8,-1.911299605590382,8
3247,106,32,97,16,-1.9159665785715099,16
3248,76,11,99,5,-1.9173589523208336,6
3249,41,21,70,10,-1.9198471114809519,11
3250,28,25,80,13,-1.9225523112040797,12
3251,18,21,114,11,-1.923577249757447,10
3252,40,19,70,11,-1.9276789997691202,8
3253,31,22,18,11,-1.9306740719340922,11
3254,97,14,23,7,-1.9330528734436563,7
3255,104,13,110,8,-1.9388474450810558,5
3256,31,14,23,8,-1.9392936999416424,6
3257,55,20,25,11,-1.9429576796619947,9
3258,64,34,36,17,-1.9485056781764598,17
3259,71,12,78,6,-1.9545808326383198,6
3260,94,10,60,5,-1.9558814631865937,5
3261,35,11,50,6,-1.9581460146246743,5
3262,87,15,78,7,-1.9606966739631162,8
3263,55,62,86,33,-1.9647331960922172,29
3264,97,16,75,9,-1.9718298395799774,7
3265,37,33,88,18,-1.979989875378531,15
3266,7,13,72,7,-1.9828862428029774,6
3267,25,38,28,22,-1.983389891159918,16
3268,13,13,48,7,-1.984822076945226,6
3269,4,19,53,10,-1.987694792892672,9
3270,58,11,50,6,-1.9915314759076352,5
3271,112,15,104,8,-1.9939359727925703,7
3272,7,24,69,12,-1.9945381002011557,12
3273,17,14,64,7,-1.997717670710988,7
3274,68,57,65,31,-2.0015768761708967,26
3275,51,20,12,11,-2.0030592525833657,9
3276,40,44,9,24,-2.013131078746107,20
3277,58,10,4,6,-2.016897461480046,4
3278,90,36,8,20,-2.01946478207178,16
3279,107,18,29,11,-2.0238382608603613,7
3280,87,30,75,16,-2.024772500508876,14
3281,73,12,55,6,-2.024829564390717,6
3282,80,10,38,6,-2.0310395723254184,4
3283,114,14,91,7,-2.031242634143396,7
3284,20,42,8,22,-2.032934980330156,20
3285,63,12,58,5,-2.0345686518653676,7
3286,88,14,89,7,-2.035463499061412,7
3287,60,24,90,14,-2.039727571926182,10
3288,54,17,23,9,-2.040126358853802,8
3289,80,31,65,16,-2.05091984654234,15
3290,9,17,84,9,-2.0546690063899433,8
3291,3,33,86,18,-2.0568330726615542,15
3292,31,25,3,12,-2.062807661672897,13
3293,45,22,13,12,-2.063714442075688,10
3294,49,16,68,8,-2.063780554877947,8
3295,114,23,50,13,-2.0649465321872778,10
3296,28,36,46,21,-2.0672815532521795,15
3297,60,52,77,28,-2.0764857415563527,24
3298,63,10,82,5,-2.0779758612966877,5
3299,5,50,109,25,-2.081151775830807,25
3300,114,13,98,7,-2.0825036861166173,6
3301,69,23,41,14,-2.0831103194133975,9
3302,36,73,7,39,-2.0934963107077063,34
3303,8,22,97,11,-2.094799206270941,11
3304,29,15,16,7,-2.096096770007441,8
3305,55,34,83,17,-2.0962093979720193,17
3306,84,22,109,12,-2.0978150302320913,10
3307,5,62,28,32,-2.10037433995057,30
3308,60,24,99,13,-2.100940382067204,11
3309,35,23,20,13,-2.1036160096888272,10
3310,100,23,8,13,-2.1093275750438307,10
3311,70,21,97,12,-2.110003760847125,9
3312,88,18,81,9,-2.113043846902455,9
3313,33,12,74,6,-2.113811361821,6
3314,30,13,48,6,-2.114145406665778,7
3315,40,15,11,8,-2.115832802221002,7
3316,64,20,1,10,-2.116432620959366,10
3317,70,11,53,6,-2.117480208536356,5
3318,91,30,28,16,-2.128036121988931,14
3319,16,14,72,7,-2.1283970579297686,7
3320,57,18,28,10,-2.1287632199740103,8
3321,68,17,15,10,-2.135080722439133,7
3322,28,49,11,25,-2.1398999630410587,24
3323,17,21,49,13,-2.1421419201328797,8
3324,46,27,87,13,-2.150785198948074,14
3325,7,17,80,10,-2.151623343669696,7
3326,48,16,20,9,-2.152557944212157,7
3327,9,16,49,8,-2.159298612128284,8
3328,51,65,88,32,-2.162417188252714,33
3329,84,12,17,6,-2.1646737051112903,6
3330,74,14,88,9,-2.16536396125082,5
3331,13,22,11,11,-2.165914141538766,11
3332,39,11,33,6,-2.1701558874520313,5
3333,49,45,39,25,-2.1782029000103353,20
3334,70,26,63,14,-2.1813121472430432,12
3335,74,64,8,36,-2.1866220406514896,28
3336,84,31,51,17,-2.1892581830667406,14
3337,16,57,60,30,-2.197502548183126,27
3338,13,51,49,26,-2.2090696411697515,25
3339,55,19,57,9,-2.210406003923328,10
3340,40,12,112,6,-2.2105918484505547,6
3341,96,50,5,28,-2.21142719225076,22
3342,51,38,28,19,-2.2134732604167904,19
3343,8,11,112,5,-2.214468435350456,6
3344,69,11,104,7,-2.21747944835034,4
3345,99,13,98,6,-2.22125816779338,7
3346,114,11,11,5,-2.2223336020983733,6
3347,51,22,1,11,-2.223305174454598,11
3348,33,11,88,5,-2.224220943421554,6
3349,100,16,28,9,-2.2255414738387724,7
3350,25,16,90,9,-2.226157693683706,7
3351,74,27,20,15,-2.230377352624161,12
3352,70,25,68,13,-2.2334926025833965,12
3353,3,14,81,8,-2.2358028798300933,6
3354,104,35,87,17,-2.2393020839894078,18
3355,4,38,88,20,-2.24592170041755,18
3356,28,43,87,22,-2.2459488534631893,21
3357,7,25,20,13,-2.251051671042148,12
3358,54,14,41,7,-2.2511014360561394,7
3359,25,30,95,16,-2.25397314365567,14
3360,60,50,51,29,-2.2562800486782213,21
3361,46,24,60,13,-2.263806664184089,11
3362,96,66,28,35,-2.2674069446039327,31
3363,31,10,61,5,-2.2696136748473594,5
3364,71,16,80,8,-2.2753923838048147,8
3365,74,46,37,24,-2.2838690954080456,22
3366,31,21,50,11,-2.283882121200707,10
3367,4,13,106,6,-2.287883468044352,7
3368,78,19,68,10,-2.2881985924711277,9
3369,114,10,94,6,-2.2912532605689226,4
3370,45,18,114,10,-2.292094813707231,8
3371,5,24,100,13,-2.2932427434044693,11
3372,96,36,106,20,-2.2984565902488896,16
3373,109,16,68,10,-2.29851232062389,6
3374,58,22,9,12,-2.2991812833114658,10
3375,109,13,23,7,-2.3017906431791286,6
3376,69,18,107,10,-2.304614755370786,8
3377,3,23,9,12,-2.3162904113567793,11
3378,57,13,84,6,-2.3176628996042026,7
3379,107,28,34,16,-2.3192939541017417,12
3380,69,24,65,13,-2.3193082814773103,11
3381,86,87,63,50,-2.3201836482496514,37
3382,102,21,104,10,-2.320627297470276,11
3383,64,23,50,12,-2.3285304422785043,11
3384,53,28,25,14,-2.3301510854690832,14
3385,93,12,20,6,-2.3328644598895543,6
3386,4,17,104,10,-2.3357072159096566,7
3387,51,20,49,11,-2.337593611464387,9
3388,12,15,13,6,-2.3425974502134452,9
3389,31,36,4,21,-2.3535355966794675,15
3390,109,14,96,8,-2.3566759619593642,6
3391,5,23,99,12,-2.3616219022642833,11
3392,106,37,104,19,-2.3634716745562443,18
3393,70,19,7,12,-2.364945757295021,7
3394,96,55,8,30,-2.3714393570924233,25
3395,96,10,69,6,-2.371580754307745,4
3396,51,46,54,24,-2.375734614007647,22
3397,84,28,55,15,-2.3790863004124483,13
3398,49,18,54,9,-2.3820443029674467,9
3399,56,13,75,8,-2.3840139649043506,5
3400,104,25,96,14,-2.3866419839158355,11
3401,71,21,4,13,-2.3871750117365993,8
3402,95,40,104,22,-2.389034218387607,18
3403,8,12,111,6,-2.390343846489093,6
3404,87,22,83,11,-2.3903571419434884,11
3405,7,10,85,6,-2.3932559335609835,4
3406,8,10,56,6,-2.4000860547179794,4
3407,77,19,86,11,-2.4096878419842764,8
3408,93,33,8,17,-2.4111455321691304,16
3409,25,46,107,24,-2.4187485647838773,22
3410,99,11,109,6,-2.419517402501058,5
3411,55,66,13,35,-2.419975034997169,31
3412,75,20,91,7,-2.4323694332612673,13
3413,99,21,87,12,-2.432411032680885,9
3414,106,39,55,22,-2.4381392466666045,17
3415,51,37,9,19,-2.442051118378038,18
3416,50,10,32,4,-2.4440541907162716,6
3417,53,46,39,25,-2.4451604588200344,21
3418,85,18,107,10,-2.4579163644894484,8
3419,27,10,54,5,-2.463869496934477,5
3420,74,40,87,22,-2.4671563114027464,18
3421,81,17,4,10,-2.467812477706327,7
3422,5,50,46,28,-2.4690859933319382,22
3423,51,28,36,15,-2.4708671287104753,13
3424,9,61,7,31,-2.4756046461152823,30
3425,13,79,16,43,-2.481046846177392,36
3426,39,30,95,16,-2.481130681096556,14
3427,111,11,18,6,-2.489910872635885,5
3428,31,20,87,10,-2.492676559594957,10
3429,3,20,65,11,-2.4971368500383213,9
3430,109,18,37,10,-2.5010134043415313,8
3431,86,81,74,42,-2.502577054921237,39
3432,13,30,63,16,-2.513355364840316,14
3433,39,18,62,9,-2.5162035004252656,9
3434,36,15,12,8,-2.5163199425137495,7
3435,86,44,60,24,-2.5193623407260133,20
3436,50,32,39,17,-2.524569549657206,15
3437,68,13,11,7,-2.5250619833588037,6
3438,4,18,39,10,-2.5267698999647226,8
3439,65,83,16,45,-2.5324454922464255,38
3440,60,11,111,7,-2.535604443502029,4
3441,11,35,63,21,-2.539597707853179,14
3442,88,38,64,21,-2.541399167445805,17
3443,86,34,91,18,-2.5421304216054597,16
3444,16,13,52,7,-2.542332195506543,6
3445,20,26,13,15,-2.5463784696778813,11
3446,1,19,73,11,-2.5534291003907295,8
3447,88,52,55,30,-2.55406284196069,22
3448,63,10,83,4,-2.557624644664858,6
3449,87,13,92,7,-2.5651869545632544,6
3450,107,28,91,16,-2.5653431282322647,12
3451,91,11,47,6,-2.565831417578021,5
3452,20,11,57,6,-2.572722724988934,5
3453,88,55,87,27,-2.583232804809496,28
3454,7,50,104,27,-2.5854072339864174,23
3455,62,21,87,11,-2.586304566496697,10
3456,54,32,80,16,-2.5928190955886397,16
3457,31,23,39,13,-2.5934090452929364,10
3458,27,19,40,8,-2.5947052105553348,11
3459,57,15,15,8,-2.596980169377468,7
3460,91,23,36,13,-2.600483205457647,10
3461,16,29,109,15,-2.610188033474426,14
3462,13,17,57,8,-2.613189040951601,9
3463,2,13,76,8,-2.6134640032331116,5
3464,17,25,7,14,-2.6142771621918577,11
3465,41,12,11,8,-2.6159479780993316,4
3466,16,44,41,22,-2.6236346308099376,22
3467,39,33,71,18,-2.629192013747391,15
3468,114,28,54,14,-2.6355280322257006,14
3469,8,13,68,7,-2.6365863647549523,6
3470,18,31,86,18,-2.6381646032412545,13
3471,95,14,33,8,-2.6415453896084555,6
3472,62,28,86,15,-2.642237041880456,13
3473,5,60,16,35,-2.643518445682432,25
3474,17,34,16,20,-2.643842309212827,14
3475,88,56,60,31,-2.6455443711538065,25
3476,71,23,62,12,-2.646301685866917,11
3477,86,43,23,23,-2.6484576158238538,20
3478,51,41,17,21,-2.6491740394334196,20
3479,51,22,47,11,-2.649428689191073,11
3480,8,24,30,13,-2.6514132136935475,11
3481,65,48,53,25,-2.6519126498591334,23
3482,88,29,92,16,-2.65412565592523,13
3483,51,38,53,20,-2.6567672529233457,18
3484,91,13,74,7,-2.658254293210725,6
3485,76,10,47,3,-2.6595736051653853,7
3486,109,31,51,19,-2.6658568783873675,12
3487,74,25,114,13,-2.666972342657448,12
3488,68,11,94,7,-2.6704707014810847,4
3489,75,18,95,10,-2.672802736686619,8
3490,44,17,25,9,-2.673535476281759,8
3491,17,17,90,8,-2.680753861205159,9
3492,13,78,68,43,-2.6939178558824084,35
3493,87,20,2,11,-2.6997368834124122,9
3494,65,53,28,29,-2.7033251524777984,24
3495,65,27,43,13,-2.7044668198991113,14
3496,37,57,107,31,-2.7122377942768767,26
3497,33,21,16,13,-2.716908579534641,8
3498,80,11,95,6,-2.7197438471090796,5
3499,70,31,104,17,-2.7208109249750048,14
3500,20,40,87,21,-2.7281534933615226,19
3501,34,12,75,6,-2.7327928404854562,6
3502,107,26,98,14,-2.733780753313525,12
3503,106,50,65,27,-2.735321183024918,23
3504,4,29,107,15,-2.7385286505263813,14
3505,104,22,97,11,-2.7396377781056187,11
3506,64,42,53,23,-2.7590266802927172,19
3507,65,85,13,47,-2.759042938762578,38
3508,28,92,86,51,-2.7696595786946707,41
3509,10,11,5,5,-2.7716738654503192,6
3510,13,15,96,8,-2.773454366126088,7
3511,38,14,9,7,-2.77647152671147,7
3512,97,15,9,7,-2.7891659901703596,8
3513,107,37,97,19,-2.7907845067840067,18
3514,108,19,86,9,-2.7920033870005003,10
3515,36,13,100,7,-2.7923934619121096,6
3516,1,26,7,14,-2.793205495238504,12
3517,114,25,4,13,-2.7973762559419417,12
3518,86,40,71,21,-2.8018541855071084,19
3519,41,15,99,8,-2.808167291861728,7
3520,20,73,86,40,-2.812574705202229,33
3521,107,35,18,21,-2.8126640539885566,14
3522,106,33,68,18,-2.8127952198562447,15
3523,15,17,99,10,-2.8189668514207975,7
3524,47,13,64,8,-2.821240379057225,5
3525,71,13,18,7,-2.821320109059578,6
3526,74,33,104,19,-2.832959821636547,14
3527,65,18,77,9,-2.836180648453273,9
3528,68,20,30,10,-2.8393809182025875,10
3529,60,12,89,6,-2.8396731138810423,6
3530,23,19,95,10,-2.8404436396815522,9
3531,9,32,36,18,-2.8429818871077073,14
3532,50,14,3,7,-2.8431293488179503,7
3533,86,100,16,55,-2.8435049478583063,45
3534,104,13,23,8,-2.8445076862849517,5
3535,33,13,97,7,-2.8486496222061595,6
3536,18,20,74,10,-2.8496142222224696,10
3537,99,18,51,9,-2.8534777973740635,9
3538,20,25,70,14,-2.8599876555664228,11
3539,60,23,63,13,-2.8746236800640066,10
3540,60,50,107,28,-2.8774264827145744,22
3541,87,17,94,9,-2.8778163111812205,8
3542,3,25,107,12,-2.881694515768815,13
3543,87,17,69,9,-2.8862410771595495,8
3544,7,31,43,18,-2.8869337290340296,13
3545,74,24,75,14,-2.8903655619324415,10
3546,3,13,12,8,-2.891613615182729,5
3547,70,10,44,5,-2.8975248911261424,5
3548,23,44,107,23,-2.897916501217797,21
3549,108,13,71,7,-2.8992906212622866,6
3550,74,13,12,7,-2.901854459581128,6
3551,37,19,91,10,-2.9050960547005253,9
3552,68,104,7,57,-2.909482743764719,47
3553,108,12,25,7,-2.9132670669268257,5
3554,106,19,102,9,-2.9207255392565092,10
3555,65,15,99,8,-2.925348959200731,7
3556,97,11,49,7,-2.931895914374789,4
3557,87,20,36,12,-2.9355732508976633,8
3558,76,17,30,10,-2.9372015853586078,7
3559,54,73,86,39,-2.9383462119412935,34
3560,8,78,86,40,-2.9505503650201597,38
3561,8,16,80,8,-2.9519293865537106,8
3562,86,89,7,51,-2.9562630867796145,38
3563,36,10,29,6,-2.966716228036959,4
3564,53,11,47,6,-2.967218161853792,5
3565,37,21,2,11,-2.96975801126945,10
3566,51,33,18,17,-2.9698165149321114,16
3567,4,32,36,19,-2.9739066740354194,13
3568,60,35,87,18,-2.9762532182298993,17
3569,84,12,10,7,-2.980259678929739,5
3570,53,27,95,17,-2.981134349868032,10
3571,7,23,15,11,-2.9813224452248606,12
3572,30,10,74,5,-2.9862406732405895,5
3573,37,37,65,19,-2.9918797859979525,18
3574,18,10,27,5,-2.996654278290003,5
3575,41,28,64,17,-2.998546228465672,11
3576,69,11,4,6,-2.9994841766617175,5
3577,58,21,31,11,-2.999935565790512,10
3578,34,14,96,8,-3.001763014782562,6
3579,38,19,88,12,-3.0023329742590943,7
3580,13,21,38,10,-3.0037263796971096,11
3581,30,16,50,9,-3.004950949655304,7
3582,18,17,4,10,-3.0054619874164517,7
3583,41,21,27,11,-3.011810052781142,10
3584,55,10,78,5,-3.0279933852134207,5
3585,84,13,35,7,-3.0304994399162246,6
3586,47,16,41,9,-3.031406429138557,7
3587,51,18,98,10,-3.0331574033151085,8
3588,20,35,88,18,-3.036073338025422,17
3589,65,39,25,23,-3.0368934823131157,16
3590,96,13,38,7,-3.0422152322461713,6
3591,55,14,48,8,-3.0636269177668387,6
3592,25,18,71,10,-3.0644100067848146,8
3593,46,24,97,13,-3.066170643508982,11
3594,114,40,60,18,-3.0670908685799043,22
3595,25,30,75,17,-3.069551733540898,13
3596,41,11,74,5,-3.0735662157516845,6
3597,37,22,98,12,-3.078006071981289,10
3598,87,14,45,8,-3.086220297325659,6
3599,16,20,6,10,-3.0894843149716715,10
3600,91,10,64,6,-3.0993479020870796,4
3601,68,14,99,8,-3.100103615084465,6
3602,60,15,92,9,-3.101629065738581,6
3603,106,25,109,13,-3.1028448270841773,12
3604,4,24,50,12,-3.1105592371369597,12
3605,17,25,25,14,-3.1106502600539105,11
3606,55,29,53,16,-3.1154264109145684,13
3607,80,11,36,6,-3.1158574211756616,5
3608,91,27,5,16,-3.121858390948631,11
3609,28,52,88,30,-3.1252466726738275,22
3610,107,64,51,38,-3.1254338730064415,26
3611,8,70,16,39,-3.1304849607513634,31
3612,32,20,86,11,-3.136567451220027,9
3613,23,23,75,11,-3.148733601092015,12
3614,63,21,46,10,-3.156280457471709,11
3615,84,31,87,17,-3.1565105897665355,14
3616,82,21,86,12,-3.1586560919846263,9
3617,87,32,23,19,-3.1607512154600745,13
3618,62,17,13,9,-3.161295276739798,8
3619,74,14,90,9,-3.168061351028922,5
3620,86,16,110,9,-3.1694821197260485,7
3621,60,25,106,15,-3.171261503808182,10
3622,68,56,88,31,-3.1716887522574075,25
3623,69,11,47,6,-3.1775295332798312,5
3624,65,25,83,13,-3.1850517665827933,12
3625,50,54,37,28,-3.1883352760136074,26
3626,71,38,65,22,-3.1904333369863855,16
3627,81,14,68,8,-3.1985312995714845,6
3628,5,49,55,27,-3.198953177181802,22
3629,39,41,36,23,-3.1998605067578225,18
3630,76,12,44,7,-3.2019945343572456,5
3631,31,47,60,23,-3.2094707274879264,24
3632,97,19,50,11,-3.210625734622642,8
3633,23,19,64,10,-3.2123729115980186,9
3634,28,39,55,23,-3.2184704312839756,16
3635,63,29,97,16,-3.219195053710692,13
3636,7,55,23,30,-3.222928305376168,25
3637,16,21,4,10,-3.223993814900797,11
3638,97,10,56,5,-3.2314262120369195,5
3639,36,49,107,26,-3.234838704648262,23
3640,20,25,11,15,-3.245274337075932,10
3641,107,15,94,10,-3.2534973524779978,5
3642,25,47,114,27,-3.2540864225169766,20
3643,95,14,84,8,-3.2568961944145873,6
3644,74,24,7,15,-3.257493143792889,9
3645,95,14,76,8,-3.257651508839797,6
3646,13,25,109,14,-3.261500174975238,11
3647,76,23,98,13,-3.2651133620022033,10
3648,93,14,70,8,-3.2714518634318708,6
3649,91,11,102,6,-3.2738070744638943,5
3650,67,13,114,7,-3.274670651234843,6
3651,45,18,16,11,-3.276855643218356,7
3652,18,14,81,8,-3.285175513857383,6
3653,50,17,41,10,-3.294641138718325,7
3654,108,14,64,7,-3.297085602036541,7
3655,5,60,104,32,-3.3007473735225057,28
3656,84,80,86,40,-3.306900749327819,40
3657,7,110,13,60,-3.3089382778797343,50
3658,66,11,86,6,-3.309294151623436,5
3659,75,31,60,17,-3.313915862803686,14
3660,84,16,97,10,-3.316428205809935,6
3661,57,10,64,6,-3.321529793039179,4
3662,8,29,60,15,-3.32366617515942,14
3663,39,30,64,17,-3.3245242307335383,13
3664,76,13,71,6,-3.3359186512389036,7
3665,5,13,68,7,-3.3380294056441127,6
3666,98,20,54,11,-3.3414082574983,9
3667,33,13,75,8,-3.342736023465549,5
3668,91,15,40,8,-3.345577169162442,7
3669,20,10,83,5,-3.347889825164404,5
3670,107,15,14,9,-3.3479962116917545,6
3671,47,18,87,10,-3.3511866209997354,8
3672,3,12,54,6,-3.3552278990212483,6
3673,112,15,88,9,-3.357440926186597,6
3674,27,48,7,26,-3.3617414996167194,22
3675,71,22,28,13,-3.3619344486700453,9
3676,8,23,14,13,-3.3634201583462153,10
3677,97,25,54,13,-3.364815342765676,12
3678,20,17,40,10,-3.3649339637959637,7
3679,55,56,107,30,-3.369618935589803,26
3680,98,15,73,8,-3.3800553651819163,7
3681,55,28,36,15,-3.383336577257353,13
3682,16,34,20,21,-3.3889237253680067,13
3683,55,48,39,27,-3.3894226122709816,21
3684,104,10,73,6,-3.391491099464731,4
3685,40,28,43,15,-3.392922253607483,13
3686,28,13,4,7,-3.3940824912486858,6
3687,53,54,18,29,-3.397966382939779,25
3688,98,26,104,12,-3.4091853213510745,14
3689,46,21,68,11,-3.4173658858402494,10
3690,37,12,4,7,-3.4218717037755084,5
3691,16,31,57,17,-3.427620898937532,14
3692,12,13,74,7,-3.4342312359972222,6
3693,25,31,102,17,-3.4382241991917164,14
3694,114,10,93,6,-3.4434774013838236,4
3695,23,21,37,11,-3.4530437057487418,10
3696,68,26,23,13,-3.454047877840213,13
3697,5,23,33,12,-3.454327509177194,11
3698,51,49,106,27,-3.457607975311812,22
3699,37,46,20,25,-3.457621476755263,21
3700,1,32,13,19,-3.462932922524283,13
3701,106,19,30,10,-3.463995690702536,9
3702,54,26,9,14,-3.4668855776458423,12
3703,5,60,74,32,-3.4699961467083447,28
3704,16,14,73,7,-3.4738693799097957,7
3705,81,10,23,6,-3.4745303728026347,4
3706,54,57,96,29,-3.47661338595835,28
3707,28,69,50,39,-3.477008608564353,30
3708,65,28,70,17,-3.478419403846197,11
3709,18,16,55,8,-3.481046717374471,8
3710,70,20,25,11,-3.484518115943737,9
3711,36,13,62,7,-3.489528327052378,6
3712,65,15,109,10,-3.4929763691198903,5
3713,39,26,17,15,-3.492996402510658,11
3714,114,36,97,20,-3.494809729950691,16
3715,9,26,50,15,-3.4989626487903873,11
3716,68,14,85,9,-3.5027894631624408,5
3717,107,19,93,11,-3.5035103312902427,8
3718,23,16,74,9,-3.5053157619270587,7
3719,33,10,49,6,-3.5057518320537775,4
3720,84,15,91,8,-3.5069437670955055,7
3721,104,38,8,21,-3.5073414065674897,17
3722,106,50,107,27,-3.5165007722129795,23
3723,62,34,16,20,-3.5174461635881284,14
3724,17,22,97,12,-3.5176024597849698,10
3725,17,11,112,6,-3.5191492672023625,5
3726,68,11,43,6,-3.5239997356866337,5
3727,76,17,20,8,-3.5278207011714757,9
3728,7,15,44,8,-3.535266020755452,7
3729,36,65,40,37,-3.5400829247343655,28
3730,107,81,87,45,-3.5485615044799785,36
3731,49,31,16,17,-3.554282234706272,14
3732,57,13,23,7,-3.554408044637194,6
3733,33,11,64,7,-3.558110801858625,4
3734,85,10,63,5,-3.5623843213347826,5
3735,87,105,86,54,-3.5687448191973568,51
3736,45,14,63,8,-3.582850982463552,6
3737,20,11,69,6,-3.5870175414258565,5
3738,95,10,97,6,-3.58943247133478,4
3739,51,35,114,18,-3.5896816599559798,17
3740,51,24,108,13,-3.591871830422867,11
3741,60,29,18,16,-3.598186148290619,13
3742,62,16,28,9,-3.6140960069707972,7
3743,46,51,86,31,-3.616596365260086,20
3744,60,63,13,37,-3.6198276441550075,26
3745,109,27,87,16,-3.621467085014749,11
3746,18,19,43,9,-3.6267699505365183,10
3747,108,11,48,7,-3.633614524897183,4
3748,108,14,75,8,-3.634090811617301,6
3749,5,60,88,32,-3.63799769202775,28
3750,37,20,30,12,-3.640395609700316,8
3751,2,19,16,11,-3.6499962386684315,8
3752,50,13,27,8,-3.6503401008022798,5
3753,65,47,23,25,-3.650632324208862,22
3754,107,35,76,22,-3.6519592132431544,13
3755,32,21,107,11,-3.6546977761524695,10
3756,88,16,12,9,-3.655181484982228,7
3757,71,10,90,5,-3.656103603020123,5
3758,23,22,63,13,-3.656375723040438,9
3759,100,11,53,6,-3.6569500587649983,5
3760,96,33,97,17,-3.6574389351582637,16
3761,86,28,100,14,-3.657823277816528,14
3762,104,53,86,29,-3.66553549979236,24
3763,88,10,19,5,-3.665606739273205,5
3764,50,10,62,6,-3.6657345895143245,4
3765,65,16,102,8,-3.6702036238670743,8
3766,41,43,51,24,-3.6703668875042452,19
3767,80,25,20,14,-3.6714284273440603,11
3768,27,12,71,7,-3.672482180614423,5
3769,68,14,101,9,-3.6742625668258904,5
3770,84,20,46,12,-3.686829488531012,8
3771,40,68,13,37,-3.6903630857890595,31
3772,102,28,28,15,-3.699783063019897,13
3773,43,17,106,9,-3.706853967971227,8
3774,68,30,3,17,-3.7122120868876887,13
3775,5,21,15,13,-3.7147342263498238,8
3776,80,10,91,6,-3.719893539982741,4
3777,88,42,75,24,-3.726903391628383,18
3778,25,65,86,35,-3.735239092039536,30
3779,4,13,1,8,-3.7360390878519714,5
3780,40,42,53,23,-3.7429391558119995,19
3781,65,21,15,12,-3.7445792583431627,9
3782,9,43,65,25,-3.756511153961384,18
3783,6,16,88,9,-3.7570512530434645,7
3784,92,13,104,6,-3.7768187223532292,7
3785,65,19,112,10,-3.778140966593068,9
3786,49,12,28,6,-3.781572164594755,6
3787,6,19,44,12,-3.787510949793907,7
3788,104,13,20,8,-3.7974160411444697,5
3789,78,12,39,6,-3.805891795343841,6
3790,5,16,110,9,-3.8138584796050923,7
3791,28,46,20,26,-3.816541677506152,20
3792,31,18,91,11,-3.819701831167943,7
3793,3,10,49,6,-3.8208441036339096,4
3794,4,21,55,11,-3.821660634263143,10
3795,66,12,60,8,-3.8266322198174065,4
3796,87,16,44,9,-3.826754946057649,7
3797,51,30,70,16,-3.8297117807076546,14
3798,9,25,60,16,-3.8302277634578608,9
3799,86,19,93,11,-3.841500133967818,8
3800,111,34,65,20,-3.8475275648066676,14
3801,68,28,54,16,-3.8524478248196368,12
3802,6,14,65,8,-3.8536392094191116,6
3803,114,25,41,13,-3.8544949021986654,12
3804,18,17,91,10,-3.863168888646894,7
3805,51,16,11,8,-3.8660778701548084,8
3806,68,11,108,6,-3.86884903956731,5
3807,87,36,95,20,-3.8694007735692093,16
3808,70,46,16,27,-3.8722858370388584,19
3809,98,13,18,6,-3.8754830902904,7
3810,107,73,65,41,-3.8798906813939738,32
3811,17,15,11,8,-3.886158778436342,7
3812,62,13,76,7,-3.8913968956310074,6
3813,11,44,55,26,-3.8920841591670357,18
3814,112,13,41,7,-3.895163847789924,6
3815,63,16,17,9,-3.896935952486399,7
3816,47,29,7,17,-3.8974466826753917,12
3817,37,26,102,15,-3.901578428361024,11
3818,49,19,98,10,-3.906322793569991,9
3819,107,48,50,26,-3.9154031865307353,22
3820,70,38,37,22,-3.9227382855891673,16
3821,2,28,5,16,-3.923277825320168,12
3822,13,21,100,12,-3.92873233040865,9
3823,50,11,57,7,-3.929027822248146,4
3824,38,20,16,13,-3.9302083923805924,7
3825,3,20,16,12,-3.933123710020241,8
3826,15,13,64,6,-3.9332029302911167,7
3827,83,10,102,6,-3.9358085201394077,4
3828,97,10,80,6,-3.9365866928471034,4
3829,40,32,87,17,-3.941262642987428,15
3830,100,17,37,10,-3.9481789557688427,7
3831,76,12,34,6,-3.9517678907570324,6
3832,104,50,88,29,-3.9536343834384904,21
3833,93,24,74,13,-3.960101768879081,11
3834,65,72,104,39,-3.970649197276848,33
3835,14,12,96,7,-3.975747798085754,5
3836,43,14,41,8,-3.9773777964919623,6
3837,17,17,34,10,-3.9857052585459996,7
3838,65,32,97,18,-3.9859775040058785,14
3839,51,10,58,6,-3.991203040107808,4
3840,31,12,66,7,-4.0087548725586535,5
3841,86,20,99,12,-4.00989122283285,8
3842,54,36,55,19,-4.011039158800405,17
3843,110,20,8,12,-4.013172679497405,8
3844,114,28,102,16,-4.0171208257371775,12
3845,3,16,104,9,-4.020656220421077,7
3846,88,30,96,16,-4.030096740212504,14
3847,43,10,1,5,-4.03897671575872,5
3848,3,23,13,15,-4.045454302839316,8
3849,50,21,7,11,-4.045740478776831,10
3850,79,13,11,6,-4.047561716338114,7
3851,40,10,32,5,-4.050021677419869,5
3852,68,40,41,22,-4.050286581746885,18
3853,62,23,107,11,-4.0504669700597535,12
3854,107,67,88,39,-4.055852119959083,28
3855,80,28,16,16,-4.056076921695063,12
3856,95,10,43,6,-4.0633983206079485,4
3857,63,29,9,16,-4.065325398742937,13
3858,1,31,68,18,-4.0657893171131025,13
3859,40,57,60,32,-4.06725625489293,25
3860,109,12,43,7,-4.068059286395716,5
3861,38,20,68,12,-4.069118441023081,8
3862,50,22,74,12,-4.086243740312161,10
3863,19,11,36,6,-4.0885902184216905,5
3864,64,26,87,14,-4.098181725889204,12
3865,93,20,83,11,-4.100880722204593,9
3866,46,21,114,12,-4.104107153511736,9
3867,68,14,12,8,-4.108669111305504,6
3868,87,16,27,9,-4.120246149042717,7
3869,106,11,29,6,-4.1226863415672375,5
3870,18,19,64,11,-4.1241273612548905,8
3871,107,14,6,8,-4.134287277974908,6
3872,104,32,76,19,-4.135711821894891,13
3873,69,11,11,7,-4.1379214913131195,4
3874,29,11,23,6,-4.138000210796417,5
3875,74,18,100,10,-4.138016461047894,8
3876,71,47,53,27,-4.141303557057988,20
3877,73,13,20,8,-4.146065391689571,5
3878,62,10,60,6,-4.155747625311636,4
3879,62,15,53,8,-4.159409570332151,7
3880,50,22,40,14,-4.173703341481282,8
3881,51,74,13,40,-4.175645973323164,34
3882,9,19,70,12,-4.17870836598717,7
3883,25,27,23,15,-4.182190113226027,12
3884,88,55,40,31,-4.188882138376304,24
3885,48,14,7,7,-4.194687020035504,7
3886,100,18,23,11,-4.197161790157007,7
3887,54,15,78,9,-4.204577974310619,6
3888,36,56,65,32,-4.205692860728475,24
3889,60,26,43,15,-4.207805100047995,11
3890,17,20,46,11,-4.208745383811279,9
3891,112,11,27,6,-4.214543381192909,5
3892,5,24,39,13,-4.222693276685169,11
3893,37,18,39,10,-4.224456294423104,8
3894,28,20,30,12,-4.22622579482484,8
3895,74,12,31,7,-4.240578281890586,5
3896,46,22,20,14,-4.241307956001941,8
3897,80,17,104,9,-4.256665633473226,8
3898,60,11,80,6,-4.259959127961848,5
3899,39,53,13,29,-4.261083263502734,24
3900,7,26,6,12,-4.269618286715634,14
3901,96,12,33,5,-4.271042933020871,7
3902,96,14,85,9,-4.2835717768106525,5
3903,112,25,53,12,-4.2943591826734995,13
3904,35,17,11,10,-4.299025397751419,7
3905,44,21,20,12,-4.299103845073811,9
3906,54,28,25,16,-4.300413553073274,12
3907,109,22,20,14,-4.302333411252665,8
3908,52,10,50,5,-4.308197298973348,5
3909,20,19,17,11,-4.3112321942034,8
3910,40,22,4,12,-4.316643149060896,10
3911,86,19,15,11,-4.320856963962772,8
3912,11,25,76,15,-4.3267052425458585,10
3913,41,19,95,11,-4.332143979792176,8
3914,22,12,60,7,-4.334241842742782,5
3915,88,24,47,13,-4.347102674354305,11
3916,54,31,104,17,-4.355933806560285,14
3917,87,10,58,6,-4.362695393524183,4
3918,11,13,33,6,-4.365968233102095,7
3919,23,23,40,13,-4.36842332680331,10
3920,58,13,55,7,-4.369004483506263,6
3921,77,26,13,15,-4.370099745102938,11
3922,9,24,55,14,-4.371040618945101,10
3923,98,13,60,7,-4.372454949323837,6
3924,81,14,39,8,-4.374351069268694,6
3925,9,13,74,8,-4.37578055371931,5
3926,96,38,63,23,-4.376849709142973,15
3927,43,13,94,8,-4.383571822547894,5
3928,102,10,13,7,-4.383909812807433,3
3929,76,23,65,14,-4.385586505985179,9
3930,86,20,111,12,-4.3910837466552355,8
3931,43,37,13,19,-4.400642517704952,18
3932,16,22,102,12,-4.402711461143888,10
3933,54,24,17,13,-4.405567288972997,11
3934,64,20,114,12,-4.407773657880816,8
3935,76,12,13,7,-4.417032905676176,5
3936,13,30,99,17,-4.420966828834257,13
3937,9,18,46,10,-4.4238849359462264,8
3938,87,20,102,12,-4.423994697827658,8
3939,64,35,107,19,-4.429693624174907,16
3940,5,115,86,66,-4.430772584334585,49
3941,53,35,16,21,-4.432680586189367,14
3942,50,32,13,18,-4.432840638378544,14
3943,107,46,11,26,-4.433295300820407,20
3944,88,11,45,7,-4.4416566980945715,4
3945,109,15,95,9,-4.444131433700797,6
3946,53,25,106,13,-4.444775992545624,12
3947,37,33,13,19,-4.448467961015428,14
3948,31,67,7,38,-4.453212370234459,29
3949,16,44,95,24,-4.453378575583385,20
3950,17,32,86,16,-4.454107684882271,16
3951,73,12,50,8,-4.454782630059153,4
3952,97,11,77,7,-4.454901155383999,4
3953,32,18,37,10,-4.466542082918519,8
3954,9,14,109,7,-4.46753248183981,7
3955,57,10,91,5,-4.468260927215542,5
3956,84,16,98,10,-4.468561917829733,6
3957,18,30,88,16,-4.47012131788994,14
3958,16,33,97,18,-4.472648646474979,15
3959,25,31,96,17,-4.472832877552798,14
3960,92,12,51,6,-4.473927143910237,6
3961,107,33,95,18,-4.475609109265347,15
3962,16,40,30,23,-4.476195567754862,17
3963,70,29,88,17,-4.478319588858415,12
3964,112,15,36,9,-4.481804787740811,6
3965,27,11,55,6,-4.4890470852362,5
3966,51,45,75,25,-4.490318359114664,20
3967,3,15,64,9,-4.492765978443915,6
3968,37,15,93,9,-4.4934456656390305,6
3969,54,59,20,31,-4.494429121899646,28
3970,54,24,102,14,-4.497323538158561,10
3971,112,20,75,12,-4.4989690721071325,8
3972,84,26,16,14,-4.504335757334272,12
3973,88,93,7,51,-4.5053270586483745,42
3974,104,10,62,7,-4.506645682517949,3
3975,54,52,28,30,-4.514030967957707,22
3976,55,43,37,23,-4.516821858156877,20
3977,51,16,57,9,-4.519213768483541,7
3978,20,12,93,7,-4.531228376986993,5
3979,75,23,106,12,-4.532198108241345,11
3980,68,28,71,17,-4.532265816801446,11
3981,102,24,8,13,-4.537070383836358,11
3982,9,51,88,29,-4.537426821075462,22
3983,76,24,23,13,-4.537606040144393,11
3984,39,11,1,5,-4.548291694643937,6
3985,46,15,83,8,-4.551826612706302,7
3986,112,10,74,6,-4.553694289700708,4
3987,67,13,109,6,-4.5540965230597985,7
3988,23,15,70,8,-4.554568026577778,7
3989,104,16,99,8,-4.562749239239297,8
3990,104,21,30,11,-4.571829941100374,10
3991,95,14,99,8,-4.572737764013027,6
3992,30,12,100,7,-4.575260966636385,5
3993,87,24,71,13,-4.583143708944139,11
3994,96,32,50,18,-4.592653394244437,14
3995,64,20,55,13,-4.5985097101065335,7
3996,95,13,77,7,-4.601493224452909,6
3997,30,11,23,6,-4.601908928188203,5
3998,55,42,7,25,-4.609551229914398,17
3999,29,10,28,6,-4.612981141001358,4
4000,51,11,32,6,-4.628506428595399,5
4001,30,18,20,10,-4.629914367675179,8
4002,39,25,3,15,-4.63189766516782,10
4003,25,22,60,12,-4.636282806493915,10
4004,88,24,43,14,-4.636555985964769,10
4005,109,19,73,11,-4.637139105733963,8
4006,13,14,73,8,-4.6427133386229835,6
4007,25,15,27,8,-4.649655011418167,7
4008,63,27,64,15,-4.655022536417097,12
4009,47,15,25,8,-4.655390231832644,7
4010,98,14,55,9,-4.662824671110213,5
4011,79,18,16,10,-4.664798187963107,8
4012,8,12,52,7,-4.669562642233976,5
4013,81,22,53,13,-4.67351225402936,9
4014,9,16,62,9,-4.679077909097035,7
4015,5,16,71,9,-4.686451238703376,7
4016,98,10,39,6,-4.691177704712752,4
4017,107,67,13,37,-4.699162562307738,30
4018,88,38,11,22,-4.710454574435896,16
4019,68,51,39,28,-4.718369396030295,23
4020,7,32,28,19,-4.719931163726007,13
4021,86,17,47,10,-4.720142586161406,7
4022,75,14,15,9,-4.7291616067808215,5
4023,54,16,85,10,-4.730021736475019,6
4024,48,23,84,14,-4.73502315242232,9
4025,81,10,64,6,-4.736605613786942,4
4026,3,11,97,7,-4.7402730889790226,4
4027,68,42,114,24,-4.745053261523828,18
4028,98,16,70,10,-4.745137974355769,6
4029,77,16,25,9,-4.745845616411638,7
4030,63,38,74,21,-4.748458787006122,17
4031,5,30,90,18,-4.752640516818982,12
4032,50,16,93,10,-4.755526241513055,6
4033,97,16,60,8,-4.770560692259115,8
4034,31,15,12,8,-4.770632464521183,7
4035,70,13,90,7,-4.771084444295363,6
4036,38,27,107,16,-4.7737181379790705,11
4037,5,12,9,7,-4.777710715122403,5
4038,5,33,76,19,-4.788314400539968,14
4039,1,17,9,8,-4.79405950293998,9
4040,1,20,60,12,-4.7956289157103855,8
4041,9,29,8,14,-4.796436219845456,15
4042,25,11,111,6,-4.797175922879397,5
4043,96,22,75,15,-4.80138149231193,7
4044,16,16,110,9,-4.801952356665633,7
4045,8,28,83,15,-4.804749965348905,13
4046,108,13,96,7,-4.805162668071275,6
4047,17,13,100,9,-4.805895298432701,4
4048,106,12,6,7,-4.810944704219048,5
4049,4,17,75,10,-4.813951260599894,7
4050,54,15,14,10,-4.820525855929131,5
4051,43,17,63,10,-4.821038820338599,7
4052,25,19,31,10,-4.823839301099763,9
4053,67,15,8,9,-4.8319098461555825,6
4054,39,39,75,21,-4.835166255544909,18
4055,89,14,41,8,-4.840368821573814,6
4056,64,20,83,11,-4.840996077098241,9
4057,51,30,5,19,-4.841333405150811,11
4058,100,23,104,14,-4.850527098250833,9
4059,94,17,13,10,-4.855238762429886,7
4060,89,10,5,7,-4.862465640901751,3
4061,106,54,37,29,-4.865641247327304,25
4062,110,10,88,5,-4.870544753091406,5
4063,38,11,51,7,-4.873684208436107,4
4064,114,11,30,6,-4.882071098465157,5
4065,95,11,69,7,-4.882909765417962,4
4066,3,12,8,5,-4.887819375016217,7
4067,96,20,60,14,-4.889401556049956,6
4068,5,39,83,21,-4.890865835189012,18
4069,33,16,8,10,-4.890943290835164,6
4070,55,27,76,17,-4.892389867780943,10
4071,106,34,84,18,-4.903872752933782,16
4072,54,48,46,28,-4.906943181154002,20
4073,108,12,54,8,-4.909695920764134,4
4074,17,31,65,20,-4.917244641739983,11
4075,106,56,74,32,-4.924754963776778,24
4076,87,11,17,6,-4.927367867706464,5
4077,9,22,114,15,-4.931319071415344,7
4078,55,21,20,12,-4.931554548881413,9
4079,65,21,45,11,-4.93879712541404,10
4080,108,11,37,6,-4.94147061612662,5
4081,87,14,77,8,-4.94240192025149,6
4082,49,12,76,7,-4.943121216792114,5
4083,68,19,56,10,-4.94813216675333,9
4084,107,89,16,55,-4.950563178278419,34
4085,46,39,51,23,-4.954472518494824,16
4086,8,32,13,19,-4.955794878282507,13
4087,96,36,20,21,-4.958331873160827,15
4088,77,18,39,10,-4.961640817784316,8
4089,90,23,96,14,-4.963939687748077,9
4090,8,12,62,8,-4.964220736900479,4
4091,107,49,40,30,-4.964616090179718,19
4092,87,15,1,8,-4.968031301569398,7
4093,51,18,14,12,-4.969794868699568,6
4094,65,55,55,31,-4.974824332567949,24
4095,15,17,23,10,-4.9841342107101605,7
4096,86,71,37,40,-4.984756436647988,31
4097,39,25,27,13,-4.989393098929608,12
4098,71,15,74,8,-4.993812181109021,7
4099,63,30,104,17,-4.993963037729945,13
4100,68,12,32,8,-4.994599728673894,4
4101,35,16,16,10,-4.995780437282775,6
4102,106,41,7,21,-5.003800212982272,20
4103,5,26,93,16,-5.004460526821323,10
4104,49,21,107,11,-5.010733066245023,10
4105,53,63,7,36,-5.016298274373609,27
4106,34,16,9,9,-5.022861202196314,7
4107,63,29,55,16,-5.056066807562622,13
4108,65,17,46,11,-5.06610491085495,6
4109,33,13,90,8,-5.072843762888294,5
4110,17,10,92,6,-5.072884905069609,4
4111,20,10,32,7,-5.08216341529211,3
4112,62,17,7,10,-5.083532766636536,7
4113,104,61,107,36,-5.084587806965312,25
4114,58,14,60,8,-5.085584297125203,6
4115,95,24,60,14,-5.089480392621887,10
4116,43,27,16,17,-5.089727697712364,10
4117,110,11,87,7,-5.0925904586002675,4
4118,86,12,89,6,-5.092829255018563,6
4119,104,25,53,14,-5.094260383198605,11
4120,70,23,55,13,-5.1032220329288345,10
4121,87,28,76,17,-5.1240936522661755,11
4122,39,28,114,15,-5.125505730553987,13
4123,58,30,40,16,-5.133397385337809,14
4124,4,12,109,7,-5.135069245647407,5
4125,20,56,107,32,-5.14142546085239,24
4126,88,15,44,8,-5.148664566159752,7
4127,9,24,106,14,-5.150083731218861,10
4128,79,13,63,8,-5.150156389678723,5
4129,50,46,87,25,-5.151620252108098,21
4130,7,96,16,54,-5.155701242136665,42
4131,63,54,8,30,-5.156454172512432,24
4132,39,14,111,8,-5.158992286191917,6
4133,5,12,67,7,-5.159840528973067,5
4134,56,11,91,6,-5.160182814393273,5
4135,50,40,2,23,-5.1602643680773745,17
4136,47,26,75,17,-5.17693162231529,9
4137,51,24,4,15,-5.183921696313045,9
4138,13,25,91,14,-5.184425816199746,11
4139,113,13,40,8,-5.193726392686624,5
4140,84,11,13,7,-5.1981712851122435,4
4141,55,18,34,10,-5.202160532736089,8
4142,91,12,33,6,-5.213867650447791,6
4143,37,22,40,12,-5.218981261850287,10
4144,5,11,35,6,-5.226534281744142,5
4145,13,47,71,26,-5.235216499316669,21
4146,25,21,91,12,-5.23677892954369,9
4147,14,15,65,8,-5.239230657167625,7
4148,40,15,98,8,-5.239271076053038,7
4149,40,26,25,15,-5.242222631716463,11
4150,16,13,103,8,-5.257274881217921,5
4151,92,11,28,7,-5.266199037582341,4
4152,109,32,88,19,-5.272527791460708,13
4153,88,11,56,6,-5.280224334897691,5
4154,28,19,14,12,-5.2887953454841945,7
4155,35,11,30,6,-5.293385259461386,5
4156,86,28,49,16,-5.300994125698593,12
4157,55,25,111,15,-5.307717141421055,10
4158,65,62,87,37,-5.3117934902325254,25
4159,87,62,8,36,-5.3184514728570145,26
4160,38,29,86,17,-5.32294088989751,12
4161,102,14,97,9,-5.335160623731844,5
4162,57,25,87,15,-5.341931643339133,10
4163,65,18,62,10,-5.345755023288058,8
4164,87,33,30,19,-5.350349764034888,14
4165,51,43,104,27,-5.354494200185865,16
4166,97,35,7,19,-5.356987360153851,16
4167,112,13,106,7,-5.358449059964546,6
4168,17,12,98,6,-5.361440435561064,6
4169,63,30,75,17,-5.362343223381898,13
4170,109,24,107,15,-5.374789076628487,9
4171,7,24,100,14,-5.390746304293862,10
4172,54,24,93,15,-5.392828840599425,9
4173,90,31,54,18,-5.397442007333916,13
4174,106,52,54,28,-5.400574012233974,24
4175,86,63,11,36,-5.401837176054467,27
4176,66,11,9,6,-5.404825557202403,5
4177,37,11,49,6,-5.405793666619149,5
4178,83,15,51,10,-5.415397349279682,5
4179,40,10,38,5,-5.415692699604588,5
4180,60,27,54,16,-5.432461791262127,11
4181,57,18,97,10,-5.45235309786646,8
4182,71,43,75,27,-5.454468163058883,16
4183,68,11,80,7,-5.466227321340817,4
4184,50,15,43,10,-5.476388636923783,5
4185,36,17,99,11,-5.476671917231901,6
4186,75,10,14,6,-5.479308338136782,4
4187,70,23,114,14,-5.484820175107314,9
4188,38,20,7,11,-5.485899453240417,9
4189,112,25,86,14,-5.486758411271888,11
4190,40,49,65,28,-5.488110460552834,21
4191,1,10,46,5,-5.488587081929578,5
4192,54,20,15,11,-5.491526659354752,9
4193,62,10,18,6,-5.493140482819633,4
4194,40,20,62,10,-5.493314127309688,10
4195,102,10,67,6,-5.497246561771841,4
4196,109,13,32,7,-5.508051897308618,6
4197,83,19,95,12,-5.510188596504647,7
4198,37,59,87,35,-5.516733087496061,24
4199,46,49,13,29,-5.516940275245687,20
4200,20,10,62,6,-5.517288163699186,4
4201,57,24,88,13,-5.524909922819241,11
4202,75,20,27,11,-5.525223821089191,9
4203,102,14,33,8,-5.525239013163607,6
4204,88,23,30,12,-5.525413582454541,11
4205,51,95,16,55,-5.5262304618356275,40
4206,3,14,28,9,-5.526860673095199,5
4207,23,31,106,16,-5.535479536227777,15
4208,18,36,28,20,-5.538955354420102,16
4209,84,16,75,9,-5.542746956131477,7
4210,84,18,25,11,-5.5466876181289715,7
4211,31,53,36,30,-5.548564460468652,23
4212,25,41,8,25,-5.550067480025435,16
4213,84,14,34,7,-5.5528939684650025,7
4214,4,11,46,6,-5.55622187464566,5
4215,95,10,31,6,-5.5581891593402775,4
4216,10,11,63,7,-5.56040496031845,4
4217,60,24,3,14,-5.560495932377157,10
4218,104,60,37,36,-5.5634752610620195,24
4219,54,31,11,18,-5.565049065297328,13
4220,47,12,71,7,-5.571212302193355,5
4221,64,43,13,23,-5.572520889749911,20
4222,71,17,12,10,-5.576190752449122,7
4223,97,19,87,12,-5.581011131648729,7
4224,68,21,62,12,-5.5910040455918875,9
4225,25,32,87,18,-5.592843725263718,14
4226,63,11,99,6,-5.5958077337997105,5
4227,23,41,13,22,-5.602560116244981,19
4228,20,10,79,6,-5.6068676923155305,4
4229,43,14,27,7,-5.609839390205424,7
4230,50,15,100,9,-5.612526049660052,6
4231,50,10,6,6,-5.616920699281765,4
4232,3,22,114,14,-5.6169459155328765,8
4233,50,48,16,28,-5.617696720442926,20
4234,50,26,95,15,-5.619957219349124,11
4235,17,21,5,14,-5.625033929201381,7
4236,73,28,86,15,-5.62531345595925,13
4237,36,12,76,9,-5.641487589296995,3
4238,60,44,55,25,-5.64477193439587,19
4239,77,11,109,6,-5.645459503468275,5
4240,74,23,73,14,-5.649045009007229,9
4241,97,13,39,8,-5.649731064357227,5
4242,97,10,4,6,-5.649870700339136,4
4243,61,13,9,8,-5.652969843590385,5
4244,82,11,54,7,-5.66427830231393,4
4245,37,48,16,28,-5.664774565241773,20
4246,99,31,16,18,-5.66581833704302,13
4247,37,39,75,25,-5.670197882049106,14
4248,25,10,94,5,-5.671887186214519,5
4249,68,18,47,11,-5.681623794437403,7
4250,95,10,102,6,-5.68531996234082,4
4251,55,25,30,15,-5.686463879094617,10
4252,5,46,106,28,-5.689619439430468,18
4253,43,10,23,6,-5.689859175567735,4
4254,32,10,70,5,-5.692479372096212,5
4255,46,40,8,22,-5.695904868807615,18
4256,53,10,29,7,-5.706367610412568,3
4257,69,26,51,16,-5.708510695737556,10
4258,54,11,29,6,-5.709851331879876,5
4259,40,26,114,17,-5.715670519906255,9
4260,102,10,23,6,-5.716053822653882,4
4261,37,18,41,11,-5.716493275276267,7
4262,51,26,25,15,-5.726135112848949,11
4263,48,20,11,12,-5.726887293490206,8
4264,9,14,45,9,-5.727853500458989,5
4265,25,48,13,26,-5.729332953997916,22
4266,112,14,13,8,-5.733766605814065,6
4267,106,42,25,26,-5.737688222420908,16
4268,77,12,36,7,-5.751140829309579,5
4269,34,17,86,10,-5.754838058234217,7
4270,51,73,39,42,-5.7559747310891485,31
4271,53,13,58,6,-5.756559382638664,7
4272,92,10,65,6,-5.758565875475844,4
4273,62,11,100,6,-5.76483412631544,5
4274,71,30,64,19,-5.764884814228726,11
4275,9,23,18,15,-5.785477096919834,8
4276,86,37,64,21,-5.796824578298753,16
4277,55,28,74,16,-5.797157459674131,12
4278,64,45,7,25,-5.8010614589687695,20
4279,106,28,80,17,-5.812470547213422,11
4280,49,10,100,5,-5.813425744151518,5
4281,5,16,40,9,-5.82052725169565,7
4282,9,42,107,24,-5.825633505220708,18
4283,51,14,62,8,-5.840109303871166,6
4284,87,16,108,10,-5.840502938250504,6
4285,65,29,64,16,-5.843001839077046,13
4286,46,37,74,23,-5.850135921281392,14
4287,7,17,34,10,-5.863504951401834,7
4288,65,52,51,32,-5.865717524678075,20
4289,95,36,54,20,-5.865979569344108,16
4290,28,49,104,28,-5.869912935195165,21
4291,3,34,7,21,-5.87756648772805,13
4292,36,12,46,7,-5.88209418081934,5
4293,36,18,28,10,-5.89839978381916,8
4294,25,16,93,9,-5.904464695396422,7
4295,107,33,100,17,-5.907266287901797,16
4296,45,15,41,10,-5.914462706154762,5
4297,63,10,93,6,-5.917563250275586,4
4298,109,47,28,29,-5.921317060443457,18
4299,13,26,47,15,-5.922014718305203,11
4300,114,20,73,12,-5.924435121305104,8
4301,63,45,37,27,-5.933785173114153,18
4302,7,15,33,8,-5.9471342175078945,7
4303,14,12,39,7,-5.9475481477923315,5
4304,10,12,97,6,-5.950831581917707,6
4305,40,18,97,11,-5.966918416140385,7
4306,27,12,74,6,-5.991317096712257,6
4307,31,25,114,14,-5.9918765203954925,11
4308,70,57,54,34,-6.000249372764341,23
4309,17,10,99,6,-6.011623328938978,4
4310,71,31,30,18,-6.024215205048038,13
4311,46,20,95,12,-6.027785407812037,8
4312,50,17,91,11,-6.027790824025908,6
4313,57,12,78,7,-6.03107487711256,5
4314,86,29,69,17,-6.032202467444129,12
4315,31,31,75,17,-6.03348213428737,14
4316,98,24,7,15,-6.033686003781978,9
4317,32,16,8,9,-6.041444852098721,7
4318,68,48,16,30,-6.053036366464971,18
4319,63,19,90,11,-6.053395439788755,8
4320,9,10,35,5,-6.055687068848653,5
4321,28,18,23,10,-6.0662027716624305,8
4322,87,76,16,44,-6.066796148835431,32
4323,41,27,23,16,-6.068042449918635,11
4324,48,14,74,7,-6.068043245358376,7
4325,41,25,60,14,-6.080070950949514,11
4326,5,44,20,27,-6.084413199436969,17
4327,107,23,111,12,-6.08814286411973,11
4328,44,10,71,6,-6.0911400566932725,4
4329,86,39,98,22,-6.096402500191196,17
4330,88,40,23,26,-6.098802854801483,14
4331,60,12,102,7,-6.1025406778466875,5
4332,79,10,55,6,-6.105260957218082,4
4333,7,12,90,7,-6.108519045195329,5
4334,31,13,81,9,-6.1171597913254026,4
4335,88,35,25,23,-6.12387967695023,12
4336,97,24,55,15,-6.128965912516969,9
4337,80,13,31,9,-6.13276887148396,4
4338,48,10,23,6,-6.136507124451631,4
4339,46,14,109,8,-6.137839688733693,6
4340,63,16,78,8,-6.142144937717797,8
4341,39,48,40,29,-6.1478732659202615,19
4342,112,15,31,10,-6.149641402394962,5
4343,20,11,85,6,-6.150943417431858,5
4344,58,13,16,8,-6.156802466115247,5
4345,89,10,63,7,-6.159771716986654,3
4346,87,41,68,24,-6.166464303817792,17
4347,76,23,97,13,-6.171425808149793,10
4348,84,54,28,32,-6.1786789402149065,22
4349,35,14,55,8,-6.18171019735336,6
4350,84,15,38,8,-6.186656588515755,7
4351,70,28,74,15,-6.203999405338755,13
4352,65,21,38,11,-6.2252846155522565,10
4353,55,31,80,17,-6.225846961531595,14
4354,50,41,104,25,-6.230364171354916,16
4355,51,97,7,60,-6.231180255750106,37
4356,9,32,28,18,-6.2373511594029205,14
4357,62,15,54,9,-6.240490314200173,6
4358,107,24,58,15,-6.246057958192936,9
4359,53,41,107,25,-6.250695932210901,16
4360,5,17,43,10,-6.250727481432203,7
4361,88,83,86,49,-6.254550732132809,34
4362,39,22,92,12,-6.263991845659126,10
4363,95,12,15,7,-6.265255655621161,5
4364,20,28,39,15,-6.273682118106889,13
4365,4,21,86,13,-6.2794844995496994,8
4366,102,11,41,7,-6.282861273718874,4
4367,92,12,16,9,-6.284475222709882,3
4368,64,16,70,11,-6.2860092045587415,5
4369,88,56,65,35,-6.287559020425313,21
4370,114,17,23,11,-6.291790840234865,6
4371,83,16,39,10,-6.297771796270442,6
4372,55,13,29,8,-6.301089833667023,5
4373,30,26,53,15,-6.311098789496546,11
4374,5,25,32,15,-6.322230990899956,10
4375,57,11,76,7,-6.324386635638288,4
4376,112,14,54,9,-6.326711825622494,5
4377,4,18,63,11,-6.33309005279508,7
4378,98,20,11,11,-6.3386776528601825,9
4379,84,12,30,8,-6.354899474173293,4
4380,27,13,92,7,-6.356396578041118,6
4381,44,12,28,6,-6.3579705752280935,6
4382,56,21,7,12,-6.361794853449643,9
4383,84,32,74,17,-6.37967811989364,15
4384,71,27,50,16,-6.37993434567586,11
4385,108,18,16,11,-6.383719600885128,7
4386,77,13,74,8,-6.38427445953612,5
4387,77,13,106,7,-6.407119934187455,6
4388,77,19,107,11,-6.4169470483546815,8
4389,33,16,40,11,-6.427211772717695,5
4390,109,20,41,13,-6.432688342356182,7
4391,75,50,86,28,-6.43422204324356,22
4392,36,39,86,23,-6.43939444107294,16
4393,16,49,75,29,-6.443913435512627,20
4394,87,20,4,13,-6.445923142452617,7
4395,28,10,6,6,-6.452419128804086,4
4396,86,30,27,19,-6.453315924089684,11
4397,87,25,90,15,-6.454852453391627,10
4398,43,26,107,16,-6.466098586244282,10
4399,39,15,12,9,-6.475459814124789,6
4400,17,20,28,12,-6.478742661851247,8
4401,78,25,86,15,-6.48911817733207,10
4402,104,10,48,6,-6.493358473776669,4
4403,104,27,41,15,-6.500266163182682,12
4404,4,12,56,6,-6.509885274579447,6
4405,28,15,35,8,-6.525585250622974,7
4406,38,14,109,9,-6.53962010725684,5
4407,55,10,49,6,-6.541972088163769,4
4408,18,21,77,14,-6.545250800191178,7
4409,3,11,41,8,-6.560880189791295,3
4410,25,37,104,21,-6.567754121461538,16
4411,114,26,53,15,-6.571088082289226,11
4412,1,26,40,16,-6.58137324665705,10
4413,60,25,30,17,-6.5923697926317155,8
4414,96,28,65,16,-6.593487230396348,12
4415,37,18,80,11,-6.59536314979572,7
4416,81,18,71,11,-6.61709770119633,7
4417,100,30,16,19,-6.617449381235234,11
4418,5,48,25,29,-6.626414170343123,19
4419,64,28,16,18,-6.646602698554465,10
4420,114,15,76,10,-6.653911993113485,5
4421,37,19,71,11,-6.65399605348867,8
4422,71,11,83,6,-6.6562053803338666,5
4423,13,13,14,9,-6.663851771345143,4
4424,88,36,27,20,-6.672694825026895,16
4425,70,14,49,8,-6.672966411521807,6
4426,53,51,68,31,-6.677046957897992,20
4427,47,20,107,12,-6.679988416533417,8
4428,37,10,29,6,-6.680734619445758,4
4429,106,11,111,8,-6.697425895741327,3
4430,91,12,15,6,-6.697476716978325,6
4431,74,15,83,8,-6.703298030488857,7
4432,40,10,6,6,-6.705680107058635,4
4433,68,23,97,14,-6.71314119034243,9
4434,97,35,28,22,-6.716635909782018,13
4435,32,10,65,6,-6.718474357729474,4
4436,32,11,97,7,-6.7220085367153315,4
4437,95,11,100,6,-6.722166987268522,5
4438,95,13,14,8,-6.731405281187272,5
4439,96,38,74,24,-6.731828732252354,14
4440,109,43,54,27,-6.7374181706906375,16
4441,20,11,52,7,-6.739976324437407,4
4442,38,10,29,6,-6.744621955429494,4
4443,51,15,102,9,-6.749472817285659,6
4444,96,79,86,48,-6.750994185821139,31
4445,90,13,53,8,-6.752088210585149,5
4446,107,23,33,13,-6.763493299081546,10
4447,27,14,6,8,-6.780540737481573,6
4448,31,10,55,6,-6.798197972656263,4
4449,71,10,49,6,-6.8003776926672845,4
4450,93,14,16,8,-6.800404971341563,6
4451,13,25,108,16,-6.801707995205208,9
4452,45,18,60,10,-6.802248227913869,8
4453,114,16,100,10,-6.806713890734191,6
4454,96,20,51,12,-6.8091583197949745,8
4455,9,14,25,9,-6.810304163725227,5
4456,52,10,65,7,-6.817085213239556,3
4457,31,69,68,41,-6.8216343585610195,28
4458,106,25,95,16,-6.830338155584793,9
4459,96,14,78,9,-6.830515928543477,5
4460,95,29,13,17,-6.852052215706936,12
4461,96,19,114,12,-6.857320738328298,7
4462,71,39,16,25,-6.859693337666749,14
4463,11,17,75,10,-6.860129083231022,7
4464,4,43,60,24,-6.864343045215706,19
4465,87,48,7,30,-6.8660731048454515,18
4466,36,12,57,8,-6.873476463690229,4
4467,18,21,54,12,-6.880495431858326,9
4468,99,15,106,10,-6.882359612487446,5
4469,5,47,114,28,-6.885144276646174,19
4470,65,22,90,12,-6.887045978873849,10
4471,88,16,76,9,-6.891817282335724,7
4472,53,10,49,6,-6.90781300095477,4
4473,55,36,104,22,-6.909075624793387,14
4474,46,38,16,23,-6.920639082616032,15
4475,30,19,75,11,-6.923427737676235,8
4476,88,12,99,7,-6.939131232028662,5
4477,2,27,63,16,-6.942761121987027,11
4478,17,14,41,9,-6.944180159767115,5
4479,50,11,15,7,-6.9507529081852075,4
4480,18,12,47,8,-6.958091333768663,4
4481,104,18,32,12,-6.959225086389547,6
4482,36,34,16,21,-6.96230955324868,13
4483,84,15,83,8,-6.963483843011809,7
4484,51,21,97,14,-6.980039097404116,7
4485,94,12,55,7,-6.987298934898081,5
4486,55,20,17,11,-6.987444025974705,9
4487,13,23,111,13,-6.988942249892523,10
4488,1,19,114,12,-6.990089974683046,7
4489,5,15,62,9,-6.9927087595973925,6
4490,48,13,80,9,-6.99747900943173,4
4491,86,14,45,8,-7.001591160951406,6
4492,40,15,95,9,-7.026458120737084,6
4493,18,16,100,9,-7.026565168419708,7
4494,54,29,13,19,-7.026908366399237,10
4495,87,24,3,15,-7.028655258681693,9
4496,58,22,7,12,-7.035143698213465,10
4497,38,28,37,17,-7.041316380566512,11
4498,11,10,64,7,-7.044290994994302,3
4499,73,16,65,10,-7.056062739811477,6
4500,18,27,68,16,-7.057508559262057,11
4501,65,39,30,24,-7.058570840380226,15
4502,64,13,44,8,-7.05920038211248,5
4503,25,21,100,12,-7.062312436550092,9
4504,49,14,50,8,-7.064134383315742,6
4505,38,21,63,14,-7.071277555225252,7
4506,98,14,102,8,-7.075813129571892,6
4507,70,35,28,21,-7.078735797739843,14
4508,13,29,81,18,-7.09040644902069,11
4509,3,20,36,13,-7.093052097907007,7
4510,13,19,90,12,-7.099319512939565,7
4511,13,16,44,10,-7.100478256103446,6
4512,39,11,19,6,-7.101501058499144,5
4513,110,16,51,10,-7.104586521997479,6
4514,83,28,86,19,-7.104640535135333,9
4515,3,23,88,14,-7.12663205785296,9
4516,67,11,88,8,-7.127393540580368,3
4517,48,32,63,20,-7.1299692009467925,12
4518,17,21,4,14,-7.131209049726909,7
4519,107,57,75,39,-7.131800392099847,18
4520,87,51,13,33,-7.139410033835633,18
4521,75,39,18,23,-7.143872456900073,16
4522,60,17,5,11,-7.144002600647478,6
4523,93,23,87,14,-7.164798687762666,9
4524,14,14,86,8,-7.166696838482464,6
4525,43,16,64,9,-7.166853133398247,7
4526,60,12,84,9,-7.1701831921763475,3
4527,88,72,54,43,-7.171089550335251,29
4528,47,12,23,8,-7.180906240191951,4
4529,63,20,27,11,-7.19472225275396,9
4530,61,17,53,11,-7.205087339517602,6
4531,40,20,35,13,-7.223846117897835,7
4532,75,10,20,6,-7.241047227766171,4
4533,40,32,54,19,-7.243609732204197,13
4534,5,14,31,9,-7.246607645789562,5
4535,90,13,46,8,-7.250761878801305,5
4536,93,12,98,7,-7.251352809271133,5
4537,54,11,38,7,-7.25460278530091,4
4538,65,29,4,18,-7.258642786898054,11
4539,81,19,75,12,-7.259552889264539,7
4540,31,31,41,19,-7.267301725174955,12
4541,70,16,110,10,-7.267896542251016,6
4542,96,10,62,7,-7.268496266352443,3
4543,57,13,106,7,-7.272492874678534,6
4544,20,42,65,27,-7.275621933808214,15
4545,49,21,87,11,-7.287852583518847,10
4546,36,17,97,10,-7.301788222671786,7
4547,91,41,16,27,-7.309347152714906,14
4548,106,24,39,14,-7.312269199982411,10
4549,55,26,109,14,-7.3182997081126135,12
4550,65,23,1,13,-7.319832649719675,10
4551,5,42,70,25,-7.323141246130922,17
4552,81,25,86,17,-7.333013220803047,8
4553,68,14,92,9,-7.338682351737512,5
4554,8,25,73,15,-7.3587900254771785,10
4555,23,13,49,8,-7.360298065336568,5
4556,64,12,49,7,-7.364918196286091,5
4557,114,10,77,6,-7.365477220397804,4
4558,33,16,25,11,-7.36592627296452,5
4559,74,15,34,10,-7.367415754617588,5
4560,41,26,87,16,-7.368765436268465,10
4561,4,12,30,7,-7.371580414746792,5
4562,71,10,73,6,-7.373234065194552,4
4563,51,31,27,20,-7.390169773800459,11
4564,5,10,1,6,-7.391988711274882,4
4565,46,41,37,27,-7.398384968299376,14
4566,55,65,16,42,-7.408891459698617,23
4567,69,27,13,17,-7.410798113719346,10
4568,41,34,36,18,-7.412500474371831,16
4569,91,19,8,12,-7.416456742894205,7
4570,18,23,63,15,-7.424434558796219,8
4571,112,11,18,8,-7.442617961192051,3
4572,84,28,8,18,-7.447150756775401,10
4573,71,13,70,7,-7.447387393345607,6
4574,63,62,16,37,-7.448491338619512,25
4575,75,30,46,18,-7.449361290092636,12
4576,100,17,75,9,-7.449782688238095,8
4577,76,18,112,10,-7.452810243863066,8
4578,97,53,86,32,-7.453774682156136,21
4579,110,21,37,12,-7.457046552670356,9
4580,53,12,45,7,-7.463487107897495,5
4581,54,14,94,9,-7.465192097558689,5
4582,31,37,64,23,-7.4738922265185375,14
4583,63,15,108,9,-7.475559971035059,6
4584,36,14,70,8,-7.476080415111231,6
4585,89,10,48,7,-7.47675761274391,3
4586,96,11,41,8,-7.480521636982391,3
4587,27,27,16,17,-7.481407495599661,10
4588,98,29,91,18,-7.486111931896229,11
4589,77,18,55,11,-7.520653437888105,7
4590,3,16,53,10,-7.523939046153444,6
4591,55,11,6,8,-7.526848268362213,3
4592,51,31,64,19,-7.52751645484338,12
4593,33,20,51,14,-7.541152096210821,6
4594,107,16,12,11,-7.554377135078079,5
4595,23,11,33,7,-7.562255793226968,4
4596,86,23,43,15,-7.565521202755199,8
4597,5,14,34,10,-7.5706698448560905,4
4598,77,12,46,7,-7.574271980014295,5
4599,112,18,7,11,-7.57933344765053,7
4600,81,14,41,9,-7.584350575630448,5
4601,88,18,58,11,-7.5880987725104365,7
4602,36,20,18,12,-7.59490287850123,8
4603,80,22,96,14,-7.6325568595370585,8
4604,5,29,97,19,-7.639418302115126,10
4605,88,20,108,13,-7.642505031143239,7
4606,9,35,16,23,-7.644783932906994,12
4607,60,11,70,7,-7.646435749026202,4
4608,31,13,33,7,-7.647223417443056,6
4609,96,24,37,14,-7.66584492569651,10
4610,11,32,5,20,-7.6874421575338765,12
4611,7,25,111,15,-7.6903234257719815,10
4612,112,10,1,5,-7.69062482458681,5
4613,108,17,53,9,-7.691782047867258,8
4614,104,39,40,25,-7.699889638025223,14
4615,77,15,41,10,-7.700447698799745,5
4616,64,13,46,8,-7.70178518963715,5
4617,109,10,69,6,-7.709222479752555,4
4618,20,34,63,20,-7.7184970833134745,14
4619,102,19,57,11,-7.725209435984635,8
4620,2,28,28,18,-7.726967938716942,10
4621,52,10,63,6,-7.736846011905837,4
4622,84,11,44,6,-7.741464370739851,5
4623,54,13,73,8,-7.746921178252214,5
4624,39,24,84,15,-7.748470893977124,9
4625,68,63,40,41,-7.7522463426238595,22
4626,25,49,37,29,-7.755599308877523,20
4627,73,11,53,7,-7.756297558195456,4
4628,86,14,10,8,-7.764445720347282,6
4629,114,14,92,10,-7.774797164908212,4
4630,39,48,86,28,-7.785751888070244,20
4631,48,15,50,10,-7.798532000224026,5
4632,110,12,114,8,-7.80031681097971,4
4633,49,21,75,13,-7.802050873504806,8
4634,81,23,60,14,-7.817127893520487,9
4635,46,46,25,27,-7.8204011950255445,19
4636,98,17,8,11,-7.832264077196576,6
4637,54,57,63,36,-7.834983225160243,21
4638,39,22,74,13,-7.83839665574887,9
4639,109,19,53,12,-7.841205358929898,7
4640,13,41,114,23,-7.855529583445472,18
4641,91,26,106,17,-7.859341034872017,9
4642,35,12,44,7,-7.859665557157517,5
4643,90,25,114,15,-7.8701656835045455,10
4644,23,17,55,9,-7.8715706098888365,8
4645,104,17,15,11,-7.875168892784025,6
4646,69,15,70,10,-7.889236203805598,5
4647,108,11,76,7,-7.890267325318873,4
4648,18,12,38,7,-7.905676227138177,5
4649,82,10,88,6,-7.9125780836424955,4
4650,20,16,33,10,-7.9280624383644875,6
4651,64,12,77,6,-7.928282722369054,6
4652,106,59,13,37,-7.928893565121882,22
4653,34,10,18,7,-7.93407311360503,3
4654,87,18,29,12,-7.938305879679429,6
4655,43,14,54,8,-7.93899481598767,6
4656,77,13,27,8,-7.939137496569419,5
4657,87,17,73,12,-7.94220715025842,5
4658,53,12,89,7,-7.949973026478008,5
4659,51,10,29,6,-7.954085942877761,4
4660,5,25,65,15,-7.967561696591303,10
4661,4,12,12,8,-7.976222296376226,4
4662,84,28,5,17,-7.986435375626319,11
4663,87,14,15,8,-7.9871826221688895,6
4664,70,16,13,10,-7.990308468406848,6
4665,96,19,102,12,-7.995631160966494,7
4666,31,18,43,8,-8.011472574516002,10
4667,25,12,48,7,-8.01244102921806,5
4668,51,38,76,25,-8.013014238505109,13
4669,50,41,75,27,-8.02466935745211,14
4670,39,18,57,11,-8.042964198775268,7
4671,7,19,73,11,-8.049715087137763,8
4672,12,11,9,7,-8.058955245687951,4
4673,31,30,9,19,-8.059796732295993,11
4674,88,11,85,7,-8.068264760243629,4
4675,28,24,93,16,-8.07091688053174,8
4676,53,25,87,14,-8.07726427006638,11
4677,97,16,110,10,-8.077466293642948,6
4678,5,61,8,37,-8.080732178020163,24
4679,63,46,51,27,-8.098442592455973,19
4680,60,33,23,21,-8.110771933628392,12
4681,57,14,114,9,-8.115945976762234,5
4682,16,15,81,10,-8.120114808218235,5
4683,91,14,51,9,-8.141325110005308,5
4684,29,12,75,7,-8.144839094845086,5
4685,33,11,68,7,-8.166895131198164,4
4686,47,19,16,12,-8.178952833737181,7
4687,98,13,108,8,-8.179403178791246,5
4688,63,25,98,15,-8.180008105424527,10
4689,60,35,104,25,-8.183651908443377,10
4690,61,10,107,6,-8.19056957850756,4
4691,109,24,11,16,-8.196422948591085,8
4692,57,25,8,16,-8.20914757769532,9
4693,3,24,40,16,-8.21009163331203,8
4694,54,15,91,9,-8.22419323895329,6
4695,39,10,102,6,-8.224547128845817,4
4696,106,21,69,13,-8.230262561693124,8
4697,81,16,106,9,-8.234635443757195,7
4698,19,14,68,8,-8.240798182078718,6
4699,16,12,89,7,-8.24232911238878,5
4700,68,13,20,8,-8.25656599286033,5
4701,109,21,74,14,-8.264824669876235,7
4702,55,49,40,31,-8.264830770768937,18
4703,48,27,86,17,-8.264848391369249,10
4704,14,12,37,7,-8.266467835075433,5
4705,55,34,50,20,-8.268886532039618,14
4706,76,12,75,7,-8.269580351796622,5
4707,55,15,100,8,-8.275270908208638,7
4708,91,18,41,12,-8.276671952774393,6
4709,106,31,90,21,-8.28384546124837,10
4710,97,22,18,14,-8.298065482812461,8
4711,53,11,28,7,-8.30735230376955,4
4712,18,38,13,23,-8.31155891824464,15
4713,90,13,30,8,-8.325698662002964,5
4714,50,25,76,17,-8.328303760573554,8
4715,36,45,13,29,-8.340727615472174,16
4716,98,18,13,12,-8.341994513785483,6
4717,93,34,65,20,-8.350774120379098,14
4718,5,22,7,14,-8.357081514884824,8
4719,9,11,11,7,-8.359525570926444,4
4720,107,21,45,13,-8.374668953212842,8
4721,52,14,28,8,-8.38312541721312,6
4722,46,10,6,6,-8.386722378353735,4
4723,104,10,67,6,-8.393331116483225,4
4724,68,19,28,13,-8.40041770505836,6
4725,34,18,109,11,-8.400920779627398,7
4726,20,19,91,11,-8.407006886407046,8
4727,51,85,86,50,-8.410737442922484,35
4728,91,24,68,14,-8.412577437061726,10
4729,8,20,64,13,-8.418575329228208,7
4730,79,21,48,13,-8.423308200700253,8
4731,90,19,73,12,-8.424101991862472,7
4732,114,20,55,13,-8.432483182241098,7
4733,54,19,1,12,-8.434556866218065,7
4734,70,24,96,13,-8.437417991026262,11
4735,114,32,8,21,-8.446067232393617,11
4736,107,30,80,20,-8.450019757222567,10
4737,96,14,95,9,-8.450373982592183,5
4738,16,10,85,7,-8.463981088255796,3
4739,12,20,60,10,-8.47808740593529,10
4740,68,56,75,37,-8.483707229345061,19
4741,1,16,75,11,-8.487454866261048,5
4742,18,18,30,11,-8.488638483548714,7
4743,37,10,94,7,-8.495177713557316,3
4744,40,28,64,18,-8.49607162432113,10
4745,60,14,61,8,-8.502669551258707,6
4746,45,10,91,6,-8.504304930616431,4
4747,69,17,63,12,-8.506537399631055,5
4748,88,23,62,14,-8.51262512712999,9
4749,106,13,12,9,-8.530975907772833,4
4750,20,12,18,8,-8.532272478061662,4
4751,94,13,28,9,-8.536990091746686,4
4752,62,13,114,8,-8.549556180002718,5
4753,36,11,78,7,-8.552435160203329,4
4754,7,19,78,11,-8.565348954184037,8
4755,55,23,95,15,-8.57500650986488,8
4756,49,15,40,9,-8.588514005098899,6
4757,50,22,90,14,-8.598522697493998,8
4758,6,16,13,10,-8.627925335393327,6
4759,97,19,41,12,-8.638943706099203,7
4760,88,16,77,10,-8.678317130754186,6
4761,18,10,3,7,-8.681798681010822,3
4762,39,14,110,10,-8.694421097429624,4
4763,2,10,30,6,-8.704387763563812,4
4764,3,10,96,6,-8.709326138906565,4
4765,102,15,63,9,-8.71016569998991,6
4766,45,10,58,6,-8.721721801464438,4
4767,88,35,39,22,-8.74018182363142,13
4768,11,23,104,15,-8.742484307216113,8
4769,106,14,38,7,-8.74501943352997,7
4770,18,23,106,15,-8.778191080978738,8
4771,46,19,7,13,-8.788211094177631,6
4772,31,28,107,15,-8.798674063671838,13
4773,7,30,45,19,-8.801229657293117,11
4774,42,10,106,7,-8.802546839644418,3
4775,47,18,36,12,-8.810892372607713,6
4776,76,28,63,19,-8.821395394022662,9
4777,36,19,63,12,-8.822881427312195,7
4778,77,13,49,9,-8.842593838828112,4
4779,87,15,32,10,-8.84415502943487,5
4780,114,30,28,18,-8.875783073761175,12
4781,40,16,28,9,-8.877350715587879,7
4782,91,26,87,17,-8.887112732676092,9
4783,97,12,69,8,-8.888377862411463,4
4784,53,14,27,10,-8.90629843674804,4
4785,109,20,7,13,-8.908032141063202,7
4786,107,15,89,10,-8.908975430626485,5
4787,8,32,109,19,-8.913990428825272,13
4788,25,19,110,13,-8.917701672558223,6
4789,88,101,16,66,-8.91886711620617,35
4790,91,10,11,7,-8.923724837318142,3
4791,84,14,104,8,-8.932998314387538,6
4792,43,24,39,14,-8.934327178088367,10
4793,31,12,73,8,-8.93891957013575,4
4794,80,13,11,8,-8.941133144462878,5
4795,68,17,69,10,-8.951691444155669,7
4796,32,11,28,7,-8.963821007682874,4
4797,114,20,47,12,-8.969382880850324,8
4798,74,19,102,12,-8.969831254032448,7
4799,79,13,7,8,-8.987188867047667,5
4800,60,17,17,11,-8.995312545980157,6
4801,69,10,62,6,-9.00706523943993,4
4802,36,15,5,9,-9.008614310253614,6
4803,107,26,48,16,-9.037134061886896,10
4804,112,10,58,6,-9.041979275484929,4
4805,106,23,2,14,-9.061321745571256,9
4806,75,34,28,22,-9.068390514566694,12
4807,98,15,20,10,-9.068391127675763,5
4808,86,29,44,19,-9.073857704921481,10
4809,8,34,95,21,-9.07920947405897,13
4810,51,11,48,6,-9.079697327016946,5
4811,84,41,63,25,-9.10313407107926,16
4812,31,15,109,10,-9.113887572404183,5
4813,17,18,104,11,-9.118260519592534,7
4814,1,25,86,16,-9.124826219314393,9
4815,5,43,50,26,-9.156049369840705,17
4816,30,12,27,7,-9.159316291712273,5
4817,40,15,92,10,-9.168940871834318,5
4818,102,15,40,9,-9.171373555966687,6
4819,49,15,41,9,-9.171912615870816,6
4820,86,39,41,26,-9.172157333193885,13
4821,112,16,39,10,-9.17506097605606,6
4822,88,30,15,21,-9.176202112652083,9
4823,40,17,73,11,-9.199997222971483,6
4824,40,12,2,8,-9.204153353273353,4
4825,57,17,11,10,-9.206442600524502,7
4826,76,15,54,10,-9.214343370527448,5
4827,4,15,27,9,-9.21491506769711,6
4828,37,15,64,10,-9.227089681457189,5
4829,107,31,2,20,-9.235597195463592,11
4830,76,10,15,6,-9.241288842836557,4
4831,50,29,60,17,-9.241321859956901,12
4832,66,13,65,9,-9.24629898792323,4
4833,12,17,53,10,-9.27312011933641,7
4834,93,13,75,8,-9.279825087560207,5
4835,38,19,39,12,-9.2800617682445,7
4836,51,14,80,9,-9.288063840727723,5
4837,77,19,63,13,-9.291814452323939,6
4838,22,11,109,7,-9.30323095736105,4
4839,55,13,2,8,-9.30651882359562,5
4840,67,15,86,9,-9.306541844943451,6
4841,107,12,110,8,-9.307853181235297,4
4842,8,34,75,23,-9.310281336500847,11
4843,31,26,27,15,-9.313550400018615,11
4844,70,17,50,10,-9.316243790355681,7
4845,76,22,16,12,-9.339094465816045,10
4846,96,46,16,32,-9.342765312407819,14
4847,48,10,98,7,-9.346073134818255,3
4848,39,70,16,44,-9.35308699106358,26
4849,50,12,23,9,-9.354699302165743,3
4850,39,16,109,12,-9.356347251836707,4
4851,45,13,35,7,-9.365578608940048,6
4852,111,15,28,10,-9.365771514395545,5
4853,39,17,76,12,-9.374915521858478,5
4854,3,10,84,6,-9.385748847208339,4
4855,36,11,109,8,-9.390936468630553,3
4856,76,37,86,24,-9.404159373470087,13
4857,112,11,38,8,-9.413940162098223,3
4858,1,10,15,7,-9.42159486047143,3
4859,92,14,64,7,-9.432471863302016,7
4860,53,12,78,7,-9.436495389192622,5
4861,63,11,32,7,-9.44232166344675,4
4862,68,28,76,21,-9.459920139276978,7
4863,66,17,107,11,-9.469730190602778,6
4864,39,38,18,25,-9.477799828508715,13
4865,7,29,37,18,-9.500511382222342,11
4866,43,17,75,12,-9.501415277619838,5
4867,99,22,37,15,-9.502759058160713,7
4868,2,13,114,8,-9.50915856241785,5
4869,80,14,90,10,-9.509239360264804,4
4870,25,32,20,21,-9.520523686179052,11
4871,31,22,1,13,-9.525804060927038,9
4872,108,13,106,9,-9.535201707134298,4
4873,63,13,81,8,-9.541818568077552,5
4874,97,24,13,15,-9.567486234498414,9
4875,43,14,100,8,-9.569290027183786,6
4876,60,44,64,30,-9.569439655645416,14
4877,54,24,30,16,-9.570998833719646,8
4878,109,11,30,7,-9.576510357445859,4
4879,69,15,58,9,-9.580148024352619,6
4880,39,14,80,9,-9.589468521855673,5
4881,53,13,8,9,-9.596286006275326,4
4882,68,19,55,13,-9.598434976526491,6
4883,9,17,20,11,-9.610959353403572,6
4884,8,14,99,8,-9.611065592860308,6
4885,20,36,50,24,-9.619543641365507,12
4886,9,16,76,11,-9.62150457184245,5
4887,109,17,70,11,-9.623350653501726,6
4888,63,17,100,10,-9.628829836647936,7
4889,29,22,65,13,-9.643319235535328,9
4890,63,16,111,10,-9.656549842780757,6
4891,9,30,87,18,-9.657202776782615,12
4892,71,12,100,8,-9.66068752031631,4
4893,38,12,53,8,-9.664145468055217,4
4894,109,17,17,11,-9.67292277687966,6
4895,87,19,100,11,-9.686243494464469,8
4896,13,14,58,10,-9.687344315616334,4
4897,32,16,16,10,-9.721720922013692,6
4898,39,19,100,12,-9.733162985159312,7
4899,84,27,20,19,-9.752482123804995,8
4900,18,42,16,28,-9.75454627994462,14
4901,83,24,37,15,-9.783726366978415,9
4902,93,10,62,6,-9.798162399200404,4
4903,39,14,90,9,-9.813134332006266,5
4904,75,25,104,16,-9.822163907084752,9
4905,98,10,53,6,-9.839111782848335,4
4906,63,16,30,10,-9.842696842263113,6
4907,18,12,76,8,-9.8476224935035,4
4908,91,34,63,23,-9.863803572303501,11
4909,81,12,114,7,-9.869667650649568,5
4910,39,21,46,12,-9.87039628115896,9
4911,71,15,17,9,-9.874078720771612,6
4912,3,14,25,9,-9.907996037168818,5
4913,2,10,95,7,-9.9203126299905,3
4914,17,10,38,6,-9.957251396991314,4
4915,18,20,50,12,-9.960321484724405,8
4916,27,15,37,10,-9.960774411821363,5
4917,88,18,73,12,-9.974203425238962,6
4918,52,13,87,8,-9.98485251805505,5
4919,109,14,93,9,-9.987067099161266,5
4920,10,13,107,8,-9.98735340517921,5
4921,48,11,34,7,-9.987399142382838,4
4922,65,25,95,16,-9.987438820754939,9
4923,57,12,75,8,-10.001839571130395,4
4924,9,13,43,8,-10.011482215577137,5
4925,18,14,11,9,-10.031989827572827,5
4926,29,12,70,7,-10.037060199943543,5
4927,38,10,44,7,-10.048373138060267,3
4928,57,12,54,9,-10.066024134547122,3
4929,28,10,110,6,-10.066740720619942,4
4930,106,12,79,8,-10.079963228120917,4
4931,74,11,89,7,-10.093150392265773,4
4932,8,24,18,17,-10.10300859124231,7
4933,36,36,53,25,-10.11473282468799,11
4934,102,20,50,12,-10.118106239071224,8
4935,35,10,8,7,-10.118762046100299,3
4936,15,20,8,12,-10.121581558030638,8
4937,70,14,46,9,-10.128652016947743,5
4938,109,10,92,7,-10.132066653367776,3
4939,31,37,53,23,-10.136338371296794,14
4940,23,11,96,7,-10.143008283174424,4
4941,102,14,76,9,-10.166991590900437,5
4942,69,11,40,8,-10.175676528085834,3
4943,104,13,89,8,-10.178686881843591,5
4944,51,27,20,16,-10.18965396567182,11
4945,37,41,97,27,-10.190687502541847,14
4946,33,13,71,9,-10.195530501937561,4
4947,2,15,98,9,-10.198603389321665,6
4948,37,36,11,24,-10.207174749413833,12
4949,68,24,25,16,-10.21179043309895,8
4950,31,17,30,10,-10.214096274935343,7
4951,112,20,64,14,-10.224123936701867,6
4952,41,19,20,12,-10.239156920032366,7
4953,88,18,100,12,-10.248815429425125,6
4954,25,43,7,29,-10.249875265637383,14
4955,106,16,67,10,-10.252161434234205,6
4956,99,12,77,9,-10.252199704478636,3
4957,104,12,34,8,-10.27427919250402,4
4958,35,11,97,8,-10.275101346884465,3
4959,84,10,71,7,-10.279461085413814,3
4960,78,13,40,10,-10.282455211399137,3
4961,69,24,60,14,-10.299447344288494,10
4962,81,14,7,8,-10.321582987727558,6
4963,1,13,37,8,-10.34216426905315,5
4964,63,17,1,10,-10.344681903521664,7
4965,79,24,86,16,-10.359095369944336,8
4966,81,13,104,7,-10.361322759461327,6
4967,109,24,63,15,-10.36151391797182,9
4968,1,23,16,17,-10.375674453583683,6
4969,93,16,106,10,-10.37915501513517,6
4970,51,32,100,18,-10.389410054532467,14
4971,16,11,78,7,-10.397637170720277,4
4972,7,11,110,6,-10.42257657923173,5
4973,114,19,95,12,-10.422604339796184,7
4974,57,18,70,10,-10.42994298882783,8
4975,39,16,44,10,-10.434810009571377,6
4976,60,11,34,8,-10.444545857082172,3
4977,62,10,49,7,-10.453994552700898,3
4978,31,10,6,6,-10.459894630543896,4
4979,77,12,23,8,-10.47207373365885,4
4980,102,19,107,12,-10.474471969151432,7
4981,107,11,67,8,-10.497709880226346,3
4982,102,13,75,9,-10.50135368794083,4
4983,12,12,114,7,-10.504954578013217,5
4984,37,14,89,8,-10.519274673853,6
4985,17,10,102,7,-10.521913643472296,3
4986,97,19,71,13,-10.523533962196899,6
4987,66,10,7,6,-10.534532214717434,4
4988,56,16,86,11,-10.543126647721751,5
4989,84,24,11,16,-10.56388232319587,8
4990,9,15,95,9,-10.569002592922953,6
4991,7,51,75,34,-10.587695481592943,17
4992,38,15,75,11,-10.597530026810052,4
4993,91,31,7,22,-10.60910028610159,9
4994,101,12,16,8,-10.62271769748288,4
4995,71,18,98,12,-10.627953776602759,6
4996,106,61,16,42,-10.640155923618929,19
4997,64,20,30,13,-10.642272986004782,7
4998,98,25,5,16,-10.662918685540621,9
4999,86,32,102,22,-10.668729155825625,10
5000,17,23,40,16,-10.673939896309559,7
5001,12,14,23,9,-10.685853401881314,5
5002,107,18,15,13,-10.69151788090047,5
5003,28,20,34,14,-10.703466452032458,6
5004,74,25,51,18,-10.704030149650722,7
5005,36,13,43,8,-10.713552025008546,5
5006,111,11,54,8,-10.714143810197228,3
5007,60,15,37,9,-10.721994289598655,6
5008,39,20,23,13,-10.742827162036495,7
5009,53,22,41,15,-10.750334109299274,7
5010,45,13,23,9,-10.763590899157698,4
5011,7,11,59,8,-10.771239818059199,3
5012,15,11,47,7,-10.775485769989336,4
5013,35,14,36,10,-10.78250796990051,4
5014,91,25,55,18,-10.791612827626562,7
5015,77,27,104,18,-10.795670361212089,9
5016,18,20,15,14,-10.81146794442466,6
5017,87,25,98,17,-10.830753925226263,8
5018,14,17,16,11,-10.870649232838183,6
5019,77,16,71,11,-10.872072685026803,5
5020,41,21,111,13,-10.875724405637953,8
5021,88,41,63,29,-10.892208716891064,12
5022,46,11,100,7,-10.904685887838546,4
5023,5,17,73,11,-10.90738305979487,6
5024,31,10,78,6,-10.912809716780334,4
5025,64,14,27,10,-10.925557497140751,4
5026,13,10,89,6,-10.939542022741616,4
5027,91,12,23,7,-10.949067409142138,5
5028,53,10,15,7,-10.9539479023651,3
5029,47,15,9,10,-10.968614103246171,5
5030,88,37,50,24,-10.986958086725291,13
5031,107,13,56,8,-11.000292497508868,5
5032,71,13,15,9,-11.00914391321026,4
5033,68,12,45,8,-11.02401972838907,4
5034,114,12,32,8,-11.045874107216177,4
5035,114,26,87,16,-11.046799663049542,10
5036,11,11,99,7,-11.04788337752713,4
5037,87,10,12,7,-11.056786464431308,3
5038,80,13,78,9,-11.09791576617006,4
5039,32,13,74,9,-11.101664191982367,4
5040,107,27,57,18,-11.159896333247294,9
5041,4,16,43,10,-11.162760468553993,6
5042,107,38,30,25,-11.164530658826866,13
5043,46,15,30,10,-11.187097177578686,5
5044,109,10,91,7,-11.192740070217315,3
5045,61,12,6,8,-11.200388242698184,4
5046,65,45,114,29,-11.20792553692763,16
5047,1,11,89,7,-11.20901106938993,4
5048,87,13,79,10,-11.211504341364096,3
5049,106,18,98,12,-11.217270403208776,6
5050,51,13,73,9,-11.219804453521853,4
5051,96,20,46,12,-11.223825219116964,8
5052,19,11,87,7,-11.236119998263332,4
5053,109,17,75,12,-11.242273446455997,5
5054,51,28,95,20,-11.244919045567018,8
5055,72,18,86,12,-11.245438259267335,6
5056,81,13,40,9,-11.249205674756395,4
5057,83,16,107,11,-11.24958512039028,5
5058,70,29,87,18,-11.250414739740132,11
5059,48,12,90,8,-11.252381363492235,4
5060,86,20,26,14,-11.252422321391004,6
5061,103,14,86,9,-11.266539954551964,5
5062,20,10,64,8,-11.273683916826545,2
5063,86,10,29,7,-11.288307199014056,3
5064,5,10,80,7,-11.295210617596885,3
5065,96,25,7,18,-11.300422106484014,7
5066,70,15,30,9,-11.302914088005606,6
5067,79,10,80,6,-11.30670069299901,4
5068,28,46,63,32,-11.30701920844641,14
5069,60,23,47,16,-11.31330562577917,7
5070,96,23,48,16,-11.323041657346815,7
5071,18,12,69,8,-11.324568934723304,4
5072,69,25,16,16,-11.332843945161658,9
5073,46,10,18,7,-11.344187759634409,3
5074,29,13,60,8,-11.371173035745986,5
5075,38,11,4,8,-11.395009854616482,3
5076,35,23,76,15,-11.39691854534874,8
5077,95,10,29,7,-11.401888238693147,3
5078,106,39,114,26,-11.417874917507989,13
5079,104,17,64,12,-11.423286049235614,5
5080,60,14,76,11,-11.431632032165169,3
5081,88,10,98,7,-11.438021992981458,3
5082,81,14,47,10,-11.445134927289029,4
5083,57,12,65,8,-11.482165332996512,4
5084,78,10,84,7,-11.490007761865318,3
5085,91,10,69,6,-11.501202941557144,4
5086,54,44,37,30,-11.514339123049963,14
5087,94,12,86,8,-11.544074142973756,4
5088,76,15,74,9,-11.544600382799558,6
5089,15,10,49,7,-11.54727068179138,3
5090,71,10,111,7,-11.563837134119527,3
5091,104,16,36,10,-11.564722196156035,6
5092,50,15,33,10,-11.568332857311571,5
5093,17,15,53,10,-11.579207502470608,5
5094,88,65,13,44,-11.59374697560307,21
5095,10,14,7,9,-11.631959119868696,5
5096,19,19,7,14,-11.638604289638174,5
5097,103,11,55,8,-11.639657223031874,3
5098,107,17,78,12,-11.645622319804351,5
5099,9,15,17,10,-11.652473414654485,5
5100,1,12,18,9,-11.656493402808342,3
5101,46,12,53,8,-11.691208139074996,4
5102,96,13,91,9,-11.692854193124042,4
5103,70,23,108,16,-11.716508786473792,7
5104,67,11,16,8,-11.761532223804268,3
5105,1,37,55,26,-11.769033555767942,11
5106,71,19,104,12,-11.784281392964676,7
5107,65,12,91,8,-11.784658313781671,4
5108,54,10,44,7,-11.791894285038754,3
5109,40,21,8,15,-11.791921402372775,6
5110,87,23,48,16,-11.827762552608771,7
5111,104,18,90,12,-11.89837391797068,6
5112,11,13,93,10,-11.901577910299338,3
5113,106,23,46,14,-11.922619928802636,9
5114,18,27,95,18,-11.951490678023534,9
5115,104,12,1,8,-12.020108292717424,4
5116,20,14,34,10,-12.080633416209027,4
5117,96,27,98,18,-12.125771968912133,9
5118,63,12,92,7,-12.136993324985582,5
5119,30,13,34,9,-12.147427118368974,4
5120,70,22,2,14,-12.153236389251056,8
5121,84,10,112,7,-12.19652421867294,3
5122,76,18,7,11,-12.196617315781682,7
5123,106,11,78,8,-12.21024325274275,3
5124,28,32,74,22,-12.21103450586095,10
5125,70,21,11,15,-12.225051268467027,6
5126,39,23,91,16,-12.232573714352018,7
5127,35,10,87,6,-12.264853365777979,4
5128,35,23,107,17,-12.292793992800659,6
5129,108,10,28,6,-12.299856976610261,4
5130,51,13,111,9,-12.302448210462586,4
5131,12,11,75,7,-12.349857549218326,4
5132,54,22,100,15,-12.349967715760693,7
5133,33,13,87,9,-12.350753088118475,4
5134,60,20,49,14,-12.35214452080387,6
5135,97,12,67,9,-12.35346782744064,3
5136,9,23,64,17,-12.391246669177534,6
5137,8,13,78,10,-12.411635409020537,3
5138,53,16,43,12,-12.41343484704957,4
5139,50,17,36,10,-12.423703215189779,7
5140,88,40,53,28,-12.503961998215974,12
5141,35,11,104,7,-12.510382448223586,4
5142,5,27,75,17,-12.535083552437035,10
5143,31,71,13,48,-12.537286324138343,23
5144,51,15,15,10,-12.562268876837926,5
5145,5,27,57,19,-12.572003913811173,8
5146,63,34,80,24,-12.572385685987724,10
5147,13,14,80,9,-12.596651210163866,5
5148,54,33,75,22,-12.657132724468568,11
5149,5,14,48,10,-12.657719903594751,4
5150,52,11,30,8,-12.667026316194525,3
5151,88,16,111,12,-12.710530076381987,4
5152,36,16,8,11,-12.721597845881664,5
5153,106,14,33,10,-12.736963404825662,4
5154,36,10,95,7,-12.746346244298937,3
5155,81,12,54,8,-12.757047966098474,4
5156,27,20,104,15,-12.796343894614779,5
5157,104,20,49,14,-12.812277987885736,6
5158,112,14,60,10,-12.818986730922628,4
5159,9,10,108,6,-12.825707088631287,4
5160,65,20,2,15,-12.841827331353704,5
5161,109,19,27,12,-12.854514856980064,7
5162,38,14,104,9,-12.882056867121564,5
5163,75,12,98,8,-12.900340980932176,4
5164,92,13,41,9,-12.929503950347238,4
5165,39,11,108,7,-12.951016324577209,4
5166,114,12,27,8,-13.009570993376595,4
5167,65,29,27,20,-13.035250514579241,9
5168,39,12,58,9,-13.038608389876652,3
5169,36,26,27,17,-13.042063327238697,9
5170,46,38,104,26,-13.083570903140272,12
5171,90,15,20,10,-13.08396173697106,5
5172,28,17,69,11,-13.091770978065748,6
5173,39,29,30,20,-13.10113473228172,9
5174,38,10,2,6,-13.106587736027677,4
5175,38,12,71,9,-13.11375866950239,3
5176,70,10,83,6,-13.118339150755117,4
5177,112,13,51,9,-13.12503322058542,4
5178,77,15,53,10,-13.125923769197522,5
5179,37,28,95,21,-13.149042342745602,7
5180,88,17,102,13,-13.153141792955822,4
5181,28,13,41,9,-13.19117071449606,4
5182,54,18,36,12,-13.217744798273172,6
5183,54,26,48,18,-13.218100464174018,8
5184,60,25,27,19,-13.218976933527705,6
5185,46,16,50,10,-13.220197801431315,6
5186,60,13,108,9,-13.225499906177387,4
5187,41,16,8,12,-13.244566662838952,4
5188,88,36,95,25,-13.24512473637818,11
5189,96,39,11,27,-13.252582377716239,12
5190,11,23,95,17,-13.263288005084238,6
5191,5,31,102,21,-13.269431869962297,10
5192,99,12,7,8,-13.274517260788413,4
5193,106,19,64,13,-13.295192075566398,6
5194,112,12,100,8,-13.302851040311163,4
5195,3,11,15,7,-13.34908879632687,4
5196,83,18,16,13,-13.35123547721314,5
5197,32,11,55,7,-13.36363963009391,4
5198,62,18,74,13,-13.411803700884379,5
5199,53,15,75,10,-13.423496737137004,5
5200,32,12,25,7,-13.427877456338663,5
5201,55,17,102,12,-13.448934349992442,5
5202,90,10,93,7,-13.452391800759145,3
5203,39,24,15,18,-13.46292216758355,6
5204,46,11,98,7,-13.482621473195687,4
5205,70,10,34,7,-13.500624883981926,3
5206,29,17,88,12,-13.506047616712264,5
5207,9,23,41,16,-13.506797271173358,7
5208,1,10,78,7,-13.511302040012385,3
5209,103,11,74,8,-13.53565105452587,3
5210,10,10,37,6,-13.538762623915119,4
5211,46,12,93,9,-13.65474091099076,3
5212,86,16,92,11,-13.67676060817369,5
5213,57,19,7,12,-13.697105013999769,7
5214,44,14,104,10,-13.703910249073422,4
5215,31,25,63,18,-13.714594813504094,7
5216,33,14,63,10,-13.733555706081619,4
5217,112,11,97,9,-13.794615799527321,2
5218,63,16,57,10,-13.810752926681854,6
5219,27,11,49,8,-13.828388035620172,3
5220,8,17,34,12,-13.860433740960481,5
5221,83,13,11,10,-13.863860744018641,3
5222,13,23,30,15,-13.875626061777945,8
5223,54,16,2,12,-13.913344645570438,4
5224,83,11,23,8,-13.9232349355535,3
5225,57,11,34,8,-13.937862830072245,3
5226,69,19,75,14,-13.94230448490658,5
5227,71,24,40,17,-13.948125771645659,7
5228,68,15,58,11,-13.959014166695402,4
5229,77,29,40,21,-14.048771071022598,8
5230,71,10,91,7,-14.063234581200414,3
5231,54,18,71,12,-14.18324547541803,6
5232,80,11,41,8,-14.186716292232557,3
5233,66,11,63,8,-14.209916362631542,3
5234,60,28,91,19,-14.21948701708733,9
5235,77,15,30,11,-14.240898393688356,4
5236,94,21,16,15,-14.265495530226403,6
5237,60,21,74,14,-14.268042080973927,7
5238,11,11,30,8,-14.299516136130784,3
5239,37,12,34,9,-14.300571264435137,3
5240,102,11,46,8,-14.307494713152051,3
5241,50,18,80,14,-14.309192739594003,4
5242,77,27,7,19,-14.33556677589385,8
5243,51,22,77,15,-14.341625905559265,7
5244,83,10,40,8,-14.347262135245904,2
5245,14,11,80,7,-14.435345395194508,4
5246,5,12,44,9,-14.447481002517355,3
5247,2,10,73,7,-14.457830254043136,3
5248,25,12,34,9,-14.468789684868275,3
5249,51,18,45,13,-14.493324057948728,5
5250,58,12,54,8,-14.49579317723416,4
5251,2,12,13,8,-14.516038794033763,4
5252,37,12,73,8,-14.533349572792924,4
5253,99,12,50,8,-14.581629542155014,4
5254,55,11,15,9,-14.630800697849656,2
5255,97,11,14,9,-14.634263785488013,2
5256,83,19,114,14,-14.71253096490687,5
5257,102,10,90,6,-14.739148726840858,4
5258,106,14,32,11,-14.741977351969277,3
5259,37,12,18,9,-14.803594606441187,3
5260,85,11,55,8,-14.836765173492132,3
5261,91,17,30,13,-14.854653528597783,4
5262,108,10,8,8,-14.88327570809189,2
5263,104,16,9,11,-14.915937256999365,5
5264,17,21,95,16,-14.970865650802967,5
5265,75,10,45,8,-15.003649946946844,2
5266,99,18,25,13,-15.014737107768294,5
5267,7,15,61,10,-15.062720453324895,5
5268,3,17,63,14,-15.071396371833842,3
5269,13,11,19,8,-15.079444977391654,3
5270,9,12,48,9,-15.097519161061683,3
5271,35,11,27,8,-15.129282720135883,3
5272,71,17,41,13,-15.162388636591329,4
5273,12,14,41,10,-15.231681493254909,4
5274,68,15,61,11,-15.24709195978541,4
5275,99,18,107,13,-15.347683777553833,5
5276,71,10,11,7,-15.386871545741162,3
5277,25,14,49,10,-15.43786379260084,4
5278,107,25,73,17,-15.460672720698524,8
5279,94,16,81,10,-15.463781780556559,6
5280,60,13,100,10,-15.468043250681323,3
5281,31,15,69,10,-15.502962092044207,5
5282,2,18,104,12,-15.50344370749933,6
5283,106,10,89,6,-15.508251121091035,4
5284,14,11,25,9,-15.536643242754739,2
5285,31,12,104,8,-15.561592201078605,4
5286,5,20,23,15,-15.563915929412014,5
5287,31,44,16,32,-15.592889476070622,12
5288,45,14,4,10,-15.600891470448104,4
5289,85,11,106,8,-15.605731963514037,3
5290,97,13,90,9,-15.62188808576594,4
5291,88,16,80,11,-15.676196886577952,5
5292,1,13,8,10,-15.702434313684371,3
5293,80,13,75,10,-15.71805205236554,3
5294,35,12,80,9,-15.72406211872363,3
5295,77,14,37,10,-15.73169378416834,4
5296,96,16,93,12,-15.73319462766121,4
5297,35,10,75,8,-15.755761764469415,2
5298,63,17,62,12,-15.764032245306241,5
5299,37,10,15,8,-15.78269510258246,2
5300,77,16,8,12,-15.792942369486319,4
5301,70,10,48,7,-15.796496446665468,3
5302,39,18,99,14,-15.84878961626863,4
5303,91,11,76,9,-15.872477419459234,2
5304,9,30,53,22,-15.894615033798411,8
5305,70,13,80,11,-15.90133341789594,2
5306,63,13,14,9,-15.961958621197994,4
5307,31,16,98,11,-16.004000710168857,5
5308,5,18,41,12,-16.050377082501456,6
5309,112,15,28,11,-16.113496626946453,4
5310,17,15,23,11,-16.142798996109963,4
5311,52,17,86,13,-16.226058333370403,4
5312,58,18,65,13,-16.230092308358206,5
5313,69,21,53,15,-16.247322250303586,6
5314,51,19,78,13,-16.249500683193986,6
5315,25,25,11,20,-16.429746187224737,5
5316,55,15,14,12,-16.464885141480416,3
5317,79,12,104,8,-16.610032165830475,4
5318,36,10,101,8,-16.627946704419497,2
5319,41,12,30,8,-16.67014747818193,4
5320,71,15,95,10,-16.72675418994599,5
5321,68,13,50,9,-16.739560938672483,4
5322,76,10,1,7,-16.815372977495876,3
5323,30,14,95,10,-16.836817117204564,4
5324,97,14,38,11,-16.838290194315167,3
5325,31,10,38,6,-16.97274158238424,4
5326,50,16,77,13,-16.97319460562341,3
5327,87,12,34,9,-16.98781036825935,3
5328,68,14,112,10,-16.9896861687312,4
5329,50,18,53,13,-17.001925465006995,5
5330,109,25,114,20,-17.09393681935433,5
5331,10,13,51,10,-17.100960272868033,3
5332,69,14,49,10,-17.144708838601282,4
5333,5,22,27,16,-17.186967099907662,6
5334,35,12,63,9,-17.190706154289504,3
5335,68,13,100,9,-17.287141142351707,4
5336,106,10,35,7,-17.319051156851785,3
5337,39,10,45,7,-17.32115834390289,3
5338,43,10,45,7,-17.339723268429022,3
5339,81,19,51,13,-17.438974370621573,6
5340,18,14,23,10,-17.468338798211544,4
5341,83,11,110,9,-17.575104905290946,2
5342,28,27,90,21,-17.5763540242808,6
5343,83,19,13,15,-17.652916390105926,4
5344,9,14,15,10,-17.660327773109127,4
5345,3,11,5,7,-17.694163901939547,4
5346,69,14,30,10,-17.76525861498344,4
5347,5,18,30,15,-17.81053305502534,3
5348,8,10,69,8,-17.824588271872045,2
5349,88,17,32,13,-17.824594134673823,4
5350,114,11,111,8,-17.846918134233796,3
5351,57,11,69,9,-17.903713317642495,2
5352,68,21,95,18,-17.962668451083434,3
5353,33,18,55,14,-17.969879843551904,4
5354,55,11,44,8,-18.073593929874917,3
5355,19,10,55,7,-18.123273148174388,3
5356,43,15,55,13,-18.330276358916965,2
5357,103,10,109,7,-18.37872283171988,3
5358,18,10,5,8,-18.464269170029826,2
5359,33,14,65,11,-18.512762180418843,3
5360,31,15,106,11,-18.52908676481624,4
5361,28,17,99,13,-18.754584808369174,4
5362,81,15,87,10,-18.82493018419675,5
5363,11,10,2,8,-18.92308479788875,2
5364,4,13,98,11,-18.936498509144613,2
5365,112,10,47,7,-19.05098189885603,3
5366,57,10,31,7,-19.217116599721326,3
5367,54,16,4,14,-19.244087603842104,2
5368,18,14,99,11,-19.290873438644514,3
5369,12,11,27,9,-19.43334632488541,2
5370,77,16,16,13,-19.494965112936953,3
5371,51,10,101,8,-19.538804927619935,2
5372,68,10,90,8,-19.75244962865367,2
5373,32,12,95,10,-19.760326388824467,2
5374,75,11,111,8,-20.026411874817093,3
5375,36,18,30,16,-20.033620464488322,2
5376,51,15,2,11,-20.284269757170097,4
5377,91,12,43,10,-20.29321965959792,2
5378,35,11,48,9,-20.438098241934796,2
5379,81,12,49,9,-20.5963472275708,3
5380,112,10,87,8,-20.648609256164324,2
5381,79,10,30,8,-20.824119521738712,2
5382,38,11,55,9,-20.87506721402826,2
5383,84,10,7,8,-21.17364400986741,2
5384,51,17,90,15,-21.316832661511143,2
5385,91,16,104,15,-21.31971827875211,1
5386,4,13,25,11,-21.42004260246313,2
5387,97,10,34,8,-21.449947297008155,2
5388,4,15,41,10,-21.480590173913868,5
5389,58,15,86,12,-21.50384076763655,3
5390,31,12,62,9,-21.790941067775986,3
5391,112,15,20,13,-21.822113913104296,2
5392,3,14,75,12,-21.94698136707857,2
5393,97,12,91,10,-22.175648770183788,2
5394,51,11,34,9,-22.213174768846976,2
5395,65,25,100,22,-22.41765276800298,3
5396,47,10,55,8,-22.558686434869564,2
5397,28,10,10,9,-23.03135332069283,1
5398,9,21,27,17,-23.072306521845082,4
5399,8,11,4,10,-23.17790508365148,1
5400,112,15,78,12,-23.26703499317457,3
5401,112,12,71,10,-23.507799276651657,2
5402,102,10,30,8,-23.768301124479738,2
5403,69,11,27,9,-23.965125451311458,2
5404,97,12,73,9,-24.10757303293757,3
5405,107,10,19,10,-24.226623453768692,0
5406,112,10,49,9,-24.460078908180627,1
5407,77,15,75,13,-25.509874365270075,2
5408,37,10,44,10,-28.25347707422472,0
5409,23,11,90,10,-28.300961743533676,1
