,againstHero,games,hero,losses,shift,wins
0,3,10,39,0,28.725074023896866,10
1,40,11,71,1,25.278218082934554,10
2,48,10,35,1,25.155197930838906,9
3,75,14,77,2,24.219783572291735,12
4,44,10,55,2,23.361076236430034,8
5,10,10,28,1,23.03135332069283,9
6,14,12,55,1,22.798222840334336,11
7,2,13,51,3,22.46077922587735,10
8,34,11,51,2,22.213174768846972,9
9,38,11,97,1,22.176359713839886,10
10,86,12,52,2,21.816288972743816,10
11,27,15,9,4,21.65491087687075,11
12,55,10,43,1,21.47756068248007,9
13,3,10,60,2,21.47258720408984,8
14,23,10,17,2,21.215760860674095,8
15,71,11,54,2,21.21323377888104,9
16,61,10,68,2,21.209357422961563,8
17,63,13,36,2,20.993616769797562,11
18,111,11,40,3,20.888432020263267,8
19,57,11,13,3,20.619945240208803,8
20,4,10,54,1,20.381350839445236,9
21,55,16,33,3,20.174007528343807,13
22,107,10,66,2,20.152222817707916,8
23,95,12,32,2,19.760326388824463,10
24,15,16,39,3,19.411328140872982,13
25,95,10,71,4,19.39571879208051,6
26,99,14,18,3,19.290873438644514,11
27,28,14,112,3,19.249826897720943,11
28,104,13,91,1,19.168888324804982,12
29,48,12,5,2,19.15405252867682,10
30,69,14,106,3,18.98728224350163,11
31,77,14,50,2,18.9601043763584,12
32,2,10,11,2,18.923084797888755,8
33,27,14,60,2,18.903299216443365,12
34,90,15,51,2,18.880140990693622,13
35,90,26,28,5,18.776580206085537,21
36,44,10,5,2,18.758661413857347,8
37,114,23,109,4,18.683167060990836,19
38,98,10,46,3,18.66966202924449,7
39,5,10,18,2,18.464269170029823,8
40,100,13,39,3,18.341842925227056,10
41,78,10,51,3,18.31394254950606,7
42,100,16,65,3,18.245562374078016,13
43,63,13,31,3,18.243604523218732,10
44,60,16,50,4,18.193608082564946,12
45,26,11,86,2,18.01144379039894,9
46,8,13,77,3,17.994666569137156,10
47,16,14,77,3,17.677083033460956,11
48,111,10,75,3,17.662362853053892,7
49,86,11,103,3,17.58257489935951,8
50,16,10,67,2,17.493350405648194,8
51,95,23,51,5,17.35650130333503,18
52,34,11,87,3,17.338115350277818,8
53,43,10,86,2,17.32008208206117,8
54,35,10,106,3,17.319051156851785,7
55,8,12,36,3,17.245136656584343,9
56,63,12,35,3,17.190706154289504,9
57,30,13,77,3,17.18336585400938,10
58,75,10,80,2,17.160491094383627,8
59,27,21,5,6,17.02393852387809,15
60,53,10,46,3,17.023590244335466,7
61,34,12,8,3,16.979471141980934,9
62,10,11,86,3,16.95145578080744,8
63,40,12,17,2,16.84478158480246,10
64,95,14,30,4,16.836817117204568,10
65,30,17,5,3,16.83586234693501,14
66,41,14,5,5,16.723825478761608,9
67,37,12,60,3,16.65752424604732,9
68,17,11,71,3,16.565755993613635,8
69,64,10,8,2,16.564735872759318,8
70,27,14,109,5,16.55698843286494,9
71,13,10,6,3,16.528041255540572,7
72,11,25,25,5,16.429746187224733,20
73,32,13,88,4,16.30207764263433,9
74,73,10,16,3,16.163676933136152,7
75,63,10,69,2,16.16074793909268,8
76,7,23,77,6,16.022128463052777,17
77,95,21,11,5,16.006249051562754,16
78,13,16,83,4,15.934926256250733,12
79,9,10,71,3,15.885359893651664,7
80,23,13,18,4,15.879451530655546,9
81,80,17,50,3,15.873366771105445,14
82,67,14,106,4,15.86890640221611,10
83,88,13,29,4,15.850906570917441,9
84,99,18,39,4,15.84878961626863,14
85,48,10,70,3,15.796496446665468,7
86,14,12,63,4,15.759973477645744,8
87,34,10,17,2,15.75126461275924,8
88,93,16,96,4,15.733194627661211,12
89,80,12,35,3,15.72406211872363,9
90,23,16,5,4,15.598001372374195,12
91,99,15,28,4,15.590204088651856,11
92,104,18,2,6,15.503443707499333,12
93,1,10,104,3,15.49273511650189,7
94,90,12,97,4,15.449883037579115,8
95,49,14,25,4,15.43786379260084,10
96,8,12,1,3,15.417408715441647,9
97,114,26,106,7,15.379372194357796,19
98,34,16,28,4,15.364383659890448,12
99,7,11,99,3,15.3158743249674,8
100,8,17,40,4,15.30500620212985,13
101,67,11,97,2,15.281658756670776,9
102,114,16,83,4,15.254612667104073,12
103,89,12,107,3,15.163906699283089,9
104,80,11,70,2,15.1572772977841,9
105,48,12,9,3,15.097519161061681,9
106,91,12,96,3,15.083901067533665,9
107,25,18,99,5,15.014737107768298,13
108,50,15,46,5,14.990794174346137,10
109,64,12,31,3,14.94753843905641,9
110,87,21,91,5,14.888779659526465,16
111,76,23,51,5,14.827020215296272,18
112,32,14,106,3,14.741977351969275,11
113,109,12,39,2,14.675982860996214,10
114,100,10,60,3,14.612225079139728,7
115,50,12,99,4,14.581629542155014,8
116,37,11,77,3,14.55993313549925,8
117,27,10,35,3,14.547141678753416,7
118,16,14,32,4,14.542782322425316,10
119,48,24,54,7,14.535603927866184,17
120,73,12,37,4,14.533349572792922,8
121,13,11,2,3,14.516038794033767,8
122,73,10,2,3,14.457830254043136,7
123,100,20,54,6,14.454126910452931,14
124,89,10,74,3,14.4466828072844,7
125,40,10,83,2,14.347262135245902,8
126,30,12,18,3,14.310372508653467,9
127,46,11,102,3,14.30749471315205,8
128,34,12,37,3,14.30057126443514,9
129,30,11,11,3,14.29951613613078,8
130,14,10,97,2,14.259112129654318,8
131,15,15,18,4,14.248476385059174,11
132,92,12,39,4,14.220068086204256,8
133,74,19,60,6,14.155436372823559,13
134,90,16,104,5,14.144947006647104,11
135,54,10,111,2,14.107577214977887,8
136,7,12,76,5,14.076112540272657,7
137,100,15,88,4,14.04956823717941,11
138,76,21,35,7,14.001262608885755,14
139,25,17,68,5,13.975333228554623,12
140,106,20,91,4,13.947658584561143,16
141,23,11,83,3,13.9232349355535,8
142,11,13,83,3,13.863860744018647,10
143,100,21,51,8,13.816816739386772,13
144,33,13,50,4,13.8066594696148,9
145,93,12,46,3,13.65474091099076,9
146,107,17,99,5,13.582126995646107,12
147,74,11,103,3,13.53565105452587,8
148,23,10,77,3,13.476022973760971,7
149,93,10,90,3,13.452391800759148,7
150,51,11,10,3,13.446955688168293,8
151,87,16,53,6,13.445191662192824,10
152,50,15,70,5,13.44110105599258,10
153,25,12,32,5,13.427877456338663,7
154,30,21,39,6,13.42696028846743,15
155,45,13,7,4,13.38957872768084,9
156,18,11,37,3,13.371391730474068,8
157,55,11,32,4,13.36363963009391,7
158,34,11,20,3,13.36206244645375,8
159,16,18,83,5,13.351235477213141,13
160,95,18,17,5,13.342671111008823,13
161,65,10,33,3,13.314880602814076,7
162,111,12,63,4,13.262790476904582,8
163,8,16,41,4,13.244566662838952,12
164,49,10,69,4,13.198330525042142,6
165,36,16,41,6,13.196270804003616,10
166,7,34,25,9,13.172286751090267,25
167,69,14,28,5,13.159247509741927,9
168,34,11,30,3,13.149679586972224,8
169,57,22,107,7,13.099281826721857,15
170,80,10,14,4,13.097202558791373,6
171,11,13,18,4,13.094881521032239,9
172,56,11,68,4,13.08064935100822,7
173,65,23,111,6,13.044696089382947,17
174,16,17,76,6,13.039487797353612,11
175,34,11,25,3,12.978396480778377,8
176,16,16,94,4,12.969401282348118,12
177,77,16,51,5,12.941193832575705,11
178,53,22,36,6,12.92735429238951,16
179,95,27,37,7,12.921122211679824,20
180,49,11,77,3,12.92036615088008,8
181,57,22,16,7,12.918311642986259,15
182,13,36,88,9,12.917026099914276,27
183,40,22,77,6,12.904839091751661,16
184,78,10,96,3,12.899686199305037,7
185,60,17,9,4,12.84061869332771,13
186,30,14,46,4,12.822811242166974,10
187,81,11,18,3,12.791307902712878,8
188,104,15,71,5,12.790892712888178,10
189,102,16,55,5,12.774824407782457,11
190,114,14,39,4,12.750125704729554,10
191,28,10,52,3,12.725624774771763,7
192,13,14,69,5,12.641628123294486,9
193,13,11,98,3,12.600193093477749,8
194,57,27,5,8,12.572003913811171,19
195,71,17,97,5,12.555483253298778,12
196,102,30,5,10,12.54926139668405,20
197,81,12,16,3,12.547755736616809,9
198,75,33,7,9,12.535077682101436,24
199,15,10,50,3,12.479053092203714,7
200,53,11,9,4,12.474704729291487,7
201,104,10,79,4,12.467627013550153,6
202,63,11,33,3,12.458058441923846,8
203,11,38,96,12,12.43376452627604,26
204,73,11,7,4,12.404360121203124,7
205,55,13,23,5,12.384564492570101,8
206,80,24,107,6,12.365033339093644,18
207,53,11,77,4,12.351449758473517,7
208,71,23,86,7,12.334894371248911,16
209,65,11,73,3,12.330685068480049,8
210,13,32,31,10,12.325688956707522,22
211,2,15,54,4,12.306524573726035,11
212,11,21,70,6,12.22505126846703,15
213,114,19,13,8,12.22395713294129,11
214,13,16,64,6,12.159796917460309,10
215,2,22,70,8,12.153236389251056,14
216,92,11,40,3,12.122125058634301,8
217,4,14,31,5,12.100566281149307,9
218,7,32,87,10,12.062260908290176,22
219,5,24,98,8,11.989855689002855,16
220,49,19,104,6,11.962718506463766,13
221,64,10,18,3,11.95683679306048,7
222,97,38,37,12,11.95034053539652,26
223,108,11,87,3,11.937760746567227,8
224,75,26,5,10,11.916835118435042,16
225,41,10,9,4,11.907689209620179,6
226,93,13,11,3,11.901577910299338,10
227,69,14,88,4,11.887869311273402,10
228,73,21,107,8,11.81929745969668,13
229,80,31,63,9,11.797889683549815,22
230,23,10,50,2,11.788365261374189,8
231,17,12,60,4,11.78066870315527,8
232,8,17,15,6,11.780660660956793,11
233,48,10,51,4,11.705725037939857,6
234,16,19,69,7,11.675682600934618,12
235,57,13,63,5,11.67022671873631,8
236,76,23,107,6,11.647663179181828,17
237,16,22,31,8,11.63574533732437,14
238,36,10,54,3,11.58437851581158,7
239,71,11,77,3,11.581570179573193,8
240,114,11,2,3,11.567668937733664,8
241,95,30,88,10,11.54585052065846,20
242,74,15,76,6,11.544600382799558,9
243,74,31,28,10,11.526159046117094,21
244,30,14,91,4,11.480842967022573,10
245,111,15,41,6,11.468901535117379,9
246,58,10,88,3,11.468111187213925,7
247,7,19,5,6,11.44406267553112,13
248,37,14,27,4,11.378309035824227,10
249,100,13,63,5,11.33209634222994,8
250,41,13,97,4,11.33180129311275,9
251,48,23,96,7,11.32304165734682,16
252,114,21,90,7,11.316575519517894,14
253,98,26,96,9,11.315795357847566,17
254,80,10,79,4,11.30670069299901,6
255,80,10,5,3,11.295210617596885,7
256,90,12,48,4,11.252381363492233,8
257,79,13,87,3,11.211504341364096,10
258,30,20,54,6,11.207068797640524,14
259,47,14,60,5,11.169608085813236,9
260,27,12,77,4,11.13773931409657,8
261,107,20,53,6,11.110522115221906,14
262,74,13,32,4,11.101664191982366,9
263,77,13,88,4,11.099370566703435,9
264,20,14,98,4,11.083964695514595,10
265,20,29,25,9,11.06909713193041,20
266,110,18,25,5,11.063714709672922,13
267,34,13,5,3,11.055394545543235,10
268,99,11,11,4,11.04788337752713,7
269,46,19,96,8,11.04431019266856,11
270,95,12,68,3,11.025681038861348,9
271,98,10,40,4,11.010186531894902,6
272,23,14,39,5,10.999796656050236,9
273,16,21,9,7,10.976377975200077,14
274,27,21,51,7,10.96981827885492,14
275,74,19,39,7,10.936319651937492,12
276,104,35,46,12,10.919285643804978,23
277,73,17,5,6,10.907383059794872,11
278,100,11,46,4,10.904685887838546,7
279,36,10,25,4,10.872848892533504,6
280,60,11,81,4,10.850721376705717,7
281,23,16,68,6,10.850372230875434,10
282,48,25,107,9,10.827629447931269,16
283,41,26,86,7,10.826191446306183,19
284,13,15,97,5,10.822388503528412,10
285,80,11,88,4,10.820834504420485,7
286,8,11,53,3,10.761161561739844,8
287,98,22,63,8,10.75970205191674,14
288,7,49,51,17,10.755730593232087,32
289,3,10,86,3,10.74425568721737,7
290,30,16,13,6,10.738595010557942,10
291,37,43,54,14,10.702102057687048,29
292,75,12,93,4,10.68974449521869,8
293,54,13,76,4,10.686858558117363,9
294,70,11,36,4,10.685404725540554,7
295,50,32,20,11,10.68090573343548,21
296,50,13,64,5,10.676473731405572,8
297,13,56,51,20,10.674831658804266,36
298,2,16,65,4,10.668339624865121,12
299,37,22,7,8,10.662936414000136,14
300,71,13,63,5,10.644681087019856,8
301,16,58,39,20,10.638146873534158,38
302,106,11,77,4,10.594156026318409,7
303,40,10,27,4,10.593233275804696,6
304,87,18,41,6,10.566422140881262,12
305,16,45,96,13,10.56639260365633,32
306,86,33,76,11,10.565024036126953,22
307,88,18,57,7,10.555628423294737,11
308,65,40,88,13,10.522929181632808,27
309,36,11,47,3,10.516857883390177,8
310,104,11,38,4,10.511918642412144,7
311,28,10,68,3,10.490940734087157,7
312,68,26,53,8,10.490912205608934,18
313,13,39,87,13,10.475224192177569,26
314,104,18,27,5,10.473446544405565,13
315,87,12,33,4,10.466998002217025,8
316,78,11,80,4,10.465715646953605,7
317,110,13,97,4,10.452372833112596,9
318,54,16,40,6,10.441560488291174,10
319,4,14,68,5,10.435649222560748,9
320,27,24,36,9,10.427651739608258,15
321,78,10,63,4,10.405129843299601,6
322,98,22,87,7,10.38881617820971,15
323,106,16,93,6,10.37915501513517,10
324,7,15,56,6,10.375257452050729,9
325,75,10,38,3,10.37132525716886,7
326,83,13,84,5,10.357457702755646,8
327,8,18,91,6,10.34860151027639,12
328,50,17,102,7,10.348240016843025,10
329,63,26,91,8,10.346434337063867,18
330,73,17,90,6,10.345640275158654,11
331,20,18,55,7,10.312518824176754,11
332,63,41,28,13,10.300883603096642,28
333,63,40,84,15,10.295594423044465,25
334,7,20,91,6,10.294223036185205,14
335,13,10,94,3,10.278886232089443,7
336,15,11,51,4,10.274901265855426,7
337,77,12,99,3,10.252199704478638,9
338,104,12,44,4,10.208907808787586,8
339,98,15,2,6,10.198603389321667,9
340,106,25,23,10,10.189298769719457,15
341,102,10,65,4,10.189199303308586,6
342,7,43,40,14,10.18855247085411,29
343,36,13,68,5,10.182081213012962,8
344,86,45,97,16,10.163469283868963,29
345,27,10,30,4,10.156324487184852,6
346,8,10,35,3,10.118762046100299,7
347,107,15,83,5,10.114574167697794,10
348,54,12,57,3,10.066024134547122,9
349,40,12,43,4,10.065244307333751,8
350,16,34,46,12,9.989350548671633,22
351,107,21,35,6,9.980358662107303,15
352,38,13,106,6,9.972431475981123,7
353,40,21,104,7,9.970558522733771,14
354,7,11,47,3,9.948030631901805,8
355,75,31,8,10,9.942334170394213,21
356,44,22,86,8,9.92971305051496,14
357,70,15,109,5,9.924354258384088,10
358,16,57,106,19,9.916522961853746,38
359,100,17,87,7,9.910234475754471,10
360,46,10,77,4,9.900782595186337,6
361,16,34,18,11,9.881360464557634,23
362,30,14,106,5,9.870728252110508,9
363,87,24,70,9,9.867797329951717,15
364,86,23,79,8,9.865377107457421,15
365,63,20,109,8,9.854767957937824,12
366,37,24,83,9,9.783726366978417,15
367,11,23,84,8,9.766296004538773,15
368,81,16,13,6,9.763106493512709,10
369,97,10,53,4,9.746355004042211,6
370,100,12,55,5,9.7405489879536,7
371,86,32,39,13,9.737500722437058,19
372,63,33,88,11,9.734010190028808,22
373,76,11,39,3,9.681961570558546,8
374,27,21,65,8,9.65792044215186,13
375,39,21,106,8,9.647313810026368,13
376,70,12,64,4,9.645861185980307,8
377,27,12,41,5,9.625499011512424,7
378,99,14,8,6,9.61106559286031,8
379,86,17,1,6,9.605183903195394,11
380,86,15,35,6,9.604686839909265,9
381,62,11,8,3,9.593511144115352,8
382,64,12,40,4,9.579728068353155,8
383,13,39,39,15,9.579171098092761,24
384,63,49,54,17,9.574771666628008,32
385,2,21,106,8,9.573373481710446,13
386,90,13,39,5,9.529975909191753,8
387,62,13,63,5,9.527211231443939,8
388,23,18,76,6,9.525082848083137,12
389,107,11,10,4,9.504556938677329,7
390,37,22,99,7,9.502759058160713,15
391,1,14,51,6,9.497188859338962,8
392,104,26,77,9,9.48377934817974,17
393,63,16,77,5,9.465120093670686,11
394,95,22,18,9,9.461457865276858,13
395,34,14,55,6,9.45781065185775,8
396,40,10,102,4,9.454137715098852,6
397,100,10,95,4,9.449134938035408,6
398,32,11,63,4,9.44232166344675,7
399,83,14,74,6,9.43011849323839,8
400,87,14,114,6,9.425866585368668,8
401,114,10,110,3,9.422657787947912,7
402,75,34,50,11,9.419538696401691,23
403,37,41,63,14,9.417998111066987,27
404,31,19,36,7,9.400152768298826,12
405,76,20,50,6,9.400140024953476,14
406,55,23,91,7,9.380332489392515,16
407,71,12,37,5,9.38020830857434,7
408,107,12,43,5,9.3558585338088,7
409,63,23,76,7,9.35386164955796,16
410,51,22,74,7,9.344397651003662,15
411,109,15,34,6,9.338464853736001,9
412,75,23,54,8,9.319695519056216,15
413,108,16,51,6,9.306988990301447,10
414,90,13,80,4,9.306752684001106,9
415,2,13,55,5,9.306518823595622,8
416,114,15,96,5,9.304547518897671,10
417,68,12,49,5,9.304457096949385,7
418,2,29,107,10,9.295436230624016,19
419,53,10,114,4,9.295261082214134,6
420,13,26,18,10,9.261423401559433,16
421,74,14,62,5,9.256148160859697,9
422,74,24,70,10,9.249270082293563,14
423,17,12,63,4,9.24390740307754,8
424,90,15,13,5,9.234210365017372,10
425,13,27,36,10,9.217087239245355,17
426,86,11,56,4,9.213458879693576,7
427,9,22,40,7,9.21187298392594,15
428,2,12,40,4,9.204153353273352,8
429,51,15,33,4,9.201089002652214,11
430,70,15,68,6,9.199626874800046,9
431,46,21,106,9,9.198394638018083,12
432,23,23,60,8,9.187895606482023,15
433,98,13,84,4,9.18267526002018,9
434,16,35,91,11,9.182394894220272,24
435,5,27,84,10,9.167674877244863,17
436,18,13,97,5,9.160967974857392,8
437,50,43,5,17,9.156049369840707,26
438,51,10,38,3,9.15594810457023,7
439,107,13,62,5,9.134381411880929,8
440,7,18,96,5,9.132819640450865,13
441,110,10,39,3,9.085258579238133,7
442,95,34,8,13,9.079209474058969,21
443,76,23,55,7,9.05690191061572,16
444,88,37,104,13,9.039961252537605,24
445,104,22,75,8,9.039829127143499,14
446,5,13,36,5,9.023272142505265,8
447,109,25,55,11,9.015163892645331,14
448,90,17,63,6,8.996303299649265,11
449,11,22,109,7,8.976986883454371,15
450,102,17,87,6,8.972219911227105,11
451,37,10,108,4,8.970431804543574,6
452,65,24,17,7,8.966237081762033,17
453,28,11,32,4,8.963821007682872,7
454,76,11,2,3,8.951755335280877,8
455,11,13,80,5,8.941133144462878,8
456,104,14,84,6,8.932998314387538,8
457,11,10,91,3,8.923724837318142,7
458,70,17,57,8,8.906737604649802,9
459,104,31,25,12,8.87953260249694,19
460,91,18,60,7,8.876805794182985,11
461,47,10,39,4,8.876547255057023,6
462,114,19,68,6,8.869347207739377,13
463,28,16,17,6,8.863383779145725,10
464,73,13,98,5,8.853796300056942,8
465,40,20,37,8,8.849367605337227,12
466,37,25,38,9,8.83307113340101,16
467,11,14,57,6,8.783548700894539,8
468,69,18,86,6,8.7805890555138,12
469,79,11,106,4,8.777841617086459,7
470,63,15,18,5,8.775103349520558,10
471,23,11,40,4,8.770651576874254,7
472,88,12,38,3,8.749107019275815,9
473,61,10,40,4,8.7398122874208,6
474,27,16,63,7,8.735488991646301,9
475,16,16,108,6,8.735246502538358,10
476,30,10,2,4,8.704387763563812,6
477,40,26,55,9,8.69649105603948,17
478,30,11,90,4,8.695806027026102,7
479,16,28,71,9,8.69282168657732,19
480,4,10,51,4,8.688285343377753,6
481,53,18,30,7,8.677860974225489,11
482,9,24,68,10,8.654072997578577,14
483,73,10,51,3,8.653546669629687,7
484,11,34,37,12,8.643977561339529,22
485,30,12,70,6,8.628315532902242,6
486,95,13,40,5,8.623923471834955,8
487,32,11,114,4,8.619976183865209,7
488,13,18,54,6,8.613765121761865,12
489,90,22,50,8,8.598522697494,14
490,15,13,75,4,8.597300929966654,9
491,71,13,5,5,8.58837744258604,8
492,64,11,65,5,8.583165704821926,6
493,27,20,86,7,8.578635265192984,13
494,104,20,11,7,8.558536461608563,13
495,50,31,55,12,8.547249952830775,19
496,15,10,107,3,8.540362330799288,7
497,40,17,30,6,8.539900905776541,11
498,16,14,1,4,8.53085575505153,10
499,7,37,53,13,8.522907627277366,24
500,86,27,83,8,8.51226403433352,19
501,86,16,72,6,8.471272734246591,10
502,1,12,65,5,8.469252925408412,7
503,95,14,96,5,8.45037398259218,9
504,13,41,25,17,8.44596846540986,24
505,51,14,110,5,8.405376385205704,9
506,107,10,3,5,8.399424845192016,5
507,6,10,46,4,8.386722378353735,6
508,55,26,1,10,8.37390398971046,16
509,30,17,55,7,8.360959444216725,10
510,65,29,40,12,8.33521891201525,17
511,15,14,104,5,8.330235989560043,9
512,99,10,63,4,8.327283039780834,6
513,4,10,28,4,8.326181765732452,6
514,108,15,70,5,8.323316395893162,10
515,65,13,76,4,8.31287645900771,9
516,75,12,76,5,8.269580351796622,7
517,37,12,14,5,8.266467835075433,7
518,89,12,16,5,8.242329112388783,7
519,69,11,87,5,8.233960994375396,6
520,64,11,37,4,8.227838269840156,7
521,60,40,16,16,8.226624219295168,24
522,34,11,104,4,8.215395618768705,7
523,20,11,44,4,8.212958514210372,7
524,28,26,114,11,8.202690137168576,15
525,93,14,50,5,8.18736526783909,9
526,8,26,114,9,8.173491580547305,17
527,20,14,102,6,8.160756483849335,8
528,107,16,77,6,8.158868103512413,10
529,104,35,55,13,8.14798328327785,22
530,75,12,29,5,8.144839094845086,7
531,100,19,25,8,8.126357393020873,11
532,63,11,43,4,8.123064953208495,7
533,8,61,5,24,8.080732178020162,37
534,20,23,84,7,8.075470698309143,16
535,93,24,28,8,8.070916880531737,16
536,13,19,1,6,8.052562460990153,13
537,9,16,39,7,8.050579472794494,9
538,15,14,86,5,8.007884617525495,9
539,89,13,37,6,7.999447796068283,7
540,102,19,96,7,7.9956311609664965,12
541,95,14,109,5,7.99234383641533,9
542,104,17,17,7,7.988529600474542,10
543,102,10,91,4,7.970489437012806,6
544,89,12,104,5,7.965629364641425,7
545,75,34,68,12,7.960537885099937,22
546,51,33,63,13,7.954169936455738,20
547,97,14,84,4,7.932419590040102,10
548,100,22,86,10,7.9304951685165435,12
549,13,34,106,13,7.912363306794574,21
550,95,23,65,9,7.912040515511822,14
551,73,13,87,4,7.889148900875538,9
552,28,13,36,6,7.8800289290868415,7
553,63,31,48,11,7.879517250797574,20
554,20,23,51,10,7.873291814736603,13
555,85,13,96,4,7.87177905722743,9
556,8,56,87,21,7.858183704584654,35
557,95,21,55,8,7.84870978802165,13
558,8,17,98,6,7.8322640771965775,11
559,3,11,87,4,7.830562213641775,7
560,39,24,88,8,7.807721079101317,16
561,48,20,79,8,7.777732866617034,12
562,13,21,77,8,7.77099234673501,13
563,60,22,75,8,7.764402562201019,14
564,41,16,109,5,7.764026883273389,11
565,37,49,25,20,7.755599308877524,29
566,73,13,54,5,7.746921178252216,8
567,65,35,20,12,7.738425215752467,23
568,109,31,8,13,7.730735193905243,18
569,9,16,31,6,7.730408681533598,10
570,60,18,4,7,7.727377186059123,11
571,88,46,28,17,7.71200049058573,29
572,68,19,18,8,7.707757227223851,11
573,46,13,70,5,7.705270409518369,8
574,48,22,87,8,7.698735978257642,14
575,5,32,11,12,7.687442157533876,20
576,90,28,106,10,7.670984333772028,18
577,86,24,48,9,7.668739325888133,15
578,37,24,96,10,7.665844925696509,14
579,106,20,18,8,7.647336586140196,12
580,87,17,9,7,7.636446410051055,10
581,44,16,16,7,7.63510947214958,9
582,96,22,80,8,7.6325568595370585,14
583,15,10,87,4,7.629777802129095,6
584,51,18,96,7,7.611388504075612,11
585,104,28,60,8,7.608625351956834,20
586,20,15,90,6,7.5926874674698235,9
587,7,11,57,5,7.588315416894252,6
588,65,10,47,4,7.5834592832669205,6
589,69,10,74,4,7.579248302946877,6
590,30,22,71,9,7.548090335788275,13
591,62,14,87,5,7.54541053050395,9
592,96,23,70,11,7.543405368906036,12
593,114,18,70,6,7.542200625865836,12
594,111,14,7,6,7.536933625844229,8
595,97,13,68,5,7.535952472100061,8
596,104,18,102,8,7.533956675469565,10
597,98,16,106,6,7.529459965554982,10
598,70,10,71,5,7.515715016674821,5
599,102,16,88,5,7.5023041010359375,11
600,86,10,94,4,7.492158076331634,6
601,74,13,48,6,7.488504403150373,7
602,64,22,60,9,7.480163011009312,13
603,108,15,63,6,7.475559971035058,9
604,64,12,75,5,7.4656335763035075,7
605,17,16,55,7,7.461932340099582,9
606,25,45,46,19,7.439996628911812,26
607,29,13,107,4,7.409187331272264,9
608,70,11,69,4,7.401520759866324,7
609,60,10,12,5,7.400797875656224,5
610,37,41,46,14,7.398384968299374,27
611,91,18,20,8,7.395662966437773,10
612,16,21,84,9,7.387304706787613,12
613,51,11,91,4,7.381482405770834,7
614,34,15,74,5,7.367415754617591,10
615,109,13,46,5,7.363639283748701,8
616,25,38,106,14,7.361514789314747,24
617,1,11,31,6,7.35927281306795,5
618,72,12,16,5,7.333554822764275,7
619,97,18,104,8,7.327124557030449,10
620,102,31,86,11,7.3220305228245754,20
621,110,14,70,5,7.302453099036633,9
622,58,13,107,5,7.3015258521878605,8
623,107,19,109,6,7.298695286121334,13
624,16,31,68,11,7.297118928031951,20
625,28,14,111,5,7.296837620354718,9
626,98,12,93,5,7.2513528092711335,7
627,41,12,50,4,7.250027884407811,8
628,8,17,110,6,7.2499619180163615,11
629,16,11,101,4,7.238690209169098,7
630,86,70,51,30,7.23152344232766,40
631,13,20,15,8,7.226944117697118,12
632,97,28,5,10,7.203089227401705,18
633,57,15,55,7,7.186289928876396,8
634,106,12,43,5,7.182282377952387,7
635,16,15,35,5,7.1780383239732055,10
636,18,19,75,8,7.169915429722034,11
637,104,37,51,13,7.163563755536349,24
638,7,10,3,3,7.15195406317859,7
639,73,18,109,7,7.142307709742035,11
640,32,14,87,5,7.113585901413377,9
641,63,12,79,4,7.1114844508040305,8
642,91,16,18,6,7.097990672660609,10
643,1,10,17,4,7.089282944121619,6
644,46,11,9,5,7.085087450613435,6
645,43,15,5,6,7.075267806513356,9
646,64,18,39,7,7.072183333319318,11
647,90,23,87,9,7.067717517445951,14
648,17,22,39,8,7.053406202555405,14
649,6,11,107,4,7.048403625284058,7
650,91,20,25,8,7.04452512181193,12
651,28,25,2,9,7.040494915317705,16
652,46,17,39,8,7.035363973882464,9
653,80,27,106,10,7.029777914575281,17
654,74,31,84,14,7.0251363399754485,17
655,16,12,93,5,7.007856526653325,7
656,88,15,71,7,7.006386088822309,8
657,30,33,65,12,7.006135379271245,21
658,62,15,5,6,6.992708759597391,9
659,6,10,106,4,6.989547350675936,6
660,15,14,65,5,6.98678701664079,9
661,49,11,30,4,6.986267783548394,7
662,50,15,18,7,6.975457853882176,8
663,107,18,32,8,6.9462091695657895,10
664,44,10,87,4,6.930092376966648,6
665,41,15,91,5,6.893895997089626,10
666,106,15,99,5,6.882359612487447,10
667,16,21,64,8,6.86770029445223,13
668,104,47,28,19,6.867595835363374,28
669,75,17,11,7,6.860129083231025,10
670,98,14,49,6,6.852175548516358,8
671,107,17,102,7,6.840789603969229,10
672,44,11,88,5,6.8383818341711695,6
673,77,17,18,6,6.834378391566045,11
674,28,28,18,11,6.828401096604493,17
675,65,24,5,10,6.826704214447485,14
676,51,17,23,7,6.813238789143917,10
677,8,39,46,17,6.790452136276324,22
678,70,15,98,5,6.782158452834323,10
679,88,27,70,10,6.779439228833638,17
680,53,15,86,7,6.770826247743165,8
681,97,30,96,13,6.762245122268197,17
682,48,10,108,3,6.749808304712147,7
683,102,15,51,6,6.74947281728566,9
684,88,10,3,4,6.747446753866268,6
685,74,38,96,14,6.731828732252355,24
686,14,13,95,5,6.731405281187272,8
687,97,11,32,4,6.722008536715331,7
688,111,11,106,3,6.697425895741327,8
689,107,19,108,7,6.6816630284897025,12
690,29,10,37,4,6.680734619445758,6
691,7,14,46,5,6.66505874936229,9
692,95,21,50,9,6.657433489482592,12
693,83,11,71,5,6.656205380333864,6
694,63,14,102,6,6.6522226016193855,8
695,98,12,99,6,6.6450573588341655,6
696,25,48,5,19,6.626414170343125,29
697,8,27,84,10,6.62258104422981,17
698,33,19,107,8,6.618873691013778,11
699,100,15,7,6,6.61563192934305,9
700,100,11,23,5,6.60887180201957,6
701,86,63,88,26,6.602525441298171,37
702,107,26,36,11,6.599705149917169,15
703,83,17,64,7,6.597115059465707,10
704,65,28,96,12,6.593487230396348,16
705,28,33,70,13,6.5875803788420075,20
706,86,77,96,30,6.579835199705017,47
707,64,14,36,5,6.578676960982073,9
708,9,13,54,5,6.575353735842605,8
709,70,13,7,6,6.573007690002734,7
710,30,25,107,9,6.568354667768392,16
711,108,15,88,6,6.566472472480611,9
712,36,11,71,5,6.564594491374976,6
713,107,23,27,9,6.540851857375382,14
714,27,11,50,4,6.540575751678349,7
715,16,88,88,34,6.539746345614138,54
716,75,20,96,6,6.53962686497079,14
717,74,11,68,5,6.535840872424688,6
718,60,36,71,15,6.5321043259800335,21
719,86,20,18,7,6.52089641370123,13
720,112,11,107,5,6.519143239441155,6
721,29,14,87,5,6.515319434766387,9
722,60,23,68,9,6.510943888891177,14
723,50,30,96,12,6.50669589608909,18
724,86,42,104,18,6.498243850038454,24
725,31,11,50,4,6.4969883827749815,7
726,23,31,107,12,6.491903236534169,19
727,14,17,28,6,6.462988674713604,11
728,100,10,30,4,6.461771751506818,6
729,7,21,97,9,6.455761793933853,12
730,50,27,88,11,6.454854939095326,16
731,60,20,53,8,6.451987631407908,12
732,7,36,18,16,6.441568021771817,20
733,31,13,18,5,6.429121792537089,8
734,63,19,23,7,6.414686550201393,12
735,60,16,25,7,6.40548534704152,9
736,86,15,111,7,6.385538684815059,8
737,103,11,16,4,6.384231863654396,7
738,74,13,23,5,6.3699879675856135,8
739,37,16,100,6,6.343110325621272,10
740,11,20,98,9,6.338677652860182,11
741,77,12,87,5,6.328764001805247,7
742,95,15,75,6,6.30501186711362,9
743,90,20,65,9,6.287381903113806,11
744,8,22,57,8,6.276405634666305,14
745,57,18,102,8,6.264739678585861,10
746,92,22,88,8,6.250454469623379,14
747,7,41,36,17,6.247180697913235,24
748,9,16,63,6,6.237431535049686,10
749,13,28,37,12,6.230409881481568,16
750,60,17,41,7,6.220086958048467,10
751,97,10,33,4,6.197569301394057,6
752,65,17,29,8,6.195856005776575,9
753,55,17,77,7,6.195572885542833,10
754,16,25,27,9,6.183189816584679,16
755,99,11,88,5,6.17703713379853,6
756,37,59,104,23,6.175700710267806,36
757,91,21,98,7,6.169098881994584,14
758,30,27,87,11,6.164077985923405,16
759,62,11,68,5,6.151919742975855,6
760,54,34,109,13,6.139125062485929,21
761,75,13,1,4,6.1372401761978495,9
762,96,22,90,8,6.131526760597793,14
763,55,24,97,9,6.128965912516967,15
764,102,23,54,9,6.120079150891424,14
765,52,10,8,4,6.118835452590007,6
766,77,12,68,5,6.11278994285269,7
767,93,16,86,6,6.1080887829358055,10
768,55,10,79,4,6.105260957218084,6
769,65,13,4,5,6.100786289642473,8
770,16,12,45,5,6.0971373646815925,7
771,68,12,5,5,6.084537265067714,7
772,20,44,5,17,6.084413199436967,27
773,87,45,65,18,6.081114534010457,27
774,111,21,16,9,6.073294425875792,12
775,29,11,55,4,6.0636297407404705,7
776,17,15,109,6,6.060510853587173,9
777,40,27,107,10,6.058646893377404,17
778,91,10,90,4,6.057465510076112,6
779,33,15,20,6,6.052404113154946,9
780,92,10,87,4,6.051934591270965,6
781,8,16,32,7,6.041444852098721,9
782,37,10,1,5,6.037547835973022,5
783,20,13,41,5,6.02906816064692,8
784,95,20,46,8,6.027785407812038,12
785,109,16,60,7,6.026577074635168,9
786,7,59,86,21,6.022960317529565,38
787,99,10,17,4,6.0116233289389776,6
788,114,28,65,12,6.011563249640665,16
789,39,24,50,10,6.010792416092778,14
790,40,11,75,4,6.006938010180454,7
791,45,14,36,6,5.990434586984983,8
792,25,24,54,10,5.984288858689808,14
793,40,36,51,14,5.967332713634328,22
794,25,31,88,11,5.956673984495013,20
795,25,11,3,5,5.956284840526985,6
796,7,10,35,4,5.944825657129105,6
797,62,16,71,6,5.939967307930557,10
798,13,14,91,5,5.935981325781478,9
799,75,13,49,5,5.930211092104401,8
800,27,11,106,6,5.912387451440968,5
801,93,16,25,7,5.904464695396421,9
802,60,14,96,4,5.900809515031541,10
803,64,14,41,5,5.8984927048413835,9
804,16,22,100,9,5.892480519477383,13
805,49,11,60,4,5.889051777859123,7
806,91,16,50,6,5.8887528000057765,10
807,16,81,51,34,5.884437275751713,47
808,97,15,40,6,5.878372345170693,9
809,69,13,50,5,5.875505034614897,8
810,46,12,90,5,5.830565699084015,7
811,40,16,5,7,5.820527251695649,9
812,70,39,5,17,5.812017017327767,22
813,74,28,55,12,5.797157459674129,16
814,107,40,25,17,5.793952829150563,23
815,51,33,65,12,5.790474157456974,21
816,97,27,107,12,5.771441172656417,15
817,98,33,86,14,5.764694207614795,19
818,16,57,55,21,5.757509198556426,36
819,25,24,40,10,5.7546667775712015,14
820,91,20,88,8,5.750112640421962,12
821,37,20,110,9,5.74878628902198,11
822,46,42,54,17,5.7427950319383285,25
823,100,16,74,7,5.736028437636332,9
824,87,35,20,15,5.726562552686569,20
825,84,12,9,5,5.723245457590759,7
826,62,10,106,4,5.720849022877857,6
827,28,34,97,13,5.710448223070004,21
828,50,13,48,5,5.7070179051031635,8
829,80,22,55,10,5.702005440074988,12
830,68,30,51,11,5.700265456026805,19
831,100,14,18,6,5.697684011266831,8
832,46,27,75,11,5.691502289376633,16
833,68,11,78,5,5.69097212907535,6
834,20,20,35,8,5.6905199842725205,12
835,106,12,57,6,5.685749140437754,6
836,70,16,41,8,5.685339970613444,8
837,102,10,95,4,5.685319962340818,6
838,94,10,25,5,5.671887186214519,5
839,16,31,99,13,5.665818337043021,18
840,54,11,82,4,5.664278302313932,7
841,55,11,35,5,5.650743870496083,6
842,2,38,50,16,5.650047560448173,22
843,73,23,74,9,5.649045009007229,14
844,30,16,104,7,5.645606660779902,9
845,73,24,8,10,5.645022963800572,14
846,28,48,84,20,5.640820939476543,28
847,65,13,6,5,5.631765359162988,8
848,13,28,53,11,5.6297256886458005,17
849,5,20,17,7,5.625033929201379,13
850,114,43,5,18,5.610879096822169,25
851,80,11,48,4,5.594209169092441,7
852,40,31,88,13,5.590111425362956,18
853,52,12,16,5,5.588665300895637,7
854,25,11,43,3,5.587553515371877,8
855,11,14,17,6,5.581185513103199,8
856,3,10,68,4,5.578876648633715,6
857,75,42,16,17,5.574878659689373,25
858,55,27,63,12,5.56831553028517,15
859,87,22,93,9,5.565802071262539,13
860,63,11,10,4,5.56040496031845,7
861,76,14,102,6,5.556814882908007,8
862,8,41,25,16,5.550067480025434,25
863,54,53,88,23,5.542564383595122,30
864,33,14,102,6,5.525239013163607,8
865,77,11,64,6,5.511154382484386,5
866,95,19,83,7,5.510188596504647,12
867,104,21,100,8,5.507335747436163,13
868,74,34,46,13,5.475304789089528,21
869,70,13,91,6,5.470850370265932,7
870,23,39,7,16,5.4670672513658625,23
871,7,14,109,6,5.465407476689179,8
872,109,21,16,9,5.461892685468702,12
873,50,12,49,5,5.454154014714142,7
874,32,17,104,6,5.4353295484317545,11
875,7,53,88,22,5.426849580199116,31
876,25,24,51,10,5.4243870806149275,14
877,6,18,7,10,5.417883969079586,8
878,83,10,50,5,5.416126776091855,5
879,51,15,83,5,5.415397349279681,10
880,96,10,67,5,5.408732724512927,5
881,23,12,111,6,5.4067861909700285,6
882,88,20,1,8,5.397487106945941,12
883,63,25,2,11,5.395919280999036,14
884,84,19,39,8,5.386084146529571,11
885,65,24,9,10,5.366229535489773,14
886,88,23,36,11,5.35861662524284,12
887,102,30,25,13,5.32886134482215,17
888,7,31,27,12,5.323258509815234,19
889,60,19,54,8,5.320340059713547,11
890,100,14,50,6,5.313595407031385,8
891,88,14,35,6,5.305527424977248,8
892,55,12,98,4,5.28874716527487,8
893,16,23,40,10,5.274788154271569,13
894,30,21,60,7,5.268270822677399,14
895,17,17,20,7,5.256441987432858,10
896,7,25,95,11,5.246470392426651,14
897,75,10,81,3,5.244290614702669,7
898,28,44,109,17,5.243370342287004,27
899,37,49,50,22,5.228576286593012,27
900,68,29,31,13,5.2180764734942775,16
901,107,49,104,20,5.216996634772605,29
902,74,52,106,22,5.205641315490498,30
903,55,13,108,6,5.197810339207508,7
904,23,12,104,4,5.195671558199883,8
905,64,19,88,7,5.188669550676785,12
906,75,28,71,11,5.185023405419134,17
907,7,41,41,18,5.180683668884163,23
908,76,11,9,4,5.175496612984152,7
909,28,24,7,10,5.175100649214178,14
910,67,12,5,5,5.159840528973067,7
911,38,13,8,5,5.158625539766783,8
912,16,46,37,19,5.156319944125245,27
913,37,20,23,9,5.153587203140157,11
914,86,22,73,10,5.151945844046346,12
915,14,13,54,4,5.139758720068028,9
916,80,11,71,5,5.115089624287771,6
917,68,14,30,6,5.111528108885009,8
918,55,22,70,9,5.1032220329288345,13
919,54,54,70,23,5.096904873313987,31
920,11,30,54,13,5.089658806379616,17
921,99,16,36,6,5.086907679142809,10
922,16,14,38,5,5.077979390760908,9
923,87,12,111,5,5.07353420920843,7
924,91,27,86,11,5.054253859133064,16
925,106,45,5,18,5.052056869360905,27
926,86,26,80,12,5.05164493959972,14
927,86,12,112,5,5.05141242296813,7
928,15,19,5,7,5.0418557472432015,12
929,76,13,95,5,5.029825996184284,8
930,74,35,63,15,5.021214981434137,20
931,93,26,5,10,5.004460526821323,16
932,95,13,114,6,4.9943384894533605,7
933,86,43,75,20,4.9885660683259605,23
934,37,71,86,31,4.984756436647984,40
935,27,13,25,6,4.983545927288363,7
936,40,20,1,8,4.981454143490505,12
937,41,20,104,9,4.977191518101772,11
938,27,10,4,5,4.97533683590121,5
939,65,22,71,9,4.972239247659549,13
940,55,47,5,20,4.968791694509535,27
941,68,17,1,7,4.951539236320594,10
942,33,11,7,5,4.950732991604976,6
943,60,22,95,9,4.936116623099728,13
944,37,52,106,24,4.929607997592941,28
945,12,15,51,6,4.929478770854846,9
946,46,18,17,8,4.929301996976194,10
947,96,29,25,13,4.925630164170213,16
948,38,12,5,5,4.92351943090761,7
949,64,19,86,8,4.92164196443337,11
950,8,18,23,8,4.91675749277209,10
951,74,21,50,9,4.905584887178799,12
952,34,11,7,4,4.8999742789281955,7
953,28,13,62,5,4.8955044879359315,8
954,55,32,54,14,4.893010226063712,18
955,83,39,5,18,4.890865835189014,21
956,8,12,3,7,4.88781937501622,5
957,100,13,114,5,4.886489949545645,8
958,110,11,104,4,4.886003470603164,7
959,8,52,63,23,4.864260653101078,29
960,63,30,20,14,4.86232561538827,16
961,39,24,107,12,4.859521009098862,12
962,53,31,71,13,4.858094109954183,18
963,38,13,84,6,4.854976710780188,7
964,5,30,51,11,4.841333405150811,19
965,13,22,95,9,4.839189119607627,13
966,97,17,17,8,4.833173263702722,9
967,39,15,83,6,4.8326399553033035,9
968,8,15,67,6,4.831909846155583,9
969,7,59,68,25,4.818136728337691,34
970,37,37,70,15,4.817822919278334,22
971,75,18,87,7,4.814941727585257,11
972,88,26,109,10,4.813288380865055,16
973,96,13,108,6,4.805162668071275,7
974,87,38,39,16,4.796337577701307,22
975,102,19,16,9,4.795025141717224,10
976,100,21,5,9,4.790180113588851,12
977,32,24,5,10,4.788591776396215,14
978,99,23,60,10,4.788512200740043,13
979,76,33,5,14,4.788314400539968,19
980,92,13,7,4,4.780218736430547,9
981,23,21,41,9,4.77939200845321,12
982,9,12,5,5,4.777710715122403,7
983,28,51,54,21,4.774713175137818,30
984,46,16,65,6,4.770389277379545,10
985,20,56,54,26,4.770199196047598,30
986,75,36,37,13,4.761783492346941,23
987,13,32,23,16,4.756005264014363,16
988,84,13,95,5,4.755677362807473,8
989,90,30,5,12,4.752640516818983,18
990,64,13,104,5,4.751268233959821,8
991,25,16,77,7,4.745845616411638,9
992,110,12,16,5,4.744361952221326,7
993,13,25,50,10,4.736472238931539,15
994,57,11,84,4,4.735926438073418,7
995,50,65,28,28,4.73524581768419,37
996,88,12,6,5,4.723924661172382,7
997,51,17,99,8,4.721255445811637,9
998,16,63,107,25,4.707453745118705,38
999,108,12,98,5,4.704860704776837,7
1000,16,65,87,29,4.704399833490344,36
1001,7,20,17,8,4.685740229123577,12
1002,88,12,89,5,4.663566198307964,7
1003,8,35,39,16,4.640312118250007,19
1004,107,47,20,21,4.6287765404044485,26
1005,55,11,94,5,4.62125795870324,6
1006,96,13,34,5,4.620609194568736,8
1007,91,16,75,10,4.618700658898718,6
1008,77,13,95,6,4.60149322445291,7
1009,65,22,31,9,4.597416228049086,13
1010,25,15,33,5,4.583917339891116,10
1011,107,11,49,5,4.58261994672963,6
1012,54,29,90,13,4.579893896725855,16
1013,99,14,95,6,4.572737764013027,8
1014,75,17,30,8,4.572561458436264,9
1015,64,10,63,5,4.569403793082111,5
1016,17,23,107,10,4.556628194816711,13
1017,70,15,23,7,4.554568026577778,8
1018,109,13,67,7,4.5540965230597985,6
1019,53,15,95,7,4.553418388041495,8
1020,15,21,88,8,4.546696410508228,13
1021,20,43,28,18,4.544189476783367,25
1022,18,29,53,12,4.543635238262761,17
1023,27,22,68,9,4.542498192067935,13
1024,16,70,7,32,4.541203225938121,38
1025,87,57,37,24,4.5398331565645655,33
1026,8,24,102,11,4.537070383836359,13
1027,54,22,97,10,4.535944223800904,12
1028,86,14,108,7,4.5258078770363745,7
1029,83,21,87,10,4.5238867039340604,11
1030,79,12,8,4,4.5233682313953745,8
1031,16,13,14,6,4.510342602500319,7
1032,93,15,37,6,4.493445665639034,9
1033,20,15,7,7,4.4847557608097715,8
1034,91,10,57,5,4.468260927215541,5
1035,37,18,32,8,4.466542082918521,10
1036,12,20,65,8,4.465003779468814,12
1037,85,11,107,5,4.45820125427633,6
1038,9,17,50,7,4.452050276661411,10
1039,114,16,75,7,4.447723317987937,9
1040,53,23,64,10,4.44333934901001,13
1041,63,12,60,5,4.440331749337601,7
1042,13,63,7,28,4.434281502954938,35
1043,86,15,77,6,4.413638896173249,9
1044,107,47,55,21,4.411490979506615,26
1045,36,20,55,9,4.398592544427244,11
1046,74,12,77,5,4.380746142049517,7
1047,114,19,51,8,4.37838731261332,11
1048,63,38,96,15,4.376849709142971,23
1049,39,56,51,25,4.373306856508638,31
1050,50,44,107,20,4.3655615786408415,24
1051,86,113,5,48,4.357059130864303,65
1052,34,12,84,6,4.355418008053165,6
1053,41,25,63,11,4.34546407408637,14
1054,65,47,107,19,4.343893220603634,28
1055,86,20,82,8,4.3319380690325975,12
1056,102,23,114,9,4.331076584650545,14
1057,111,21,55,9,4.328392793748099,12
1058,8,21,9,11,4.328036483452337,10
1059,84,33,106,16,4.328019467626489,17
1060,55,37,28,14,4.3253848681242495,23
1061,30,21,88,10,4.322600096754096,11
1062,6,11,27,5,4.320589105702404,6
1063,93,23,54,9,4.307251305123911,14
1064,74,26,13,11,4.306038187470952,15
1065,76,24,87,10,4.304022266566311,14
1066,37,38,55,18,4.301606273781788,20
1067,27,19,39,10,4.301216458066535,9
1068,75,24,25,10,4.277372987760686,14
1069,7,29,55,13,4.275176259613077,16
1070,20,35,96,15,4.25759458795479,20
1071,95,23,106,9,4.253879576018551,14
1072,1,16,36,8,4.252120858936727,8
1073,30,11,84,4,4.231660063143016,7
1074,71,15,25,7,4.22821184042616,8
1075,74,75,86,34,4.224929805302096,41
1076,88,31,37,13,4.224270631924043,18
1077,75,27,63,12,4.221533861130906,15
1078,88,58,5,26,4.221472474474537,32
1079,43,14,51,6,4.213190249690749,8
1080,43,14,7,6,4.212115804350548,8
1081,75,38,107,13,4.210484241736751,25
1082,13,20,43,9,4.193942529467239,11
1083,65,28,93,13,4.184071657822706,15
1084,28,29,75,12,4.173159235209232,17
1085,13,25,8,11,4.169454652002989,14
1086,87,40,28,18,4.161796757953555,22
1087,94,12,87,6,4.161620639809542,6
1088,5,14,60,6,4.1550252161435335,8
1089,74,11,33,5,4.152065435529706,6
1090,39,33,60,15,4.147435206322398,18
1091,20,13,73,5,4.146065391689569,8
1092,74,19,109,7,4.145290761336613,12
1093,62,10,55,5,4.140553518041587,5
1094,60,11,28,6,4.14007204728216,5
1095,57,12,41,4,4.13369787923745,8
1096,86,13,67,6,4.131604740801435,7
1097,13,13,62,6,4.12743151741627,7
1098,80,22,65,9,4.111273433332231,13
1099,87,26,25,12,4.102463690405524,14
1100,83,20,93,9,4.100880722204593,11
1101,65,27,60,10,4.09182863961869,17
1102,13,45,40,20,4.070678505144181,25
1103,87,16,64,7,4.069370019115816,9
1104,55,10,68,4,4.068409910261689,6
1105,96,53,54,25,4.068141273301063,28
1106,44,13,6,5,4.067061192837313,8
1107,83,14,46,7,4.055902658620626,7
1108,50,30,8,15,4.0537983612302835,15
1109,88,26,9,11,4.050279879066775,15
1110,11,13,79,7,4.047561716338114,6
1111,97,27,65,12,4.042531697214399,15
1112,31,12,53,4,4.036895112605021,8
1113,35,13,28,6,4.036665461709038,7
1114,13,33,28,14,4.033447367470069,19
1115,37,44,74,20,4.033137310869005,24
1116,7,13,11,6,4.026372584132109,7
1117,7,19,98,8,4.025055128919853,11
1118,4,11,36,6,4.0157512075594965,5
1119,114,32,86,13,4.012219023441153,19
1120,104,39,50,16,4.0035445313545575,23
1121,90,11,33,4,4.003292593732325,7
1122,25,34,65,14,3.9982069365892623,20
1123,27,27,88,14,3.9972856820177016,13
1124,14,11,13,4,3.98325425585621,7
1125,37,12,69,5,3.9709549460906977,7
1126,74,24,93,11,3.9601017688790825,13
1127,33,10,39,4,3.9525968008389243,6
1128,27,10,87,5,3.9487097970098004,5
1129,80,10,97,4,3.9365866928471034,6
1130,102,10,83,4,3.9358085201394095,6
1131,16,23,62,9,3.933526039744061,14
1132,60,24,31,12,3.929911171396163,12
1133,41,13,77,5,3.9281873956506344,8
1134,71,18,106,8,3.925016935496231,10
1135,5,28,2,12,3.923277825320168,16
1136,97,11,10,6,3.9207678088340034,5
1137,100,23,107,12,3.9058802066459917,11
1138,102,26,37,11,3.9015784283610255,15
1139,104,27,63,12,3.900588527290145,15
1140,54,37,51,17,3.900510354202893,20
1141,40,18,50,7,3.897409445397431,11
1142,65,38,106,16,3.884814424795719,22
1143,96,24,104,10,3.8706241075776626,14
1144,54,15,18,7,3.870411168392847,8
1145,83,24,65,11,3.8650312387760812,13
1146,31,10,5,4,3.8620843453498637,6
1147,106,21,75,11,3.8605003548235586,10
1148,18,13,9,5,3.8577897553317615,8
1149,41,17,37,7,3.8456182281056206,10
1150,28,11,3,4,3.8388007621981846,7
1151,83,27,8,13,3.8382150032056903,14
1152,11,60,86,27,3.8353485548947646,33
1153,108,13,50,5,3.8299657646620937,8
1154,30,19,28,8,3.8298077885882966,11
1155,9,21,86,8,3.818397672909284,13
1156,60,31,86,13,3.814348469452436,18
1157,110,16,5,7,3.8138584796050923,9
1158,23,32,65,15,3.807595873030598,17
1159,71,11,68,5,3.8071954572931124,6
1160,13,53,55,24,3.7797378054985997,29
1161,80,24,54,11,3.7642119047391476,13
1162,97,16,76,8,3.7370860130894332,8
1163,16,19,80,9,3.7348635267747627,10
1164,18,23,39,10,3.7345525449544463,13
1165,43,16,88,7,3.7275454144235045,9
1166,95,25,107,12,3.721321768434082,13
1167,74,59,5,27,3.7150397399954445,32
1168,75,11,108,5,3.700340227437407,6
1169,28,28,102,13,3.6997830630198973,15
1170,89,14,50,7,3.697778125616005,7
1171,36,12,106,5,3.6961454579408475,7
1172,16,48,54,21,3.695210707305646,27
1173,78,11,87,6,3.6913711385920154,5
1174,46,20,84,8,3.686829488531013,12
1175,86,74,107,34,3.678227546478233,40
1176,55,41,11,16,3.6751670322630696,25
1177,71,23,107,10,3.6749979694495445,13
1178,8,53,96,23,3.6687416252473026,30
1179,20,31,106,13,3.6670765571458195,18
1180,79,10,88,4,3.6658466896877484,6
1181,62,10,50,4,3.6657345895143245,6
1182,8,18,7,9,3.6556475795095196,9
1183,30,20,37,8,3.640395609700316,12
1184,39,31,49,13,3.633922954184222,18
1185,4,16,16,8,3.6085337507502024,8
1186,65,57,54,26,3.600456262401302,31
1187,48,11,39,5,3.594601769104413,6
1188,28,19,98,7,3.593034409386323,12
1189,97,10,95,4,3.58943247133478,6
1190,87,10,110,4,3.5295519129657293,6
1191,13,21,17,9,3.5184767499063967,12
1192,16,50,63,22,3.517054545119613,28
1193,41,28,107,12,3.516199372673926,16
1194,13,40,41,17,3.5126682874929025,23
1195,20,21,46,8,3.51090539647306,13
1196,70,24,51,12,3.51020506286295,12
1197,91,15,84,7,3.506943767095505,8
1198,16,26,36,12,3.50513798130426,14
1199,104,30,54,14,3.494678026548527,16
1200,109,15,65,5,3.4929763691198916,10
1201,62,11,65,5,3.4832054319839996,6
1202,70,28,65,11,3.478419403846195,17
1203,16,22,15,9,3.4699236009719003,13
1204,33,23,5,11,3.454327509177194,12
1205,114,11,40,4,3.4534135965890274,7
1206,97,15,57,7,3.4435443466893796,8
1207,54,45,106,22,3.4398860335023413,23
1208,75,10,102,4,3.4391155267314995,6
1209,87,31,104,15,3.438412759763363,16
1210,87,25,109,10,3.438248375396607,15
1211,86,17,32,8,3.4193017987895304,9
1212,8,21,100,9,3.4169007429532634,12
1213,54,22,114,11,3.4158047714822755,11
1214,51,30,60,12,3.4081984536935326,18
1215,75,20,9,10,3.3902783860400745,10
1216,80,16,37,7,3.388891253141482,9
1217,40,11,11,5,3.3694158942048205,6
1218,14,23,8,10,3.3634201583462158,13
1219,16,23,17,9,3.3619063804529947,14
1220,65,61,63,28,3.3604398706518053,33
1221,20,10,9,4,3.353443346624384,6
1222,81,11,107,5,3.347004989697291,6
1223,75,13,33,5,3.342736023465548,8
1224,65,42,41,17,3.3359199836940974,25
1225,70,18,97,9,3.3275523495851074,9
1226,76,13,88,7,3.318537943308137,6
1227,70,16,95,8,3.3075112398485507,8
1228,49,10,70,4,3.3045973277956966,6
1229,16,66,8,29,3.304521902117639,37
1230,13,38,107,18,3.3016013396204555,20
1231,49,33,88,15,3.2989264521783306,18
1232,23,14,54,6,3.297562319364522,8
1233,114,13,67,6,3.2746706512348434,7
1234,63,34,50,15,3.274415048364832,19
1235,70,14,93,6,3.271451863431868,8
1236,86,72,84,36,3.2610166651310086,36
1237,30,10,63,4,3.254074696673354,6
1238,23,25,87,11,3.2499606858506294,14
1239,11,25,20,10,3.2452743370759327,15
1240,85,14,54,6,3.2397539807116327,8
1241,23,11,97,5,3.2361653104272845,6
1242,6,16,16,8,3.222477473963037,8
1243,14,11,88,5,3.2206098277423347,6
1244,25,16,18,6,3.21981452522341,10
1245,99,16,30,7,3.2133273586495648,9
1246,100,10,75,4,3.2132507505539607,6
1247,7,22,71,9,3.1990697606245018,13
1248,86,71,8,34,3.1963852247420705,37
1249,71,22,39,10,3.1962994910533795,12
1250,86,59,25,28,3.1954658339631274,31
1251,16,39,50,17,3.1894998784283772,22
1252,86,69,54,32,3.1888799872804534,37
1253,99,24,13,11,3.1869164042235205,13
1254,55,38,106,16,3.183251509041,22
1255,13,37,46,17,3.172904248193807,20
1256,39,29,68,15,3.172654643204153,14
1257,13,19,9,8,3.1701751167315515,11
1258,90,14,74,5,3.1680613510289204,9
1259,106,23,41,11,3.158186665525711,12
1260,76,27,104,12,3.13624900086839,15
1261,15,11,54,5,3.125295121676584,6
1262,97,23,88,11,3.1219712763134564,12
1263,71,16,87,8,3.114412062051743,8
1264,93,11,109,5,3.105851166548928,6
1265,114,32,88,15,3.1042645777828377,17
1266,65,13,44,7,3.103105872794513,6
1267,99,14,68,6,3.1001036150844663,8
1268,17,22,54,11,3.092931167491581,11
1269,28,27,91,12,3.0909280045200784,15
1270,7,10,80,5,3.0667663131231153,5
1271,51,22,109,9,3.063742492925852,13
1272,48,14,55,6,3.06362691776684,8
1273,88,41,51,19,3.0561971156136907,22
1274,96,28,88,14,3.0532343196114033,14
1275,51,13,97,6,3.049621553627842,7
1276,40,32,36,13,3.047007600783558,19
1277,38,13,96,6,3.0422152322461717,7
1278,84,21,48,9,3.0347277834877127,12
1279,75,15,84,7,3.030584614121957,8
1280,51,24,41,11,3.028997449769268,13
1281,92,10,104,4,3.013422153166298,6
1282,104,59,5,28,2.9970663239960817,31
1283,11,32,88,15,2.9946510109147497,17
1284,97,12,102,5,2.9943230050472285,7
1285,106,49,63,23,2.9941725427271724,26
1286,13,15,63,6,2.9904556427756623,9
1287,23,16,28,8,2.982809086991735,8
1288,10,12,84,5,2.980259678929738,7
1289,15,11,95,5,2.9708859793353697,6
1290,95,42,16,20,2.9607842859241957,22
1291,62,16,88,7,2.959487921171799,9
1292,102,18,74,8,2.9546185397660167,10
1293,7,16,50,8,2.9489881953696515,8
1294,86,28,17,14,2.94742778634219,14
1295,20,18,95,8,2.944277541841498,10
1296,99,15,65,7,2.9253489592007305,8
1297,97,12,98,5,2.9183345258744944,7
1298,14,15,51,6,2.907372171253044,9
1299,91,19,37,9,2.9050960547005245,10
1300,30,35,16,15,2.889296902812902,20
1301,25,29,97,13,2.870384307522535,16
1302,87,37,63,18,2.8662395111625,19
1303,63,17,38,7,2.8438368509015857,10
1304,109,18,13,7,2.8426763674639637,11
1305,87,21,57,9,2.842460195115372,12
1306,23,22,25,10,2.8322220847423267,12
1307,86,41,46,18,2.830781053281954,23
1308,46,18,63,9,2.8227341920923297,9
1309,41,10,31,4,2.8187229086868015,6
1310,7,13,29,7,2.8153327011944786,6
1311,63,13,34,6,2.8100003290876803,7
1312,75,22,74,9,2.809934258633539,13
1313,99,15,41,7,2.8081672918617278,8
1314,104,18,18,7,2.8046551455186632,11
1315,79,15,50,6,2.7998338113931376,9
1316,44,13,13,6,2.7973580079711726,7
1317,20,45,37,21,2.7863088238660265,24
1318,8,36,104,17,2.7794749735414084,19
1319,25,17,53,8,2.774786838502582,9
1320,5,11,10,6,2.7716738654503197,5
1321,65,14,48,6,2.7586384168294447,8
1322,7,29,106,15,2.7541564496724003,14
1323,14,15,11,6,2.753683750814255,9
1324,51,16,9,8,2.7534552832198242,8
1325,25,18,55,8,2.7487856444546024,10
1326,20,15,30,7,2.7449376883217553,8
1327,14,16,84,7,2.744202009506242,9
1328,53,22,51,11,2.7411105049672555,11
1329,87,42,54,18,2.7276096437522575,24
1330,36,23,75,12,2.7241097098771285,11
1331,106,15,68,7,2.7239391329930016,8
1332,41,22,18,10,2.722545546616939,12
1333,97,25,16,13,2.7225048293039356,12
1334,95,11,80,5,2.7197438471090796,6
1335,54,33,95,16,2.7046161899626613,17
1336,63,31,39,12,2.703759762386428,19
1337,63,23,68,10,2.690003456626381,13
1338,97,23,46,11,2.6830528559454945,12
1339,71,27,8,13,2.6791944013625146,14
1340,71,10,27,4,2.67033656132775,6
1341,11,15,35,7,2.658402580780903,8
1342,74,13,91,6,2.658254293210725,7
1343,16,26,53,12,2.6570935949339445,14
1344,28,36,25,15,2.6530805265031128,21
1345,109,47,5,23,2.651945214364779,24
1346,30,24,8,11,2.6514132136935467,13
1347,4,15,17,6,2.6508612974233423,9
1348,16,60,5,25,2.6435184456824317,35
1349,114,13,36,5,2.6256770473418762,8
1350,107,13,31,8,2.6235262544994726,5
1351,15,14,7,7,2.6229324561632237,7
1352,34,10,76,5,2.615955033214912,5
1353,16,13,29,7,2.598885422100126,6
1354,39,25,53,10,2.598263210359535,15
1355,39,23,5,11,2.5977698137373055,12
1356,80,24,28,11,2.5705556034476817,13
1357,11,10,69,4,2.569037957161563,6
1358,83,10,63,6,2.557624644664858,4
1359,63,15,95,7,2.557509411427886,8
1360,86,14,14,7,2.5565201304900333,7
1361,23,29,88,12,2.5400262638911513,17
1362,76,16,109,7,2.5285469015591207,9
1363,36,14,87,7,2.5281752879458814,7
1364,55,21,90,11,2.5152743292271547,10
1365,107,55,37,25,2.511119120051266,30
1366,37,18,109,8,2.501013404341532,10
1367,11,20,48,9,2.499763597895506,11
1368,13,29,75,13,2.4929930545695704,16
1369,87,16,49,9,2.4853547789713173,7
1370,49,34,13,17,2.481881382117497,17
1371,8,39,20,18,2.4774464429650913,21
1372,13,41,60,17,2.4669231276518246,24
1373,8,65,88,30,2.461291700037279,35
1374,11,46,16,19,2.461047191041384,27
1375,104,20,68,9,2.460733719128006,11
1376,54,14,49,7,2.454208065190866,7
1377,46,48,5,21,2.452279517290662,27
1378,32,10,50,6,2.444054190716271,4
1379,20,17,97,8,2.4355837212433697,9
1380,87,21,99,9,2.4324110326808843,12
1381,109,11,99,5,2.4195174025010595,6
1382,86,11,4,5,2.4130242941982507,6
1383,43,11,18,6,2.4128380364549287,5
1384,81,10,88,5,2.411097045225808,5
1385,87,39,50,19,2.4090424159296533,20
1386,9,19,107,8,2.4084484321092074,11
1387,110,13,86,6,2.4084031140746345,7
1388,25,17,70,8,2.405943954843893,9
1389,99,19,86,8,2.400382898068694,11
1390,64,14,55,7,2.3960526203970374,7
1391,93,14,84,6,2.3958694367553783,8
1392,20,20,109,8,2.3908375286297607,12
1393,111,12,8,6,2.390343846489095,6
1394,65,38,68,17,2.3895840201765175,21
1395,15,20,25,8,2.380758889536655,12
1396,99,23,5,11,2.3616219022642833,12
1397,48,14,109,6,2.3615030071790217,8
1398,23,11,27,5,2.3601895117131306,6
1399,4,12,18,5,2.3471024733316344,7
1400,71,13,55,7,2.3436435297521276,6
1401,4,12,55,5,2.3369208193901314,7
1402,33,12,11,7,2.336303729576231,5
1403,37,11,43,4,2.332605420766109,7
1404,50,25,51,12,2.3323232012179402,13
1405,7,54,65,28,2.3205034614266054,26
1406,86,20,38,9,2.317394772106249,11
1407,106,36,96,16,2.2984565902488905,20
1408,86,13,81,5,2.283313324562977,8
1409,7,42,39,19,2.2827281847053524,23
1410,28,66,96,31,2.267406944603933,35
1411,46,34,28,14,2.2549666124967906,20
1412,86,40,90,18,2.2520097652852837,22
1413,63,81,86,35,2.2518352832097657,46
1414,76,23,8,11,2.22939302069529,12
1415,28,16,100,7,2.2255414738387724,9
1416,75,19,23,10,2.214683450644989,9
1417,112,11,8,6,2.2144684353504553,5
1418,86,28,2,14,2.2092021993038244,14
1419,63,25,40,12,2.207258123694637,13
1420,37,24,84,11,2.201223464549896,13
1421,77,14,65,7,2.2011849181716925,7
1422,8,23,48,10,2.2004165749645987,13
1423,106,21,17,9,2.1959594385945413,12
1424,96,11,14,5,2.19268862994012,6
1425,74,17,7,10,2.191637272999585,7
1426,13,18,11,8,2.1907015938393704,10
1427,8,64,74,28,2.186622040651489,36
1428,104,11,57,7,2.1780874103759786,4
1429,13,44,86,19,2.175174771531293,25
1430,23,10,29,5,2.1610971150686167,5
1431,28,10,40,5,2.155370208616526,5
1432,2,19,87,9,2.150541163273267,10
1433,65,11,49,5,2.145737587122752,6
1434,53,19,104,9,2.1450025037605407,10
1435,16,83,86,37,2.142098668447526,46
1436,109,16,50,8,2.1420450648202105,8
1437,16,50,13,23,2.1401141705570708,27
1438,73,14,106,7,2.139958358931589,7
1439,53,23,88,10,2.138168696621838,13
1440,53,12,109,5,2.1301547013759303,7
1441,8,15,33,6,2.129402754491363,9
1442,104,25,109,12,2.1264175418400835,13
1443,41,10,89,5,2.124994842096453,5
1444,25,15,84,7,2.1183956865956017,8
1445,48,13,30,7,2.114145406665778,6
1446,7,22,63,12,2.108294344937298,10
1447,28,62,5,30,2.1003743399505708,32
1448,97,22,8,11,2.094799206270941,11
1449,8,14,18,7,2.089050009065866,7
1450,75,16,31,8,2.087556959781139,8
1451,75,12,109,5,2.086370884794744,7
1452,78,10,88,5,2.0850362472415522,5
1453,82,10,63,5,2.077975861296688,5
1454,57,15,46,7,2.0747037466091505,8
1455,50,26,25,13,2.0720055901853556,13
1456,97,26,63,12,2.0694495254936975,14
1457,16,21,98,10,2.0672287007178305,11
1458,97,30,106,15,2.0644256996528543,15
1459,50,11,112,5,2.0629004046061317,6
1460,9,13,106,6,2.060718850116028,7
1461,50,15,30,7,2.0464195072984315,8
1462,90,24,60,10,2.0397275719261816,14
1463,99,16,15,7,2.0375168850995924,9
1464,13,14,70,6,2.032328222536006,8
1465,55,12,73,6,2.0248295643907164,6
1466,76,24,70,11,2.0205668013908826,13
1467,8,36,90,16,2.0194647820717804,20
1468,7,20,64,10,2.019343501861671,10
1469,65,61,86,28,2.0164936640720437,33
1470,111,12,39,6,2.0153993087738304,6
1471,111,32,68,16,2.0126661744958776,16
1472,13,22,71,11,2.0055170376197826,11
1473,33,10,99,5,1.9995697947435775,5
1474,46,38,11,17,1.9985912350445674,21
1475,84,10,35,5,1.9965083140622215,5
1476,6,11,87,5,1.9839334145784242,6
1477,50,59,54,28,1.9778919128236314,31
1478,2,12,75,5,1.9694128550530172,7
1479,8,41,51,19,1.9688998977328516,22
1480,75,15,47,6,1.9532622296516966,9
1481,77,16,4,7,1.946865778937695,9
1482,54,20,7,10,1.9447372983062396,10
1483,25,15,57,7,1.9367936004868358,8
1484,87,30,84,14,1.9310332903828065,16
1485,112,10,75,5,1.9289326018714483,5
1486,23,32,86,14,1.9182051181478577,18
1487,99,11,76,6,1.9173589523208343,5
1488,30,14,96,7,1.9170201840499577,7
1489,1,15,7,8,1.9162712570705793,7
1490,70,17,39,9,1.9157212262198098,8
1491,74,14,108,7,1.8987503296630384,7
1492,49,21,86,10,1.8976322802746382,11
1493,111,19,107,10,1.8958566397093335,9
1494,114,10,71,4,1.8941331560457364,6
1495,87,41,88,20,1.8938761253475072,21
1496,5,26,91,11,1.892251700304698,15
1497,5,49,96,22,1.8890948283914337,27
1498,25,15,64,7,1.8875583909669966,8
1499,16,48,74,22,1.8818651609735453,26
1500,98,18,37,9,1.8817953145609947,9
1501,28,26,9,13,1.873436210764629,13
1502,20,15,76,8,1.8717042450890158,7
1503,74,13,17,6,1.8676704113074118,7
1504,37,44,28,20,1.8670737685584553,24
1505,37,95,5,46,1.8654288703425719,49
1506,2,17,84,8,1.8594432529031952,9
1507,51,15,31,6,1.8557010320017515,9
1508,86,56,55,27,1.8505820225718854,29
1509,83,19,88,10,1.8504010929562806,9
1510,31,13,40,6,1.849890478930514,7
1511,34,12,106,5,1.8480424044178243,7
1512,114,27,16,14,1.8471183538717204,13
1513,50,18,114,8,1.8469975740050815,10
1514,109,24,106,12,1.8438625812895593,12
1515,37,46,51,24,1.8410186071468577,22
1516,102,13,99,6,1.8212893413036875,7
1517,8,64,28,29,1.8060421386611976,35
1518,87,26,60,12,1.7993355932005026,14
1519,104,49,16,24,1.794859812655941,25
1520,2,20,37,10,1.7943143656917857,10
1521,41,14,40,8,1.7937189898742476,6
1522,13,34,27,16,1.788593702056898,18
1523,87,65,107,31,1.7871251834002548,34
1524,37,25,90,12,1.7816453937181782,13
1525,48,23,16,10,1.7794429962560594,13
1526,96,56,107,25,1.7781061515399443,31
1527,41,21,68,11,1.7763568577637876,10
1528,7,26,4,13,1.7757689326218205,13
1529,36,23,39,12,1.764986784559493,11
1530,84,26,70,12,1.7530345342228948,14
1531,107,56,63,29,1.7429188660610804,27
1532,36,19,60,9,1.7363741266115713,10
1533,36,16,9,7,1.73307659819646,9
1534,70,19,75,10,1.7314858975507377,9
1535,60,13,11,7,1.72978393860355,6
1536,25,41,39,20,1.7265831391361315,21
1537,88,32,68,14,1.7171070398474249,18
1538,95,25,28,11,1.7143083531485523,14
1539,60,30,88,12,1.714040943532787,18
1540,74,10,85,5,1.7134982697618455,5
1541,84,13,76,6,1.710890300241341,7
1542,46,10,41,4,1.7055763851805161,6
1543,86,14,33,6,1.6956445150868669,8
1544,86,92,87,48,1.693335552900358,44
1545,76,29,96,13,1.6762730706442965,16
1546,96,14,73,7,1.6753693979758282,7
1547,114,24,97,11,1.6750618167368518,13
1548,77,15,5,7,1.6718563886987095,8
1549,107,31,70,15,1.6685978034904536,16
1550,32,11,109,6,1.6660133397695764,5
1551,107,28,60,13,1.6582323453541974,15
1552,13,47,68,23,1.653534001312979,24
1553,28,28,39,13,1.636644088967189,15
1554,34,11,9,6,1.6242149298552002,5
1555,65,52,13,26,1.619815567475023,26
1556,55,49,88,22,1.6154630922330864,27
1557,18,10,111,5,1.6141345577429873,5
1558,23,43,16,20,1.6132165016908744,23
1559,63,25,70,12,1.612262611699524,13
1560,104,10,81,6,1.6058410210160248,4
1561,34,21,107,9,1.6030565634408773,12
1562,87,15,97,6,1.595552572689484,9
1563,95,23,39,11,1.5861677629693824,12
1564,2,15,25,8,1.5845186001024008,7
1565,17,24,50,12,1.572128057564237,12
1566,84,18,80,8,1.570942028221592,10
1567,70,11,90,5,1.5691735166520109,6
1568,91,16,39,7,1.558556429144287,9
1569,44,16,63,8,1.5571463971544324,8
1570,104,23,83,10,1.5563880557352996,13
1571,8,19,17,10,1.5403077254917843,9
1572,86,84,28,39,1.5371508387010582,45
1573,107,11,79,6,1.5337921396437175,5
1574,106,19,83,8,1.5311768047912764,11
1575,35,14,37,7,1.523131742310598,7
1576,39,11,4,5,1.5205153281631296,6
1577,86,45,109,22,1.51710611276112,23
1578,16,17,2,8,1.5157503924432267,9
1579,46,12,55,5,1.5148590180899557,7
1580,51,13,36,7,1.509572027592031,6
1581,70,13,9,6,1.504563121307626,7
1582,98,23,104,9,1.501246773408476,14
1583,104,52,65,25,1.4929358228195106,27
1584,102,16,106,8,1.4908896648943566,8
1585,63,11,112,6,1.4854774169813643,5
1586,20,28,16,12,1.47224219682996,16
1587,39,32,65,17,1.4681800474902627,15
1588,28,14,89,6,1.4639788382157592,8
1589,108,12,13,5,1.4622090647131183,7
1590,28,44,65,20,1.4603377305503502,24
1591,98,19,76,8,1.4493678922731097,11
1592,70,13,40,6,1.43617994756994,7
1593,91,12,54,6,1.4331424659599215,6
1594,106,14,110,7,1.4258595725562953,7
1595,74,10,98,5,1.4177496992788108,5
1596,102,15,11,6,1.4114820984859568,9
1597,55,27,84,13,1.3965203244162756,14
1598,95,17,23,9,1.3963563173964124,8
1599,55,50,51,23,1.392880835478624,27
1600,83,19,97,10,1.3860983501952917,9
1601,39,12,12,6,1.3850490174415733,6
1602,11,48,28,24,1.3816823064618553,24
1603,104,10,112,5,1.3794403907953838,5
1604,97,13,50,7,1.3748102351512164,6
1605,86,18,85,9,1.3738528392472165,9
1606,90,11,76,6,1.3711097869836062,5
1607,41,24,39,11,1.3694981081138715,13
1608,53,24,40,12,1.3660456737747546,12
1609,97,13,75,7,1.365095248526459,6
1610,54,58,107,28,1.3638628984241818,30
1611,25,26,30,14,1.363384718034577,12
1612,51,29,17,13,1.3591705652702635,16
1613,111,13,13,7,1.3589509075541042,6
1614,4,30,13,14,1.354309950897764,16
1615,60,38,40,18,1.349380569605351,20
1616,98,10,18,4,1.3471084627969787,6
1617,106,39,88,17,1.34469695650301,22
1618,79,17,28,8,1.3443965025775713,9
1619,84,17,90,8,1.3434141546201468,9
1620,8,66,37,32,1.3357403383797626,34
1621,10,16,8,7,1.3145513780375315,9
1622,70,10,102,6,1.3043211125718095,4
1623,88,18,4,8,1.301574456251896,10
1624,16,65,65,31,1.3014138339062762,34
1625,106,16,48,8,1.2966873109190276,8
1626,17,34,37,18,1.2727375464984247,16
1627,87,41,55,19,1.2726321489984762,22
1628,62,10,76,5,1.2686993930037311,5
1629,84,37,96,19,1.2684027154450666,18
1630,28,18,73,8,1.2674667464036864,10
1631,65,13,14,7,1.2593828148312758,6
1632,51,18,30,9,1.2591099162694142,9
1633,86,14,78,6,1.2581466617600456,8
1634,11,44,107,21,1.2577214098422742,23
1635,30,12,7,5,1.2481777080985,7
1636,109,19,84,9,1.24524860607484,10
1637,54,19,98,9,1.237916298592764,10
1638,74,35,65,17,1.220959592696592,18
1639,106,11,40,5,1.2113951648017514,6
1640,97,31,74,15,1.194748531335218,16
1641,25,25,109,12,1.1927554377225935,13
1642,57,14,28,7,1.1812096036740403,7
1643,54,13,68,6,1.1603728149056827,7
1644,2,40,8,20,1.1594572352269998,20
1645,55,45,65,23,1.1488867924519441,22
1646,50,11,73,4,1.148123985347342,7
1647,20,14,48,6,1.1319086574299344,8
1648,107,53,7,24,1.126192275510305,29
1649,13,39,5,19,1.1249218143526358,20
1650,65,22,36,10,1.1134691556637997,12
1651,53,16,5,7,1.1100089939054687,9
1652,5,47,54,22,1.0944368571176064,25
1653,83,16,109,9,1.0939664342434448,7
1654,86,67,20,32,1.090808542947844,35
1655,18,20,107,9,1.087633411979241,11
1656,90,30,16,13,1.086450964750539,17
1657,87,23,40,11,1.078724579012571,12
1658,83,33,55,17,1.0771475436917035,16
1659,49,10,28,4,1.071731750298935,6
1660,87,26,46,14,1.071726994655554,12
1661,67,20,37,9,1.0707700527635258,11
1662,84,59,107,29,1.0684618045247287,30
1663,39,14,20,8,1.0673965411691178,6
1664,9,35,7,16,1.0539792889091706,19
1665,16,24,49,11,1.0511839451073195,13
1666,33,16,28,9,1.0436942408383045,7
1667,88,11,74,4,1.043558433601539,7
1668,114,16,46,7,1.0425155794457335,9
1669,87,17,80,8,1.02311056991515,9
1670,70,10,33,5,1.0222975969230632,5
1671,87,23,68,11,1.0190463084335866,12
1672,93,20,88,9,1.0138818382921346,11
1673,20,23,80,11,1.0138169865719238,12
1674,87,29,95,14,1.0109411688585392,15
1675,60,10,78,4,1.0077900317025859,6
1676,60,30,55,14,1.0068325257396056,16
1677,20,22,70,11,1.0037779537681712,11
1678,109,10,71,5,0.9970275319814977,5
1679,107,13,14,7,0.9920091994330184,6
1680,106,67,28,32,0.9916026418837893,35
1681,104,13,80,7,0.9861315816908558,6
1682,107,10,12,6,0.9798393160313019,4
1683,96,44,87,22,0.9639736076499449,22
1684,14,14,5,6,0.9561035605846475,8
1685,63,27,25,12,0.9527168084783876,15
1686,88,13,47,6,0.949625238519646,7
1687,87,38,74,18,0.9489215682392524,20
1688,8,31,65,16,0.9484938734547238,15
1689,37,20,76,11,0.942629410207245,9
1690,18,12,55,5,0.9424181916365569,7
1691,91,24,107,11,0.9408438298942094,13
1692,30,38,86,18,0.9407202047224429,20
1693,43,13,39,5,0.9397651908861315,8
1694,49,12,8,5,0.934404378662043,7
1695,88,36,41,18,0.9319834822337307,18
1696,8,32,93,16,0.929819616045558,16
1697,25,22,83,10,0.9290503981463761,12
1698,88,14,31,7,0.9277772630137017,7
1699,18,18,74,8,0.9157992079065538,10
1700,108,10,25,5,0.9146750049457186,5
1701,51,33,46,15,0.911353828101423,18
1702,18,15,65,8,0.9097582893498202,7
1703,71,14,50,6,0.8949040923055441,8
1704,107,31,46,16,0.8942764168819464,15
1705,90,18,88,9,0.8925647585085008,9
1706,55,16,53,7,0.8816434712346441,9
1707,18,18,40,8,0.8805030745356137,10
1708,10,10,114,4,0.8617397018011257,6
1709,96,13,109,6,0.860547999068384,7
1710,27,11,8,6,0.8585027849962472,5
1711,39,14,96,6,0.8584786467987305,8
1712,25,60,16,29,0.8584428289781936,31
1713,46,15,68,7,0.8565592203009194,8
1714,49,13,51,6,0.850234920668641,7
1715,8,64,54,33,0.8453996480922652,31
1716,86,10,89,4,0.8309374732906825,6
1717,64,15,68,6,0.8290037423488786,9
1718,2,16,46,8,0.8285194662826778,8
1719,83,15,60,8,0.8249582076687048,7
1720,114,49,107,23,0.823856943103199,26
1721,50,12,4,6,0.8210544229672087,6
1722,74,37,25,18,0.8204962979912085,19
1723,25,14,90,7,0.8193923685462247,7
1724,106,88,86,44,0.818482380162344,44
1725,55,12,41,6,0.8180588554995193,6
1726,49,14,17,6,0.8168710470278943,8
1727,86,22,62,11,0.8138929518965301,11
1728,106,39,50,18,0.8096202630526165,21
1729,8,14,80,6,0.8089658215861046,8
1730,48,12,13,6,0.8080555546550418,6
1731,8,22,60,10,0.8056366298661098,12
1732,96,36,55,18,0.7893581602386032,18
1733,65,17,84,9,0.7808353432634707,8
1734,46,20,60,10,0.7782430213526009,10
1735,33,15,104,8,0.7704375614853092,7
1736,83,13,7,8,0.7695159448560518,5
1737,106,33,104,15,0.7665725528171266,18
1738,11,15,51,8,0.765784841674621,7
1739,77,43,60,21,0.7542255805180192,22
1740,114,22,74,12,0.7506194135084285,10
1741,28,27,48,13,0.7484805696104432,14
1742,104,30,74,14,0.7473029478332428,16
1743,65,30,37,16,0.7390927440074131,14
1744,44,15,25,7,0.7339941983900393,8
1745,8,47,11,21,0.7230407809506088,26
1746,88,12,48,5,0.721628645159468,7
1747,82,13,28,7,0.7153587234866209,6
1748,70,52,8,26,0.714533044758106,26
1749,18,12,36,6,0.7140101804629405,6
1750,75,29,39,15,0.7103866309575745,14
1751,88,30,84,16,0.7084791071128511,14
1752,76,15,30,8,0.708134364255956,7
1753,50,40,11,19,0.6981183946332987,21
1754,27,11,99,6,0.6941577039356042,5
1755,23,15,15,7,0.6735916899677631,8
1756,106,46,11,20,0.6535108004818931,26
1757,88,53,46,26,0.6457677667508945,27
1758,31,12,27,4,0.6450919649382086,8
1759,98,16,50,8,0.6426219058041094,8
1760,16,20,43,9,0.6408960966953514,11
1761,107,24,68,11,0.6364871522445633,13
1762,57,11,51,5,0.636000530409219,6
1763,11,11,97,6,0.6269874474505769,5
1764,107,62,5,31,0.6252815058217583,31
1765,63,12,49,6,0.6194857515150322,6
1766,102,11,98,6,0.6175099367937772,5
1767,75,32,51,16,0.6073440581538613,16
1768,88,53,107,24,0.6022797482610652,29
1769,20,10,40,5,0.6005897193257779,5
1770,97,17,93,8,0.5934767161556218,9
1771,86,19,36,10,0.5911010841978774,9
1772,55,34,75,19,0.5893925674836219,15
1773,87,13,4,7,0.5888852574445144,6
1774,107,65,28,31,0.5830983269262209,34
1775,2,17,96,8,0.5793042045284421,9
1776,65,28,53,12,0.5740519391740134,16
1777,106,22,100,10,0.5684257462870975,12
1778,41,16,75,8,0.565449381163993,8
1779,51,15,98,7,0.562825043605883,8
1780,97,30,2,14,0.5614740846174435,16
1781,84,29,50,15,0.5600416600783537,14
1782,83,10,2,5,0.5594397265150824,5
1783,17,22,25,11,0.5587031515817832,11
1784,102,10,84,5,0.555323987307036,5
1785,98,23,107,11,0.5449263063258658,12
1786,114,19,17,9,0.5301119499866597,10
1787,20,15,13,8,0.5291560401746672,7
1788,76,20,46,10,0.528169825790584,10
1789,1,12,73,6,0.5279151460001303,6
1790,55,18,9,9,0.5222183978590045,9
1791,8,77,55,40,0.5209880175994289,37
1792,107,12,94,7,0.5206364747602409,5
1793,86,14,34,7,0.5201415239407956,7
1794,104,36,95,17,0.5001729275119371,19
1795,107,22,38,10,0.49903482068084093,12
1796,75,13,27,5,0.4974930029627913,8
1797,114,34,104,18,0.4968214764130304,16
1798,95,28,74,13,0.47842550860281996,15
1799,88,28,75,15,0.47530286144516876,13
1800,18,21,88,9,0.47382956721093483,12
1801,7,50,60,26,0.47348705107057026,24
1802,20,19,2,9,0.46802771578138846,10
1803,31,33,7,15,0.464983563552205,18
1804,35,12,40,6,0.46270701875768405,6
1805,39,39,55,19,0.44589075584889887,20
1806,68,23,86,10,0.4454824181803146,13
1807,90,15,11,7,0.4409004522210816,8
1808,33,13,54,7,0.43670790689912964,6
1809,8,74,107,39,0.43526473064358406,35
1810,74,17,80,9,0.4324611679866122,8
1811,65,31,75,15,0.4168106708730313,16
1812,11,16,32,9,0.41605311029258796,7
1813,84,14,79,8,0.41419542722796737,6
1814,63,38,5,16,0.40800993583737216,22
1815,104,38,7,18,0.407060415049054,20
1816,107,45,51,24,0.4067088674204109,21
1817,28,71,16,36,0.4038581985222006,35
1818,114,24,60,10,0.3998336508197411,14
1819,99,14,104,8,0.39792129449437547,6
1820,18,22,87,11,0.396331636427475,11
1821,90,15,17,8,0.39476347822724994,7
1822,114,11,84,5,0.3934140776601028,6
1823,8,13,44,6,0.3904420875790005,7
1824,44,10,107,5,0.38493222335044347,5
1825,106,35,70,16,0.3799995965185726,19
1826,41,34,16,17,0.37202946782842305,17
1827,28,22,83,9,0.36492740395353174,13
1828,7,20,49,12,0.36023304009198776,8
1829,33,13,13,6,0.3582518771999595,7
1830,114,22,7,10,0.3486533356280044,12
1831,87,57,106,29,0.3434828808648843,28
1832,112,11,106,5,0.33737099377770785,6
1833,106,14,60,7,0.336939838579221,7
1834,54,25,84,13,0.33308077981097683,12
1835,76,20,11,9,0.3179380930289623,11
1836,100,14,13,7,0.31281355713139547,7
1837,16,39,70,18,0.3070972120099422,21
1838,50,47,86,25,0.30104953753715946,22
1839,70,49,86,23,0.28498345260667884,26
1840,37,13,39,7,0.28210005082695544,6
1841,67,12,25,6,0.2816428039469064,6
1842,114,11,76,6,0.2730224401145197,5
1843,63,33,11,14,0.27232059503922706,19
1844,74,38,54,18,0.2707426697250304,20
1845,40,41,86,18,0.2696078724260043,23
1846,1,18,107,9,0.2675172086968496,9
1847,84,11,17,5,0.26657119917942235,6
1848,28,23,76,12,0.2624094415845059,11
1849,33,11,96,7,0.2613811530785739,4
1850,28,18,71,8,0.2547312662987768,10
1851,95,40,5,21,0.25348100991507183,19
1852,104,23,70,11,0.24845959053171268,12
1853,65,26,50,13,0.2462354821363454,13
1854,95,27,25,14,0.24426390880142534,13
1855,30,10,108,5,0.24117256366227835,5
1856,39,27,54,14,0.2411407426172287,13
1857,47,13,13,7,0.23809942430747263,6
1858,18,13,60,7,0.2333478150647963,6
1859,106,32,51,16,0.2298821008875154,16
1860,28,32,51,17,0.22942654135968313,15
1861,114,15,73,8,0.22701369403263455,7
1862,11,40,87,22,0.22473431916089695,18
1863,114,25,20,12,0.21848473013005174,13
1864,114,39,25,18,0.2007103993314441,21
1865,91,16,68,7,0.19891329035935268,9
1866,106,69,8,32,0.1950573284676129,37
1867,14,14,106,6,0.19021668109411646,8
1868,20,11,104,5,0.18707180650761046,6
1869,35,11,70,6,0.18631436457958764,5
1870,37,13,62,8,0.17494933246516955,5
1871,39,28,104,14,0.1748605393390361,14
1872,33,13,95,6,0.16746373964834158,7
1873,53,18,106,8,0.16234006612035815,10
1874,57,20,37,10,0.16220303080862575,10
1875,16,19,33,8,0.15766880077552775,11
1876,57,16,86,8,0.15508905237468196,8
1877,11,25,74,12,0.15006666233224167,13
1878,69,14,51,7,0.14920558294134031,7
1879,65,13,43,5,0.14707048531237632,8
1880,40,32,39,15,0.144256549036331,17
1881,41,22,25,9,0.134750942385696,13
1882,50,16,34,8,0.13128791109247806,8
1883,93,17,107,8,0.12757170749762345,9
1884,74,21,2,11,0.11327187771293404,10
1885,88,14,73,8,0.11071484178267989,6
1886,87,57,5,28,0.10062627053374182,29
1887,63,20,114,9,0.09244039887809458,11
1888,79,15,16,7,0.0846210771917389,8
1889,11,27,39,14,0.08435132768700179,13
1890,65,22,11,12,0.08328669901936944,10
1891,109,17,97,8,0.072227519024473,9
1892,1,12,41,7,0.06956730370978459,5
1893,51,41,87,20,0.06646293648636259,21
1894,95,14,41,7,0.06115623663116419,7
1895,95,47,86,22,0.0533388813813724,25
1896,104,47,13,23,0.04192367949433417,24
1897,87,13,14,7,0.034291897518969265,6
1898,77,12,39,6,0.028576279160181645,6
1899,51,25,84,12,0.01096799308021332,13
1900,2,20,88,10,0.009580056392909242,10
1901,68,30,40,16,0.0080764800874891,14
1902,114,35,37,19,0.00622221621453757,16
1903,109,20,102,10,0.0026602667859183526,10
1904,99,25,55,13,0.0009906570474895915,12
1905,51,27,18,13,0.0007193374773444448,14
1906,18,27,51,14,-0.0007193374773441816,13
1907,55,25,99,12,-0.0009906570474892363,13
1908,102,20,109,10,-0.0026602667859165763,10
1909,37,35,114,16,-0.006222216214538382,19
1910,40,30,68,14,-0.008076480087489608,16
1911,88,20,2,10,-0.009580056392909242,10
1912,84,25,51,13,-0.01096799308021332,12
1913,39,12,77,6,-0.028576279160181645,6
1914,14,13,87,6,-0.034291897518968995,7
1915,13,47,104,24,-0.04192367949433599,23
1916,86,47,95,25,-0.053338881381371626,22
1917,41,14,95,7,-0.061156236631162826,7
1918,87,41,51,21,-0.06646293648636131,20
1919,41,12,1,5,-0.0695673037097837,7
1920,97,17,109,9,-0.07222751902447341,8
1921,11,22,65,10,-0.08328669901936994,12
1922,39,27,11,13,-0.08435132768700153,14
1923,16,15,79,8,-0.08462107719174033,7
1924,114,20,63,11,-0.09244039887809513,9
1925,5,57,87,29,-0.10062627053374157,28
1926,73,14,88,6,-0.11071484178267912,8
1927,2,21,74,10,-0.11327187771293505,11
1928,34,16,50,8,-0.13128791109247828,8
1929,25,22,41,13,-0.13475094238569565,9
1930,39,32,40,17,-0.1442565490363309,15
1931,43,13,65,8,-0.1470704853123769,5
1932,51,14,69,7,-0.14920558294134112,7
1933,74,25,11,13,-0.1500666623322408,12
1934,86,16,57,8,-0.15508905237468193,8
1935,33,19,16,11,-0.15766880077552733,8
1936,37,20,57,10,-0.162203030808627,10
1937,106,18,53,10,-0.16234006612035895,8
1938,95,13,33,7,-0.16746373964834213,6
1939,104,28,39,14,-0.17486053933903567,14
1940,62,13,37,5,-0.17494933246516897,8
1941,70,11,35,5,-0.18631436457958692,6
1942,104,11,20,6,-0.1870718065076108,5
1943,106,14,14,8,-0.19021668109411646,6
1944,8,69,106,37,-0.19505732846761326,32
1945,68,16,91,9,-0.19891329035935135,7
1946,25,39,114,21,-0.2007103993314442,18
1947,20,25,114,13,-0.21848473013005537,12
1948,87,40,11,18,-0.22473431916089676,22
1949,73,15,114,7,-0.22701369403263538,8
1950,51,32,28,15,-0.22942654135968277,17
1951,51,32,106,16,-0.22988210088751668,16
1952,60,13,18,6,-0.23334781506479574,7
1953,13,13,47,6,-0.23809942430747372,7
1954,54,27,39,13,-0.24114074261722843,14
1955,108,10,30,5,-0.24117256366227763,5
1956,25,27,95,13,-0.2442639088014252,14
1957,50,26,65,13,-0.24623548213634697,13
1958,70,23,104,12,-0.2484595905317144,11
1959,5,40,95,19,-0.253481009915071,21
1960,71,18,28,10,-0.2547312662987772,8
1961,96,11,33,4,-0.26138115307857424,7
1962,76,23,28,11,-0.2624094415845068,12
1963,17,11,84,6,-0.26657119917942235,5
1964,107,18,1,9,-0.2675172086968504,9
1965,86,41,40,23,-0.26960787242600365,18
1966,54,38,74,20,-0.27074266972503125,18
1967,11,33,63,19,-0.27232059503922706,14
1968,76,11,114,5,-0.2730224401145186,6
1969,25,12,67,6,-0.2816428039469064,6
1970,39,13,37,6,-0.28210005082695544,7
1971,86,49,70,26,-0.28498345260667907,23
1972,86,47,50,22,-0.3010495375371577,25
1973,70,39,16,21,-0.3070972120099418,18
1974,13,14,100,7,-0.31281355713139697,7
1975,84,25,54,12,-0.33308077981097556,13
1976,60,14,106,7,-0.336939838579221,7
1977,106,11,112,6,-0.33737099377770813,5
1978,106,57,87,28,-0.3434828808648838,29
1979,107,57,74,28,-0.34781875244302674,29
1980,7,22,114,12,-0.34865333562800416,10
1981,13,13,33,7,-0.3582518771999591,6
1982,49,20,7,8,-0.3602330400919879,12
1983,83,22,28,13,-0.36492740395353107,9
1984,16,34,41,17,-0.37202946782842294,17
1985,70,35,106,19,-0.37999959651857307,16
1986,107,10,44,5,-0.38493222335044386,5
1987,44,13,8,7,-0.3904420875789997,6
1988,84,11,114,6,-0.39341407766010245,5
1989,17,15,90,7,-0.39476347822725016,8
1990,87,22,18,11,-0.3963316364274748,11
1991,104,14,99,6,-0.39792129449437524,8
1992,60,24,114,14,-0.3998336508197404,10
1993,16,71,28,35,-0.4038581985222006,36
1994,51,45,107,21,-0.4067088674204111,24
1995,7,38,104,20,-0.4070604150490546,18
1996,5,38,63,22,-0.4080099358373725,16
1997,12,11,88,5,-0.4090282765032756,6
1998,79,14,84,6,-0.414195427227968,8
1999,32,16,11,7,-0.4160531102925862,9
2000,75,31,65,16,-0.4168106708730309,15
2001,80,17,74,8,-0.4324611679866118,9
2002,107,74,8,35,-0.43526473064358473,39
2003,54,13,33,6,-0.43670790689912903,7
2004,11,15,90,8,-0.4409004522210813,7
2005,86,23,68,13,-0.4454824181803151,10
2006,55,39,39,20,-0.4458907558489008,19
2007,40,12,35,6,-0.46270701875768433,6
2008,7,33,31,18,-0.4649835635522051,15
2009,2,19,20,10,-0.4680277157813875,9
2010,60,50,7,24,-0.4734870510705713,26
2011,88,21,18,12,-0.47382956721093483,9
2012,75,28,88,13,-0.47530286144516903,15
2013,74,28,95,15,-0.4784255086028221,13
2014,104,34,114,16,-0.4968214764130313,18
2015,27,13,75,8,-0.49749300296279125,5
2016,38,22,107,12,-0.49903482068084154,10
2017,95,36,104,19,-0.5001729275119376,17
2018,34,14,86,7,-0.5201415239407952,7
2019,94,12,107,5,-0.5206364747602409,7
2020,55,77,8,37,-0.5209880175994306,40
2021,9,18,55,9,-0.5222183978590039,9
2022,73,12,1,6,-0.5279151460001312,6
2023,46,20,76,10,-0.5281698257905821,10
2024,13,15,20,7,-0.529156040174666,8
2025,17,19,114,10,-0.5301119499866599,9
2026,107,23,98,12,-0.5449263063258661,11
2027,84,10,102,5,-0.5553239873070354,5
2028,25,22,17,11,-0.5587031515817824,11
2029,2,10,83,5,-0.559439726515081,5
2030,50,29,84,14,-0.5600416600783534,15
2031,2,30,97,16,-0.5614740846174444,14
2032,98,15,51,8,-0.5628250436058823,7
2033,75,16,41,8,-0.565449381163992,8
2034,100,22,106,12,-0.5684257462870971,10
2035,88,31,20,17,-0.5704944851473027,14
2036,53,28,65,16,-0.5740519391740124,12
2037,93,11,20,5,-0.5766686262962127,6
2038,96,17,2,9,-0.5793042045284422,8
2039,28,65,107,34,-0.5830983269262211,31
2040,4,13,87,6,-0.588885257444514,7
2041,75,34,55,15,-0.5893925674836225,19
2042,36,19,86,9,-0.5911010841978774,10
2043,93,17,97,9,-0.5934767161556219,8
2044,40,10,20,5,-0.600589719325777,5
2045,51,32,75,16,-0.6073440581538619,16
2046,107,40,106,21,-0.6086942385566221,19
2047,98,11,102,5,-0.6175099367937773,6
2048,49,12,63,6,-0.619485751515032,6
2049,5,62,107,31,-0.6252815058217575,31
2050,97,11,11,5,-0.626987447450576,6
2051,51,11,57,6,-0.6360005304092176,5
2052,68,24,107,13,-0.6364871522445631,11
2053,43,20,16,11,-0.6408960966953504,9
2054,50,16,98,8,-0.6426219058041119,8
2055,27,12,31,8,-0.6450919649382086,4
2056,46,53,88,27,-0.6457677667508949,26
2057,11,46,106,26,-0.6535108004818926,20
2058,15,15,23,8,-0.6735916899677633,7
2059,99,11,27,5,-0.6941577039356038,6
2060,11,40,50,21,-0.698118394633299,19
2061,30,15,76,7,-0.708134364255956,8
2062,84,30,88,14,-0.7084791071128513,16
2063,39,29,75,14,-0.710386630957576,15
2064,36,12,18,6,-0.7140101804629401,6
2065,8,52,70,26,-0.7145330447581052,26
2066,28,13,82,6,-0.7153587234866207,7
2067,107,29,90,15,-0.7206295892273683,14
2068,48,12,88,7,-0.7216286451594675,5
2069,11,47,8,26,-0.7230407809506088,21
2070,25,15,44,8,-0.7339941983900398,7
2071,37,30,65,14,-0.7390927440074138,16
2072,74,30,104,16,-0.7473029478332418,14
2073,48,27,28,14,-0.7484805696104441,13
2074,74,22,114,10,-0.7506194135084283,12
2075,60,43,77,22,-0.7542255805180188,21
2076,51,15,11,7,-0.7657848416746224,8
2077,104,33,106,18,-0.7665725528171268,15
2078,7,13,83,5,-0.7695159448560503,8
2079,104,15,33,7,-0.7704375614853106,8
2080,60,20,46,10,-0.7782430213526004,10
2081,84,17,65,8,-0.7808353432634698,9
2082,55,36,96,18,-0.7893581602386027,18
2083,60,22,8,12,-0.8056366298661101,10
2084,13,12,48,6,-0.808055554655042,6
2085,80,14,8,8,-0.8089658215861041,6
2086,50,39,106,21,-0.8096202630526154,18
2087,62,22,86,11,-0.813892951896531,11
2088,76,39,106,18,-0.8161691661592908,21
2089,17,14,49,8,-0.8168710470278943,6
2090,41,12,55,6,-0.8180588554995193,6
2091,90,14,25,7,-0.8193923685462242,7
2092,20,27,74,13,-0.8203305748765273,14
2093,25,37,74,19,-0.8204962979912087,18
2094,4,12,50,6,-0.821054422967209,6
2095,107,49,114,26,-0.8238569431031986,23
2096,60,15,83,7,-0.8249582076687048,8
2097,46,16,2,8,-0.8285194662826783,8
2098,68,15,64,9,-0.8290037423488801,6
2099,89,10,86,6,-0.8309374732906832,4
2100,106,39,76,22,-0.8387660623508122,17
2101,54,64,8,31,-0.8453996480922648,33
2102,51,13,49,7,-0.8502349206686404,6
2103,68,15,46,8,-0.8565592203009186,7
2104,16,60,25,31,-0.8584428289781936,29
2105,96,14,39,8,-0.8584786467987305,6
2106,8,11,27,5,-0.8585027849962465,6
2107,109,13,96,7,-0.8605479990683851,6
2108,114,10,10,6,-0.8617397018011254,4
2109,40,18,18,10,-0.8805030745356136,8
2110,53,16,55,9,-0.8816434712346433,7
2111,88,18,90,9,-0.8925647585085011,9
2112,46,31,107,15,-0.8942764168819444,16
2113,50,14,71,8,-0.8949040923055446,6
2114,65,15,18,7,-0.9097582893498202,8
2115,46,33,51,18,-0.911353828101423,15
2116,25,10,108,5,-0.9146750049457175,5
2117,74,18,18,10,-0.915799207906551,8
2118,31,14,88,7,-0.9277772630137004,7
2119,83,22,25,12,-0.9290503981463769,10
2120,93,32,8,16,-0.9298196160455592,16
2121,41,36,88,18,-0.931983482233731,18
2122,8,12,49,7,-0.934404378662043,5
2123,39,13,43,8,-0.9397651908861313,5
2124,86,38,30,20,-0.9407202047224418,18
2125,107,24,91,13,-0.9408438298942093,11
2126,55,12,18,7,-0.942418191636556,5
2127,76,20,37,9,-0.9426294102072454,11
2128,65,31,8,15,-0.9484938734547224,16
2129,74,38,87,20,-0.9489215682392524,18
2130,47,13,88,7,-0.9496252385196459,6
2131,25,27,63,15,-0.9527168084783868,12
2132,5,14,14,8,-0.9561035605846475,6
2133,87,44,96,22,-0.9639736076499452,22
2134,12,10,107,4,-0.9798393160313011,6
2135,80,13,104,6,-0.9861315816908558,7
2136,28,67,106,35,-0.9916026418837889,32
2137,71,10,109,5,-0.9970275319814981,5
2138,70,22,20,11,-1.00377795376817,11
2139,55,30,60,16,-1.0068325257396056,14
2140,78,10,60,6,-1.0077900317025854,4
2141,95,29,87,15,-1.0109411688585377,14
2142,80,23,20,12,-1.0138169865719233,11
2143,88,20,93,11,-1.013881838292134,9
2144,68,23,87,12,-1.0190463084335872,11
2145,33,10,70,5,-1.0222975969230645,5
2146,80,17,87,9,-1.023110569915149,8
2147,46,16,114,9,-1.0425155794457348,7
2148,74,11,88,7,-1.0435584336015389,4
2149,28,16,33,7,-1.0436942408383059,9
2150,106,40,107,20,-1.0462409899534795,20
2151,49,24,16,13,-1.0511839451073195,11
2152,7,35,9,19,-1.0539792889091701,16
2153,20,14,39,6,-1.0673965411691182,8
2154,107,59,84,30,-1.06846180452473,29
2155,37,20,67,11,-1.0707700527635244,9
2156,46,26,87,12,-1.0717269946555545,14
2157,28,10,49,6,-1.0717317502989343,4
2158,55,33,83,16,-1.0771475436917033,17
2159,40,23,87,12,-1.0787245790125717,11
2160,16,30,90,17,-1.0864509647505376,13
2161,107,20,18,11,-1.0876334119792432,9
2162,20,67,86,35,-1.090808542947844,32
2163,109,16,83,7,-1.0939664342434439,9
2164,54,47,5,25,-1.094436857117606,22
2165,74,57,107,30,-1.0972534237415095,27
2166,5,16,53,9,-1.1100089939054691,7
2167,36,22,65,12,-1.1134691556638003,10
2168,5,39,13,20,-1.1249218143526365,19
2169,7,53,107,29,-1.126192275510306,24
2170,48,14,20,8,-1.1319086574299342,6
2171,73,11,50,7,-1.1481239853473426,4
2172,65,45,55,22,-1.1488867924519452,23
2173,8,40,2,20,-1.1594572352270007,20
2174,68,13,54,7,-1.1603728149056827,6
2175,28,14,57,7,-1.181209603674041,7
2176,109,25,25,13,-1.1927554377225942,12
2177,74,31,97,16,-1.194748531335217,15
2178,40,11,106,6,-1.2113951648017518,5
2179,65,35,74,18,-1.2209595926965924,17
2180,98,19,54,10,-1.2379162985927636,9
2181,84,19,109,10,-1.2452486060748378,9
2182,7,12,30,7,-1.248177708098501,5
2183,78,14,86,8,-1.2581466617600445,6
2184,30,18,51,9,-1.2591099162694146,9
2185,14,13,65,6,-1.259382814831276,7
2186,73,18,28,10,-1.2674667464036864,8
2187,96,37,84,18,-1.2684027154450674,19
2188,76,10,62,5,-1.2686993930037296,5
2189,55,41,87,22,-1.2726321489984769,19
2190,37,34,17,16,-1.272737546498424,18
2191,65,65,16,34,-1.301413833906276,31
2192,4,18,88,10,-1.3015744562518974,8
2193,102,10,70,4,-1.3043211125718082,6
2194,8,16,10,9,-1.3145513780375313,7
2195,37,66,8,34,-1.3357403383797612,32
2196,90,17,84,9,-1.3434141546201466,8
2197,28,17,79,9,-1.3443965025775715,8
2198,88,39,106,22,-1.3446969565030102,17
2199,18,10,98,6,-1.3471084627969787,4
2200,40,38,60,20,-1.3493805696053502,18
2201,13,30,4,16,-1.3543099508977632,14
2202,13,13,111,6,-1.3589509075541066,7
2203,17,29,51,16,-1.3591705652702633,13
2204,30,26,25,12,-1.3633847180345777,14
2205,107,58,54,30,-1.36386289842418,28
2206,75,13,97,6,-1.365095248526459,7
2207,40,24,53,12,-1.3660456737747542,12
2208,39,24,41,13,-1.3694981081138706,11
2209,76,11,90,5,-1.371109786983603,6
2210,85,18,86,9,-1.3738528392472158,9
2211,50,13,97,6,-1.3748102351512186,7
2212,112,10,104,5,-1.3794403907953843,5
2213,28,48,11,24,-1.3816823064618546,24
2214,12,12,39,6,-1.3850490174415748,6
2215,97,19,83,9,-1.386098350195291,10
2216,51,50,55,27,-1.3928808354786235,23
2217,23,17,95,8,-1.3963563173964137,9
2218,84,27,55,14,-1.3965203244162752,13
2219,11,15,102,9,-1.4114820984859553,6
2220,98,10,74,5,-1.417749699278812,5
2221,110,14,106,7,-1.425859572556296,7
2222,54,12,91,6,-1.4331424659599221,6
2223,40,13,70,7,-1.4361799475699388,6
2224,76,19,98,11,-1.4493678922731097,8
2225,65,44,28,24,-1.4603377305503498,20
2226,13,12,108,7,-1.462209064713119,5
2227,89,14,28,8,-1.4639788382157586,6
2228,65,32,39,15,-1.4681800474902618,17
2229,16,28,20,16,-1.4722421968299606,12
2230,112,11,63,5,-1.4854774169813643,6
2231,106,16,102,8,-1.4908896648943564,8
2232,65,52,104,27,-1.4929358228195102,25
2233,104,23,98,14,-1.5012467734084751,9
2234,9,13,70,7,-1.5045631213076247,6
2235,36,13,51,6,-1.509572027592031,7
2236,55,12,46,7,-1.514859018089955,5
2237,2,17,16,9,-1.5157503924432272,8
2238,109,45,86,23,-1.5171061127611198,22
2239,4,11,39,6,-1.520515328163129,5
2240,37,14,35,7,-1.523131742310598,7
2241,83,19,106,11,-1.531176804791276,8
2242,79,11,107,5,-1.5337921396437189,6
2243,28,84,86,45,-1.5371508387010575,39
2244,17,19,8,9,-1.5403077254917807,10
2245,83,23,104,13,-1.5563880557352991,10
2246,63,16,44,8,-1.557146397154433,8
2247,39,16,91,9,-1.5585564291442864,7
2248,86,88,106,45,-1.5603498963910098,43
2249,90,11,70,6,-1.5691735166520102,5
2250,80,18,84,10,-1.5709420282215925,8
2251,50,24,17,12,-1.5721280575642353,12
2252,25,15,2,7,-1.5845186001024019,8
2253,39,23,95,12,-1.5861677629693829,11
2254,97,15,87,9,-1.5955525726894844,6
2255,107,21,34,12,-1.6030565634408767,9
2256,81,10,104,4,-1.6058410210160257,6
2257,70,25,63,13,-1.612262611699524,12
2258,16,43,23,23,-1.613216501690873,20
2259,111,10,18,5,-1.614134557742986,5
2260,88,49,55,27,-1.6154630922330873,22
2261,13,52,65,26,-1.619815567475023,26
2262,9,11,34,5,-1.6242149298552002,6
2263,39,28,28,15,-1.6366440889671883,13
2264,68,47,13,24,-1.653534001312979,23
2265,60,28,107,15,-1.6582323453541967,13
2266,109,11,32,5,-1.666013339769578,6
2267,70,31,107,16,-1.6685978034904543,15
2268,5,15,77,8,-1.671856388698709,7
2269,97,24,114,13,-1.6750618167368516,11
2270,73,14,96,7,-1.6753693979758282,7
2271,96,29,76,16,-1.676273070644297,13
2272,33,14,86,8,-1.695644515086867,6
2273,41,10,46,6,-1.7055763851805168,4
2274,76,13,84,7,-1.710890300241341,6
2275,85,10,74,5,-1.7134982697618457,5
2276,88,30,60,18,-1.7140409435327881,12
2277,28,25,95,14,-1.7143083531485501,11
2278,68,32,88,18,-1.7171070398474242,14
2279,39,41,25,21,-1.726583139136132,20
2280,11,13,60,6,-1.729783938603551,7
2281,75,19,70,9,-1.7314858975507368,10
2282,9,16,36,9,-1.7330765981964604,7
2283,60,19,36,10,-1.7363741266115724,9
2284,63,56,107,27,-1.7429188660610804,29
2285,70,26,84,14,-1.7530345342228948,12
2286,39,23,36,11,-1.7649867845594949,12
2287,4,26,7,13,-1.7757689326218213,13
2288,68,21,41,10,-1.7763568577637876,11
2289,107,56,96,31,-1.778106151539944,25
2290,16,23,48,13,-1.7794429962560583,10
2291,90,25,37,13,-1.7816453937181784,12
2292,27,34,13,18,-1.7885937020568976,16
2293,40,14,41,6,-1.7937189898742463,8
2294,37,20,2,10,-1.7943143656917857,10
2295,16,49,104,25,-1.794859812655941,24
2296,60,26,87,14,-1.7993355932005026,12
2297,28,64,8,35,-1.8060421386611965,29
2298,99,13,102,7,-1.8212893413036864,6
2299,51,46,37,22,-1.8410186071468577,24
2300,106,24,109,12,-1.8438625812895593,12
2301,114,18,50,10,-1.8469975740050815,8
2302,16,27,114,13,-1.8471183538717209,14
2303,106,12,34,7,-1.848042404417825,5
2304,40,13,31,7,-1.8498904789305148,6
2305,88,19,83,9,-1.8504010929562806,10
2306,55,56,86,29,-1.850582022571885,27
2307,31,15,51,9,-1.8557010320017515,6
2308,84,17,2,9,-1.859443252903194,8
2309,5,95,37,49,-1.865428870342572,46
2310,28,44,37,24,-1.8670737685584557,20
2311,17,13,74,7,-1.8676704113074127,6
2312,76,15,20,7,-1.871704245089016,8
2313,9,26,28,13,-1.8734362107646296,13
2314,37,18,98,9,-1.8817953145609947,9
2315,74,48,16,26,-1.8818651609735453,22
2316,64,15,25,8,-1.887558390966997,7
2317,96,49,5,27,-1.889094828391433,22
2318,91,26,5,15,-1.8922517003046981,11
2319,88,41,87,21,-1.8938761253475078,20
2320,71,10,114,6,-1.8941331560457335,4
2321,107,19,111,9,-1.8958566397093317,10
2322,86,21,49,11,-1.8976322802746393,10
2323,108,14,74,7,-1.8987503296630384,7
2324,39,17,70,8,-1.9157212262198098,9
2325,7,15,1,7,-1.9162712570705793,8
2326,96,14,30,7,-1.9170201840499566,7
2327,76,11,99,5,-1.9173589523208336,6
2328,86,32,23,18,-1.9182051181478563,14
2329,75,10,112,5,-1.9289326018714505,5
2330,84,30,87,16,-1.9310332903828082,14
2331,57,15,25,8,-1.9367936004868347,7
2332,7,20,54,10,-1.9447372983062394,10
2333,4,16,77,9,-1.9468657789376955,7
2334,47,15,75,9,-1.9532622296516962,6
2335,51,41,8,22,-1.9688998977328516,19
2336,75,12,2,7,-1.9694128550530146,5
2337,54,59,50,31,-1.97789191282363,28
2338,87,11,6,6,-1.9839334145784238,5
2339,35,10,84,5,-1.996508314062219,5
2340,11,38,46,21,-1.9985912350445674,17
2341,99,10,33,5,-1.9995697947435764,5
2342,71,22,13,11,-2.005517037619783,11
2343,68,32,111,16,-2.012666174495878,16
2344,39,12,111,6,-2.0153993087738304,6
2345,86,61,65,33,-2.016493664072043,28
2346,64,20,7,10,-2.0193435018616697,10
2347,90,36,8,20,-2.01946478207178,16
2348,70,24,76,13,-2.0205668013908817,11
2349,73,12,55,6,-2.024829564390717,6
2350,70,14,13,8,-2.0323282225360066,6
2351,15,16,99,9,-2.037516885099592,7
2352,60,24,90,14,-2.039727571926182,10
2353,30,15,50,8,-2.046419507298431,7
2354,106,13,9,7,-2.060718850116027,6
2355,112,11,50,6,-2.062900404606131,5
2356,106,30,97,15,-2.0644256996528543,15
2357,98,21,16,11,-2.0672287007178314,10
2358,63,26,97,14,-2.0694495254936975,12
2359,25,26,50,13,-2.0720055901853556,13
2360,46,15,57,8,-2.074703746609149,7
2361,63,10,82,5,-2.0779758612966877,5
2362,88,10,78,5,-2.085036247241552,5
2363,109,12,75,7,-2.0863708847947433,5
2364,20,31,88,15,-2.0865737097726504,16
2365,31,16,75,8,-2.0875569597811383,8
2366,18,14,8,7,-2.0890500090658657,7
2367,8,22,97,11,-2.094799206270941,11
2368,5,62,28,32,-2.10037433995057,30
2369,63,22,7,10,-2.108294344937298,12
2370,30,13,48,6,-2.114145406665778,7
2371,84,15,25,8,-2.118395686595601,7
2372,90,29,107,15,-2.1196846881008575,14
2373,89,10,41,5,-2.1249948420964526,5
2374,109,25,104,13,-2.1264175418400826,12
2375,33,15,8,9,-2.1294027544913625,6
2376,109,12,53,7,-2.1301547013759294,5
2377,88,23,53,13,-2.138168696621837,10
2378,106,14,73,7,-2.1399583589315894,7
2379,13,50,16,27,-2.1401141705570708,23
2380,50,16,109,8,-2.1420450648202096,8
2381,86,83,16,46,-2.142098668447526,37
2382,104,19,53,10,-2.1450025037605402,9
2383,49,11,65,6,-2.145737587122752,5
2384,87,19,2,10,-2.1505411632732674,9
2385,40,10,28,5,-2.1553702086165254,5
2386,29,10,23,5,-2.1610971150686176,5
2387,86,44,13,25,-2.175174771531292,19
2388,57,11,104,4,-2.1780874103759786,7
2389,74,64,8,36,-2.1866220406514896,28
2390,11,18,13,10,-2.1907015938393695,8
2391,7,17,74,7,-2.1916372729995834,10
2392,14,11,96,6,-2.19268862994012,5
2393,17,21,106,12,-2.1959594385945422,9
2394,48,23,8,13,-2.2004165749645987,10
2395,65,14,77,7,-2.2011849181716925,7
2396,84,24,37,13,-2.2012234645498956,11
2397,40,25,63,13,-2.2072581236946376,12
2398,2,28,86,14,-2.2092021993038244,14
2399,8,11,112,5,-2.214468435350456,6
2400,23,19,75,9,-2.2146834506449893,10
2401,107,53,88,30,-2.217360415761429,23
2402,100,16,28,9,-2.2255414738387724,7
2403,8,23,76,12,-2.2293930206952894,11
2404,74,27,20,15,-2.230377352624161,12
2405,86,81,63,46,-2.2518352832097666,35
2406,90,40,86,22,-2.252009765285282,18
2407,28,34,46,20,-2.254966612496791,14
2408,96,66,28,35,-2.2674069446039327,31
2409,39,42,7,23,-2.282728184705352,19
2410,81,13,86,8,-2.283313324562978,5
2411,96,36,106,20,-2.2984565902488896,16
2412,38,20,86,11,-2.3173947721062502,9
2413,65,54,7,26,-2.320503461426607,28
2414,51,25,50,13,-2.3323232012179407,12
2415,43,11,37,7,-2.33260542076611,4
2416,11,12,33,5,-2.336303729576231,7
2417,55,12,4,7,-2.336920819390133,5
2418,55,13,71,6,-2.3436435297521294,7
2419,18,12,4,7,-2.3471024733316344,5
2420,27,11,23,6,-2.360189511713131,5
2421,109,14,48,8,-2.3615030071790217,6
2422,5,23,99,12,-2.3616219022642833,11
2423,25,20,15,12,-2.380758889536655,8
2424,68,38,65,21,-2.3895840201765175,17
2425,8,12,111,6,-2.390343846489093,6
2426,109,20,20,12,-2.3908375286297607,8
2427,84,14,93,8,-2.3958694367553792,6
2428,55,14,64,7,-2.3960526203970383,7
2429,86,19,99,11,-2.400382898068693,8
2430,70,17,25,9,-2.4059439548438926,8
2431,86,13,110,7,-2.4084031140746323,6
2432,107,19,9,11,-2.408448432109207,8
2433,50,39,87,20,-2.409042415929656,19
2434,87,92,86,45,-2.410474151921404,47
2435,88,10,81,5,-2.411097045225806,5
2436,18,11,43,5,-2.4128380364549287,6
2437,4,11,86,6,-2.41302429419825,5
2438,99,11,109,6,-2.419517402501058,5
2439,99,21,87,12,-2.432411032680885,9
2440,97,17,20,9,-2.4355837212433706,8
2441,50,10,32,4,-2.4440541907162716,6
2442,5,48,46,27,-2.452279517290662,21
2443,49,14,54,7,-2.454208065190869,7
2444,68,20,104,11,-2.460733719128008,9
2445,88,65,8,35,-2.4612917000372785,30
2446,60,41,13,24,-2.4669231276518238,17
2447,20,39,8,21,-2.4774464429650904,18
2448,13,34,49,17,-2.481881382117498,17
2449,49,16,87,7,-2.4853547789713173,9
2450,75,29,13,16,-2.49299305456957,13
2451,109,18,37,10,-2.5010134043415313,8
2452,37,55,107,30,-2.511119120051266,25
2453,90,21,55,10,-2.5152743292271547,11
2454,87,14,36,7,-2.5281752879458814,7
2455,109,16,76,9,-2.5285469015591193,7
2456,88,29,23,17,-2.540026263891151,12
2457,95,15,63,8,-2.5575094114278856,7
2458,63,10,83,4,-2.557624644664858,6
2459,69,10,11,6,-2.5690379571615622,4
2460,28,24,80,13,-2.570555603447683,11
2461,5,23,39,12,-2.597769813737307,11
2462,53,25,39,15,-2.5982632103595353,10
2463,29,13,16,6,-2.5988854221001265,7
2464,76,10,34,5,-2.6159550332149113,5
2465,7,14,15,7,-2.6229324561632237,7
2466,31,13,107,5,-2.623526254499472,8
2467,36,13,114,8,-2.625677047341876,5
2468,5,60,16,35,-2.643518445682432,25
2469,17,15,4,9,-2.6508612974233428,6
2470,8,24,30,13,-2.6514132136935475,11
2471,5,47,109,24,-2.6519452143647766,23
2472,25,36,28,21,-2.653080526503112,15
2473,53,26,16,14,-2.6570935949339445,12
2474,91,13,74,7,-2.658254293210725,6
2475,35,15,11,8,-2.6584025807809044,7
2476,27,10,71,6,-2.670336561327749,4
2477,8,27,71,14,-2.679194401362514,13
2478,46,23,97,12,-2.6830528559454945,11
2479,68,23,63,13,-2.6900034566263815,10
2480,39,31,63,19,-2.7037597623864276,12
2481,95,33,54,17,-2.704616189962661,16
2482,80,11,95,6,-2.7197438471090796,5
2483,16,25,97,12,-2.7225048293039347,13
2484,18,22,41,12,-2.7225455466169386,10
2485,68,15,106,8,-2.7239391329930007,7
2486,75,23,36,11,-2.724109709877128,12
2487,54,42,87,24,-2.7276096437522535,18
2488,51,22,53,11,-2.741110504967257,11
2489,84,16,14,9,-2.744202009506241,7
2490,55,18,25,10,-2.748785644454604,8
2491,9,16,51,8,-2.7534552832198247,8
2492,11,15,14,9,-2.753683750814255,6
2493,106,29,7,14,-2.7541564496724003,15
2494,48,14,65,8,-2.7586384168294438,6
2495,107,44,11,24,-2.75870917523516,20
2496,10,11,5,5,-2.7716738654503192,6
2497,53,17,25,9,-2.774786838502579,8
2498,104,36,8,19,-2.7794749735414097,17
2499,107,65,87,35,-2.7800863205063164,30
2500,37,45,20,24,-2.7863088238660243,21
2501,13,13,44,7,-2.7973580079711726,6
2502,50,15,79,9,-2.7998338113931363,6
2503,18,18,104,11,-2.8046551455186632,7
2504,41,15,99,8,-2.808167291861728,7
2505,74,22,75,13,-2.809934258633541,9
2506,34,13,63,7,-2.81000032908768,6
2507,29,13,7,6,-2.8153327011944786,7
2508,31,10,41,6,-2.8187229086868015,4
2509,63,18,46,9,-2.822734192092329,9
2510,46,41,86,23,-2.830781053281953,18
2511,25,22,23,12,-2.8322220847423263,10
2512,57,21,87,12,-2.842460195115371,9
2513,13,18,109,11,-2.8426763674639637,7
2514,38,17,63,10,-2.8438368509015834,7
2515,63,37,87,19,-2.8662395111624996,18
2516,97,29,25,16,-2.8703843075225346,13
2517,16,35,30,20,-2.8892969028129025,15
2518,37,19,91,10,-2.9050960547005253,9
2519,51,15,14,9,-2.9073721712530443,6
2520,98,12,97,7,-2.9183345258744953,5
2521,65,15,99,8,-2.925348959200731,7
2522,95,18,20,10,-2.9442775418414966,8
2523,17,28,86,14,-2.94742778634219,14
2524,50,16,7,8,-2.948988195369652,8
2525,88,16,62,9,-2.959487921171801,7
2526,16,42,95,22,-2.960784285924195,20
2527,95,11,15,6,-2.9708859793353706,5
2528,84,12,10,7,-2.980259678929739,5
2529,28,16,23,8,-2.982809086991735,8
2530,63,15,13,9,-2.9904556427756623,6
2531,63,49,106,26,-2.99417254272717,23
2532,102,12,97,7,-2.99432300504723,5
2533,88,32,11,17,-2.9946510109147497,15
2534,5,59,104,31,-2.9970663239960813,28
2535,104,10,92,6,-3.0134221531662972,4
2536,41,24,51,13,-3.028997449769268,11
2537,84,15,75,8,-3.0305846141219575,7
2538,48,21,84,12,-3.0347277834877144,9
2539,96,13,38,7,-3.0422152322461713,6
2540,36,32,40,19,-3.047007600783558,13
2541,97,13,51,7,-3.049621553627841,6
2542,88,28,96,14,-3.0532343196114025,14
2543,51,41,88,22,-3.0561971156136902,19
2544,55,14,48,8,-3.0636269177668387,6
2545,109,22,51,13,-3.0637424929258525,9
2546,80,10,7,5,-3.066766313123115,5
2547,91,27,28,15,-3.0909280045200798,12
2548,54,22,17,11,-3.09293116749158,11
2549,68,14,99,8,-3.100103615084465,6
2550,44,13,65,6,-3.103105872794513,7
2551,88,32,114,17,-3.1042645777828377,15
2552,87,16,71,8,-3.114412062051744,8
2553,88,23,97,12,-3.121971276313456,11
2554,54,11,15,6,-3.1252951216765847,5
2555,104,27,76,15,-3.1362490008683896,12
2556,41,23,106,12,-3.1581866655257085,11
2557,74,14,90,9,-3.168061351028922,5
2558,9,19,13,11,-3.1701751167315524,8
2559,68,29,39,14,-3.1726546432041536,15
2560,46,37,13,20,-3.1729042481938046,17
2561,106,38,55,22,-3.1832515090410007,16
2562,13,24,99,13,-3.1869164042235187,11
2563,54,69,86,37,-3.1888799872804525,32
2564,50,39,16,22,-3.189499878428379,17
2565,25,59,86,31,-3.195465833963126,28
2566,39,22,71,12,-3.1962994910533795,10
2567,8,71,86,37,-3.196385224742072,34
2568,71,22,7,13,-3.1990697606245018,9
2569,75,10,100,6,-3.2132507505539607,4
2570,30,16,99,9,-3.213327358649565,7
2571,18,16,25,10,-3.2198145252234087,6
2572,88,11,14,6,-3.2206098277423347,5
2573,16,16,6,8,-3.2224774739630373,8
2574,74,11,12,6,-3.2267097800337137,5
2575,97,11,23,6,-3.2361653104272836,5
2576,54,14,85,8,-3.239753980711634,6
2577,20,25,11,15,-3.245274337075932,10
2578,87,25,23,14,-3.24996068585063,11
2579,63,10,30,6,-3.254074696673354,4
2580,84,72,86,36,-3.2610166651310077,36
2581,93,14,70,8,-3.2714518634318708,6
2582,50,34,63,19,-3.274415048364832,15
2583,67,13,114,7,-3.274670651234843,6
2584,54,14,23,8,-3.29756231936452,6
2585,88,33,49,18,-3.298926452178331,15
2586,107,38,13,20,-3.3016013396204547,18
2587,8,66,16,37,-3.30452190211764,29
2588,70,10,49,6,-3.304597327795695,4
2589,95,16,70,8,-3.3075112398485507,8
2590,88,13,76,6,-3.318537943308137,7
2591,97,18,70,9,-3.327552349585108,9
2592,41,42,65,25,-3.335919983694096,17
2593,33,13,75,8,-3.342736023465549,5
2594,107,11,81,6,-3.347004989697289,5
2595,9,10,20,6,-3.353443346624384,4
2596,63,61,65,33,-3.3604398706518057,28
2597,17,23,16,14,-3.3619063804529947,9
2598,8,23,14,13,-3.3634201583462153,10
2599,11,11,40,6,-3.369415894204819,5
2600,37,16,80,9,-3.3888912531414834,7
2601,9,20,75,10,-3.3902783860400745,10
2602,60,30,51,18,-3.4081984536935317,12
2603,114,22,54,11,-3.415804771482276,11
2604,100,21,8,12,-3.4169007429532634,9
2605,32,17,86,9,-3.4193017987895304,8
2606,109,25,87,15,-3.438248375396607,10
2607,104,31,87,16,-3.438412759763362,15
2608,102,10,75,6,-3.4391155267314995,4
2609,106,45,54,23,-3.4398860335023413,22
2610,57,15,97,8,-3.44354434668938,7
2611,40,11,114,7,-3.4534135965890287,4
2612,5,23,33,12,-3.454327509177194,11
2613,15,22,16,13,-3.4699236009719012,9
2614,65,28,70,17,-3.478419403846197,11
2615,65,11,62,6,-3.4832054319840005,5
2616,65,15,109,10,-3.4929763691198903,5
2617,54,30,104,16,-3.494678026548527,14
2618,36,26,16,14,-3.50513798130426,12
2619,84,15,91,8,-3.5069437670955055,7
2620,51,24,70,12,-3.51020506286295,12
2621,46,21,20,13,-3.51090539647306,8
2622,41,40,13,23,-3.512668287492903,17
2623,107,28,41,16,-3.5161993726739245,12
2624,63,50,16,28,-3.5170545451196125,22
2625,17,21,13,12,-3.5184767499063994,9
2626,110,10,87,6,-3.5295519129657293,4
2627,11,20,76,12,-3.545061788623662,8
2628,95,10,97,6,-3.58943247133478,4
2629,98,19,28,12,-3.593034409386323,7
2630,39,11,48,6,-3.594601769104413,5
2631,54,57,65,31,-3.6004562624013,26
2632,16,16,4,8,-3.6085337507502016,8
2633,49,31,39,18,-3.6339229541842206,13
2634,37,20,30,12,-3.640395609700316,8
2635,7,18,8,9,-3.6556475795095196,9
2636,50,10,62,6,-3.6657345895143245,4
2637,88,10,79,6,-3.6658466896877493,4
2638,106,31,20,18,-3.6670765571458195,13
2639,96,53,8,30,-3.668741625247303,23
2640,107,23,71,13,-3.6749979694495467,10
2641,11,41,55,25,-3.6751670322630714,16
2642,107,74,86,40,-3.678227546478233,34
2643,84,20,46,12,-3.686829488531012,8
2644,87,11,78,5,-3.6913711385920154,6
2645,54,48,16,27,-3.695210707305645,21
2646,106,12,36,7,-3.696145457940849,5
2647,50,14,89,7,-3.697778125616005,7
2648,102,28,28,15,-3.699783063019897,13
2649,108,11,75,6,-3.7003402274374064,5
2650,5,59,74,32,-3.715039739995446,27
2651,107,25,95,13,-3.721321768434082,12
2652,88,16,43,9,-3.7275454144235036,7
2653,39,23,18,13,-3.734552544954449,10
2654,80,19,16,10,-3.734863526774762,9
2655,76,16,97,8,-3.7370860130894323,8
2656,54,24,80,13,-3.764211904739149,11
2657,55,53,13,29,-3.779737805498598,24
2658,68,11,71,6,-3.8071954572931124,5
2659,65,32,23,17,-3.807595873030597,15
2660,5,16,110,9,-3.8138584796050923,7
2661,86,31,60,18,-3.8143484694524363,13
2662,86,21,9,13,-3.818397672909285,8
2663,28,19,30,11,-3.8298077885882953,8
2664,50,13,108,8,-3.8299657646620924,5
2665,8,27,83,14,-3.8382150032056903,13
2666,3,11,28,7,-3.8388007621981854,4
2667,37,17,41,10,-3.8456182281056206,7
2668,9,13,18,8,-3.857789755331762,5
2669,75,21,106,10,-3.8605003548235586,11
2670,5,10,31,6,-3.8620843453498637,4
2671,65,24,83,13,-3.865031238776082,11
2672,18,15,54,8,-3.870411168392848,7
2673,104,24,96,14,-3.8706241075776626,10
2674,106,38,65,22,-3.8848144247957204,16
2675,16,46,11,28,-3.895324389083474,18
2676,50,18,40,11,-3.8974094453974306,7
2677,51,37,54,20,-3.900510354202894,17
2678,63,27,104,15,-3.900588527290143,12
2679,37,26,102,15,-3.901578428361024,11
2680,107,23,100,11,-3.905880206645992,12
2681,10,11,97,5,-3.9207678088340043,6
2682,2,28,5,16,-3.923277825320168,12
2683,106,18,71,10,-3.925016935496231,8
2684,77,13,41,8,-3.9281873956506344,5
2685,31,24,60,12,-3.9299111713961628,12
2686,62,23,16,14,-3.9335260397440606,9
2687,83,10,102,6,-3.9358085201394077,4
2688,97,10,80,6,-3.9365866928471034,4
2689,87,10,27,5,-3.9487097970098004,5
2690,39,10,33,6,-3.9525968008389256,4
2691,93,24,74,13,-3.960101768879081,11
2692,69,12,37,7,-3.9709549460906977,5
2693,13,11,14,7,-3.983254255856211,4
2694,88,27,27,13,-3.9972856820177034,14
2695,65,34,25,20,-3.9982069365892623,14
2696,33,11,90,7,-4.003292593732326,4
2697,50,39,104,23,-4.003544531354558,16
2698,86,32,114,19,-4.012219023441155,13
2699,36,11,4,5,-4.015751207559498,6
2700,98,19,7,11,-4.025055128919854,8
2701,11,13,7,7,-4.026372584132108,6
2702,74,44,37,24,-4.033137310869005,20
2703,28,33,13,19,-4.033447367470073,14
2704,28,13,35,7,-4.0366654617090365,6
2705,53,12,31,8,-4.036895112605022,4
2706,65,27,97,15,-4.0425316972143985,12
2707,79,13,11,6,-4.047561716338114,7
2708,9,26,88,15,-4.050279879066775,11
2709,8,30,50,15,-4.053798361230284,15
2710,46,14,83,7,-4.055902658620627,7
2711,6,13,44,8,-4.067061192837313,5
2712,54,53,96,28,-4.06814127330106,25
2713,68,10,55,6,-4.068409910261688,4
2714,64,16,87,9,-4.069370019115816,7
2715,40,45,13,25,-4.070678505144182,20
2716,60,27,65,17,-4.091828639618688,10
2717,93,20,83,11,-4.100880722204593,9
2718,25,26,87,14,-4.102463690405522,12
2719,65,22,80,13,-4.111273433332231,9
2720,62,13,13,7,-4.12743151741627,6
2721,67,13,86,7,-4.131604740801435,6
2722,41,12,57,8,-4.133697879237449,4
2723,28,11,60,5,-4.140072047282161,6
2724,55,10,62,5,-4.140553518041587,5
2725,73,13,20,8,-4.146065391689571,5
2726,60,33,39,18,-4.147435206322398,15
2727,33,11,74,6,-4.152065435529707,5
2728,60,14,5,8,-4.1550252161435335,6
2729,87,12,94,6,-4.161620639809543,6
2730,28,40,87,22,-4.161796757953555,18
2731,8,25,13,14,-4.16945465200299,11
2732,75,29,28,17,-4.173159235209231,12
2733,93,28,65,15,-4.184071657822707,13
2734,43,20,13,11,-4.1939425294672406,9
2735,107,38,75,25,-4.210484241736752,13
2736,7,14,43,8,-4.2121158043505496,6
2737,51,14,43,8,-4.21319024969075,6
2738,5,58,88,32,-4.221472474474537,26
2739,63,27,75,15,-4.221533861130908,12
2740,37,31,88,18,-4.224270631924043,13
2741,86,75,74,41,-4.224929805302094,34
2742,25,15,71,8,-4.22821184042616,7
2743,84,11,30,7,-4.231660063143013,4
2744,36,16,1,8,-4.252120858936726,8
2745,106,23,95,14,-4.253879576018551,9
2746,96,35,20,20,-4.257594587954791,15
2747,12,11,74,6,-4.2613914965588835,5
2748,55,29,7,16,-4.275176259613076,13
2749,25,24,75,14,-4.277372987760686,10
2750,39,19,27,9,-4.301216458066537,10
2751,55,38,37,20,-4.301606273781788,18
2752,13,26,74,15,-4.30603818747095,11
2753,54,23,93,14,-4.30725130512391,9
2754,27,11,6,6,-4.320589105702402,5
2755,88,21,30,11,-4.322600096754097,10
2756,28,37,55,23,-4.325384868124247,14
2757,106,33,84,17,-4.32801946762649,16
2758,9,21,8,10,-4.328036483452339,11
2759,55,21,111,12,-4.328392793748101,9
2760,114,23,102,14,-4.331076584650545,9
2761,82,20,86,12,-4.3319380690325975,8
2762,107,47,65,28,-4.343893220603634,19
2763,63,25,41,14,-4.345464074086368,11
2764,84,12,34,6,-4.355418008053163,6
2765,5,113,86,65,-4.357059130864303,48
2766,107,44,50,24,-4.365561578640842,20
2767,51,56,39,31,-4.373306856508639,25
2768,96,38,63,23,-4.376849709142973,15
2769,51,19,114,11,-4.37838731261332,8
2770,77,12,74,7,-4.380746142049517,5
2771,55,20,36,11,-4.398592544427244,9
2772,55,47,107,26,-4.411490979506617,21
2773,77,15,86,9,-4.41363889617325,6
2774,7,63,13,35,-4.43428150295494,28
2775,60,12,63,7,-4.440331749337602,5
2776,64,23,53,13,-4.44333934901001,10
2777,75,16,114,9,-4.44772331798794,7
2778,50,17,9,10,-4.452050276661412,7
2779,107,11,85,6,-4.458201254276332,5
2780,65,20,12,12,-4.465003779468813,8
2781,32,18,37,10,-4.466542082918519,8
2782,57,10,91,5,-4.468260927215542,5
2783,7,15,20,8,-4.4847557608097715,7
2784,37,15,93,9,-4.4934456656390305,6
2785,8,12,79,8,-4.523368231395376,4
2786,87,21,83,11,-4.5238867039340604,10
2787,108,14,86,7,-4.525807877036373,7
2788,97,22,54,12,-4.535944223800905,10
2789,102,24,8,13,-4.537070383836358,11
2790,37,57,87,33,-4.539833156564566,24
2791,7,70,16,38,-4.541203225938122,32
2792,68,22,27,13,-4.542498192067934,9
2793,53,29,18,17,-4.543635238262761,12
2794,28,43,20,25,-4.544189476783364,18
2795,88,21,15,13,-4.546696410508229,8
2796,95,15,53,8,-4.5534183880414965,7
2797,67,13,109,6,-4.5540965230597985,7
2798,23,15,70,8,-4.554568026577778,7
2799,107,23,17,13,-4.556628194816713,10
2800,63,10,64,5,-4.569403793082112,5
2801,30,17,75,9,-4.5725614584362635,8
2802,95,14,99,8,-4.572737764013027,6
2803,90,29,54,16,-4.579893896725853,13
2804,49,11,107,6,-4.58261994672963,5
2805,33,15,25,10,-4.583917339891116,5
2806,31,22,65,13,-4.597416228049084,9
2807,95,13,77,7,-4.601493224452909,6
2808,75,16,91,6,-4.618700658898719,10
2809,34,13,96,8,-4.620609194568736,5
2810,94,11,55,6,-4.62125795870324,5
2811,20,47,107,26,-4.628776540404446,21
2812,39,35,8,19,-4.640312118250008,16
2813,89,12,88,7,-4.663566198307963,5
2814,17,20,7,12,-4.685740229123579,8
2815,98,12,108,7,-4.704860704776838,5
2816,107,63,16,38,-4.707453745118705,25
2817,99,17,51,9,-4.721255445811637,8
2818,6,12,88,7,-4.723924661172381,5
2819,28,65,50,37,-4.7352458176841905,28
2820,84,11,57,7,-4.735926438073419,4
2821,50,25,13,15,-4.736472238931537,10
2822,16,12,110,7,-4.744361952221326,5
2823,77,16,25,9,-4.745845616411638,7
2824,104,13,64,8,-4.751268233959821,5
2825,5,30,90,18,-4.752640516818982,12
2826,95,13,84,8,-4.755677362807473,5
2827,23,32,13,16,-4.756005264014364,16
2828,37,36,75,23,-4.761783492346939,13
2829,54,56,20,30,-4.770199196047593,26
2830,65,16,46,10,-4.770389277379545,6
2831,54,51,28,30,-4.77471317513782,21
2832,5,12,9,7,-4.777710715122403,5
2833,41,21,23,12,-4.77939200845321,9
2834,7,13,92,9,-4.780218736430546,4
2835,5,33,76,19,-4.788314400539968,14
2836,60,23,99,13,-4.788512200740043,10
2837,5,24,32,14,-4.788591776396216,10
2838,5,21,100,12,-4.790180113588847,9
2839,39,38,87,22,-4.7963375777013075,16
2840,108,13,96,7,-4.805162668071275,6
2841,87,18,75,11,-4.814941727585258,7
2842,70,37,37,22,-4.817822919278335,15
2843,68,59,7,34,-4.818136728337687,25
2844,67,15,8,9,-4.8319098461555825,6
2845,83,15,39,9,-4.832639955303303,6
2846,17,17,97,9,-4.8331732637027205,8
2847,95,22,13,13,-4.839189119607627,9
2848,51,30,5,19,-4.841333405150811,11
2849,84,13,38,7,-4.854976710780188,6
2850,71,31,53,18,-4.858094109954182,13
2851,107,24,39,12,-4.859521009098862,12
2852,20,30,63,16,-4.86232561538827,14
2853,63,52,8,29,-4.864260653101076,23
2854,104,11,110,7,-4.886003470603163,4
2855,114,13,100,8,-4.886489949545647,5
2856,3,12,8,5,-4.887819375016217,7
2857,5,39,83,21,-4.890865835189012,18
2858,54,32,55,18,-4.893010226063712,14
2859,62,13,28,8,-4.895504487935932,5
2860,7,11,34,7,-4.8999742789281955,4
2861,50,21,74,12,-4.905584887178799,9
2862,86,60,11,34,-4.911056453426332,26
2863,23,18,8,10,-4.91675749277209,8
2864,86,19,64,11,-4.921641964433369,8
2865,5,12,38,7,-4.923519430907612,5
2866,25,29,96,16,-4.925630164170213,13
2867,17,18,46,10,-4.929301996976194,8
2868,51,15,12,9,-4.929478770854847,6
2869,106,52,37,28,-4.929607997592943,24
2870,95,22,60,13,-4.936116623099728,9
2871,7,11,33,6,-4.950732991604977,5
2872,1,17,68,10,-4.951539236320594,7
2873,5,47,55,27,-4.968791694509531,20
2874,71,22,65,13,-4.97223924765955,9
2875,107,17,93,10,-4.972813709998716,7
2876,4,10,27,5,-4.975336835901209,5
2877,104,20,41,11,-4.977191518101772,9
2878,1,20,40,12,-4.981454143490505,8
2879,25,13,27,7,-4.983545927288363,6
2880,86,71,37,40,-4.984756436647988,31
2881,75,43,86,23,-4.98856606832596,20
2882,114,13,95,7,-4.99433848945336,6
2883,5,26,93,16,-5.004460526821323,10
2884,63,35,74,20,-5.021214981434137,15
2885,95,13,76,8,-5.029825996184284,5
2886,5,19,15,12,-5.041855747243198,7
2887,112,12,86,7,-5.051412422968131,5
2888,80,26,86,14,-5.051644939599721,12
2889,5,45,106,27,-5.052056869360905,18
2890,86,27,91,16,-5.054253859133064,11
2891,111,12,87,7,-5.07353420920843,5
2892,38,14,16,9,-5.077979390760907,5
2893,36,16,99,10,-5.08690767914281,6
2894,54,30,11,17,-5.0896588063796155,13
2895,70,54,54,31,-5.096904873313986,23
2896,70,22,55,13,-5.1032220329288345,9
2897,30,14,68,8,-5.11152810888501,6
2898,71,11,80,6,-5.115089624287771,5
2899,54,13,14,9,-5.139758720068027,4
2900,73,22,86,12,-5.151945844046347,10
2901,23,20,37,11,-5.153587203140156,9
2902,37,46,16,27,-5.156319944125245,19
2903,8,13,38,8,-5.158625539766782,5
2904,5,12,67,7,-5.159840528973067,5
2905,7,24,28,14,-5.175100649214177,10
2906,9,11,76,7,-5.1754966129841495,4
2907,41,41,7,23,-5.180683668884162,18
2908,71,28,75,17,-5.185023405419134,11
2909,88,19,64,12,-5.188669550676785,7
2910,104,12,23,8,-5.195671558199884,4
2911,108,13,55,7,-5.197810339207505,6
2912,106,52,74,30,-5.205641315490497,22
2913,104,49,107,29,-5.216996634772606,20
2914,31,29,68,16,-5.218076473494278,13
2915,50,49,37,27,-5.22857628659301,22
2916,109,44,28,27,-5.243370342287003,17
2917,81,10,75,7,-5.244290614702668,3
2918,95,25,7,14,-5.246470392426651,11
2919,20,17,17,10,-5.256441987432859,7
2920,60,21,30,14,-5.268270822677401,7
2921,40,23,16,13,-5.274788154271569,10
2922,98,12,55,8,-5.288747165274871,4
2923,35,14,88,8,-5.305527424977249,6
2924,50,14,100,8,-5.313595407031384,6
2925,54,19,60,11,-5.320340059713543,8
2926,27,31,7,19,-5.323258509815235,12
2927,25,30,102,17,-5.328861344822154,13
2928,48,16,106,9,-5.330591930412405,7
2929,36,23,88,12,-5.3586166252428376,11
2930,9,24,65,14,-5.366229535489773,10
2931,39,19,84,11,-5.3860841465295675,8
2932,2,25,63,14,-5.3959192809990375,11
2933,1,20,88,12,-5.397487106945941,8
2934,111,12,23,6,-5.406786190970031,6
2935,67,10,96,5,-5.408732724512928,5
2936,83,15,51,10,-5.415397349279682,5
2937,50,10,83,5,-5.416126776091854,5
2938,7,18,6,8,-5.41788396907959,10
2939,51,24,25,14,-5.42438708061493,10
2940,88,53,7,31,-5.426849580199114,22
2941,104,17,32,11,-5.4353295484317545,6
2942,49,12,50,7,-5.454154014714142,5
2943,16,21,109,12,-5.461892685468699,9
2944,109,14,7,8,-5.46540747668918,6
2945,7,39,23,23,-5.4670672513658625,16
2946,91,13,70,7,-5.470850370265932,6
2947,46,34,74,21,-5.475304789089529,13
2948,100,21,104,13,-5.507335747436163,8
2949,83,19,95,12,-5.510188596504647,7
2950,64,11,77,5,-5.511154382484386,6
2951,102,14,33,8,-5.525239013163607,6
2952,88,53,54,30,-5.542564383595124,23
2953,25,41,8,25,-5.550067480025435,16
2954,10,11,63,7,-5.56040496031845,4
2955,93,22,87,13,-5.565802071262539,9
2956,63,27,55,15,-5.568315530285167,12
2957,16,42,75,25,-5.574878659689373,17
2958,68,10,3,6,-5.578876648633715,4
2959,17,14,11,8,-5.581185513103198,6
2960,43,11,25,8,-5.587553515371877,3
2961,16,12,52,7,-5.588665300895635,5
2962,88,31,40,18,-5.590111425362956,13
2963,48,11,80,7,-5.594209169092441,4
2964,5,43,114,25,-5.6108790968221705,18
2965,17,20,5,13,-5.625033929201381,7
2966,53,28,13,17,-5.6297256886458,11
2967,6,13,65,8,-5.631765359162988,5
2968,84,48,28,28,-5.640820939476543,20
2969,8,24,73,14,-5.645022963800572,10
2970,104,16,30,9,-5.6456066607798965,7
2971,74,23,73,14,-5.649045009007229,9
2972,50,38,2,22,-5.650047560448175,16
2973,35,11,55,6,-5.650743870496082,5
2974,82,11,54,7,-5.66427830231393,4
2975,99,31,16,18,-5.66581833704302,13
2976,25,10,94,5,-5.671887186214519,5
2977,95,10,102,6,-5.68531996234082,4
2978,41,16,70,8,-5.685339970613442,8
2979,57,12,106,6,-5.685749140437754,6
2980,35,20,20,12,-5.690519984272521,8
2981,78,11,68,6,-5.690972129075351,5
2982,75,27,46,16,-5.691502289376634,11
2983,87,65,16,37,-5.697360970596407,28
2984,18,14,100,8,-5.69768401126683,6
2985,51,30,68,19,-5.700265456026805,11
2986,55,22,80,12,-5.702005440074988,10
2987,48,13,50,8,-5.707017905103165,5
2988,97,34,28,21,-5.710448223070003,13
2989,106,10,62,6,-5.720849022877857,4
2990,9,12,84,7,-5.723245457590759,5
2991,20,35,87,20,-5.726562552686569,15
2992,48,20,11,12,-5.726887293490206,8
2993,74,16,100,9,-5.736028437636332,7
2994,54,42,46,25,-5.742795031938329,17
2995,110,20,37,11,-5.748786289021979,9
2996,88,20,91,12,-5.750112640421962,8
2997,40,24,25,14,-5.7546667775712015,10
2998,55,57,16,36,-5.757509198556427,21
2999,86,33,98,19,-5.764694207614796,14
3000,107,27,97,15,-5.771441172656416,12
3001,65,33,51,21,-5.790474157456975,12
3002,25,40,107,23,-5.793952829150565,17
3003,55,28,74,16,-5.797157459674131,12
3004,5,39,70,22,-5.812017017327767,17
3005,5,16,40,9,-5.82052725169565,7
3006,90,12,46,7,-5.830565699084016,5
3007,50,13,69,8,-5.875505034614895,5
3008,40,15,97,9,-5.878372345170692,6
3009,51,81,16,47,-5.884437275751712,34
3010,50,16,91,10,-5.888752800005776,6
3011,60,11,49,7,-5.889051777859122,4
3012,100,22,16,13,-5.892480519477383,9
3013,41,14,64,9,-5.8984927048413835,5
3014,96,14,60,10,-5.90080951503154,4
3015,25,16,93,9,-5.904464695396422,7
3016,106,11,27,5,-5.912387451440967,6
3017,49,13,75,8,-5.9302110921044004,5
3018,91,14,13,9,-5.935981325781478,5
3019,71,16,62,10,-5.939967307930556,6
3020,35,10,7,6,-5.944825657129106,4
3021,3,11,25,6,-5.956284840526988,5
3022,88,31,25,20,-5.956673984495014,11
3023,51,36,40,22,-5.967332713634328,14
3024,54,24,25,14,-5.984288858689811,10
3025,36,14,45,8,-5.990434586984984,6
3026,75,11,40,7,-6.006938010180454,4
3027,50,24,39,14,-6.010792416092778,10
3028,65,28,114,16,-6.011563249640665,12
3029,17,10,99,6,-6.011623328938978,4
3030,86,59,7,38,-6.022960317529566,21
3031,60,16,109,9,-6.026577074635168,7
3032,46,20,95,12,-6.027785407812037,8
3033,41,13,20,8,-6.029068160646921,5
3034,1,10,37,5,-6.037547835973022,5
3035,32,16,8,9,-6.041444852098721,7
3036,87,10,92,6,-6.051934591270965,4
3037,20,15,33,9,-6.052404113154947,6
3038,90,10,91,6,-6.057465510076111,4
3039,107,27,40,17,-6.058646893377405,10
3040,109,15,17,9,-6.060510853587175,6
3041,55,11,29,7,-6.0636297407404705,4
3042,16,21,111,12,-6.073294425875792,9
3043,65,45,87,27,-6.081114534010457,18
3044,5,44,20,27,-6.084413199436969,17
3045,5,12,68,7,-6.084537265067713,5
3046,45,12,16,7,-6.097137364681592,5
3047,4,13,65,8,-6.100786289642475,5
3048,79,10,55,6,-6.105260957218082,4
3049,86,16,93,10,-6.108088782935806,6
3050,68,12,77,7,-6.11278994285269,5
3051,8,10,52,6,-6.118835452590007,4
3052,54,23,102,14,-6.1200791508914225,9
3053,97,24,55,15,-6.128965912516969,9
3054,90,22,96,14,-6.131526760597793,8
3055,1,13,75,9,-6.1372401761978495,4
3056,109,34,54,21,-6.139125062485929,13
3057,68,11,62,6,-6.1519197429758545,5
3058,87,27,30,16,-6.164077985923404,11
3059,98,21,91,14,-6.169098881994584,7
3060,104,59,37,36,-6.175700710267806,23
3061,88,11,99,6,-6.177037133798533,5
3062,27,25,16,16,-6.183189816584679,9
3063,77,17,55,10,-6.195572885542832,7
3064,29,17,65,9,-6.195856005776575,8
3065,33,10,97,6,-6.197569301394056,4
3066,41,17,60,10,-6.2200869580484675,7
3067,37,28,13,16,-6.2304098814815685,12
3068,63,16,9,10,-6.237431535049687,6
3069,36,41,7,24,-6.247180697913231,17
3070,88,22,92,14,-6.250454469623379,8
3071,102,18,57,10,-6.264739678585858,8
3072,57,22,8,14,-6.276405634666304,8
3073,65,20,90,11,-6.287381903113807,9
3074,75,15,95,9,-6.3050118671136195,6
3075,87,12,77,7,-6.328764001805251,5
3076,98,20,11,11,-6.3386776528601825,9
3077,100,16,37,10,-6.343110325621272,6
3078,23,13,74,8,-6.3699879675856135,5
3079,14,13,107,7,-6.370548692090853,6
3080,16,11,103,7,-6.384231863654396,4
3081,111,15,86,8,-6.385538684815059,7
3082,25,16,60,9,-6.405485347041519,7
3083,23,19,63,12,-6.4146865502013934,7
3084,18,13,31,8,-6.429121792537089,5
3085,18,36,7,20,-6.441568021771814,16
3086,53,20,60,12,-6.45198763140791,8
3087,88,27,50,16,-6.454854939095323,11
3088,97,21,7,12,-6.455761793933853,9
3089,30,10,100,6,-6.461771751506818,4
3090,28,17,14,11,-6.462988674713606,6
3091,107,31,23,19,-6.491903236534169,12
3092,50,11,31,7,-6.4969883827749815,4
3093,104,42,86,24,-6.498243850038454,18
3094,96,30,50,18,-6.506695896089088,12
3095,68,23,60,14,-6.510943888891177,9
3096,87,14,29,9,-6.515319434766388,5
3097,107,11,112,6,-6.5191432394411555,5
3098,18,20,86,13,-6.52089641370123,7
3099,71,36,60,21,-6.532104325980031,15
3100,68,11,74,6,-6.535840872424689,5
3101,96,20,75,14,-6.539626864970789,6
3102,88,88,16,54,-6.539746345614137,34
3103,50,11,27,7,-6.540575751678348,4
3104,27,23,107,14,-6.540851857375384,9
3105,71,11,36,6,-6.564594491374976,5
3106,88,15,108,9,-6.566472472480613,6
3107,7,13,70,7,-6.573007690002734,6
3108,54,13,9,8,-6.575353735842605,5
3109,36,14,64,9,-6.578676960982075,5
3110,96,77,86,47,-6.579835199705017,30
3111,70,33,28,20,-6.587580378842006,13
3112,96,28,65,16,-6.593487230396348,12
3113,64,17,83,10,-6.597115059465707,7
3114,36,26,107,15,-6.599705149917166,11
3115,88,63,86,37,-6.6025254412981695,26
3116,23,11,100,6,-6.60887180201957,5
3117,7,15,100,9,-6.615631929343047,6
3118,107,19,33,11,-6.618873691013778,8
3119,84,27,8,17,-6.622581044229809,10
3120,5,48,25,29,-6.626414170343123,19
3121,99,12,98,6,-6.645057358834166,6
3122,102,14,63,8,-6.652222601619386,6
3123,71,11,83,6,-6.6562053803338666,5
3124,50,21,95,12,-6.657433489482592,9
3125,46,14,7,9,-6.665058749362287,5
3126,37,10,29,6,-6.680734619445758,4
3127,108,19,107,12,-6.681663028489704,7
3128,106,11,111,8,-6.697425895741327,3
3129,32,11,97,7,-6.7220085367153315,4
3130,95,13,14,8,-6.731405281187272,5
3131,96,38,74,24,-6.731828732252354,14
3132,3,10,88,6,-6.747446753866268,4
3133,51,15,102,9,-6.749472817285659,6
3134,108,10,48,7,-6.749808304712144,3
3135,96,30,97,17,-6.762245122268197,13
3136,86,15,53,8,-6.770826247743165,7
3137,70,27,88,17,-6.779439228833637,10
3138,98,15,70,10,-6.782158452834324,5
3139,46,39,8,22,-6.790452136276324,17
3140,23,17,51,10,-6.813238789143917,7
3141,5,24,65,14,-6.826704214447485,10
3142,18,28,28,17,-6.828401096604493,11
3143,18,17,77,11,-6.8343783915660445,6
3144,88,11,44,6,-6.838381834171168,5
3145,49,14,98,8,-6.852175548516357,6
3146,11,17,75,10,-6.860129083231022,7
3147,28,47,104,28,-6.867595835363374,19
3148,64,21,16,13,-6.867700294452231,8
3149,99,15,106,10,-6.882359612487446,5
3150,91,15,41,10,-6.893895997089624,5
3151,20,11,93,7,-6.911432650296384,4
3152,87,10,44,6,-6.930092376966648,4
3153,32,18,107,10,-6.94620916956579,8
3154,18,15,50,8,-6.975457853882176,7
3155,30,11,49,7,-6.986267783548394,4
3156,65,14,15,9,-6.98678701664079,5
3157,106,10,6,6,-6.989547350675937,4
3158,5,15,62,9,-6.9927087595973925,6
3159,87,24,76,15,-6.993292012895228,9
3160,65,33,30,21,-7.006135379271243,12
3161,71,15,88,8,-7.006386088822306,7
3162,93,12,16,7,-7.007856526653327,5
3163,84,31,74,17,-7.0251363399754485,14
3164,106,27,80,17,-7.029777914575281,10
3165,39,17,46,9,-7.035363973882463,8
3166,2,25,28,16,-7.040494915317703,9
3167,25,20,91,12,-7.04452512181193,8
3168,107,11,6,7,-7.048403625284058,4
3169,39,22,17,14,-7.053406202555407,8
3170,87,23,90,14,-7.067717517445952,9
3171,39,18,64,11,-7.072183333319319,7
3172,5,15,43,9,-7.075267806513356,6
3173,88,11,12,7,-7.079073000089318,4
3174,9,11,46,6,-7.085087450613435,5
3175,17,10,1,6,-7.089282944121619,4
3176,18,16,91,10,-7.097990672660609,6
3177,79,12,63,8,-7.1114844508040305,4
3178,87,14,32,9,-7.113585901413378,5
3179,109,18,73,11,-7.142307709742033,7
3180,3,10,7,7,-7.15195406317859,3
3181,51,37,104,24,-7.1635637555363445,13
3182,14,14,86,8,-7.166696838482464,6
3183,75,19,18,11,-7.169915429722033,8
3184,35,15,16,10,-7.178038323973206,5
3185,43,12,106,7,-7.182282377952387,5
3186,55,15,57,8,-7.186289928876395,7
3187,5,28,97,18,-7.2030892274017075,10
3188,15,20,13,12,-7.226944117697118,8
3189,51,70,86,40,-7.231523442327657,30
3190,101,11,16,7,-7.238690209169098,4
3191,110,17,8,11,-7.249961918016362,6
3192,50,12,41,8,-7.250027884407809,4
3193,93,12,98,7,-7.251352809271133,5
3194,111,14,28,9,-7.296837620354718,5
3195,68,31,16,20,-7.297118928031952,11
3196,109,19,107,13,-7.298695286121334,6
3197,107,13,58,8,-7.3015258521878605,5
3198,70,14,110,9,-7.302453099036632,5
3199,104,18,97,10,-7.327124557030451,8
3200,16,12,72,7,-7.333554822764275,5
3201,31,11,1,5,-7.3592728130679514,6
3202,106,38,25,24,-7.3615147893147475,14
3203,46,13,109,8,-7.363639283748701,5
3204,74,15,34,10,-7.367415754617588,5
3205,91,11,51,7,-7.381482405770834,4
3206,84,21,16,12,-7.387304706787613,9
3207,20,18,91,10,-7.395662966437773,8
3208,46,41,37,27,-7.398384968299376,14
3209,12,10,60,5,-7.400797875656222,5
3210,69,11,70,7,-7.401520759866326,4
3211,107,13,29,9,-7.409187331272264,4
3212,46,45,25,26,-7.439996628911813,19
3213,55,16,17,9,-7.461932340099582,7
3214,75,12,64,7,-7.465633576303509,5
3215,63,15,108,9,-7.475559971035059,6
3216,60,22,64,13,-7.4801630110093145,9
3217,48,13,74,7,-7.488504403150373,6
3218,94,10,86,6,-7.492158076331636,4
3219,71,10,70,5,-7.515715016674823,5
3220,106,16,98,10,-7.529459965554982,6
3221,74,18,102,11,-7.530680431017048,7
3222,102,18,104,10,-7.533956675469564,8
3223,68,13,97,8,-7.535952472100061,5
3224,7,14,111,8,-7.536933625844229,6
3225,70,18,114,12,-7.542200625865838,6
3226,70,23,96,12,-7.543405368906036,11
3227,87,14,62,9,-7.54541053050395,5
3228,71,22,30,13,-7.548090335788275,9
3229,74,10,69,6,-7.579248302946878,4
3230,47,10,65,6,-7.5834592832669205,4
3231,57,11,7,6,-7.58831541689425,5
3232,60,28,104,20,-7.608625351956835,8
3233,96,18,51,11,-7.611388504075614,7
3234,87,10,15,6,-7.629777802129095,4
3235,80,22,96,14,-7.6325568595370585,8
3236,16,16,44,9,-7.6351094721495825,7
3237,9,17,87,10,-7.6364464100510565,7
3238,18,20,106,12,-7.647336586140196,8
3239,96,24,37,14,-7.66584492569651,10
3240,48,24,86,15,-7.668739325888133,9
3241,106,28,90,18,-7.670984333772028,10
3242,11,32,5,20,-7.6874421575338765,12
3243,70,13,46,8,-7.705270409518368,5
3244,18,19,68,11,-7.707757227223853,8
3245,28,46,88,29,-7.712000490585732,17
3246,4,18,60,11,-7.727377186059123,7
3247,31,16,9,10,-7.730408681533597,6
3248,8,31,109,18,-7.730735193905241,13
3249,20,35,65,23,-7.738425215752467,12
3250,54,13,73,8,-7.746921178252214,5
3251,25,49,37,29,-7.755599308877523,20
3252,109,16,41,11,-7.764026883273387,5
3253,75,22,60,14,-7.764402562201023,8
3254,77,21,13,13,-7.770992346735012,8
3255,79,20,48,12,-7.7777328666170344,8
3256,88,24,39,16,-7.807721079101323,8
3257,87,11,3,7,-7.830562213641775,4
3258,98,17,8,11,-7.832264077196576,6
3259,55,21,95,13,-7.848709788021649,8
3260,87,56,8,35,-7.858183704584655,21
3261,96,13,85,9,-7.87177905722743,4
3262,51,23,20,13,-7.873291814736603,10
3263,48,31,63,20,-7.879517250797573,11
3264,36,13,28,7,-7.880028929086843,6
3265,87,13,73,9,-7.889148900875538,4
3266,65,23,95,14,-7.912040515511821,9
3267,106,34,13,21,-7.912363306794574,13
3268,86,22,100,12,-7.9304951685165435,10
3269,84,14,97,10,-7.932419590040103,4
3270,63,33,51,20,-7.954169936455738,13
3271,68,34,75,22,-7.960537885099937,12
3272,104,12,89,7,-7.965629364641427,5
3273,91,10,102,6,-7.970489437012806,4
3274,109,26,88,17,-7.9813312286542315,9
3275,17,17,104,10,-7.98852960047454,7
3276,109,14,95,9,-7.992343836415329,5
3277,96,19,102,12,-7.995631160966494,7
3278,37,13,89,7,-7.9994477960682815,6
3279,86,14,15,9,-8.007884617525496,5
3280,39,16,9,9,-8.050579472794494,7
3281,1,19,13,13,-8.05256246099015,6
3282,28,24,93,16,-8.07091688053174,8
3283,84,23,20,16,-8.075470698309143,7
3284,5,61,8,37,-8.080732178020163,24
3285,43,11,63,7,-8.123064953208495,4
3286,25,19,100,11,-8.126357393020873,8
3287,29,12,75,7,-8.144839094845086,5
3288,55,35,104,22,-8.147983283277846,13
3289,77,16,107,10,-8.158868103512408,6
3290,102,14,20,8,-8.160756483849335,6
3291,114,26,8,17,-8.173491580547305,9
3292,50,14,93,9,-8.187365267839093,5
3293,16,19,102,11,-8.19199745286954,8
3294,114,26,28,15,-8.202690137168576,11
3295,44,11,20,7,-8.212958514210372,4
3296,104,11,34,7,-8.215395618768706,4
3297,16,40,60,24,-8.22662421929517,16
3298,37,11,64,7,-8.227838269840156,4
3299,87,11,69,6,-8.233960994375394,5
3300,30,15,20,9,-8.236211957822993,6
3301,16,12,89,7,-8.24232911238878,5
3302,14,12,37,7,-8.266467835075433,5
3303,76,12,75,7,-8.269580351796622,5
3304,76,13,65,9,-8.31287645900771,4
3305,70,15,108,10,-8.323316395893164,5
3306,28,10,4,6,-8.326181765732452,4
3307,63,10,99,6,-8.327283039780834,4
3308,104,14,15,9,-8.330235989560041,5
3309,40,29,65,17,-8.33521891201525,12
3310,55,17,30,10,-8.360959444216725,7
3311,1,26,55,16,-8.373903989710458,10
3312,46,10,6,6,-8.386722378353735,4
3313,3,10,107,5,-8.399424845192016,5
3314,110,14,51,9,-8.405376385205704,5
3315,25,41,13,24,-8.44596846540986,17
3316,96,14,95,9,-8.450373982592183,5
3317,65,12,1,7,-8.469252925408407,5
3318,72,16,86,10,-8.471272734246591,6
3319,83,27,86,19,-8.512264034333521,8
3320,53,37,7,24,-8.522907627277364,13
3321,1,14,16,10,-8.53085575505153,4
3322,30,17,40,11,-8.539900905776541,6
3323,107,10,15,7,-8.540362330799292,3
3324,55,31,50,19,-8.547249952830777,12
3325,11,20,104,13,-8.558536461608565,7
3326,86,20,27,13,-8.578635265192988,7
3327,65,11,64,6,-8.583165704821925,5
3328,5,13,71,8,-8.58837744258604,5
3329,75,13,15,9,-8.597300929966652,4
3330,50,22,90,14,-8.598522697493998,8
3331,54,18,13,12,-8.613765121761865,6
3332,114,11,32,7,-8.619976183865209,4
3333,40,13,95,8,-8.623923471834955,5
3334,70,12,30,6,-8.628315532902242,6
3335,37,34,11,22,-8.643977561339529,12
3336,51,10,73,7,-8.653546669629687,3
3337,68,24,9,14,-8.654072997578577,10
3338,30,18,53,11,-8.677860974225487,7
3339,51,10,4,6,-8.688285343377753,4
3340,71,28,16,19,-8.692821686577322,9
3341,90,11,30,7,-8.695806027026098,4
3342,55,26,40,17,-8.69649105603948,9
3343,2,10,30,6,-8.704387763563812,4
3344,109,19,74,13,-8.721352652587642,6
3345,108,16,16,10,-8.735246502538358,6
3346,63,16,27,9,-8.735488991646301,7
3347,40,10,61,6,-8.7398122874208,4
3348,38,12,88,9,-8.749107019275813,3
3349,40,11,23,7,-8.770651576874254,4
3350,18,15,63,10,-8.77510334952056,5
3351,106,11,79,7,-8.77784161708646,4
3352,86,18,69,12,-8.7805890555138,6
3353,57,14,11,8,-8.783548700894539,6
3354,38,25,37,16,-8.833071133401008,9
3355,37,20,40,12,-8.849367605337227,8
3356,98,13,73,8,-8.85379630005694,5
3357,17,16,28,10,-8.863383779145725,6
3358,68,19,114,13,-8.869347207739377,6
3359,39,10,47,6,-8.876547255057021,4
3360,60,18,91,11,-8.876805794182985,7
3361,25,31,104,19,-8.87953260249694,12
3362,57,17,70,9,-8.906737604649802,8
3363,91,10,11,7,-8.923724837318142,3
3364,84,14,104,8,-8.932998314387538,6
3365,80,13,11,8,-8.941133144462878,5
3366,2,11,76,8,-8.95175533528088,3
3367,32,11,28,7,-8.963821007682874,4
3368,17,24,65,17,-8.96623708176203,7
3369,108,10,37,6,-8.970431804543574,4
3370,87,17,102,11,-8.972219911227103,6
3371,109,22,11,15,-8.976986883454375,7
3372,63,17,90,11,-8.996303299649265,6
3373,55,25,109,14,-9.015163892645331,11
3374,36,13,5,8,-9.023272142505265,5
3375,75,22,104,14,-9.039829127143499,8
3376,104,37,88,24,-9.039961252537609,13
3377,55,23,76,16,-9.05690191061572,7
3378,8,34,95,21,-9.07920947405897,13
3379,39,10,110,7,-9.085258579238133,3
3380,96,18,7,13,-9.132819640450865,5
3381,62,13,107,8,-9.13438141188093,5
3382,38,10,51,7,-9.155948104570232,3
3383,5,43,50,26,-9.156049369840705,17
3384,97,13,18,8,-9.160967974857392,5
3385,84,27,5,17,-9.167674877244863,10
3386,91,35,16,24,-9.18239489422027,11
3387,84,13,98,9,-9.18267526002018,4
3388,60,23,23,15,-9.187895606482027,8
3389,106,21,46,12,-9.198394638018083,9
3390,68,15,70,9,-9.199626874800048,6
3391,33,15,51,11,-9.201089002652214,4
3392,40,12,2,8,-9.204153353273353,4
3393,40,22,9,15,-9.21187298392594,7
3394,56,11,86,7,-9.213458879693576,4
3395,36,27,13,17,-9.217087239245357,10
3396,13,15,90,10,-9.234210365017372,5
3397,63,12,17,8,-9.243907403077538,4
3398,70,24,74,14,-9.249270082293561,10
3399,62,14,74,9,-9.256148160859695,5
3400,18,26,13,16,-9.261423401559433,10
3401,114,10,53,6,-9.295261082214134,4
3402,107,29,2,19,-9.295436230624016,10
3403,49,12,68,7,-9.304457096949383,5
3404,96,15,114,10,-9.304547518897671,5
3405,55,13,2,8,-9.30651882359562,5
3406,80,13,90,9,-9.30675268400111,4
3407,51,16,108,10,-9.306988990301447,6
3408,54,23,75,15,-9.319695519056218,8
3409,34,15,109,9,-9.338464853736003,6
3410,74,22,51,15,-9.344397651003662,7
3411,76,23,63,16,-9.35386164955796,7
3412,43,12,107,7,-9.3558585338088,5
3413,37,12,71,7,-9.38020830857434,5
3414,91,23,55,16,-9.380332489392517,7
3415,50,20,76,14,-9.400140024953474,6
3416,36,19,31,12,-9.400152768298824,7
3417,86,31,102,21,-9.40404581030503,10
3418,63,41,37,27,-9.417998111066987,14
3419,50,34,75,23,-9.41953869640169,11
3420,110,10,114,7,-9.422657787947912,3
3421,114,14,87,8,-9.42586658536867,6
3422,74,14,83,8,-9.43011849323839,6
3423,63,11,32,7,-9.44232166344675,4
3424,95,10,100,6,-9.44913493803541,4
3425,102,10,40,6,-9.454137715098852,4
3426,55,14,34,8,-9.457810651857747,6
3427,18,22,95,13,-9.461457865276858,9
3428,77,16,63,11,-9.465120093670686,5
3429,77,26,104,17,-9.48377934817974,9
3430,51,14,1,8,-9.49718885933896,6
3431,99,22,37,15,-9.502759058160713,7
3432,10,11,107,7,-9.504556938677329,4
3433,76,18,23,12,-9.525082848083137,6
3434,63,13,62,8,-9.527211231443939,5
3435,39,13,90,8,-9.529975909191752,5
3436,106,21,2,13,-9.573373481710446,8
3437,54,49,63,32,-9.574771666628008,17
3438,39,39,13,24,-9.579171098092763,15
3439,40,12,64,8,-9.579728068353155,4
3440,8,11,62,8,-9.593511144115352,3
3441,35,15,86,9,-9.604686839909265,6
3442,1,17,86,11,-9.605183903195396,6
3443,8,14,99,8,-9.611065592860308,6
3444,41,12,27,7,-9.625499011512423,5
3445,64,12,70,8,-9.645861185980307,4
3446,106,21,39,13,-9.647313810026368,8
3447,65,21,27,13,-9.65792044215186,8
3448,39,11,76,8,-9.681961570558546,3
3449,88,33,63,22,-9.734010190028812,11
3450,39,32,86,19,-9.737500722437058,13
3451,55,12,100,7,-9.740548987953597,5
3452,53,10,97,6,-9.746355004042218,4
3453,13,16,81,10,-9.763106493512707,6
3454,84,23,11,15,-9.766296004538773,8
3455,83,24,37,15,-9.783726366978415,9
3456,109,20,63,12,-9.854767957937824,8
3457,107,25,30,17,-9.863119229469133,8
3458,79,23,86,15,-9.865377107457421,8
3459,70,24,87,15,-9.867797329951719,9
3460,106,14,30,9,-9.870728252110508,5
3461,18,34,16,23,-9.881360464557632,11
3462,14,13,16,8,-9.888882095158154,5
3463,77,10,46,6,-9.900782595186337,4
3464,87,17,100,10,-9.910234475754471,7
3465,109,15,70,10,-9.924354258384088,5
3466,86,22,44,14,-9.92971305051496,8
3467,8,31,75,21,-9.942334170394213,10
3468,47,11,7,8,-9.948030631901805,3
3469,104,21,40,14,-9.970558522733771,7
3470,106,13,38,7,-9.972431475981125,6
3471,35,21,107,15,-9.980358662107305,6
3472,46,34,16,22,-9.98935054867163,12
3473,43,12,40,8,-10.065244307333751,4
3474,57,12,54,9,-10.066024134547122,3
3475,83,15,107,10,-10.114574167697793,5
3476,35,10,8,7,-10.118762046100299,3
3477,30,10,27,6,-10.15632448718485,4
3478,97,45,86,29,-10.163469283868963,16
3479,102,14,76,9,-10.166991590900437,5
3480,68,13,36,8,-10.182081213012962,5
3481,40,43,7,29,-10.18855247085411,14
3482,65,10,102,6,-10.189199303308586,4
3483,23,25,106,15,-10.18929876971946,10
3484,2,15,98,9,-10.198603389321665,6
3485,44,12,104,8,-10.208907808787586,4
3486,99,12,77,9,-10.252199704478636,3
3487,51,11,15,7,-10.274901265855426,4
3488,94,10,13,7,-10.278886232089443,3
3489,91,20,7,14,-10.294223036185203,6
3490,84,40,63,25,-10.29559442304446,15
3491,28,41,63,28,-10.300883603096644,13
3492,55,18,20,11,-10.312518824176758,7
3493,90,17,73,11,-10.345640275158654,6
3494,91,26,63,18,-10.346434337063867,8
3495,102,17,50,10,-10.348240016843025,7
3496,91,18,8,12,-10.34860151027639,6
3497,84,13,83,8,-10.35745770275565,5
3498,38,10,75,7,-10.37132525716886,3
3499,56,15,7,9,-10.375257452050729,6
3500,93,16,106,10,-10.37915501513517,6
3501,87,22,98,15,-10.388816178209707,7
3502,63,10,78,6,-10.4051298432996,4
3503,36,24,27,15,-10.427651739608255,9
3504,68,14,4,9,-10.435649222560748,5
3505,40,16,54,10,-10.441560488291174,6
3506,97,13,110,9,-10.452372833112598,4
3507,80,11,78,7,-10.465715646953603,4
3508,33,12,87,8,-10.466998002217025,4
3509,27,18,104,13,-10.473446544405565,5
3510,87,39,13,26,-10.475224192177564,13
3511,53,26,68,18,-10.49091220560894,8
3512,68,10,28,7,-10.490940734087157,3
3513,38,11,104,7,-10.511918642412144,4
3514,47,11,36,8,-10.516857883390175,3
3515,88,40,65,27,-10.522929181632811,13
3516,57,18,88,11,-10.555628423294738,7
3517,76,33,86,22,-10.565024036126953,11
3518,96,45,16,32,-10.566392603656332,13
3519,41,18,87,12,-10.566422140881258,6
3520,27,10,40,6,-10.593233275804696,4
3521,109,11,93,7,-10.593952443141525,4
3522,77,11,106,7,-10.594156026318409,4
3523,87,22,48,15,-10.632484792434644,7
3524,102,17,107,11,-10.637405716433584,6
3525,39,58,16,38,-10.638146873534158,20
3526,63,13,71,8,-10.644681087019856,5
3527,7,22,37,14,-10.662936414000132,8
3528,65,16,2,12,-10.668339624865121,4
3529,51,56,13,36,-10.67483165880427,20
3530,64,13,50,8,-10.676473731405574,5
3531,20,32,50,21,-10.680905733435484,11
3532,36,11,70,7,-10.685404725540558,4
3533,76,13,54,9,-10.686858558117365,4
3534,93,12,75,8,-10.68974449521869,4
3535,54,43,37,29,-10.702102057687048,14
3536,13,16,30,10,-10.738595010557942,6
3537,86,10,3,7,-10.74425568721737,3
3538,51,49,7,32,-10.755730593232087,17
3539,63,22,98,14,-10.75970205191674,8
3540,53,11,8,8,-10.761161561739845,3
3541,88,11,80,7,-10.820834504420484,4
3542,97,15,13,10,-10.822388503528412,5
3543,86,26,41,19,-10.826191446306183,7
3544,107,25,48,16,-10.827629447931269,9
3545,68,16,23,10,-10.850372230875436,6
3546,81,11,60,7,-10.850721376705717,4
3547,25,10,36,6,-10.872848892533508,4
3548,46,11,100,7,-10.904685887838546,4
3549,5,17,73,11,-10.90738305979487,6
3550,46,35,104,23,-10.919285643804978,12
3551,39,19,74,12,-10.936319651937493,7
3552,51,21,27,14,-10.96981827885492,7
3553,9,21,16,14,-10.976377975200077,7
3554,39,14,23,9,-10.999796656050236,5
3555,40,10,98,6,-11.010186531894902,4
3556,68,12,95,9,-11.02568103886135,3
3557,96,19,46,11,-11.044310192668554,8
3558,11,11,99,7,-11.04788337752713,4
3559,5,13,34,10,-11.055394545543237,3
3560,25,18,110,13,-11.063714709672924,5
3561,106,57,16,39,-11.06906713885185,18
3562,25,29,20,20,-11.06909713193041,9
3563,98,14,20,10,-11.083964695514595,4
3564,88,13,77,9,-11.099370566703438,4
3565,32,13,74,9,-11.101664191982367,4
3566,53,20,107,14,-11.110522115221908,6
3567,77,12,27,8,-11.13773931409657,4
3568,60,14,47,9,-11.169608085813236,5
3569,54,20,30,14,-11.20706879764052,6
3570,87,13,79,10,-11.211504341364096,3
3571,48,12,90,8,-11.252381363492235,4
3572,5,10,80,7,-11.295210617596885,3
3573,79,10,80,6,-11.30670069299901,4
3574,96,26,98,17,-11.315795357847566,9
3575,90,21,114,14,-11.316575519517894,7
3576,96,23,48,16,-11.323041657346815,7
3577,97,13,41,9,-11.331801293112749,4
3578,63,13,100,8,-11.33209634222994,5
3579,27,14,37,10,-11.378309035824225,4
3580,5,19,7,13,-11.44406267553112,6
3581,88,10,58,7,-11.468111187213925,3
3582,41,15,111,9,-11.468901535117379,6
3583,91,14,30,10,-11.480842967022573,4
3584,28,31,74,21,-11.526159046117094,10
3585,76,15,74,9,-11.544600382799558,6
3586,88,30,95,20,-11.545850520658464,10
3587,2,11,114,8,-11.567668937733664,3
3588,77,11,71,8,-11.581570179573193,3
3589,54,10,36,7,-11.58437851581158,3
3590,31,22,16,14,-11.635745337324366,8
3591,107,23,76,17,-11.647663179181833,6
3592,63,13,57,8,-11.67022671873631,5
3593,69,19,16,12,-11.675682600934618,7
3594,51,10,48,6,-11.705725037939857,4
3595,15,17,8,11,-11.78066066095679,6
3596,60,12,17,8,-11.780668703155271,4
3597,50,10,23,8,-11.788365261374185,2
3598,63,31,80,22,-11.797889683549814,9
3599,107,21,73,13,-11.819297459696681,8
3600,88,14,69,10,-11.887869311273404,4
3601,11,13,93,10,-11.901577910299338,3
3602,9,10,41,6,-11.907689209620179,4
3603,5,26,75,16,-11.916835118435044,10
3604,87,11,108,8,-11.937760746567227,3
3605,37,38,97,26,-11.950340535396526,12
3606,18,10,64,7,-11.95683679306048,3
3607,104,19,49,13,-11.962718506463764,6
3608,98,24,5,16,-11.989855689002859,8
3609,87,32,7,22,-12.062260908290174,10
3610,31,14,4,9,-12.100566281149305,5
3611,40,11,92,8,-12.122125058634301,3
3612,70,22,2,14,-12.153236389251056,8
3613,64,16,13,10,-12.159796917460309,6
3614,13,19,114,11,-12.223957132941289,8
3615,70,21,11,15,-12.225051268467027,6
3616,54,15,2,11,-12.306524573726033,4
3617,31,32,13,22,-12.32568895670752,10
3618,73,11,65,8,-12.33068506848005,3
3619,86,23,71,16,-12.334894371248911,7
3620,77,11,53,7,-12.351449758473514,4
3621,107,24,80,18,-12.365033339093642,6
3622,23,13,55,8,-12.384564492570101,5
3623,7,11,73,7,-12.404360121203126,4
3624,96,38,11,26,-12.433764526276038,12
3625,33,11,63,8,-12.458058441923846,3
3626,79,10,104,6,-12.467627013550157,4
3627,9,11,53,7,-12.474704729291489,4
3628,50,10,15,7,-12.479053092203715,3
3629,7,33,75,24,-12.535077682101438,9
3630,16,12,81,9,-12.547755736616807,3
3631,5,30,102,20,-12.549261396684052,10
3632,97,17,71,12,-12.555483253298778,5
3633,5,27,57,19,-12.572003913811173,8
3634,98,11,13,8,-12.600193093477749,3
3635,69,14,13,9,-12.641628123294486,5
3636,88,16,102,12,-12.65037372869335,4
3637,52,10,28,7,-12.725624774771763,3
3638,39,14,114,10,-12.750125704729554,4
3639,55,16,102,11,-12.774824407782454,5
3640,71,15,104,10,-12.790892712888182,5
3641,18,11,81,8,-12.791307902712878,3
3642,46,14,30,10,-12.822811242166972,4
3643,9,17,60,13,-12.84061869332771,4
3644,96,10,78,7,-12.899686199305037,3
3645,77,22,40,16,-12.904839091751665,6
3646,88,36,13,27,-12.917026099914278,9
3647,16,22,57,15,-12.91831164298626,7
3648,77,11,49,8,-12.920366150880083,3
3649,37,27,95,20,-12.921122211679824,7
3650,36,22,53,16,-12.927354292389513,6
3651,51,16,77,11,-12.941193832575703,5
3652,94,16,16,12,-12.969401282348114,4
3653,25,11,34,8,-12.978396480778377,3
3654,76,17,16,11,-13.03948779735361,6
3655,111,23,65,17,-13.044696089382953,6
3656,68,11,56,7,-13.08064935100822,4
3657,90,15,20,10,-13.08396173697106,5
3658,18,13,11,9,-13.094881521032239,4
3659,14,10,80,6,-13.097202558791372,4
3660,107,22,57,15,-13.099281826721855,7
3661,30,11,34,8,-13.149679586972228,3
3662,28,14,69,9,-13.15924750974193,5
3663,25,34,7,25,-13.17228675109026,9
3664,41,16,36,10,-13.196270804003616,6
3665,69,10,49,6,-13.198330525042142,4
3666,41,16,8,12,-13.244566662838952,4
3667,63,12,111,8,-13.262790476904586,4
3668,33,10,65,7,-13.314880602814075,3
3669,17,18,95,13,-13.342671111008821,5
3670,83,18,16,13,-13.35123547721314,5
3671,20,11,34,8,-13.36206244645375,3
3672,32,11,55,7,-13.36363963009391,4
3673,37,11,18,8,-13.371391730474068,3
3674,7,13,45,9,-13.38957872768084,4
3675,39,21,30,15,-13.426960288467429,6
3676,32,12,25,7,-13.427877456338663,5
3677,70,15,50,10,-13.441101055992577,5
3678,53,16,87,10,-13.445191662192826,6
3679,10,11,51,8,-13.446955688168295,3
3680,90,10,93,7,-13.452391800759145,3
3681,77,10,23,7,-13.476022973760971,3
3682,103,11,74,8,-13.53565105452587,3
3683,99,17,107,12,-13.582126995646108,5
3684,46,12,93,9,-13.65474091099076,3
3685,50,13,33,9,-13.806659469614802,4
3686,51,21,100,13,-13.816816739386772,8
3687,83,13,11,10,-13.863860744018641,3
3688,83,11,23,8,-13.9232349355535,3
3689,91,20,106,16,-13.947658584561143,4
3690,68,17,25,12,-13.975333228554621,5
3691,35,21,76,14,-14.001262608885755,7
3692,88,15,100,11,-14.049568237179408,4
3693,76,12,7,7,-14.076112540272657,5
3694,111,10,54,8,-14.107577214977887,2
3695,104,16,90,11,-14.1449470066471,5
3696,60,19,74,13,-14.155436372823557,6
3697,39,12,92,8,-14.220068086204257,4
3698,18,15,15,11,-14.248476385059174,4
3699,97,10,14,8,-14.259112129654316,2
3700,11,11,30,8,-14.299516136130784,3
3701,37,12,34,9,-14.300571264435137,3
3702,102,11,46,8,-14.307494713152051,3
3703,18,12,30,9,-14.310372508653467,3
3704,83,10,40,8,-14.347262135245904,2
3705,74,10,89,7,-14.446682807284398,3
3706,54,20,100,14,-14.454126910452933,6
3707,2,10,73,7,-14.457830254043136,3
3708,2,11,13,8,-14.516038794033763,3
3709,37,12,73,8,-14.533349572792924,4
3710,54,24,48,17,-14.535603927866182,7
3711,32,14,16,10,-14.542782322425317,4
3712,35,10,27,7,-14.547141678753416,3
3713,77,11,37,8,-14.55993313549925,3
3714,99,12,50,8,-14.581629542155014,4
3715,60,10,100,7,-14.61222507913973,3
3716,39,12,109,10,-14.675982860996212,2
3717,106,14,32,11,-14.741977351969277,3
3718,51,23,76,18,-14.827020215296274,5
3719,91,21,87,16,-14.888779659526469,5
3720,31,12,64,9,-14.947538439056409,3
3721,46,15,50,10,-14.99079417434614,5
3722,99,18,25,13,-15.014737107768294,5
3723,96,12,91,9,-15.083901067533665,3
3724,9,12,48,9,-15.097519161061683,3
3725,70,11,80,9,-15.157277297784104,2
3726,107,12,89,9,-15.163906699283089,3
3727,83,16,114,12,-15.254612667104073,4
3728,97,11,67,9,-15.281658756670776,2
3729,40,17,8,13,-15.305006202129846,4
3730,99,11,7,8,-15.315874324967403,3
3731,28,16,34,12,-15.364383659890448,4
3732,106,26,114,19,-15.3793721943578,7
3733,1,12,8,9,-15.41740871544165,3
3734,25,14,49,10,-15.43786379260084,4
3735,97,12,90,8,-15.449883037579118,4
3736,104,10,1,7,-15.492735116501894,3
3737,2,18,104,12,-15.50344370749933,6
3738,28,15,99,11,-15.590204088651852,4
3739,5,16,23,12,-15.598001372374195,4
3740,35,12,80,9,-15.72406211872363,3
3741,96,16,93,12,-15.73319462766121,4
3742,17,10,34,8,-15.751264612759243,2
3743,63,12,14,8,-15.759973477645744,4
3744,70,10,48,7,-15.796496446665468,3
3745,39,18,99,14,-15.84878961626863,4
3746,29,13,88,9,-15.850906570917441,4
3747,106,14,67,10,-15.86890640221611,4
3748,50,17,80,14,-15.873366771105449,3
3749,18,13,23,9,-15.879451530655546,4
3750,71,10,9,7,-15.885359893651664,3
3751,83,16,13,12,-15.934926256250732,4
3752,11,21,95,16,-16.006249051562754,5
3753,77,23,7,17,-16.02212846305278,6
3754,69,10,63,8,-16.160747939092687,2
3755,16,10,73,7,-16.163676933136152,3
3756,88,13,32,9,-16.30207764263433,4
3757,25,25,11,20,-16.429746187224737,5
3758,6,10,13,7,-16.528041255540565,3
3759,109,14,27,9,-16.556988432864937,5
3760,8,10,64,8,-16.564735872759318,2
3761,71,11,17,8,-16.56575599361363,3
3762,60,12,37,9,-16.65752424604732,3
3763,5,14,41,9,-16.723825478761608,5
3764,5,17,30,14,-16.835862346935006,3
3765,30,14,95,10,-16.836817117204564,4
3766,17,12,40,10,-16.84478158480246,2
3767,86,11,10,8,-16.95145578080744,3
3768,8,12,34,9,-16.979471141980934,3
3769,46,10,53,7,-17.02359024433546,3
3770,5,21,27,15,-17.023938523878094,6
3771,80,10,75,8,-17.160491094383627,2
3772,77,13,30,10,-17.183365854009374,3
3773,35,12,63,9,-17.190706154289504,3
3774,36,12,8,9,-17.245136656584343,3
3775,106,10,35,7,-17.319051156851785,3
3776,86,10,43,8,-17.32008208206117,2
3777,87,11,34,8,-17.33811535027782,3
3778,51,23,95,18,-17.356501303335026,5
3779,67,10,16,8,-17.493350405648194,2
3780,103,11,86,8,-17.582574899359507,3
3781,75,10,111,7,-17.66236285305389,3
3782,77,14,16,11,-17.677083033460956,3
3783,77,13,8,10,-17.994666569137152,3
3784,86,11,26,9,-18.01144379039894,2
3785,50,16,60,12,-18.19360808256495,4
3786,31,13,63,10,-18.243604523218732,3
3787,65,16,100,13,-18.24556237407802,3
3788,51,10,78,7,-18.313942549506056,3
3789,39,13,100,10,-18.341842925227056,3
3790,18,10,5,8,-18.464269170029826,2
3791,46,10,98,7,-18.66966202924449,3
3792,109,23,114,19,-18.68316706099083,4
3793,5,10,44,8,-18.75866141385734,2
3794,28,26,90,21,-18.776580206085534,5
3795,51,15,90,13,-18.880140990693626,2
3796,60,14,27,12,-18.903299216443365,2
3797,11,10,2,8,-18.92308479788875,2
3798,50,14,77,12,-18.960104376358405,2
3799,106,14,69,11,-18.98728224350163,3
3800,5,12,48,10,-19.15405252867682,2
3801,91,13,104,12,-19.168888324804986,1
3802,112,14,28,11,-19.249826897720947,3
3803,18,14,99,11,-19.290873438644514,3
3804,71,10,95,6,-19.39571879208051,4
3805,39,16,15,13,-19.411328140872982,3
3806,32,12,95,10,-19.760326388824467,2
3807,66,10,107,8,-20.152222817707916,2
3808,33,16,55,13,-20.174007528343807,3
3809,54,10,4,9,-20.381350839445236,1
3810,13,11,57,8,-20.619945240208803,3
3811,40,11,111,8,-20.888432020263263,3
3812,36,13,63,11,-20.993616769797566,2
3813,68,10,61,8,-21.209357422961563,2
3814,54,11,71,9,-21.21323377888104,2
3815,17,10,23,8,-21.215760860674102,2
3816,60,10,3,8,-21.472587204089837,2
3817,43,10,55,9,-21.477560682480068,1
3818,9,15,27,11,-21.65491087687076,4
3819,52,12,86,10,-21.816288972743816,2
3820,97,11,38,10,-22.176359713839883,1
3821,51,11,34,9,-22.213174768846976,2
3822,51,13,2,10,-22.46077922587735,3
3823,55,12,14,11,-22.798222840334333,1
3824,28,10,10,9,-23.03135332069283,1
3825,55,10,44,8,-23.361076236430034,2
3826,77,14,75,12,-24.219783572291735,2
3827,35,10,48,9,-25.15519793083891,1
3828,71,11,40,10,-25.278218082934544,1
3829,39,10,3,10,-28.725074023896866,0
