,againstHero,games,hero,losses,shift,wins
0,19,10,107,1,28.256315341969916,9
1,64,11,65,2,27.727149312498728,9
2,91,10,43,0,27.34458455824453,10
3,46,11,30,2,24.436531907478123,9
4,55,11,89,2,24.169792122479972,9
5,103,15,86,2,23.967936503754764,13
6,65,10,97,3,23.53209680517744,7
7,106,10,50,1,23.514739146454772,9
8,6,10,12,3,23.4207865353791,7
9,57,13,41,2,23.15616213187528,11
10,26,10,10,2,22.77202326046866,8
11,84,10,94,1,22.762013140609877,9
12,20,11,85,2,22.58682017719025,9
13,17,11,44,2,22.072912946241175,9
14,111,25,70,6,21.76194128198864,19
15,74,14,110,3,20.875047711546735,11
16,37,10,104,2,20.681486856575926,8
17,28,10,71,1,20.618030954774138,9
18,18,11,37,2,20.49673353679967,9
19,110,12,109,2,20.16933250309851,10
20,51,12,98,3,20.0679948728163,9
21,90,12,76,4,19.849308288721737,8
22,41,13,10,2,19.737157878272868,11
23,62,15,50,3,19.692589576651248,12
24,87,19,46,5,19.57398065475983,14
25,87,30,109,7,19.45596890113392,23
26,110,12,29,2,19.248543702222978,10
27,63,15,28,3,19.065782846243966,12
28,62,12,71,1,19.04348733516107,11
29,26,11,88,3,18.785991491960512,8
30,88,15,75,3,18.461574020804573,12
31,79,13,7,3,18.404801500191937,10
32,58,13,87,2,18.24410492014657,11
33,107,12,73,3,18.009767759901283,9
34,64,11,9,3,17.707873254379976,8
35,63,16,70,4,17.68149233309164,12
36,41,10,110,1,17.607251464829996,9
37,57,19,28,4,17.559820084625652,15
38,88,19,49,4,17.532034552741443,15
39,39,10,55,3,17.520622017928282,7
40,37,10,89,2,17.418835616565147,8
41,26,11,49,4,17.344464565076983,7
42,63,21,86,4,16.96237320607365,17
43,26,13,54,5,16.93978716229654,8
44,43,14,38,5,16.91598228541753,9
45,38,12,15,3,16.880495720481193,9
46,70,18,86,5,16.806348175717314,13
47,73,16,109,4,16.722107664046142,12
48,49,10,96,3,16.4668046049511,7
49,63,11,10,3,16.316509167938314,8
50,62,13,103,4,16.29915650058687,9
51,5,12,9,3,16.296173952922768,9
52,59,11,103,3,16.266656443008642,8
53,55,14,75,3,16.265128193907934,11
54,87,14,85,3,16.25520793639719,11
55,17,14,37,5,16.224073122382876,9
56,30,25,65,6,16.220777761486314,19
57,90,18,88,5,16.196945416210344,13
58,90,12,91,4,16.098702445179015,8
59,46,15,79,5,15.695062063539163,10
60,17,15,38,4,15.678044683298898,11
61,29,12,73,3,15.669782329836798,9
62,46,10,107,2,15.65139707745225,8
63,106,20,87,4,15.583574530645652,16
64,16,10,59,4,15.561569445873218,6
65,39,11,54,3,15.528226686771601,8
66,28,11,66,4,15.514046365780628,7
67,106,12,11,2,15.453171865714515,10
68,70,13,88,3,15.44587119057327,10
69,74,11,112,3,15.445414304360199,8
70,106,12,88,2,15.367046226675958,10
71,63,16,76,3,15.315183161564981,13
72,90,11,18,3,15.206260273523743,8
73,84,14,40,5,15.139436492633184,9
74,57,15,37,4,15.067776643574769,11
75,55,13,85,4,14.980602580320598,9
76,26,24,38,7,14.873702675608982,17
77,93,11,17,3,14.792328082005683,8
78,93,25,38,8,14.706979782976543,17
79,49,11,62,4,14.691411076024671,7
80,90,11,93,4,14.682520064465667,7
81,88,14,13,6,14.6368480815469,8
82,62,19,20,5,14.584809923949425,14
83,48,11,73,3,14.582237633015303,8
84,55,15,11,4,14.552741756285249,11
85,111,31,62,9,14.463263378850396,22
86,104,10,50,3,14.369017199502489,7
87,46,11,91,3,14.304066831342244,8
88,60,10,8,3,14.262033464961128,7
89,50,12,109,4,14.261856398454313,8
90,57,14,76,4,14.156354151485953,10
91,30,14,85,4,14.008346410378739,10
92,57,20,9,5,13.952239963411898,15
93,30,27,54,8,13.923397923845725,19
94,70,12,109,3,13.902253335630233,9
95,55,22,2,7,13.871872112800908,15
96,38,16,73,6,13.771113964229547,10
97,111,16,109,5,13.722443192828694,11
98,37,10,13,3,13.710588735524032,7
99,26,13,69,4,13.66583811938565,9
100,84,17,13,6,13.614397809771186,11
101,37,12,5,3,13.593067112324485,9
102,28,29,109,9,13.560226410906258,20
103,107,27,62,9,13.491527071908125,18
104,13,15,73,5,13.471561712276639,10
105,10,24,23,9,13.345513564331808,15
106,30,12,62,4,13.325811773490166,8
107,18,13,2,4,13.31796160775977,9
108,89,12,73,4,13.292782754035754,8
109,58,10,89,3,13.242354787086834,7
110,55,17,109,5,13.091080409868951,12
111,30,24,9,7,13.086601208658116,17
112,107,15,70,5,13.053888487638648,10
113,50,10,11,3,13.016746288382762,7
114,51,17,48,4,12.926828220690847,13
115,3,11,8,3,12.917286316124727,8
116,6,14,66,4,12.900366001703459,10
117,86,14,17,4,12.845058614378047,10
118,2,21,76,7,12.801773404860658,14
119,69,10,41,4,12.786110356364535,6
120,26,35,107,9,12.719830578595298,26
121,73,11,90,3,12.699639901607053,8
122,46,21,9,8,12.65253338448702,13
123,73,15,23,5,12.578415919943863,10
124,8,15,66,4,12.577302494556069,11
125,86,13,109,5,12.564742847433584,8
126,13,10,86,3,12.514933779078898,7
127,104,12,48,3,12.498145078794371,9
128,93,22,62,7,12.439036445917942,15
129,20,18,23,5,12.419097927334024,13
130,9,11,97,4,12.349501112253755,7
131,93,12,26,4,12.342400061412198,8
132,93,17,50,6,12.303370496346986,11
133,63,16,9,6,12.275723948784513,10
134,93,20,41,5,12.152619394683915,15
135,54,27,109,9,12.131563798369136,18
136,58,11,103,3,12.093407699535737,8
137,79,11,112,3,12.089617166544242,8
138,29,11,70,3,12.030336124564109,8
139,38,15,10,4,12.029907406435383,11
140,63,21,79,7,11.989301107152892,14
141,14,11,65,3,11.952914938466222,8
142,93,10,76,3,11.9232506042626,7
143,18,13,17,5,11.905263091036245,8
144,16,15,106,5,11.893774539717962,10
145,55,13,106,4,11.870951241031621,9
146,43,14,109,5,11.866460109925438,9
147,85,17,37,4,11.836833776252563,13
148,23,15,62,4,11.828374088275869,11
149,28,14,112,5,11.811196680681133,9
150,50,11,37,4,11.791517943036679,7
151,37,14,63,5,11.788951691627307,9
152,26,14,46,5,11.785571142877396,9
153,104,18,98,7,11.758094591275455,11
154,15,10,79,3,11.756403792330063,7
155,93,15,48,4,11.743861625157336,11
156,70,13,62,5,11.719880801732709,8
157,46,11,86,3,11.702567693743317,8
158,93,13,75,5,11.701725422413729,8
159,93,15,1,4,11.687642643688715,11
160,10,18,55,7,11.634204977110192,11
161,98,17,15,6,11.628891195956703,11
162,32,15,88,4,11.62259561238565,11
163,30,26,103,8,11.5945127814643,18
164,65,16,18,5,11.593628436717697,11
165,74,22,48,8,11.585683993127107,14
166,16,18,13,6,11.568229122492738,12
167,65,16,102,6,11.565057266886955,10
168,38,22,109,7,11.561969316834697,15
169,107,10,7,3,11.56115244063066,7
170,109,15,6,5,11.553622356231047,10
171,16,28,70,8,11.544275868635912,20
172,41,31,109,7,11.540113156994366,24
173,43,17,28,5,11.503038032270851,12
174,17,20,41,5,11.462467383182338,15
175,34,15,91,5,11.445515293888622,10
176,2,22,103,6,11.358008021341288,16
177,39,10,2,4,11.302944205280658,6
178,13,13,41,5,11.285884419294261,8
179,98,12,71,4,11.256798740703502,8
180,65,18,44,7,11.219859746185271,11
181,20,14,48,4,11.21238169699314,10
182,15,10,28,3,11.176545961741331,7
183,93,19,37,6,11.135373057728058,13
184,74,10,104,3,11.124138818031259,7
185,35,10,28,3,11.074308940964794,7
186,30,20,16,6,11.056706393827778,14
187,98,12,110,4,11.026999619900328,8
188,49,17,16,6,11.010920636133424,11
189,20,19,10,6,11.010427213733353,13
190,38,14,6,4,11.005398790381081,10
191,30,10,43,3,10.958461383133036,7
192,55,23,62,9,10.947383871127185,14
193,49,18,86,8,10.91347154436731,10
194,98,48,41,18,10.835326353590219,30
195,17,16,23,5,10.781653305644484,11
196,93,37,9,12,10.753480854770812,25
197,107,12,66,4,10.732234223681386,8
198,87,29,6,10,10.703931695338108,19
199,91,10,85,5,10.702453755941072,5
200,37,14,41,5,10.694476243263011,9
201,6,35,44,13,10.67278245600393,22
202,107,16,109,6,10.668493285549742,10
203,38,13,58,4,10.642287291889902,9
204,98,37,88,11,10.639663528048942,26
205,48,10,39,4,10.636653060776387,6
206,54,15,104,5,10.631063301403962,10
207,65,10,101,4,10.616476001261294,6
208,110,17,8,5,10.493443474648158,12
209,10,19,1,6,10.478183626603695,13
210,14,10,54,3,10.443430113517227,7
211,64,17,86,6,10.437285409841268,11
212,70,19,65,6,10.41844263586608,13
213,29,10,17,3,10.395985227153457,7
214,2,11,75,4,10.369833561069749,7
215,8,14,89,5,10.313019177206716,9
216,60,10,38,4,10.186949801542621,6
217,37,14,34,5,10.040882054419713,9
218,65,14,59,6,10.036164804159641,8
219,88,11,30,5,10.02483572373662,6
220,11,11,48,4,10.021932577969972,7
221,76,17,34,6,9.994247540573088,11
222,90,20,23,7,9.967154481509692,13
223,111,24,38,9,9.966212518632439,15
224,93,11,70,4,9.928875321549775,7
225,87,13,17,5,9.922998390575081,8
226,16,11,108,4,9.921562283850516,7
227,11,17,86,7,9.920784017899694,10
228,10,14,50,5,9.907166966632534,9
229,107,30,41,12,9.880991735942342,18
230,32,22,109,8,9.859589833142886,14
231,17,28,9,10,9.851089499965493,18
232,111,20,37,8,9.840471570719451,12
233,54,25,76,10,9.821966207421672,15
234,70,13,74,4,9.800022679632328,9
235,93,17,91,6,9.794639196057782,11
236,63,18,91,7,9.755061220541068,11
237,84,13,106,6,9.721232372178164,7
238,73,21,111,8,9.713634051639158,13
239,29,32,38,11,9.681299801122258,21
240,88,11,85,4,9.65630194872786,7
241,106,14,20,6,9.651889529369445,8
242,98,26,62,10,9.641858129313677,16
243,13,21,8,7,9.615323131026955,14
244,8,12,35,5,9.605315474711038,7
245,30,18,70,6,9.585226013483615,12
246,23,22,89,8,9.576875474490599,14
247,60,21,65,8,9.571951123571171,13
248,6,11,58,4,9.489496457414935,7
249,103,11,19,4,9.481054864710421,7
250,18,17,84,6,9.48013150601899,11
251,8,20,71,8,9.460862953446574,12
252,87,16,5,6,9.446283858022081,10
253,30,27,87,9,9.441306317195094,18
254,57,11,10,4,9.43267475148189,7
255,34,16,74,6,9.430626027485216,10
256,48,17,35,6,9.405686959524614,11
257,46,17,8,6,9.405496106583277,11
258,55,22,30,9,9.385734127086305,13
259,63,26,54,10,9.380965402014514,16
260,2,33,86,11,9.362488660748074,22
261,79,19,75,6,9.342561498216153,13
262,50,17,23,7,9.300090532650529,10
263,20,34,9,11,9.290302263411942,23
264,38,20,86,6,9.280969369301586,14
265,43,14,50,5,9.27474781724881,9
266,110,12,50,4,9.252517401752682,8
267,111,46,54,17,9.235401744617302,29
268,55,16,37,6,9.183747537097531,10
269,13,26,28,8,9.183739107543797,18
270,84,28,85,12,9.160197369727126,16
271,93,29,103,11,9.099325117611023,18
272,26,12,32,5,9.09769401619869,7
273,106,13,109,5,9.062668099795829,8
274,15,12,16,4,9.059606623425509,8
275,91,16,50,5,9.044194652502608,11
276,74,35,76,12,9.02110943529627,23
277,84,11,44,4,9.017421120510091,7
278,41,19,62,7,9.00335332858162,12
279,37,41,86,16,8.9832167055326,25
280,74,19,18,7,8.9712615057984,12
281,65,14,96,6,8.945535735868065,8
282,48,18,111,6,8.93792122942067,12
283,107,20,110,8,8.933567921834609,12
284,10,20,86,7,8.92570532964782,13
285,112,11,50,4,8.921235906620762,7
286,8,23,57,9,8.905396375956737,14
287,10,11,85,5,8.810276618143424,6
288,29,10,76,3,8.806443209825622,7
289,23,24,93,10,8.804783518097919,14
290,93,32,84,11,8.779261084845606,21
291,104,27,28,9,8.752482125180736,18
292,63,12,20,4,8.747811376407107,8
293,30,24,37,8,8.742074606758964,16
294,32,17,107,5,8.731768023357226,12
295,55,31,54,10,8.716015508186064,21
296,76,16,62,8,8.710475893988358,8
297,2,17,73,7,8.68105241339238,10
298,48,11,75,3,8.67281534666425,8
299,34,18,109,7,8.662734980033562,11
300,65,26,32,10,8.65722618752934,16
301,84,14,66,5,8.616861190106436,9
302,11,10,76,4,8.560443995014507,6
303,32,25,9,9,8.53109215537152,16
304,98,60,65,22,8.49413981702294,38
305,30,27,86,7,8.45360686296445,20
306,98,21,1,7,8.436557583367685,14
307,73,21,10,7,8.419335562342072,14
308,90,11,89,4,8.396796914570167,7
309,48,12,38,4,8.376240779730173,8
310,20,10,70,3,8.374580328727138,7
311,77,12,8,4,8.373441110755328,8
312,30,17,50,7,8.363042610972485,10
313,76,18,41,7,8.284971187696902,11
314,65,12,58,6,8.279172093518044,6
315,76,11,109,3,8.273966572487598,8
316,17,30,8,11,8.267140148743708,19
317,51,11,37,4,8.265197669915755,7
318,111,14,17,6,8.239799794462428,8
319,26,10,16,4,8.231874067384071,6
320,28,13,94,5,8.222371266039163,8
321,93,36,54,11,8.207302497792842,25
322,11,11,9,4,8.198586667223204,7
323,32,24,41,10,8.170536046764159,14
324,26,44,87,17,8.146474895568335,27
325,55,36,9,12,8.11977265059526,24
326,10,31,28,10,8.119129269340046,21
327,19,14,9,6,8.117304295019109,8
328,54,39,41,14,8.096759700478561,25
329,30,15,10,5,8.08039942607508,10
330,6,12,13,5,8.074590184679876,7
331,55,50,87,18,8.001636513353814,32
332,90,15,41,6,7.997737246515682,9
333,65,35,48,13,7.9807562612280805,22
334,109,12,37,5,7.972273664149992,7
335,71,10,9,4,7.971373091011489,6
336,111,27,86,11,7.962255850113393,16
337,2,41,65,14,7.9589934151571535,27
338,107,29,6,11,7.905082416130331,18
339,74,27,88,9,7.895683127849934,18
340,49,14,13,6,7.890029815709072,8
341,109,30,9,12,7.889736540676636,18
342,74,11,12,5,7.8813359238936185,6
343,20,18,49,7,7.854535242795636,11
344,98,18,11,7,7.845858753819518,11
345,28,19,11,7,7.83619411212359,12
346,76,32,37,11,7.820497576953577,21
347,30,15,49,6,7.795814319272768,9
348,29,13,109,5,7.7648215544268036,8
349,50,17,48,7,7.751737687672278,10
350,103,15,109,5,7.74806703390503,10
351,55,26,38,11,7.745065833950479,15
352,84,28,88,10,7.743138956836476,18
353,111,14,85,5,7.729378570457984,9
354,23,11,59,4,7.703199044299857,7
355,65,24,50,9,7.669757652755209,15
356,84,19,62,8,7.65619075053016,11
357,49,22,65,9,7.648203777845676,13
358,54,10,106,4,7.643289711475541,6
359,87,16,34,6,7.640142491832506,10
360,84,30,10,12,7.620608168656018,18
361,91,21,76,8,7.53854735511653,13
362,29,20,107,7,7.525530619454996,13
363,34,10,38,4,7.513274255260262,6
364,11,13,87,5,7.500246141417867,8
365,43,19,87,7,7.5001879241242175,12
366,79,12,80,5,7.494960416200487,7
367,54,27,37,9,7.469706742796568,18
368,111,30,32,13,7.463790988299924,17
369,104,10,23,4,7.459802178175596,6
370,23,24,37,9,7.440544332640973,15
371,88,17,57,7,7.432081698575297,10
372,98,14,68,4,7.427653338623123,10
373,75,13,9,4,7.420012168869883,9
374,103,29,74,10,7.419118005067162,19
375,41,13,49,4,7.406139067429071,9
376,98,15,5,6,7.40308817440165,9
377,54,21,10,8,7.316914939103651,13
378,50,11,68,4,7.299975074722132,7
379,13,13,20,4,7.287197108459041,9
380,41,22,86,9,7.286274520016925,13
381,23,15,70,6,7.277989111704888,9
382,30,10,73,4,7.27524129591905,6
383,88,14,38,6,7.257573306252311,8
384,74,19,109,8,7.255868408074382,11
385,55,41,98,16,7.2398162826998345,25
386,10,19,76,8,7.223608714939963,11
387,87,10,56,4,7.222698791088141,6
388,84,48,48,20,7.209403276697926,28
389,111,13,34,6,7.201437198359541,7
390,5,11,6,4,7.175117705775805,7
391,90,12,70,4,7.158523730695325,8
392,98,35,76,14,7.116562365346761,21
393,16,16,89,6,7.102664218068734,10
394,10,10,13,5,7.081545477709261,5
395,98,24,34,8,7.0691518153654185,16
396,8,53,48,21,7.064834453033995,32
397,11,13,54,5,7.053030822989655,8
398,91,37,28,14,7.047707205955762,23
399,87,34,50,13,7.043252292270627,21
400,59,19,79,8,7.0352036880537865,11
401,8,56,76,22,7.029702728241303,34
402,111,20,6,8,7.01838566892247,12
403,8,48,93,18,7.017566439579715,30
404,51,10,6,3,7.003530037614207,7
405,90,19,6,8,7.0034906221582,11
406,79,11,101,5,6.9908614259308735,6
407,73,10,68,4,6.95394987102174,6
408,90,14,17,6,6.930186835428711,8
409,107,30,50,11,6.921374494500155,19
410,57,12,74,4,6.9176042424257504,8
411,8,36,38,14,6.910326910265974,22
412,41,45,103,15,6.896034695840802,30
413,65,18,68,8,6.89592459737167,10
414,89,11,87,4,6.890327484533061,7
415,17,20,84,8,6.874361487047255,12
416,90,24,8,9,6.838297347223881,15
417,16,71,9,26,6.825766832468779,45
418,28,11,64,5,6.82253762472366,6
419,32,26,79,10,6.821690929992381,16
420,88,21,6,8,6.808639243885847,13
421,76,39,28,16,6.804995058327358,23
422,91,35,41,13,6.801656465480552,22
423,16,25,85,10,6.790728536327192,15
424,93,14,43,5,6.79067137162001,9
425,55,35,20,15,6.786443158254519,20
426,87,50,28,20,6.785536302011417,30
427,26,24,109,9,6.785414157125367,15
428,73,13,93,5,6.746815708884676,8
429,111,42,41,18,6.742879314894578,24
430,2,19,34,8,6.729658072634226,11
431,18,24,79,11,6.727434004130173,13
432,89,11,74,5,6.7140175484003635,6
433,73,16,88,6,6.709173893318198,10
434,79,18,62,8,6.70668334197217,10
435,20,34,79,13,6.674702669544552,21
436,18,24,9,10,6.669379438735331,14
437,74,16,49,7,6.669033870592301,9
438,86,14,85,7,6.640232602185862,7
439,23,14,18,5,6.63118753114106,9
440,107,20,76,8,6.611819543573891,12
441,74,23,38,10,6.562267688513878,13
442,28,54,41,24,6.549671741224454,30
443,16,40,88,14,6.547604687657639,26
444,79,18,70,9,6.541994947083337,9
445,74,15,106,7,6.5362197915338545,8
446,16,79,86,31,6.517762010081222,48
447,17,13,62,5,6.51109228837904,8
448,87,25,18,9,6.500921078177537,16
449,73,36,9,15,6.4959532992484235,21
450,23,11,48,5,6.485113687277626,6
451,17,10,10,4,6.479497194252798,6
452,32,16,86,7,6.471177759830174,9
453,28,74,9,32,6.46902981057878,42
454,90,10,62,4,6.441503246890602,6
455,88,34,54,14,6.435609123308374,20
456,12,14,28,5,6.429365216940004,9
457,86,24,88,9,6.421829854483621,15
458,16,25,91,10,6.409140256729836,15
459,90,12,50,5,6.3963545792520575,7
460,15,14,84,5,6.375647385580588,9
461,103,22,88,8,6.368772240906124,14
462,31,10,28,4,6.368565836830035,6
463,106,17,86,6,6.344519143476505,11
464,86,18,73,7,6.340120760849839,11
465,14,11,79,4,6.325200961615044,7
466,88,41,76,18,6.323191299261618,23
467,62,19,54,7,6.312055934230411,12
468,8,33,109,14,6.3077294568861335,19
469,90,16,54,7,6.290244829620479,9
470,79,23,106,10,6.288631840986401,13
471,6,40,28,16,6.2836176921265,24
472,111,15,44,6,6.282001615200402,9
473,6,11,106,5,6.262787648448941,6
474,2,17,48,8,6.245081234312723,9
475,2,35,41,13,6.231438093089566,22
476,16,14,34,6,6.229556768499603,8
477,2,11,66,4,6.205381429919993,7
478,90,21,87,7,6.151740663205762,14
479,74,53,65,21,6.137709015019595,32
480,111,11,56,4,6.133528731729061,7
481,87,45,41,20,6.130516050826405,25
482,30,14,76,5,6.105099986395528,9
483,70,21,76,8,6.104247467977058,13
484,28,25,89,11,6.088973901063954,14
485,74,30,86,12,6.063445254541929,18
486,93,15,30,6,6.056393100709427,9
487,54,49,9,20,6.050802275785849,29
488,79,32,107,12,6.039727207849199,20
489,35,13,86,4,6.029699746849705,9
490,1,14,107,6,6.012748941227003,8
491,84,41,76,19,6.0122133251855985,22
492,98,48,91,22,6.010481139866045,26
493,49,10,77,5,6.002993751357126,5
494,107,19,34,8,5.973688522150957,11
495,74,25,6,10,5.973570320498578,15
496,17,10,34,4,5.97086385916694,6
497,20,33,103,11,5.96431634987825,22
498,8,23,49,10,5.962799116224744,13
499,89,25,10,10,5.961935346068015,15
500,49,30,98,13,5.930886416801632,17
501,16,13,96,5,5.918742950992743,8
502,111,71,65,33,5.901383737891229,38
503,98,49,103,19,5.894528502030377,30
504,17,17,16,7,5.868342075872022,10
505,63,25,48,10,5.850121984887349,15
506,49,28,87,13,5.837138934523044,15
507,104,12,84,5,5.83583289734061,7
508,46,14,37,6,5.834073346635607,8
509,2,10,44,4,5.82972376449153,6
510,2,11,51,5,5.82458141989376,6
511,1,12,86,5,5.820822605148493,7
512,96,10,28,4,5.817657099477481,6
513,13,21,79,7,5.816978385717296,14
514,23,16,55,7,5.806506460340061,9
515,93,35,87,14,5.801672416811602,21
516,63,14,87,6,5.794939568846776,8
517,15,23,76,9,5.782831260117769,14
518,32,18,54,7,5.782610489553489,11
519,51,14,79,6,5.7725066910082035,8
520,49,24,9,9,5.76893486693949,15
521,75,15,28,7,5.767432508412387,8
522,38,29,9,13,5.756435186772363,16
523,90,20,37,8,5.742590617036877,12
524,55,20,76,9,5.742456288243529,11
525,89,23,65,10,5.729458742490648,13
526,18,11,51,5,5.697627847770078,6
527,43,13,9,6,5.682535108763634,7
528,8,13,56,5,5.662090518526135,8
529,63,50,65,21,5.6463970088136985,29
530,41,45,9,17,5.6439057397283525,28
531,26,22,29,8,5.630548836449718,14
532,74,35,91,15,5.590543375115505,20
533,28,25,17,10,5.573169674184406,15
534,9,12,51,5,5.566013437140973,7
535,28,11,97,6,5.54697078214519,5
536,6,35,48,15,5.544547995709246,20
537,46,10,2,4,5.541906116456113,6
538,63,15,98,7,5.5319776999855375,8
539,23,41,8,17,5.530959099012352,24
540,111,36,103,15,5.530917867453256,21
541,28,46,54,19,5.5206143371290795,27
542,34,10,51,4,5.497172152397963,6
543,74,21,73,9,5.496437468937688,12
544,16,39,87,17,5.479884914015475,22
545,54,35,38,14,5.47856504565386,21
546,93,28,74,10,5.4705081639253095,18
547,87,16,57,7,5.466000765538215,9
548,14,10,9,3,5.463439437022661,7
549,16,26,107,11,5.454588725112236,15
550,109,16,23,6,5.438260955948294,10
551,87,22,51,10,5.433091918626146,12
552,94,18,20,7,5.424401699040207,11
553,20,26,38,11,5.422962328602487,15
554,55,27,41,13,5.421661683278699,14
555,98,37,50,17,5.407228229606667,20
556,43,11,103,5,5.4056340195812504,6
557,19,10,28,4,5.405282356849322,6
558,6,27,20,13,5.3915163015983865,14
559,110,23,65,9,5.3850619906564345,14
560,8,66,41,30,5.38335326188138,36
561,54,11,71,4,5.354693946074447,7
562,20,20,88,8,5.3485269428007625,12
563,63,22,16,10,5.328266419123545,12
564,20,84,65,34,5.311994770706184,50
565,93,43,28,18,5.299040789810327,25
566,104,14,76,6,5.288345369680406,8
567,17,23,79,10,5.280486878224028,13
568,87,50,9,22,5.2671060931851255,28
569,63,15,85,7,5.266282773446653,8
570,74,22,29,10,5.260819792223967,12
571,28,20,85,9,5.2561838588407,11
572,18,19,48,8,5.245315113768612,11
573,1,10,111,5,5.238983537325087,5
574,16,16,93,7,5.217988854591054,9
575,55,14,18,6,5.21003106995447,8
576,111,10,57,4,5.186942618450884,6
577,104,15,62,6,5.186101581217904,9
578,16,30,74,12,5.170451377759473,18
579,26,38,20,16,5.156160372920298,22
580,34,25,79,12,5.148724789022986,13
581,98,10,52,5,5.141825899051737,5
582,87,24,88,9,5.130994862549945,15
583,41,29,89,12,5.128070897369617,17
584,20,31,84,12,5.125132779135493,19
585,103,21,18,9,5.1172633080953505,12
586,87,27,76,11,5.116388437491941,16
587,70,10,48,4,5.103393723771425,6
588,107,28,2,12,5.101731059055636,16
589,9,11,1,5,5.096238795529086,6
590,29,25,84,11,5.094046057364016,14
591,16,20,73,9,5.070658783374491,11
592,109,16,84,7,5.067243867891083,9
593,63,14,88,6,5.029062789658772,8
594,84,28,63,11,5.019888301540257,17
595,89,15,84,5,5.015269353437395,10
596,79,16,73,7,5.012547822539445,9
597,107,19,104,7,4.998347958456829,12
598,26,30,65,13,4.98261857456072,17
599,50,18,73,9,4.9783134285735455,9
600,89,10,20,4,4.976403038151212,6
601,46,10,70,4,4.972558334053198,6
602,10,10,59,5,4.967497448599417,5
603,1,17,8,8,4.943313786871868,9
604,11,11,93,6,4.9352888324581015,5
605,46,11,103,5,4.9349144398730305,6
606,65,11,5,5,4.90161537792141,6
607,34,17,65,8,4.896601201112152,9
608,62,27,9,11,4.876428914210389,16
609,38,24,87,10,4.849210013950484,14
610,39,11,63,5,4.830077117168623,6
611,89,11,109,5,4.829014520032646,6
612,110,10,28,5,4.821015306608337,5
613,55,29,6,10,4.803715742468646,19
614,86,11,18,5,4.795064637153174,6
615,34,10,103,3,4.7904730345691835,7
616,111,10,104,4,4.785383853867563,6
617,84,29,34,11,4.780446789091473,18
618,46,23,54,9,4.7761943840724514,14
619,46,19,28,8,4.773210022871566,11
620,98,17,94,7,4.761676089313327,10
621,65,66,54,30,4.757496898509859,36
622,107,36,9,18,4.756936242672488,18
623,88,10,104,4,4.74391725280927,6
624,6,12,32,5,4.741771241477238,7
625,76,21,35,8,4.725447690057796,13
626,90,30,9,13,4.71783274464291,17
627,87,14,14,6,4.712999134730352,8
628,109,19,93,8,4.710552248323453,11
629,9,39,86,17,4.70220588142573,22
630,50,39,79,18,4.700291458157237,21
631,51,24,86,10,4.69284349674076,14
632,26,16,6,6,4.685058896386023,10
633,63,21,107,8,4.678463769301045,13
634,41,53,20,21,4.672832095577478,32
635,87,46,86,19,4.648429262967539,27
636,9,29,88,12,4.640775240739044,17
637,16,23,104,10,4.63379333705212,13
638,68,11,87,5,4.6261419910984936,6
639,86,10,15,5,4.60305467364883,5
640,8,101,9,46,4.590254866611679,55
641,8,84,79,40,4.5760241503466785,44
642,2,31,6,13,4.57536971568475,18
643,17,15,48,7,4.57243158960934,8
644,2,37,9,17,4.570200756721712,20
645,8,24,106,12,4.568385804351563,12
646,55,22,32,9,4.561305856484579,13
647,9,20,89,7,4.555028073124964,13
648,90,19,48,8,4.553954489066489,11
649,74,24,23,11,4.530539923458648,13
650,65,26,109,13,4.522732343847645,13
651,91,36,9,16,4.519475424395421,20
652,86,18,93,8,4.518633091858861,10
653,111,29,93,14,4.510765206652466,15
654,38,38,28,17,4.506160175549613,21
655,9,17,59,7,4.5029610514141964,10
656,29,11,62,5,4.502398822563124,6
657,111,29,91,14,4.500138929465921,15
658,14,15,28,5,4.4990639134595956,10
659,29,21,93,9,4.4989593922467,12
660,74,31,107,13,4.496848852346025,18
661,111,21,29,11,4.484029622528672,10
662,111,25,15,10,4.472513123100842,15
663,73,23,84,8,4.463513313785126,15
664,84,32,2,14,4.438454989875698,18
665,90,10,13,5,4.435057658973358,5
666,84,36,41,14,4.405400183867787,22
667,111,38,74,17,4.395421398955392,21
668,29,29,8,13,4.3862864415616,16
669,1,14,65,6,4.384642024421804,8
670,54,13,89,5,4.375934710162813,8
671,87,11,94,5,4.375015437142173,6
672,79,13,44,6,4.35641543376227,7
673,75,19,16,8,4.325958452336133,11
674,87,37,29,16,4.317833214151956,21
675,41,20,1,7,4.310885836842606,13
676,30,16,107,6,4.31051675338316,10
677,85,15,48,6,4.3053632687921874,9
678,55,14,34,5,4.304037025765173,9
679,32,25,98,11,4.297859841525708,14
680,46,21,76,8,4.290697960762892,13
681,103,34,28,15,4.283445470085917,19
682,37,24,88,10,4.265987830661223,14
683,65,108,9,48,4.259267083972893,60
684,55,16,91,6,4.250002044063523,10
685,58,11,9,4,4.244957448818405,7
686,18,13,49,6,4.243576516469453,7
687,23,41,98,17,4.243286610418413,24
688,51,19,16,7,4.242679291932901,12
689,97,11,8,4,4.238412616249588,7
690,29,26,20,11,4.235090000321542,15
691,87,30,91,13,4.231572272835857,17
692,50,34,103,15,4.223445001067976,19
693,23,20,86,9,4.219319390999459,11
694,93,73,65,32,4.214075863061876,41
695,26,24,103,11,4.2106057067079385,13
696,51,24,8,10,4.1878112962147656,14
697,2,16,32,7,4.169077635966495,9
698,16,22,18,9,4.167483705263703,13
699,16,27,6,13,4.159304128363459,14
700,30,28,8,11,4.155265384733845,17
701,65,23,91,12,4.150101209000142,11
702,16,11,35,5,4.150016684827545,6
703,37,15,2,7,4.147220527730259,8
704,103,28,54,13,4.131111544590628,15
705,37,39,98,17,4.116775978907109,22
706,50,25,86,10,4.103724204758594,15
707,48,33,54,13,4.10362086951445,20
708,106,16,65,7,4.0921186691282205,9
709,32,15,38,6,4.090422340111541,9
710,87,54,79,26,4.0807363503382055,28
711,90,12,104,6,4.064341220930972,6
712,65,10,75,4,4.061741964132056,6
713,84,15,71,7,4.0469973544528735,8
714,107,48,20,22,4.046021303128476,26
715,52,10,65,4,4.03382642115339,6
716,79,44,48,20,4.010962969563104,24
717,10,11,109,5,4.004247407956422,6
718,87,26,37,13,3.9965570187790034,13
719,73,29,8,11,3.9924196449780625,18
720,104,13,10,6,3.98234198179897,7
721,26,26,28,11,3.9790441547640487,15
722,86,35,48,15,3.9586303393963,20
723,51,11,107,4,3.9575121006200358,7
724,23,32,87,13,3.9566444001518777,19
725,93,18,10,7,3.9549788743691674,11
726,23,39,84,18,3.9529498437083554,21
727,16,65,65,30,3.949946744776858,35
728,6,22,73,11,3.947699618921396,11
729,30,19,48,8,3.915724412415478,11
730,94,16,54,8,3.8978006398785645,8
731,98,47,84,21,3.890833745652655,26
732,20,25,109,9,3.878585285280937,16
733,38,14,49,7,3.855128614080598,7
734,23,12,34,6,3.853881899354071,6
735,8,20,75,9,3.8505131421822583,11
736,37,10,75,4,3.844326750652962,6
737,54,19,51,9,3.840546896941151,10
738,16,68,84,31,3.8384485778938835,37
739,17,16,49,7,3.8354352643495573,9
740,8,69,16,29,3.830024698724433,40
741,23,40,9,18,3.825851357048053,22
742,32,14,91,7,3.8253106560348464,7
743,8,39,62,18,3.8203580499873473,21
744,93,15,18,7,3.8000555745474087,8
745,110,12,103,5,3.7849274590311146,7
746,26,11,110,6,3.7814954576991564,5
747,86,43,76,20,3.770551952832362,23
748,74,19,55,10,3.7670610658889934,9
749,28,22,49,9,3.761707702389012,13
750,65,38,86,17,3.7527386956678193,21
751,57,12,18,4,3.7525453734501917,8
752,76,33,48,14,3.748463043734357,19
753,10,20,74,8,3.741560720435788,12
754,48,16,41,7,3.7233952099256955,9
755,84,22,38,9,3.7215580721113755,13
756,60,10,87,5,3.716219490276845,5
757,32,14,10,5,3.709056496740225,9
758,91,15,62,7,3.7079997693755615,8
759,32,35,8,16,3.704344714378896,19
760,16,18,20,9,3.701780437410533,9
761,54,34,70,16,3.700162543327729,18
762,90,33,28,14,3.692345711046821,19
763,26,46,8,22,3.689219062321196,24
764,104,16,87,6,3.675421340584443,10
765,57,17,65,6,3.66200460796526,11
766,16,38,37,15,3.653813418657004,23
767,46,17,88,7,3.642829227288957,10
768,98,10,112,5,3.634369737429613,5
769,10,12,18,4,3.6042571144804363,8
770,87,14,75,7,3.5866681857153266,7
771,54,41,6,16,3.576182334552821,25
772,29,12,46,5,3.5756011188612877,7
773,16,16,57,8,3.5714373486183058,8
774,50,25,38,11,3.5687465201033057,14
775,13,28,9,11,3.550319505488332,17
776,70,26,87,11,3.5345174393475727,15
777,65,13,94,6,3.5056909876146594,7
778,98,32,29,15,3.4944771315816667,17
779,86,10,66,5,3.4816650108427076,5
780,1,14,55,6,3.472860068937084,8
781,23,15,26,7,3.459704667443896,8
782,86,12,57,6,3.4531517504498637,6
783,107,10,37,4,3.444420525023787,6
784,5,10,91,6,3.4255398118724356,4
785,87,53,20,24,3.419631734436972,29
786,98,31,10,14,3.404355165617583,17
787,32,20,84,8,3.403700726822617,12
788,37,40,8,18,3.4036571085144507,22
789,57,12,6,4,3.4000169565132325,8
790,65,16,15,8,3.3963132917863037,8
791,70,14,50,7,3.3858944797818467,7
792,76,14,13,7,3.383197454645703,7
793,2,14,85,7,3.3798876085075156,7
794,6,26,91,12,3.3700663593758144,14
795,49,18,6,8,3.361990920437635,10
796,48,15,96,7,3.3566527784765543,8
797,55,79,8,33,3.3433762407278653,46
798,55,13,57,5,3.3276700776213226,8
799,111,51,9,25,3.320225202022207,26
800,16,18,62,8,3.3165301409136885,10
801,2,26,109,10,3.295965627936023,16
802,57,23,84,10,3.2865946702288213,13
803,59,11,98,5,3.2664563544762513,6
804,73,30,65,13,3.2644989461981972,17
805,30,21,29,10,3.244422511134119,11
806,76,15,18,6,3.2371919896499475,9
807,49,11,85,5,3.2340490592317157,6
808,75,11,86,5,3.23005608562416,6
809,70,28,84,13,3.2115322566926667,15
810,91,13,37,6,3.1893915884876662,7
811,111,15,75,8,3.1768571401147816,7
812,18,13,88,6,3.1759771370815293,7
813,50,19,16,9,3.1594632722429505,10
814,73,16,54,7,3.15458999081358,9
815,23,23,88,10,3.1441600025036927,13
816,13,14,111,6,3.137242431792204,8
817,74,62,8,29,3.093004845550061,33
818,43,16,65,8,3.0818646979565365,8
819,70,15,55,7,3.055120987205429,8
820,62,28,87,12,3.0525441320022706,16
821,26,17,43,7,3.0481873322386313,10
822,9,14,44,8,3.0418979222799787,6
823,48,17,89,8,3.030683667814096,9
824,65,10,66,5,3.0275758007203697,5
825,38,18,16,9,3.0174584469144032,9
826,34,13,48,6,3.0034879360796243,7
827,51,15,65,7,3.002433018856541,8
828,26,16,89,8,3.0015441091670585,8
829,10,23,48,11,2.9986085364843453,12
830,14,10,48,3,2.9948475417245812,7
831,79,58,37,25,2.964015442225525,33
832,65,72,28,32,2.95741614475882,40
833,32,33,28,15,2.9362166355349024,18
834,55,37,88,15,2.9210181897272123,22
835,2,41,10,18,2.8955248222440733,23
836,90,30,111,13,2.8905447130543305,17
837,30,19,6,7,2.8896247906630976,12
838,111,22,76,12,2.8888180973130932,10
839,16,52,98,23,2.8744462121533845,29
840,90,25,107,12,2.8707019854150553,13
841,103,26,91,14,2.81795550429567,12
842,104,12,55,6,2.817049603991469,6
843,8,85,107,41,2.8168131208732516,44
844,8,75,87,33,2.816657962193604,42
845,93,25,107,11,2.8066980710044707,14
846,38,55,65,25,2.8065899103574585,30
847,17,30,103,13,2.786263791329437,17
848,79,29,93,15,2.7764930954452365,14
849,54,34,50,14,2.769221861295628,20
850,70,18,2,7,2.768805537158304,11
851,50,15,89,7,2.7678854176457244,8
852,41,40,23,18,2.767380745524291,22
853,79,26,104,10,2.76733655223797,16
854,2,18,23,9,2.7670043698876174,9
855,84,61,86,27,2.762082939248179,34
856,48,19,103,9,2.74551902113029,10
857,23,14,29,6,2.7325720738957853,8
858,79,25,89,10,2.7323432784581803,15
859,26,14,30,9,2.729526864464305,5
860,48,44,9,19,2.7118293842835715,25
861,103,24,55,11,2.703742749314949,13
862,46,10,18,4,2.6832650728648453,6
863,6,21,86,10,2.6797895540068417,11
864,37,16,20,7,2.6697969055897994,9
865,30,25,38,13,2.6609022960305304,12
866,15,14,8,7,2.659395326985167,7
867,106,11,9,5,2.6544531376629674,6
868,30,24,84,11,2.649950052405462,13
869,48,33,37,16,2.6418897918039517,17
870,8,42,103,17,2.6366758249260935,25
871,111,23,50,10,2.6260965282140734,13
872,9,16,94,8,2.620832608628453,8
873,30,40,28,18,2.6105936366755755,22
874,38,20,112,9,2.5875581099779743,11
875,28,57,86,28,2.5779395106930414,29
876,90,21,16,10,2.556904125602615,11
877,30,10,11,4,2.556482524063204,6
878,91,41,8,20,2.5454365457229,21
879,49,15,48,8,2.5444991556032637,7
880,63,10,49,5,2.5291147398136253,5
881,28,69,16,32,2.52518159689103,37
882,50,19,29,8,2.5251415163545525,11
883,28,27,70,14,2.5100244330478434,13
884,98,41,107,18,2.504606560314171,23
885,75,12,50,5,2.4925159155893497,7
886,65,50,103,21,2.4835688434443703,29
887,37,15,62,7,2.478947668963917,8
888,26,27,98,15,2.4699465773486544,12
889,8,46,88,21,2.4622937925313138,25
890,41,40,38,19,2.4535603181412866,21
891,18,16,50,8,2.435107533000617,8
892,55,13,90,6,2.423005519398733,7
893,86,14,104,7,2.41764341864853,7
894,50,36,9,17,2.4068423828458214,19
895,55,38,16,17,2.4019689679738265,21
896,65,82,88,37,2.4015391527263157,45
897,43,22,74,10,2.3993639128069244,12
898,18,18,6,8,2.3903639022739704,10
899,8,73,54,35,2.365319578181275,38
900,8,25,68,12,2.35813484080187,13
901,58,12,2,5,2.3563851300758447,7
902,79,35,88,14,2.352890279260208,21
903,41,56,79,27,2.337441224056112,29
904,41,11,94,5,2.327533953224649,6
905,28,57,18,27,2.325443992999963,30
906,65,10,39,5,2.3211966169516858,5
907,28,39,37,18,2.3108067440306623,21
908,86,31,107,15,2.2992857783625373,16
909,87,32,54,15,2.279380424010783,17
910,20,13,32,6,2.2751108005385445,7
911,84,78,9,34,2.274353058782541,44
912,62,25,28,10,2.271350662558558,15
913,62,18,32,9,2.263686769900323,9
914,37,40,9,18,2.2628015576501816,22
915,62,10,106,5,2.25172428368668,5
916,20,44,98,20,2.2445302838681975,24
917,103,26,87,12,2.244435120608379,14
918,8,11,58,6,2.225895511877211,5
919,54,12,57,5,2.224387822283533,7
920,8,18,11,8,2.2144208281589424,10
921,74,15,63,7,2.1980226227942294,8
922,73,35,41,16,2.1896111209660925,19
923,44,19,28,7,2.1816767204067147,12
924,89,18,98,8,2.1800794132028996,10
925,14,22,84,8,2.174771822979343,14
926,74,45,9,20,2.167006985909848,25
927,111,19,46,9,2.165349951686943,10
928,111,54,28,25,2.1618622413747612,29
929,9,11,15,5,2.1575516880448644,6
930,18,10,32,5,2.157224109221358,5
931,29,21,79,10,2.154722811821747,11
932,16,49,41,24,2.1541831229994863,25
933,8,58,86,26,2.142368055545514,32
934,84,44,111,19,2.142252654485593,25
935,16,37,76,18,2.1381270128695977,19
936,111,33,26,15,2.137133581510591,18
937,54,18,3,9,2.135806802832069,9
938,98,63,2,30,2.135100922237145,33
939,34,23,28,10,2.098323974878283,13
940,75,18,84,8,2.093719925532618,10
941,74,49,84,23,2.0936938979696,26
942,13,19,48,7,2.077711897708858,12
943,9,17,104,7,2.074620642084027,10
944,98,56,54,28,2.07348295312418,28
945,91,11,18,5,2.068864434806556,6
946,62,22,88,10,2.068203078615547,12
947,85,22,65,9,2.0630480183814526,13
948,91,18,10,8,2.053920396033922,10
949,30,25,98,10,2.050620342220537,15
950,38,52,98,24,2.0498657703552294,28
951,84,72,65,35,2.037917633089768,37
952,8,14,96,7,2.0352117697299548,7
953,88,20,93,12,2.03337259421067,8
954,87,66,65,30,2.0306725693730434,36
955,32,26,16,12,2.021073617693015,14
956,59,14,8,7,2.010238389237962,7
957,98,55,74,27,2.0085674767082775,28
958,37,10,71,4,1.989603705819686,6
959,55,10,97,5,1.9884220470048688,5
960,103,13,37,6,1.9837820518429876,7
961,6,47,79,22,1.9831957209831137,25
962,49,11,29,4,1.9792119029563418,7
963,50,20,34,11,1.9535612317766191,9
964,76,24,6,12,1.937944044447951,12
965,16,17,11,7,1.9332915209945327,10
966,62,10,48,4,1.9270832455013291,6
967,10,13,29,6,1.9268740097605626,7
968,65,20,13,11,1.923636761815708,9
969,6,22,37,11,1.9187411338779805,11
970,76,10,17,4,1.904894860536603,6
971,41,11,61,5,1.903478014849791,6
972,5,18,28,9,1.8930799000381913,9
973,54,20,29,8,1.8852461336565378,12
974,98,27,18,13,1.877022513938192,14
975,34,10,90,5,1.875212395692607,5
976,54,17,112,8,1.871566293788823,9
977,49,25,55,14,1.8646594153921858,11
978,73,19,98,9,1.8513717297876215,10
979,6,39,98,18,1.8448936378969205,21
980,2,30,111,14,1.8367449192872438,16
981,90,19,84,9,1.8307456952070562,10
982,8,48,18,22,1.8210825548731258,26
983,20,22,73,11,1.8197178736344486,11
984,93,10,85,4,1.8184953609101577,6
985,87,25,32,13,1.8019631830327207,12
986,85,13,76,5,1.8000085206097032,8
987,57,10,109,4,1.7866317267766754,6
988,15,20,54,9,1.7760257646065063,11
989,84,32,55,15,1.7463159686665124,17
990,107,35,38,17,1.7434138897292857,18
991,71,18,65,9,1.7385086790308775,9
992,17,12,30,6,1.7366091011141076,6
993,16,29,103,14,1.7358551004647216,15
994,76,10,45,5,1.7263356630732685,5
995,38,11,76,5,1.699907222636557,6
996,34,15,20,6,1.6974281353522305,9
997,98,41,86,18,1.6914695767197412,23
998,54,27,91,15,1.6885326799927167,12
999,16,49,2,23,1.6778156958659614,26
1000,79,38,74,16,1.6713290506213756,22
1001,48,13,91,6,1.6698911192681907,7
1002,6,49,65,26,1.6288389900978633,23
1003,103,26,6,11,1.6275337563735748,15
1004,86,24,91,12,1.616399802398324,12
1005,10,18,90,8,1.612631742744166,10
1006,14,15,8,7,1.6047577872069896,8
1007,70,56,8,28,1.5940338293248182,28
1008,17,13,50,6,1.587542514822458,7
1009,104,27,8,11,1.5847929007576513,16
1010,30,31,79,14,1.58089006956607,17
1011,96,14,86,6,1.5713948623262897,8
1012,86,55,79,27,1.57010775899593,28
1013,76,10,14,5,1.56343838736732,5
1014,106,14,41,7,1.55653648871753,7
1015,84,11,46,5,1.5536654797415743,6
1016,50,33,2,15,1.5483452933241444,18
1017,6,21,46,9,1.5348461201360555,12
1018,85,12,38,6,1.5317416798467223,6
1019,63,20,8,9,1.516147236738685,11
1020,74,18,50,9,1.5058020463222817,9
1021,103,12,85,5,1.5052357650596415,7
1022,55,18,43,9,1.4993353058682126,9
1023,41,18,18,8,1.4488156792449156,10
1024,79,62,111,28,1.4456912335304024,34
1025,50,36,41,18,1.4450486751473977,18
1026,16,44,54,21,1.4396923883896255,23
1027,103,10,57,6,1.4334929374709406,4
1028,109,11,112,5,1.4303792106135154,6
1029,65,10,3,5,1.425825292351592,5
1030,13,11,2,4,1.4221213524937664,7
1031,88,31,111,14,1.4213124620809892,17
1032,8,47,20,22,1.420582435666663,25
1033,96,13,55,6,1.4199005276160928,7
1034,2,24,38,13,1.4146987667991204,11
1035,8,40,50,20,1.4130020441022069,20
1036,51,26,84,11,1.3946044446619845,15
1037,65,34,10,16,1.3889990791790807,18
1038,54,20,23,9,1.3830605566363516,11
1039,44,13,8,5,1.382360749568672,8
1040,54,17,85,9,1.3789825215785754,8
1041,16,32,10,15,1.3769942516048166,17
1042,23,14,32,8,1.36299015760623,6
1043,111,47,55,24,1.3611225123553383,23
1044,107,51,28,26,1.3501244034635755,25
1045,29,18,34,10,1.3490741689669339,8
1046,76,30,9,14,1.3464329670764867,16
1047,48,32,98,16,1.346038192120595,16
1048,84,41,87,20,1.3385938795219072,21
1049,79,61,16,28,1.3376507869334486,33
1050,54,34,107,16,1.3280682216199444,18
1051,98,13,57,7,1.3243405021868635,6
1052,37,35,65,16,1.3173393657012906,19
1053,54,43,84,20,1.3144548521624781,23
1054,38,17,106,8,1.3101869215810398,9
1055,87,15,110,7,1.3076573931351647,8
1056,86,12,62,8,1.3029764877822878,4
1057,86,27,55,14,1.2918316727309191,13
1058,55,12,17,6,1.2644044388351476,6
1059,50,10,63,4,1.2561234705003208,6
1060,8,24,43,12,1.2491635720553627,12
1061,23,42,65,21,1.2395198214726815,21
1062,28,33,88,15,1.2332708273566548,18
1063,2,36,87,16,1.230956912786467,20
1064,74,24,46,13,1.2274275532310792,11
1065,17,14,54,7,1.2121687634663056,7
1066,10,25,87,13,1.200382738763758,12
1067,8,19,85,10,1.1861465554197632,9
1068,103,10,1,6,1.178228962480731,4
1069,109,23,98,11,1.1685291459099245,12
1070,106,16,28,6,1.1679607746125358,10
1071,9,34,6,16,1.164779086663607,18
1072,79,76,9,37,1.156057079763386,39
1073,73,25,87,11,1.1555083165045317,14
1074,91,31,107,14,1.1523326808129475,17
1075,79,36,38,17,1.1399672014475488,19
1076,10,13,88,6,1.116078708489712,7
1077,98,69,8,33,1.112214433038039,36
1078,20,37,28,16,1.1119178008636916,21
1079,16,10,56,4,1.1063673005412145,6
1080,73,16,28,9,1.102601583168376,7
1081,6,42,84,20,1.1025381642551553,22
1082,65,41,29,18,1.0863542275741345,23
1083,76,15,103,6,1.064891024931597,9
1084,51,14,55,6,1.0640892363499774,8
1085,79,13,5,5,1.0633661477796628,8
1086,84,68,28,33,1.0606530128405567,35
1087,64,11,84,6,1.0531813217300625,5
1088,34,23,9,12,1.0530539128922707,11
1089,98,11,106,6,1.0522359380778141,5
1090,74,16,62,9,1.038357756374001,7
1091,63,10,14,5,1.036767688889011,5
1092,13,23,98,9,1.0334282765850014,14
1093,107,36,103,17,1.0215275466090674,19
1094,48,34,87,16,1.0138064194658996,18
1095,79,11,94,5,0.999869198006996,6
1096,8,12,5,7,0.9947252871595059,5
1097,32,15,74,7,0.9878312338208298,8
1098,41,16,30,8,0.9850557086879019,8
1099,111,16,68,7,0.9831903657030904,9
1100,91,20,23,10,0.9792678927031672,10
1101,103,44,9,24,0.9734466854109779,20
1102,68,10,16,5,0.9723777343104946,5
1103,54,44,20,20,0.965531605512796,24
1104,84,40,107,19,0.9630991799556797,21
1105,10,11,15,6,0.9620268464624092,5
1106,84,28,49,14,0.9573548536710029,14
1107,20,19,68,10,0.9561217863728688,9
1108,86,22,20,11,0.9513488629224628,11
1109,57,15,91,6,0.9462820674582961,9
1110,2,22,88,10,0.9353035146429401,12
1111,54,34,79,17,0.93397106002864,17
1112,85,19,9,8,0.9266510351352133,11
1113,13,11,74,5,0.9258529887550367,6
1114,54,50,86,24,0.9257187248188621,26
1115,103,12,89,5,0.9245541578032253,7
1116,60,11,9,6,0.9156618531106675,5
1117,93,15,49,8,0.9146738839447187,7
1118,79,39,90,17,0.8969827248841548,22
1119,62,21,65,9,0.8755953834255741,12
1120,29,12,18,7,0.8741742779448103,5
1121,20,33,30,15,0.8624210657658014,18
1122,103,16,32,7,0.8405021181328091,9
1123,111,44,87,22,0.837629282060696,22
1124,2,34,54,17,0.8033910108899872,17
1125,49,25,54,13,0.7952964242907768,12
1126,29,25,9,13,0.7771037627191238,12
1127,107,45,65,20,0.7750649968921992,25
1128,70,49,98,24,0.7703441864474497,25
1129,112,17,87,9,0.7591685884445001,8
1130,23,24,6,12,0.757380072902326,12
1131,55,12,13,6,0.7567536850396058,6
1132,37,11,73,5,0.7437455399697707,6
1133,46,12,10,6,0.7362386600396065,6
1134,8,91,65,41,0.7286756190519219,50
1135,87,48,107,22,0.7220336856386385,26
1136,79,70,84,34,0.7045123518634121,36
1137,16,36,111,19,0.7024109034978862,17
1138,50,15,88,8,0.6966849372246732,7
1139,41,23,43,11,0.6921842337130496,12
1140,44,12,16,7,0.6740631728235357,5
1141,76,13,20,7,0.6610311160325412,6
1142,65,33,104,18,0.6526567218920184,15
1143,32,10,30,5,0.6490824873820774,5
1144,74,39,41,21,0.6406425090111565,18
1145,16,17,1,9,0.638053866963686,8
1146,91,18,44,8,0.6160976329615543,10
1147,11,11,79,7,0.6107232313792162,4
1148,55,22,29,12,0.608123085968795,10
1149,111,37,20,19,0.6068837109506102,18
1150,73,15,55,7,0.6065055891974576,8
1151,79,18,49,8,0.6053065369071557,10
1152,62,18,38,9,0.6043816495722358,9
1153,6,43,8,20,0.5988016059813149,23
1154,98,20,101,11,0.594870864776421,9
1155,75,10,23,5,0.5879055997029298,5
1156,55,25,48,13,0.5820892769422626,12
1157,48,18,107,9,0.5787798745894364,9
1158,15,14,2,7,0.5683026145731128,7
1159,89,17,111,9,0.5563633904658294,8
1160,90,18,2,9,0.5540783404275302,9
1161,79,41,55,22,0.550687264714179,19
1162,10,18,37,8,0.5468156041706492,10
1163,2,22,62,10,0.5462872756743675,12
1164,98,67,79,35,0.5423907596369391,32
1165,66,13,41,7,0.534743534153649,6
1166,104,14,51,7,0.5303101352697448,7
1167,16,47,48,23,0.5276480958458563,24
1168,91,13,73,5,0.5133686150476426,8
1169,46,13,98,6,0.4949016763373522,7
1170,23,16,30,9,0.4884824633855258,7
1171,32,10,94,5,0.48339556643762405,5
1172,48,22,88,10,0.48151324400012674,12
1173,26,39,41,23,0.4754162497584248,16
1174,29,32,28,16,0.47285680343469233,16
1175,65,11,80,6,0.4579944933573847,5
1176,98,16,58,9,0.4540736471862188,7
1177,88,18,41,9,0.44177382423880074,9
1178,98,18,85,10,0.441092054257157,8
1179,96,15,79,7,0.4381198674132664,8
1180,23,37,103,19,0.4333042786770578,18
1181,26,11,50,6,0.4324180875363617,5
1182,98,33,93,16,0.4249481440030074,17
1183,9,41,98,18,0.424424835693392,23
1184,109,14,79,7,0.42130275303052095,7
1185,84,17,96,8,0.4094187460594172,9
1186,23,26,107,13,0.40709415642669183,13
1187,93,16,55,8,0.39897461255756417,8
1188,41,13,85,6,0.3897097634286919,7
1189,88,28,107,13,0.3809872191952965,15
1190,55,52,28,23,0.3713410617274032,29
1191,44,10,50,5,0.37049181398411835,5
1192,70,22,9,10,0.35783800642150543,12
1193,75,11,74,5,0.34828087363750365,6
1194,55,54,65,24,0.33480129578262635,30
1195,49,17,91,9,0.3285488305810779,8
1196,8,65,2,34,0.324118263007153,31
1197,19,14,41,8,0.30768619148938015,6
1198,2,23,30,12,0.29321348863964647,11
1199,98,58,28,30,0.2696965888382482,28
1200,37,22,70,11,0.26541516331841886,11
1201,35,13,79,6,0.2611575923038565,7
1202,103,28,38,14,0.2481523476415201,14
1203,18,27,54,14,0.24449076708154974,13
1204,84,12,1,6,0.2428062343244942,6
1205,2,31,74,16,0.2426189207787665,15
1206,66,20,9,10,0.23945533670543603,10
1207,85,10,66,5,0.23847533791686767,5
1208,84,58,37,30,0.2306892845057094,28
1209,87,11,71,6,0.21156446783375316,5
1210,30,22,74,10,0.20088773846185115,12
1211,29,36,41,18,0.19641039337775912,18
1212,30,18,18,8,0.18809198027763627,10
1213,26,19,2,10,0.15549736717273138,9
1214,23,38,28,19,0.15194126752419734,19
1215,50,13,20,7,0.14861324836967482,6
1216,6,23,112,11,0.14608972875934934,12
1217,32,18,50,10,0.14361277931057495,8
1218,74,20,37,10,0.1351513012183972,10
1219,13,11,87,6,0.13022005589559751,5
1220,74,45,54,24,0.12330639621907567,21
1221,91,19,88,9,0.11151015137343248,10
1222,6,29,41,15,0.0941275477253323,14
1223,38,15,110,8,0.07451058664372948,7
1224,8,68,84,35,0.05464007169044907,33
1225,85,24,79,13,0.034805559038930234,11
1226,40,14,65,6,0.022138801901295854,8
1227,37,15,38,8,0.0011031238349569132,7
1228,38,15,37,7,-0.0011031238349578606,8
1229,65,14,40,8,-0.022138801901296672,6
1230,13,13,107,6,-0.03566165788038671,7
1231,65,81,79,42,-0.04424467295364335,39
1232,76,38,65,18,-0.05184006466891194,20
1233,79,50,103,24,-0.05775390300531491,26
1234,2,25,20,13,-0.06141520142574363,12
1235,79,46,76,22,-0.06498451452398714,24
1236,110,15,38,7,-0.07451058664372871,8
1237,87,42,74,20,-0.07958529470361445,22
1238,84,47,103,22,-0.09369403051445593,25
1239,41,29,6,14,-0.09412754772533327,15
1240,43,19,20,10,-0.09655439021695145,9
1241,88,19,91,10,-0.11151015137343323,9
1242,17,17,20,9,-0.12665014758012894,8
1243,87,11,13,5,-0.13022005589559688,6
1244,37,20,74,10,-0.135151301218397,10
1245,111,25,30,13,-0.14558741487159338,12
1246,20,13,50,6,-0.14861324836967535,7
1247,87,34,98,16,-0.1724338468755451,18
1248,50,46,84,24,-0.17381504780590146,22
1249,17,19,74,10,-0.18384205614173943,9
1250,18,18,30,10,-0.18809198027763716,8
1251,74,22,30,12,-0.20088773846185182,10
1252,71,11,87,5,-0.21156446783375446,6
1253,66,10,85,5,-0.23847533791686928,5
1254,9,20,66,10,-0.23945533670543603,10
1255,1,12,84,6,-0.24280623432449092,6
1256,54,27,18,13,-0.24449076708155026,14
1257,38,28,103,14,-0.24815234764151944,14
1258,79,13,35,7,-0.26115759230385677,6
1259,70,22,37,11,-0.2654151633184179,11
1260,28,62,79,35,-0.2862694375463453,27
1261,30,23,2,11,-0.29321348863964564,12
1262,41,14,19,6,-0.30768619148938214,8
1263,10,27,111,13,-0.3114645815059003,14
1264,28,44,50,22,-0.32045066520029036,22
1265,91,17,49,8,-0.32854883058107764,9
1266,43,16,98,8,-0.334919329248079,8
1267,28,64,2,33,-0.34518024809502945,31
1268,74,11,75,6,-0.3482808736375043,5
1269,9,22,70,12,-0.3578380064215045,10
1270,50,10,44,5,-0.37049181398411835,5
1271,90,30,65,14,-0.37730681884186645,16
1272,85,13,41,7,-0.3897097634286919,6
1273,55,16,93,8,-0.3989746125575646,8
1274,107,26,23,13,-0.4070941564266929,13
1275,65,32,17,16,-0.4089458448973926,16
1276,96,17,84,9,-0.4094187460594168,8
1277,107,32,55,18,-0.4118175820283301,14
1278,79,14,109,7,-0.42130275303052045,7
1279,98,41,9,23,-0.42442483569339234,18
1280,93,33,98,17,-0.42494814400300696,16
1281,79,15,96,8,-0.43811986741326575,7
1282,85,18,98,8,-0.44109205425715736,10
1283,41,18,88,9,-0.4417738242388016,9
1284,80,11,65,5,-0.457994493357384,6
1285,28,32,29,16,-0.47285680343469205,16
1286,88,22,48,12,-0.48151324400012674,10
1287,94,10,32,5,-0.4833955664376234,5
1288,91,41,79,20,-0.4867348746757923,21
1289,98,13,46,7,-0.494901676337354,6
1290,73,13,91,8,-0.5133686150476421,5
1291,20,23,110,11,-0.5195268671329448,12
1292,48,47,16,24,-0.527648095845856,23
1293,51,14,104,7,-0.5303101352697429,7
1294,41,13,66,6,-0.5347435341536495,7
1295,62,22,2,12,-0.5462872756743683,10
1296,37,18,10,10,-0.5468156041706485,8
1297,111,17,89,8,-0.556363390465831,9
1298,79,81,65,40,-0.5589485959558708,41
1299,107,18,48,9,-0.5787798745894376,9
1300,48,25,55,12,-0.5820892769422619,13
1301,23,10,75,5,-0.5879055997029312,5
1302,49,24,107,13,-0.5883775965859891,11
1303,16,37,23,19,-0.5884301363027267,18
1304,101,20,98,9,-0.5948708647764195,11
1305,39,10,87,5,-0.5972214062189816,5
1306,23,33,79,18,-0.5991196107820859,15
1307,38,18,62,9,-0.6043816495722345,9
1308,55,15,73,8,-0.6065055891974562,7
1309,29,22,55,10,-0.6081230859687949,12
1310,79,11,11,4,-0.6107232313792149,7
1311,44,18,91,10,-0.6160976329615553,8
1312,41,39,74,18,-0.640642509011156,21
1313,6,19,62,11,-0.6431821395568814,8
1314,30,10,32,5,-0.6490824873820789,5
1315,104,33,65,15,-0.6526567218920186,18
1316,29,20,103,10,-0.6578144863835312,10
1317,74,51,28,27,-0.6578859259255861,24
1318,20,13,76,6,-0.6610311160325401,7
1319,8,63,10,33,-0.6621130971618493,30
1320,28,39,48,21,-0.6668117441508868,18
1321,16,12,44,5,-0.6740631728235359,7
1322,101,15,23,7,-0.6750621504160544,8
1323,88,15,50,7,-0.6966849372246742,8
1324,74,42,87,23,-0.7245745938864455,19
1325,10,12,46,6,-0.7362386600396065,6
1326,73,11,37,6,-0.7437455399697719,5
1327,13,12,55,6,-0.7567536850396056,6
1328,87,17,112,8,-0.7591685884445006,9
1329,98,49,70,25,-0.770344186447448,24
1330,54,34,2,17,-0.8033910108899884,17
1331,91,21,29,10,-0.8357535316372816,11
1332,10,51,79,29,-0.8544891772527285,22
1333,38,18,91,10,-0.8605561818804589,8
1334,30,33,20,18,-0.8624210657658024,15
1335,18,12,29,5,-0.8741742779448094,7
1336,65,21,62,12,-0.8755953834255741,9
1337,85,18,74,9,-0.8842572167875924,9
1338,93,30,20,17,-0.8968767950978295,13
1339,49,15,93,7,-0.9146738839447184,8
1340,111,29,18,15,-0.9151185639276579,14
1341,9,11,60,5,-0.9156618531106686,6
1342,89,12,103,7,-0.9245541578032253,5
1343,28,78,8,40,-0.9254529528643421,38
1344,86,50,54,26,-0.9257187248188627,24
1345,9,19,85,11,-0.9266510351352133,8
1346,88,22,2,12,-0.9353035146429405,10
1347,91,15,57,9,-0.9462820674582971,6
1348,20,22,86,11,-0.9513488629224631,11
1349,8,70,111,34,-0.9571051337572238,36
1350,49,28,84,14,-0.9573548536710035,14
1351,15,11,10,5,-0.9620268464624092,6
1352,16,10,68,5,-0.9723777343104946,5
1353,68,16,111,9,-0.9831903657030906,7
1354,30,16,41,8,-0.9850557086879017,8
1355,91,23,20,11,-0.9903622576025491,12
1356,5,12,8,5,-0.9947252871595057,7
1357,94,11,79,6,-0.9998691980069959,5
1358,41,33,70,17,-1.0073100144887814,16
1359,28,51,74,25,-1.0091220915487187,26
1360,87,34,48,18,-1.0138064194658998,16
1361,41,13,75,7,-1.0160682715228835,6
1362,8,78,28,40,-1.0187943079709858,38
1363,98,32,90,17,-1.0267736789331345,15
1364,103,10,75,5,-1.035188460357086,5
1365,112,10,8,5,-1.0357746876565699,5
1366,14,10,63,5,-1.0367676888890103,5
1367,62,16,74,7,-1.0383577563740003,9
1368,111,27,23,15,-1.048513117845392,12
1369,89,13,6,6,-1.0487640819634654,7
1370,106,11,98,5,-1.0522359380778148,6
1371,28,68,84,35,-1.0606530128405551,33
1372,5,13,79,8,-1.0633661477796628,5
1373,55,14,51,8,-1.0640892363499783,6
1374,103,15,76,9,-1.0648910249315973,6
1375,51,24,28,12,-1.0697876821134717,12
1376,73,20,103,10,-1.0728746625988024,10
1377,29,41,65,23,-1.0863542275741362,18
1378,84,42,6,22,-1.1025381642551555,20
1379,28,16,73,7,-1.102601583168377,9
1380,56,10,16,6,-1.1063673005412131,4
1381,91,23,30,13,-1.146326244872261,10
1382,65,81,41,44,-1.1521295696669458,37
1383,87,25,73,14,-1.155508316504531,11
1384,34,10,1,4,-1.158449896925856,6
1385,6,34,9,18,-1.1647790866636063,16
1386,28,16,106,10,-1.1679607746125358,6
1387,1,10,103,4,-1.178228962480731,6
1388,79,67,98,33,-1.185782047717224,34
1389,84,68,8,34,-1.1871889007217196,34
1390,111,49,98,25,-1.1971941446177512,24
1391,107,36,111,18,-1.1978257080625474,18
1392,87,25,10,12,-1.200382738763757,13
1393,23,37,16,19,-1.2113990211273438,18
1394,54,14,17,7,-1.212168763466305,7
1395,84,46,50,23,-1.2316325109812616,23
1396,88,33,28,18,-1.233270827356654,15
1397,2,51,79,27,-1.2385569143211732,24
1398,63,10,50,6,-1.2561234705003208,4
1399,17,12,55,6,-1.2644044388351479,6
1400,55,27,86,13,-1.2918316727309198,14
1401,107,18,10,10,-1.302641998274499,8
1402,62,12,86,4,-1.3029764877822885,8
1403,110,15,87,8,-1.307657393135164,7
1404,106,17,38,9,-1.3101869215810407,8
1405,103,47,84,26,-1.3117535282727075,21
1406,84,43,54,23,-1.3144548521624781,20
1407,65,35,37,19,-1.3173393657012917,16
1408,57,13,98,6,-1.3243405021868624,7
1409,90,32,98,16,-1.3246080262099156,16
1410,107,34,54,18,-1.3280682216199446,16
1411,91,15,109,7,-1.3373257862259469,8
1412,87,41,84,21,-1.3385938795219061,20
1413,98,32,48,16,-1.3460381921205946,16
1414,9,30,76,16,-1.3464329670764872,14
1415,34,18,29,8,-1.3490741689669334,10
1416,74,33,20,17,-1.353456899126018,16
1417,32,14,23,6,-1.3629901576062295,8
1418,59,16,41,9,-1.3704315284875221,7
1419,85,17,54,8,-1.3789825215785738,9
1420,23,15,76,7,-1.3791825091008199,8
1421,8,13,44,8,-1.3823607495686732,5
1422,23,20,54,11,-1.3830605566363494,9
1423,84,70,79,37,-1.3852590410612948,33
1424,84,26,51,15,-1.3946044446619839,11
1425,41,81,65,39,-1.4041433009139985,42
1426,43,18,107,9,-1.4171119653199424,9
1427,50,44,28,23,-1.4189035523606586,21
1428,55,13,96,7,-1.4199005276160916,6
1429,111,31,88,17,-1.4213124620809878,14
1430,3,10,65,5,-1.425825292351591,5
1431,107,23,18,13,-1.4296389206294247,10
1432,112,11,109,6,-1.4303792106135154,5
1433,57,10,103,4,-1.43349293747094,6
1434,54,44,16,23,-1.439692388389625,21
1435,23,27,111,13,-1.4435580232116272,14
1436,17,43,98,22,-1.4651649500523514,21
1437,20,13,90,6,-1.4684862703100507,7
1438,85,12,103,7,-1.505235765059642,5
1439,50,18,74,9,-1.5058020463222825,9
1440,62,19,6,9,-1.506313038221411,10
1441,8,20,63,11,-1.5161472367386843,9
1442,98,43,17,23,-1.5166447539243209,20
1443,6,14,50,8,-1.5219443856325081,6
1444,48,39,28,19,-1.5266198577889885,20
1445,38,12,85,6,-1.5317416798467212,6
1446,37,58,84,29,-1.5410671219703609,29
1447,46,11,84,6,-1.553665479741575,5
1448,41,14,106,7,-1.5565364887175293,7
1449,14,10,76,5,-1.56343838736732,5
1450,94,11,2,6,-1.566847919784111,5
1451,79,55,86,28,-1.5701077589959298,27
1452,86,14,96,8,-1.5713948623262906,6
1453,29,16,16,9,-1.5836522711307057,7
1454,8,27,104,16,-1.5847929007576513,11
1455,8,56,70,28,-1.594033829324818,28
1456,8,15,14,8,-1.6047577872069896,7
1457,50,31,55,18,-1.6118897905773097,13
1458,90,18,10,10,-1.612631742744166,8
1459,91,22,84,11,-1.6140489066565649,11
1460,91,24,86,12,-1.6163998023983253,12
1461,79,16,57,9,-1.6225267683647033,7
1462,87,44,111,23,-1.641789170650758,21
1463,91,13,48,7,-1.6698911192681911,6
1464,20,21,112,10,-1.6804120498088793,11
1465,91,27,54,12,-1.688532679992717,15
1466,86,41,98,23,-1.6914695767197396,18
1467,23,18,57,10,-1.6948872060166507,8
1468,18,13,20,7,-1.69876804268239,6
1469,76,11,38,6,-1.6999072226365548,5
1470,65,38,76,21,-1.7259377131088651,17
1471,45,10,76,5,-1.7263356630732685,5
1472,16,16,29,8,-1.7271978980205005,8
1473,103,29,16,15,-1.735855100464721,14
1474,30,12,17,6,-1.736609101114107,6
1475,65,18,71,9,-1.7385086790308772,9
1476,38,35,107,18,-1.7434138897292857,17
1477,55,32,84,17,-1.7463159686665113,15
1478,111,70,8,39,-1.7509750705170983,31
1479,54,20,15,11,-1.7760257646065063,9
1480,84,22,91,12,-1.7835975804372517,10
1481,109,10,57,6,-1.7866317267766754,4
1482,76,13,85,8,-1.8000085206097036,5
1483,32,25,87,12,-1.8019631830327214,13
1484,93,25,6,13,-1.8024437751588966,12
1485,18,11,85,7,-1.8067340182792189,4
1486,84,19,90,10,-1.8307456952070555,9
1487,98,19,73,10,-1.851371729787623,9
1488,55,25,49,11,-1.8646594153921843,14
1489,112,17,54,9,-1.8715662937888236,8
1490,90,10,34,5,-1.8752123956926063,5
1491,28,18,5,9,-1.8930799000381917,9
1492,103,14,70,8,-1.9027941936339994,6
1493,61,11,41,6,-1.9034780148497894,5
1494,90,19,86,11,-1.9043174139425585,8
1495,17,10,76,6,-1.9048948605366014,4
1496,55,41,79,20,-1.9167817193509258,21
1497,37,22,6,11,-1.9187411338779805,11
1498,13,20,65,9,-1.9236367618157104,11
1499,48,10,62,6,-1.9270832455013296,4
1500,11,17,16,10,-1.9332915209945327,7
1501,6,24,76,12,-1.937944044447951,12
1502,6,25,93,13,-1.9383775932498641,12
1503,34,20,50,9,-1.9535612317766202,11
1504,10,63,8,32,-1.9653037165737905,31
1505,54,45,74,22,-1.97553752674608,23
1506,29,11,49,7,-1.9792119029563418,4
1507,37,13,103,7,-1.9837820518429876,6
1508,41,16,34,9,-1.9846654519938336,7
1509,97,10,55,5,-1.9884220470048688,5
1510,71,10,37,6,-1.9896037058196856,4
1511,55,32,107,16,-1.9907427811642213,16
1512,74,55,98,28,-2.008567476708278,27
1513,85,13,107,5,-2.0121024102187826,8
1514,9,30,10,15,-2.0135222581265264,15
1515,74,17,90,9,-2.030135359930969,8
1516,93,20,88,8,-2.033372594210669,12
1517,96,14,8,7,-2.0352117697299557,7
1518,26,14,73,8,-2.0368384601286986,6
1519,65,72,84,37,-2.0379176330897706,35
1520,98,52,38,28,-2.0498657703552294,24
1521,26,30,9,17,-2.052887996849143,13
1522,10,18,91,10,-2.0539203960339205,8
1523,65,22,85,13,-2.0630480183814526,9
1524,88,22,62,12,-2.068203078615548,10
1525,54,56,98,28,-2.0734829531241803,28
1526,104,17,9,10,-2.0746206420840276,7
1527,48,19,13,12,-2.0777118977088573,7
1528,8,69,98,37,-2.081911402735009,32
1529,90,17,74,9,-2.0848494229315673,8
1530,84,49,74,26,-2.0936938979695996,23
1531,84,18,75,10,-2.0937199255326187,8
1532,28,23,34,13,-2.0983239748782827,10
1533,3,18,54,9,-2.1358068028320694,9
1534,1,15,87,7,-2.138632690920939,8
1535,111,44,84,25,-2.1422526544855915,19
1536,86,58,8,32,-2.142368055545515,26
1537,32,10,18,5,-2.1572241092213575,5
1538,15,11,9,6,-2.1575516880448644,5
1539,65,54,55,32,-2.1621650885730803,22
1540,84,22,14,14,-2.1747718229793427,8
1541,98,18,89,10,-2.180079413202899,8
1542,28,19,44,12,-2.1816767204067156,7
1543,65,45,107,26,-2.197287219114421,19
1544,63,15,74,8,-2.1980226227942294,7
1545,11,18,8,10,-2.214420828158943,8
1546,65,30,90,17,-2.2173212695918445,13
1547,57,12,54,7,-2.224387822283533,5
1548,58,11,8,5,-2.2258955118772117,6
1549,20,44,54,25,-2.2268078604275408,19
1550,74,29,26,16,-2.2324393914305243,13
1551,106,10,62,5,-2.251724283686679,5
1552,50,14,6,7,-2.2618843791117285,7
1553,9,40,37,22,-2.262801557650182,18
1554,32,18,62,9,-2.2636867699003225,9
1555,28,25,62,15,-2.271350662558558,10
1556,32,13,20,7,-2.2751108005385445,6
1557,107,31,86,16,-2.2992857783625364,15
1558,37,39,28,21,-2.310806744030662,18
1559,103,37,23,19,-2.3239729626949814,18
1560,94,11,41,6,-2.3275339532246493,5
1561,43,23,41,13,-2.3652994967791563,10
1562,16,61,79,34,-2.3998450437774235,27
1563,28,24,51,13,-2.4031456876246624,11
1564,104,14,86,7,-2.417643418648528,7
1565,57,16,79,8,-2.4270888358529543,8
1566,50,16,18,8,-2.4351075330006164,8
1567,79,24,85,12,-2.448715961670296,12
1568,55,31,50,15,-2.4517037059312856,16
1569,38,40,41,21,-2.4535603181412866,19
1570,29,27,6,14,-2.45903121181426,13
1571,88,46,8,25,-2.4622937925313138,21
1572,9,44,103,21,-2.4769487250437585,23
1573,29,20,2,11,-2.477941203005181,9
1574,62,15,37,8,-2.4789476689639174,7
1575,65,49,6,24,-2.47968083130177,25
1576,50,12,75,7,-2.4925159155893497,5
1577,107,41,98,23,-2.504606560314172,18
1578,70,27,28,13,-2.510024433047842,14
1579,29,19,50,11,-2.525141516354553,8
1580,70,33,41,17,-2.5290882561404504,16
1581,49,10,63,5,-2.5291147398136253,5
1582,8,43,6,24,-2.5371830216491102,19
1583,48,15,49,7,-2.544499155603262,8
1584,8,41,91,21,-2.5454365457229002,20
1585,11,10,30,6,-2.5564825240632034,4
1586,111,27,10,15,-2.561286831397376,12
1587,79,51,2,27,-2.570420600253088,24
1588,86,57,28,29,-2.577939510693039,28
1589,112,20,38,11,-2.5875581099779774,9
1590,8,25,34,12,-2.599349637379093,13
1591,86,19,90,9,-2.5999398967094858,10
1592,107,24,49,12,-2.600438468942416,12
1593,28,40,30,22,-2.6105936366755755,18
1594,37,33,48,17,-2.6418897918039517,16
1595,84,24,30,13,-2.649950052405462,11
1596,30,25,111,13,-2.6528736151948067,12
1597,9,11,106,6,-2.6544531376629665,5
1598,63,11,111,6,-2.656681768070538,5
1599,8,14,15,7,-2.6593953269851673,7
1600,98,49,111,27,-2.661784450073085,22
1601,111,13,43,8,-2.669621436422116,5
1602,20,16,37,9,-2.669796905589799,7
1603,86,21,6,11,-2.6797895540068413,10
1604,49,18,32,9,-2.688514142434056,9
1605,90,39,79,23,-2.6906940404909006,16
1606,87,36,2,21,-2.7024458768536723,15
1607,9,44,48,25,-2.7118293842835715,19
1608,10,30,9,17,-2.725511572413539,13
1609,30,14,26,5,-2.7295268644643054,9
1610,29,14,23,8,-2.732572073895786,6
1611,65,91,8,52,-2.7337241986003473,39
1612,76,46,79,26,-2.734881782595198,20
1613,103,19,48,10,-2.7455190211302885,9
1614,30,23,91,11,-2.757139530858619,12
1615,104,26,79,16,-2.7673365522379703,10
1616,89,15,50,8,-2.767885417645722,7
1617,50,34,54,20,-2.769221861295628,14
1618,12,11,8,6,-2.8009343879230215,5
1619,65,55,38,30,-2.806589910357459,25
1620,107,25,93,14,-2.806698071004472,11
1621,55,12,104,6,-2.817049603991468,6
1622,107,40,84,22,-2.830387598342809,18
1623,18,29,111,16,-2.859497108899379,13
1624,107,25,90,13,-2.870701985415053,12
1625,98,52,16,29,-2.8744462121533867,23
1626,76,22,111,10,-2.8888180973130924,12
1627,111,30,90,17,-2.89054471305433,13
1628,32,18,49,10,-2.892278990328854,8
1629,34,16,6,8,-2.8927905205883553,8
1630,20,23,91,13,-2.91310351812833,10
1631,88,37,55,22,-2.9210181897272123,15
1632,41,36,29,19,-2.9244119186735795,17
1633,76,15,23,9,-2.940407468731348,6
1634,79,41,91,23,-2.9490646524657533,18
1635,37,58,79,33,-2.9640154422255227,25
1636,74,18,85,10,-2.978897137377882,8
1637,98,23,13,15,-2.9928471993749595,8
1638,48,10,14,7,-2.9948475417245817,3
1639,48,23,10,12,-2.998608536484347,11
1640,89,16,26,8,-3.0015441091670585,8
1641,65,15,51,8,-3.0024330188565416,7
1642,8,11,12,6,-3.0172474302587955,5
1643,16,18,38,9,-3.0174584469144037,9
1644,66,10,65,5,-3.0275758007203697,5
1645,89,17,48,9,-3.030683667814096,8
1646,44,14,9,6,-3.0418979222799787,8
1647,107,28,88,16,-3.04854210260548,12
1648,10,18,107,9,-3.050193716172087,9
1649,87,28,62,16,-3.05254413200227,12
1650,55,15,70,8,-3.0551209872054277,7
1651,65,16,43,8,-3.0818646979565365,8
1652,79,56,41,30,-3.1072129437235954,26
1653,20,33,74,18,-3.1279922292078326,15
1654,38,36,79,20,-3.1386740959807797,16
1655,88,23,23,13,-3.1441600025036935,10
1656,90,10,1,5,-3.14882035881255,5
1657,54,16,73,9,-3.1545899908135793,7
1658,16,19,50,10,-3.1594632722429505,9
1659,91,14,17,8,-3.16960980301192,6
1660,65,66,87,37,-3.1707364264120983,29
1661,88,13,18,7,-3.1759771370815284,6
1662,75,15,111,7,-3.17685714011478,8
1663,37,13,91,7,-3.1893915884876662,6
1664,88,82,65,46,-3.191662609516441,36
1665,26,37,79,21,-3.2224103393223973,16
1666,86,11,75,6,-3.2300560856241614,5
1667,85,11,49,6,-3.234049059231714,5
1668,87,15,1,9,-3.235954063691745,6
1669,18,15,76,9,-3.237191989649946,6
1670,65,30,73,17,-3.264498946198197,13
1671,98,11,59,6,-3.2664563544762517,5
1672,79,62,28,30,-3.2747367230887683,32
1673,84,23,57,13,-3.2865946702288213,10
1674,109,26,2,16,-3.2959656279360225,10
1675,62,18,16,10,-3.3165301409136863,8
1676,28,37,20,22,-3.3249829351159725,15
1677,57,13,55,8,-3.327670077621321,5
1678,18,23,107,12,-3.3296591016307526,11
1679,18,57,28,31,-3.341827320423698,26
1680,96,15,48,8,-3.3566527784765534,7
1681,23,20,91,11,-3.3618813048957485,9
1682,6,18,49,10,-3.361990920437636,8
1683,85,14,2,7,-3.3798876085075156,7
1684,13,14,76,7,-3.383197454645703,7
1685,50,14,70,7,-3.3858944797818475,7
1686,15,16,65,8,-3.396313291786303,8
1687,6,12,57,8,-3.4000169565132334,4
1688,84,20,32,12,-3.403700726822616,8
1689,28,54,111,30,-3.413874283084288,24
1690,91,10,5,4,-3.4255398118724374,6
1691,17,32,65,18,-3.431569242866022,14
1692,37,10,107,6,-3.444420525023787,4
1693,57,12,86,6,-3.4531517504498637,6
1694,79,34,54,18,-3.4597407834745564,16
1695,79,51,10,25,-3.461171301661281,26
1696,107,48,87,28,-3.462771267748502,20
1697,55,14,1,8,-3.472860068937083,6
1698,66,10,86,5,-3.4816650108427063,5
1699,29,32,98,17,-3.494477131581665,15
1700,2,64,28,35,-3.494662950113527,29
1701,41,49,16,26,-3.501070366837183,23
1702,94,13,65,7,-3.505690987614661,6
1703,16,11,46,6,-3.5247066219075394,5
1704,26,33,111,19,-3.5276889460712058,14
1705,87,26,70,15,-3.5345174393475727,11
1706,49,18,79,11,-3.5482844650415624,7
1707,38,25,50,14,-3.5687465201033057,11
1708,57,16,16,8,-3.5714373486183053,8
1709,75,14,87,7,-3.5866681857153258,7
1710,28,52,55,31,-3.58972001919987,21
1711,23,15,101,9,-3.591604516250614,6
1712,28,38,23,21,-3.599379928512799,17
1713,18,12,10,8,-3.6042571144804363,4
1714,16,69,28,38,-3.634335010987867,31
1715,112,10,98,5,-3.634369737429611,5
1716,73,22,20,12,-3.6521774474687554,10
1717,37,38,16,23,-3.6538134186570033,15
1718,6,16,34,9,-3.6598684680509215,7
1719,65,17,57,11,-3.66200460796526,6
1720,87,16,104,10,-3.6754213405844434,6
1721,28,33,90,19,-3.6923457110468223,14
1722,87,75,8,43,-3.698196714242334,32
1723,70,34,54,18,-3.70016254332773,16
1724,54,73,8,39,-3.701565821237184,34
1725,62,15,91,8,-3.707999769375562,7
1726,10,14,32,9,-3.709056496740224,5
1727,87,10,60,5,-3.716219490276847,5
1728,38,22,84,13,-3.721558072111377,9
1729,41,16,48,9,-3.723395209925695,7
1730,10,34,65,19,-3.7403807843221304,15
1731,48,33,76,19,-3.7484630437343593,14
1732,18,12,57,8,-3.7525453734501912,4
1733,86,38,65,21,-3.752738695667819,17
1734,49,22,28,13,-3.761707702389012,9
1735,110,11,26,5,-3.781495457699158,6
1736,103,12,110,7,-3.784927459031115,5
1737,18,15,93,8,-3.8000555745474087,7
1738,98,16,43,9,-3.8123705589147328,7
1739,62,39,8,21,-3.8203580499873464,18
1740,91,14,32,7,-3.8253106560348464,7
1741,49,16,17,9,-3.8354352643495577,7
1742,29,21,91,12,-3.840820511726981,9
1743,18,18,41,11,-3.84366102932153,7
1744,75,10,37,6,-3.8443267506529617,4
1745,75,20,8,11,-3.850513142182257,9
1746,34,12,23,6,-3.85388189935407,6
1747,49,14,38,7,-3.8551286140805963,7
1748,9,78,84,46,-3.8632336429297727,32
1749,84,47,98,26,-3.8908337456526567,21
1750,2,26,91,15,-3.8971597312680113,11
1751,54,16,94,8,-3.897800639878564,8
1752,79,31,30,18,-3.91271477985484,13
1753,48,19,30,11,-3.915724412415478,8
1754,9,30,26,15,-3.917115924375875,15
1755,74,22,43,13,-3.9345782455697673,9
1756,54,32,87,18,-3.9348055085863867,14
1757,112,10,91,5,-3.946754868280294,5
1758,73,22,6,11,-3.9476996189213933,11
1759,87,32,23,19,-3.956644400151879,13
1760,107,11,51,7,-3.957512100620035,4
1761,48,35,86,20,-3.958630339396297,15
1762,65,42,23,23,-3.9627458762007683,19
1763,2,65,8,34,-3.9783431275832335,31
1764,26,14,55,8,-3.9805474058369166,6
1765,10,13,104,7,-3.982341981798969,6
1766,98,34,87,20,-3.9852020639548185,14
1767,50,40,8,22,-3.9913080129704546,18
1768,8,29,73,18,-3.9924196449780625,11
1769,37,26,87,13,-3.9965570187790043,13
1770,28,72,65,41,-4.002474680377952,31
1771,79,33,23,17,-4.005580416521516,16
1772,48,44,79,24,-4.010962969563104,20
1773,103,50,79,29,-4.028559233170849,21
1774,28,58,98,31,-4.030600698284184,27
1775,65,10,52,6,-4.033826421153391,4
1776,74,38,79,23,-4.033953072774277,15
1777,2,19,26,10,-4.041871884320681,9
1778,98,23,109,13,-4.0431120330253485,10
1779,71,15,84,8,-4.046997354452872,7
1780,10,32,16,18,-4.051397029804468,14
1781,46,21,6,13,-4.0573986299655465,8
1782,10,41,2,24,-4.057775267216063,17
1783,75,10,65,6,-4.061741964132054,4
1784,104,12,90,6,-4.064341220930973,6
1785,2,63,98,35,-4.0864521676034835,28
1786,65,16,106,9,-4.0921186691282205,7
1787,86,25,50,15,-4.103724204758594,10
1788,98,39,37,22,-4.11677597890711,17
1789,10,16,103,9,-4.145748166667432,7
1790,2,15,37,8,-4.14722052773026,7
1791,35,11,16,6,-4.150016684827543,5
1792,91,23,65,11,-4.15010120900014,12
1793,8,28,30,17,-4.155265384733847,11
1794,86,61,84,35,-4.165048331090619,26
1795,18,22,16,13,-4.167483705263702,9
1796,32,16,2,9,-4.169077635966493,7
1797,88,35,79,22,-4.181461707831637,13
1798,8,24,51,14,-4.187811296214764,10
1799,111,62,79,37,-4.218289071737846,25
1800,86,20,23,11,-4.219319390999459,9
1801,6,24,23,13,-4.230313442640459,11
1802,91,30,87,17,-4.231572272835857,13
1803,85,19,8,10,-4.235296537690964,9
1804,79,47,6,27,-4.237391580830745,20
1805,8,11,97,7,-4.238412616249588,4
1806,16,19,51,12,-4.2426792919329,7
1807,49,13,18,7,-4.243576516469454,6
1808,98,39,6,23,-4.250381101594533,16
1809,46,24,74,12,-4.250765743447537,12
1810,48,15,85,9,-4.305363268792187,6
1811,41,39,26,18,-4.308213459712551,21
1812,107,16,30,10,-4.310516753383161,6
1813,1,20,41,13,-4.310885836842604,7
1814,29,37,87,21,-4.317833214151955,16
1815,90,13,20,8,-4.319530234657456,5
1816,16,19,75,11,-4.325958452336133,8
1817,74,31,2,17,-4.326298290158694,14
1818,44,13,79,7,-4.356415433762269,6
1819,2,11,57,7,-4.360321050424336,4
1820,16,38,55,22,-4.369027460501823,16
1821,94,11,87,6,-4.375015437142172,5
1822,1,10,90,6,-4.375601097645208,4
1823,89,13,54,8,-4.375934710162814,5
1824,8,29,29,16,-4.386286441561601,13
1825,41,36,50,20,-4.39168406813968,16
1826,41,36,84,22,-4.405400183867785,14
1827,20,19,43,10,-4.407702920435093,9
1828,103,20,73,11,-4.408542656876506,9
1829,13,10,90,5,-4.435057658973358,5
1830,2,18,90,10,-4.440452857575481,8
1831,1,10,34,7,-4.442537367084793,3
1832,76,37,16,20,-4.451124010231458,17
1833,58,16,98,8,-4.454073647186219,8
1834,84,23,73,15,-4.463513313785124,8
1835,110,23,20,13,-4.46357978693552,10
1836,15,25,111,15,-4.472513123100842,10
1837,29,21,111,10,-4.484029622528673,11
1838,107,31,74,18,-4.49684885234603,13
1839,93,21,29,12,-4.498959392246701,9
1840,28,15,14,10,-4.4990639134595956,5
1841,62,11,29,6,-4.502398822563125,5
1842,6,27,29,15,-4.503478704943507,12
1843,23,40,41,23,-4.507259861409941,17
1844,93,29,111,15,-4.510765206652467,14
1845,85,11,18,5,-4.514791288537011,6
1846,93,18,86,10,-4.51863309185886,8
1847,74,15,32,9,-4.519404747582117,6
1848,109,26,65,13,-4.522732343847644,13
1849,23,24,74,13,-4.530539923458647,11
1850,28,33,32,19,-4.541477323608219,14
1851,89,20,9,13,-4.555028073124964,7
1852,32,22,55,13,-4.5613058564845765,9
1853,106,24,8,12,-4.568385804351563,12
1854,9,37,2,20,-4.570200756721712,17
1855,48,15,17,8,-4.57243158960934,7
1856,20,17,17,9,-4.57611326270597,8
1857,15,10,86,5,-4.603054673648832,5
1858,87,11,68,6,-4.626141991098492,5
1859,104,23,16,13,-4.63379333705212,10
1860,86,46,87,27,-4.648429262967537,19
1861,2,20,29,11,-4.659724574406296,9
1862,8,62,74,35,-4.670016382982039,27
1863,79,21,29,12,-4.677275321651237,9
1864,107,21,63,13,-4.678463769301045,8
1865,86,24,51,14,-4.692843496740761,10
1866,55,47,111,26,-4.698473816305829,21
1867,9,76,79,43,-4.699969329384482,33
1868,79,39,50,21,-4.700291458157238,18
1869,86,39,9,22,-4.702205881425731,17
1870,93,19,109,11,-4.710552248323455,8
1871,14,14,87,8,-4.712999134730353,6
1872,9,30,90,17,-4.717832744642908,13
1873,35,21,76,13,-4.725447690057797,8
1874,104,10,88,6,-4.74391725280927,4
1875,54,66,65,36,-4.75749689850986,30
1876,28,19,46,11,-4.7732100228715675,8
1877,54,23,46,14,-4.7761943840724514,9
1878,104,10,111,6,-4.78538385386756,4
1879,18,11,86,6,-4.795064637153174,5
1880,9,51,111,27,-4.814055936731913,24
1881,28,10,110,5,-4.821015306608336,5
1882,29,20,54,13,-4.828224061790944,7
1883,109,11,89,6,-4.829014520032646,5
1884,63,11,39,6,-4.830077117168623,5
1885,13,13,103,7,-4.835710066696813,6
1886,107,85,8,47,-4.84582785094699,38
1887,98,25,30,16,-4.849081372286935,9
1888,30,16,23,8,-4.860653795176971,8
1889,9,27,62,16,-4.876428914210389,11
1890,26,29,74,16,-4.880620777148706,13
1891,20,53,87,30,-4.895008490605161,23
1892,6,41,54,26,-4.900522402213304,15
1893,20,30,93,15,-4.900735470483163,15
1894,5,11,65,6,-4.901615377921411,5
1895,103,11,46,6,-4.934914439873031,5
1896,93,11,11,5,-4.935288832458101,6
1897,20,37,111,20,-4.9479559141790075,17
1898,111,36,107,21,-4.95140635788508,15
1899,16,26,32,15,-4.9645961397192355,11
1900,59,10,10,5,-4.967497448599415,5
1901,20,10,89,6,-4.97640303815121,4
1902,93,29,79,15,-4.983389647169374,14
1903,104,19,107,12,-4.99834795845683,7
1904,73,16,79,9,-5.012547822539443,7
1905,84,15,89,10,-5.0152693534373975,5
1906,63,28,84,17,-5.019888301540257,11
1907,88,14,63,8,-5.029062789658771,6
1908,1,17,16,9,-5.031673674933401,8
1909,43,13,111,7,-5.0327903736846205,6
1910,103,36,107,21,-5.041185354126945,15
1911,79,54,87,29,-5.061728993049676,25
1912,84,16,109,9,-5.067243867891082,7
1913,73,20,16,11,-5.0706587833744905,9
1914,41,16,59,9,-5.075333393683101,7
1915,84,25,29,14,-5.0940460573640145,11
1916,2,28,107,16,-5.101731059055636,12
1917,65,73,93,42,-5.102964751950764,31
1918,48,10,70,6,-5.103393723771427,4
1919,76,27,87,16,-5.11638843749194,11
1920,18,21,103,12,-5.117263308095348,9
1921,111,11,63,6,-5.123399041237538,5
1922,84,31,20,19,-5.125132779135495,12
1923,89,29,41,17,-5.128070897369619,12
1924,88,24,87,15,-5.130994862549942,9
1925,20,47,8,28,-5.13696712403145,19
1926,87,26,103,15,-5.13844337309213,11
1927,52,10,98,5,-5.141825899051739,5
1928,74,30,16,18,-5.170451377759474,12
1929,84,39,23,22,-5.174802875601986,17
1930,62,15,104,9,-5.186101581217904,6
1931,57,10,111,6,-5.186942618450885,4
1932,93,16,16,9,-5.217988854591054,7
1933,9,108,65,62,-5.228072138963157,46
1934,111,10,1,5,-5.238983537325088,5
1935,48,19,18,11,-5.245315113768614,8
1936,85,15,63,8,-5.266282773446651,7
1937,9,50,87,28,-5.267106093185126,22
1938,2,33,50,20,-5.273652216296242,13
1939,76,14,104,8,-5.288345369680408,6
1940,103,30,17,18,-5.294404276815358,12
1941,8,40,37,23,-5.3188247171166365,17
1942,16,22,63,12,-5.328266419123545,10
1943,88,20,20,12,-5.3485269428007625,8
1944,71,11,54,7,-5.354693946074446,4
1945,6,13,89,8,-5.362805216014631,5
1946,41,66,8,36,-5.383353261881381,30
1947,20,27,6,14,-5.391516301598387,13
1948,28,10,19,6,-5.405282356849322,4
1949,50,37,98,20,-5.4072282296066625,17
1950,107,31,91,19,-5.409841397955918,12
1951,41,35,73,20,-5.413974250069213,15
1952,38,26,20,15,-5.422962328602488,11
1953,20,18,94,11,-5.424401699040208,7
1954,51,22,87,12,-5.433091918626144,10
1955,23,16,109,10,-5.438260955948294,6
1956,107,26,16,15,-5.454588725112235,11
1957,38,25,30,13,-5.45936332609693,12
1958,9,10,14,7,-5.463439437022661,3
1959,57,16,87,9,-5.466000765538215,7
1960,98,44,20,26,-5.475555762264778,18
1961,38,35,54,21,-5.478565045653858,14
1962,73,21,74,12,-5.49643746893769,9
1963,107,13,85,9,-5.5094890221266635,4
1964,54,46,28,27,-5.5206143371290795,19
1965,98,15,63,8,-5.531977699985538,7
1966,2,10,46,6,-5.541906116456114,4
1967,48,35,6,20,-5.544547995709246,15
1968,55,19,74,10,-5.544677661719653,9
1969,97,11,28,5,-5.54697078214519,6
1970,51,12,9,7,-5.566013437140973,5
1971,79,84,8,45,-5.56829082741472,39
1972,55,24,103,14,-5.588813975862993,10
1973,29,22,26,14,-5.630548836449718,8
1974,9,45,41,28,-5.6439057397283525,17
1975,6,26,103,16,-5.659939287843899,10
1976,50,13,17,8,-5.662435030700867,5
1977,91,29,111,16,-5.664784285354977,13
1978,9,13,43,7,-5.682535108763632,6
1979,51,11,18,6,-5.697627847770079,5
1980,65,23,89,13,-5.729458742490648,10
1981,55,14,26,8,-5.738748859328644,6
1982,76,20,55,11,-5.742456288243527,9
1983,37,20,90,12,-5.742590617036875,8
1984,9,29,38,16,-5.756435186772364,13
1985,9,36,50,21,-5.758521836854601,15
1986,76,43,86,24,-5.7608051831204765,19
1987,28,15,75,8,-5.767432508412389,7
1988,9,24,49,15,-5.768934866939488,9
1989,79,14,51,8,-5.772506691008202,6
1990,54,18,32,11,-5.782610489553489,7
1991,73,14,26,7,-5.793757710550314,7
1992,94,12,8,7,-5.79404543544707,5
1993,87,14,63,8,-5.794939568846778,6
1994,55,16,23,9,-5.806506460340061,7
1995,28,10,96,6,-5.817657099477481,4
1996,86,12,1,7,-5.820822605148494,5
1997,51,11,2,6,-5.82458141989376,5
1998,44,10,2,6,-5.829723764491529,4
1999,10,31,98,18,-5.831587893507183,13
2000,37,14,46,8,-5.834073346635607,6
2001,84,12,104,7,-5.8358328973406115,5
2002,87,28,49,15,-5.837138934523044,13
2003,48,25,63,15,-5.850121984887349,10
2004,98,41,23,25,-5.855857498312431,16
2005,16,17,17,10,-5.868342075872026,7
2006,103,34,50,20,-5.870794196365225,14
2007,8,79,55,49,-5.900174964881441,30
2008,9,45,74,27,-5.903246001506488,18
2009,96,13,16,8,-5.918742950992745,5
2010,20,11,46,5,-5.919838640633247,6
2011,2,32,84,19,-5.92758837249606,13
2012,18,27,98,16,-5.93123934771538,11
2013,10,25,89,15,-5.961935346068012,10
2014,49,23,8,13,-5.962799116224744,10
2015,34,10,17,6,-5.970863859166942,4
2016,34,19,107,11,-5.973688522150958,8
2017,23,18,2,10,-5.985551573396107,8
2018,77,10,49,5,-6.002993751357126,5
2019,91,18,38,10,-6.003578716041363,8
2020,2,11,94,6,-6.010461250553638,5
2021,91,48,98,26,-6.010481139866049,22
2022,76,41,84,22,-6.0122133251855985,19
2023,98,27,26,14,-6.028495429489334,13
2024,86,13,35,9,-6.029699746849703,4
2025,9,28,13,18,-6.048703123654873,10
2026,86,30,74,18,-6.063445254541929,12
2027,89,25,79,16,-6.066359313406789,9
2028,28,51,107,28,-6.069122685890586,23
2029,74,38,111,22,-6.079631925271179,16
2030,76,14,30,9,-6.105099986395525,5
2031,56,11,111,7,-6.133528731729063,4
2032,87,21,90,14,-6.151740663205763,7
2033,66,11,2,7,-6.205381429919995,4
2034,34,14,16,8,-6.229556768499603,6
2035,41,35,2,22,-6.231438093089563,13
2036,48,17,2,9,-6.245081234312723,8
2037,87,24,38,15,-6.25648981898309,9
2038,106,11,6,6,-6.262787648448941,5
2039,50,23,111,14,-6.270457745960824,9
2040,44,15,111,9,-6.2820016152004,6
2041,54,16,90,9,-6.290244829620479,7
2042,54,19,62,12,-6.312055934230411,7
2043,76,41,88,23,-6.323191299261617,18
2044,79,11,14,7,-6.3252009616150415,4
2045,111,30,2,18,-6.328590766591992,12
2046,65,65,16,37,-6.334573357580009,28
2047,73,18,86,11,-6.340120760849839,7
2048,65,84,20,51,-6.343089817722918,33
2049,86,17,106,11,-6.344519143476505,6
2050,28,10,31,6,-6.368565836830035,4
2051,88,22,103,14,-6.368772240906126,8
2052,84,28,70,16,-6.381194808632994,12
2053,50,12,90,7,-6.396354579252059,5
2054,39,10,65,6,-6.40523745473044,4
2055,91,25,16,15,-6.409140256729834,10
2056,88,24,86,15,-6.42182985448362,9
2057,28,14,12,9,-6.429365216940005,5
2058,54,34,88,20,-6.4356091233083745,14
2059,8,10,112,6,-6.439047583949824,4
2060,62,10,90,6,-6.4415032468905995,4
2061,9,101,8,58,-6.457930698678457,43
2062,86,16,32,9,-6.471177759830176,7
2063,48,11,23,6,-6.485113687277626,5
2064,8,35,32,20,-6.494741280760348,15
2065,9,36,73,21,-6.495953299248424,15
2066,28,34,103,20,-6.496510604338202,14
2067,18,25,87,16,-6.500921078177539,9
2068,62,13,17,8,-6.51109228837904,5
2069,86,79,16,48,-6.517762010081229,31
2070,70,14,103,7,-6.530155528635705,7
2071,57,18,23,10,-6.535348935161005,8
2072,106,15,74,8,-6.5362197915338545,7
2073,70,18,79,9,-6.541994947083339,9
2074,41,54,28,30,-6.549671741224456,24
2075,68,25,8,14,-6.551836593531009,11
2076,6,19,30,13,-6.571810356539939,6
2077,18,48,8,29,-6.594687381789504,19
2078,76,20,107,12,-6.61181954357389,8
2079,54,33,48,21,-6.6293905929603625,12
2080,16,21,90,12,-6.632184549525892,9
2081,85,14,86,7,-6.640232602185863,7
2082,17,14,91,8,-6.646960274535358,6
2083,49,16,74,9,-6.6690338705923,7
2084,9,24,18,14,-6.669379438735331,10
2085,2,14,15,8,-6.68122325045803,6
2086,62,18,79,10,-6.706683341972167,8
2087,54,25,49,14,-6.709179862826327,11
2088,9,25,29,14,-6.70933512946719,11
2089,74,11,89,6,-6.714017548400364,5
2090,111,14,13,9,-6.729510456907126,5
2091,34,19,2,11,-6.729658072634228,8
2092,41,42,111,24,-6.742879314894576,18
2093,28,50,87,30,-6.785536302011417,20
2094,20,25,2,14,-6.800156386602417,11
2095,41,35,91,22,-6.801656465480553,13
2096,28,39,76,23,-6.80499505832736,16
2097,6,21,88,13,-6.808639243885848,8
2098,64,11,28,6,-6.82253762472366,5
2099,91,26,6,15,-6.823132237906975,11
2100,16,69,8,43,-6.832024317947625,26
2101,87,39,16,23,-6.838182419308276,16
2102,8,24,90,15,-6.838297347223882,9
2103,88,13,10,8,-6.861581534296264,5
2104,28,38,38,22,-6.8687841977025155,16
2105,87,11,89,7,-6.89032748453306,4
2106,68,18,65,10,-6.895924597371667,8
2107,74,12,57,8,-6.91760424242575,4
2108,50,30,107,19,-6.921374494500155,11
2109,17,14,90,8,-6.930186835428714,6
2110,68,10,73,6,-6.95394987102174,4
2111,101,11,79,6,-6.990861425930873,5
2112,9,36,107,19,-6.995537467245023,17
2113,6,19,90,11,-7.0034906221582,8
2114,6,10,51,7,-7.0035300376142064,3
2115,34,29,84,19,-7.009777399581457,10
2116,91,26,103,13,-7.011657257024809,13
2117,93,48,8,30,-7.0175664395797135,18
2118,6,20,111,12,-7.01838566892247,8
2119,9,40,23,24,-7.023066131343451,16
2120,79,19,59,11,-7.0352036880537865,8
2121,50,34,87,21,-7.043252292270627,13
2122,28,37,91,23,-7.04770720595576,14
2123,54,13,11,8,-7.053030822989656,5
2124,48,53,8,32,-7.064834453033997,21
2125,34,24,98,16,-7.069151815365415,8
2126,13,10,10,5,-7.08154547770926,5
2127,89,16,16,10,-7.102664218068734,6
2128,76,35,98,21,-7.11656236534676,14
2129,103,20,29,12,-7.147753101442872,8
2130,32,16,103,10,-7.165401001930772,6
2131,6,11,5,7,-7.175117705775805,4
2132,34,13,111,7,-7.201437198359538,6
2133,48,48,84,28,-7.209403276697929,20
2134,6,29,55,20,-7.216182147698299,9
2135,88,29,9,18,-7.216345472997156,11
2136,76,19,10,11,-7.223608714939963,8
2137,8,41,23,25,-7.226225929875295,16
2138,73,18,50,10,-7.241939960957099,8
2139,103,49,98,31,-7.248745608369252,18
2140,38,14,88,8,-7.257573306252311,6
2141,73,10,30,6,-7.2752412959190496,4
2142,70,15,23,9,-7.277989111704888,6
2143,94,16,9,9,-7.284482029205993,7
2144,86,22,41,13,-7.286274520016925,9
2145,20,13,13,9,-7.287197108459042,4
2146,10,21,54,13,-7.316914939103655,8
2147,103,16,10,9,-7.341759223830171,7
2148,65,53,74,33,-7.345256184830916,20
2149,65,50,63,30,-7.358014786861475,20
2150,88,24,37,15,-7.378135194639771,9
2151,8,12,94,7,-7.380839863701195,5
2152,5,15,98,9,-7.40308817440165,6
2153,49,13,41,9,-7.40613906742907,4
2154,88,17,46,11,-7.407535109641899,6
2155,75,13,41,7,-7.41688145074682,6
2156,9,13,75,9,-7.420012168869883,4
2157,68,14,98,10,-7.427653338623123,4
2158,107,32,79,21,-7.430282572409814,11
2159,57,17,88,10,-7.432081698575297,7
2160,37,24,23,15,-7.440544332640971,9
2161,65,71,111,40,-7.44315444932928,31
2162,23,10,104,6,-7.459802178175598,4
2163,111,36,16,20,-7.468239795228054,16
2164,37,27,54,18,-7.469706742796568,9
2165,80,12,79,7,-7.494960416200487,5
2166,38,24,2,13,-7.498014725943601,11
2167,87,19,43,12,-7.500187924124219,7
2168,87,13,11,8,-7.5002461414178665,5
2169,38,10,34,6,-7.513274255260262,4
2170,54,28,103,16,-7.519450232339535,12
2171,107,20,29,13,-7.525530619454991,7
2172,76,21,91,13,-7.538547355116531,8
2173,28,43,93,26,-7.57301029261244,17
2174,79,23,17,14,-7.583686995894435,9
2175,41,45,87,26,-7.5997473042409585,19
2176,28,40,6,25,-7.6079577597869825,15
2177,34,16,87,10,-7.640142491832505,6
2178,106,10,54,6,-7.643289711475541,4
2179,62,19,84,11,-7.65619075053016,8
2180,74,20,10,13,-7.659112863437717,7
2181,2,49,16,30,-7.691279770578487,19
2182,59,11,23,7,-7.703199044299859,4
2183,112,21,20,13,-7.71897633781411,8
2184,85,14,111,9,-7.729378570457982,5
2185,9,71,16,46,-7.73633849027455,25
2186,88,28,84,18,-7.7431389568364795,10
2187,74,19,17,11,-7.746897696537681,8
2188,109,15,103,10,-7.74806703390503,5
2189,48,17,50,10,-7.751737687672279,7
2190,109,13,29,8,-7.7648215544268036,5
2191,49,15,30,9,-7.795814319272768,6
2192,2,18,70,12,-7.802975472592941,6
2193,90,13,55,8,-7.804139466218974,5
2194,109,25,20,17,-7.80690748170692,8
2195,37,32,76,21,-7.820497576953574,11
2196,11,19,28,12,-7.8361941121235885,7
2197,11,18,98,11,-7.845858753819514,7
2198,38,36,8,23,-7.848513446954377,13
2199,49,18,20,11,-7.854535242795636,7
2200,9,49,54,30,-7.862767512170962,19
2201,12,11,74,6,-7.881335923893619,5
2202,9,30,109,18,-7.889736540676633,12
2203,13,14,49,8,-7.890029815709072,6
2204,88,27,74,18,-7.895683127849934,9
2205,29,13,10,8,-7.953877306686606,5
2206,86,27,111,16,-7.962255850113394,11
2207,9,10,71,6,-7.971373091011489,4
2208,37,12,109,7,-7.972273664149992,5
2209,34,25,8,16,-7.975314953797204,9
2210,48,35,65,22,-7.9807562612280805,13
2211,34,16,41,9,-7.985588983079854,7
2212,46,12,29,8,-7.990068011062898,4
2213,41,15,90,9,-7.997737246515682,6
2214,74,11,13,7,-8.04867506694036,4
2215,13,12,6,7,-8.074590184679874,5
2216,10,15,30,10,-8.08039942607508,5
2217,9,14,19,8,-8.117304295019109,6
2218,28,31,10,21,-8.119129269340041,10
2219,9,36,55,24,-8.119772650595259,12
2220,85,20,28,12,-8.15287634199834,8
2221,76,56,8,35,-8.186735758017774,21
2222,9,11,11,7,-8.198586667223204,4
2223,54,36,93,25,-8.20730249779284,11
2224,94,13,28,8,-8.222371266039165,5
2225,51,19,54,11,-8.227410100820899,8
2226,16,10,26,6,-8.231874067384071,4
2227,48,19,90,12,-8.235782978996125,7
2228,8,17,1,10,-8.238012177466368,7
2229,17,14,111,8,-8.239799794462428,6
2230,84,68,16,41,-8.245378519925461,27
2231,37,11,51,7,-8.265197669915755,4
2232,8,30,17,19,-8.267140148743708,11
2233,109,11,76,8,-8.273966572487595,3
2234,58,12,65,6,-8.279172093518044,6
2235,41,18,76,11,-8.284971187696902,7
2236,34,14,55,10,-8.304742214344207,4
2237,59,17,9,11,-8.305936798720639,6
2238,109,33,8,20,-8.311226620633244,13
2239,103,45,41,31,-8.332714422601015,14
2240,9,36,91,22,-8.337030454552696,14
2241,70,10,20,7,-8.374580328727138,3
2242,65,14,1,9,-8.38534721300084,5
2243,89,11,90,7,-8.396796914570167,4
2244,88,40,16,27,-8.414893106044769,13
2245,10,21,73,14,-8.419335562342074,7
2246,1,21,98,14,-8.436557583367687,7
2247,86,27,30,20,-8.45360686296445,7
2248,56,13,8,9,-8.47665012859135,4
2249,98,30,49,18,-8.481939269224359,12
2250,68,19,20,11,-8.49950046367544,8
2251,103,24,26,14,-8.523036763842914,10
2252,9,25,32,16,-8.53109215537152,9
2253,8,46,26,27,-8.545433145117217,19
2254,76,10,11,6,-8.56044399501451,4
2255,10,18,93,12,-8.563863748489084,6
2256,2,12,58,8,-8.58540368974784,4
2257,87,35,93,22,-8.595406377397056,13
2258,66,14,84,9,-8.616861190106436,5
2259,79,25,34,14,-8.62165815876112,11
2260,32,26,65,16,-8.65722618752934,10
2261,109,18,34,11,-8.66273498003356,7
2262,75,11,48,8,-8.672815346664251,3
2263,73,17,2,10,-8.68105241339238,7
2264,20,15,34,10,-8.68693105656746,5
2265,46,11,16,7,-8.68716865467983,4
2266,6,27,16,16,-8.696725649896711,11
2267,65,17,34,10,-8.699576948418596,7
2268,62,16,76,8,-8.710475893988356,8
2269,54,31,55,21,-8.716015508186064,10
2270,20,35,55,21,-8.738108987978196,14
2271,37,24,30,16,-8.742074606758964,8
2272,20,12,63,8,-8.747811376407109,4
2273,28,27,104,18,-8.75248212518074,9
2274,38,15,32,10,-8.75452405688887,5
2275,84,32,93,21,-8.779261084845606,11
2276,91,26,2,15,-8.783750173530157,11
2277,20,53,41,35,-8.79255140026366,18
2278,74,28,93,19,-8.795682713621986,9
2279,93,24,23,14,-8.804783518097919,10
2280,76,10,29,7,-8.806443209825622,3
2281,85,11,10,6,-8.810276618143424,5
2282,84,11,64,6,-8.83326213103814,5
2283,79,26,32,17,-8.859137187931584,9
2284,94,17,98,11,-8.877059957058028,6
2285,50,11,112,7,-8.921235906620762,4
2286,91,16,55,11,-8.921765963817519,5
2287,86,20,10,13,-8.925705329647823,7
2288,110,20,107,12,-8.933567921834605,8
2289,111,18,48,12,-8.93792122942067,6
2290,46,19,111,12,-8.943973618396548,7
2291,96,14,65,8,-8.945535735868065,6
2292,18,19,74,12,-8.971261505798399,7
2293,86,41,37,25,-8.9832167055326,16
2294,62,19,41,12,-9.00335332858162,7
2295,44,11,84,7,-9.017421120510093,4
2296,76,35,74,23,-9.021109435296268,12
2297,50,16,91,11,-9.044194652502608,5
2298,16,12,15,8,-9.05960662342551,4
2299,109,13,106,8,-9.06266809979583,5
2300,32,12,26,7,-9.09769401619869,5
2301,112,23,6,14,-9.097888193162195,9
2302,57,11,2,6,-9.107338089684553,5
2303,91,35,74,22,-9.120669894046731,13
2304,65,41,2,28,-9.121243860129145,13
2305,79,24,18,14,-9.141344406761542,10
2306,85,28,84,16,-9.160197369727129,12
2307,43,24,8,15,-9.183295995535126,9
2308,28,26,13,18,-9.183739107543797,8
2309,37,16,55,10,-9.183747537097535,6
2310,20,48,107,29,-9.214441217624072,19
2311,54,46,111,29,-9.235401744617302,17
2312,50,12,110,8,-9.25251740175268,4
2313,84,20,17,13,-9.25697489923984,7
2314,50,14,43,9,-9.27474781724881,5
2315,86,20,38,14,-9.280969369301586,6
2316,9,34,20,23,-9.290302263411943,11
2317,23,17,50,10,-9.300090532650529,7
2318,107,13,13,9,-9.307281354536356,4
2319,106,23,79,14,-9.330142332667407,9
2320,29,22,74,13,-9.341715830488068,9
2321,75,19,79,13,-9.342561498216151,6
2322,8,14,59,9,-9.376826871718674,5
2323,54,26,63,16,-9.380965402014514,10
2324,30,22,55,13,-9.385734127086305,9
2325,8,17,46,11,-9.405496106583279,6
2326,35,17,48,11,-9.405686959524614,6
2327,48,13,34,8,-9.41505723405772,5
2328,89,25,28,15,-9.422989936012565,10
2329,10,11,57,7,-9.432674751481889,4
2330,87,27,30,18,-9.441306317195094,9
2331,5,16,87,10,-9.446283858022085,6
2332,84,17,18,11,-9.480131506018989,6
2333,19,11,103,7,-9.481054864710421,4
2334,58,11,6,7,-9.489496457414932,4
2335,76,23,15,15,-9.503739473265108,8
2336,79,21,13,15,-9.547980426671515,6
2337,65,21,60,13,-9.571951123571171,8
2338,85,25,16,16,-9.572199671326333,9
2339,89,22,23,14,-9.576875474490599,8
2340,107,18,43,12,-9.57800148756219,6
2341,65,60,98,39,-9.578885579734806,21
2342,70,18,30,12,-9.585226013483616,6
2343,35,12,8,7,-9.605315474711036,5
2344,8,21,13,14,-9.615323131026955,7
2345,41,27,55,16,-9.622531787318458,11
2346,18,10,46,7,-9.6369429103627,3
2347,62,26,98,16,-9.641858129313675,10
2348,20,14,106,8,-9.651889529369447,6
2349,85,11,88,7,-9.656301948727862,4
2350,38,32,29,21,-9.681299801122256,11
2351,106,13,84,7,-9.721232372178166,6
2352,103,36,111,23,-9.751404731703087,13
2353,91,18,63,11,-9.755061220541068,7
2354,103,42,8,29,-9.755203687685839,13
2355,91,17,93,11,-9.794639196057782,6
2356,74,13,70,9,-9.800022679632324,4
2357,76,25,54,15,-9.82196620742167,10
2358,9,28,17,18,-9.851089499965493,10
2359,50,14,10,9,-9.907166966632534,5
2360,86,17,11,10,-9.920784017899692,7
2361,108,11,16,7,-9.921562283850518,4
2362,17,13,87,8,-9.92299839057508,5
2363,75,10,103,6,-9.92764617859353,4
2364,70,11,93,7,-9.928875321549777,4
2365,18,14,55,9,-9.949790942140542,5
2366,87,50,55,33,-9.957250285763632,17
2367,32,30,111,18,-9.962416908002066,12
2368,38,24,111,15,-9.966212518632437,9
2369,23,20,90,13,-9.96715448150969,7
2370,34,17,76,11,-9.994247540573088,6
2371,48,11,11,7,-10.021932577969975,4
2372,30,11,88,6,-10.024835723736619,5
2373,34,14,37,9,-10.040882054419711,5
2374,10,30,84,19,-10.110326059838856,11
2375,74,29,103,20,-10.120878103689181,9
2376,65,23,110,15,-10.151511833678441,8
2377,38,10,60,6,-10.186949801542625,4
2378,9,74,28,46,-10.2354653730454,28
2379,6,16,26,11,-10.241752287967037,5
2380,87,10,39,6,-10.267299551613329,4
2381,89,14,8,9,-10.313019177206712,5
2382,9,23,34,14,-10.326274877348238,9
2383,46,11,20,8,-10.3403562689593,3
2384,50,24,65,16,-10.363532140430609,8
2385,75,11,2,7,-10.369833561069749,4
2386,76,21,70,14,-10.3832919130965,7
2387,17,10,29,7,-10.39598522715346,3
2388,65,19,70,13,-10.418442635866082,6
2389,76,21,46,15,-10.423738421119205,6
2390,86,17,64,11,-10.437285409841268,6
2391,54,10,14,7,-10.443430113517227,3
2392,79,37,26,23,-10.48182801922156,14
2393,8,17,110,12,-10.493443474648162,5
2394,20,18,16,11,-10.507912719710413,7
2395,79,34,20,23,-10.53719224502861,11
2396,32,12,6,8,-10.5718983874489,4
2397,41,39,54,26,-10.593430312504074,13
2398,101,10,65,6,-10.616476001261296,4
2399,104,15,54,10,-10.631063301403966,5
2400,39,10,48,6,-10.63665306077639,4
2401,88,37,98,26,-10.63966352804894,11
2402,58,13,38,9,-10.642287291889899,4
2403,109,16,107,10,-10.668493285549742,6
2404,44,35,6,22,-10.67278245600393,13
2405,41,14,37,9,-10.69447624326301,5
2406,103,50,65,34,-10.69843242130798,16
2407,85,10,91,5,-10.702453755941068,5
2408,6,29,87,19,-10.703931695338108,10
2409,88,16,73,11,-10.709173893318198,5
2410,66,12,107,8,-10.732234223681386,4
2411,18,14,23,10,-10.769319649937687,4
2412,23,16,17,11,-10.781653305644483,5
2413,68,11,50,8,-10.798306988405807,3
2414,41,48,98,30,-10.835326353590224,18
2415,65,30,26,19,-10.898269254189744,11
2416,86,18,49,10,-10.913471544367308,8
2417,20,38,26,25,-10.94603615247926,13
2418,2,11,13,8,-10.953261699605443,3
2419,43,10,30,7,-10.958461383133036,3
2420,56,10,87,7,-10.97544493784176,3
2421,6,14,38,10,-11.005398790381081,4
2422,110,12,98,8,-11.026999619900332,4
2423,103,13,13,8,-11.054952217566056,5
2424,16,20,30,14,-11.05670639382778,6
2425,28,10,35,7,-11.074308940964794,3
2426,6,25,74,17,-11.078169532223491,8
2427,104,10,74,7,-11.124138818031259,3
2428,37,19,93,13,-11.13537305772806,6
2429,28,10,15,7,-11.176545961741331,3
2430,48,14,20,10,-11.212381696993145,4
2431,44,18,65,11,-11.219859746185271,7
2432,50,18,32,11,-11.225096892130631,7
2433,29,21,30,13,-11.231145218657787,8
2434,71,12,98,8,-11.256798740703502,4
2435,6,29,107,19,-11.291567068221694,10
2436,2,10,39,6,-11.302944205280658,4
2437,103,22,2,16,-11.358008021341288,6
2438,41,20,17,15,-11.462467383182341,5
2439,28,17,43,12,-11.503038032270851,5
2440,70,28,16,20,-11.54427586863591,8
2441,7,10,107,7,-11.561152440630659,3
2442,109,22,38,15,-11.561969316834697,7
2443,102,16,65,10,-11.565057266886953,6
2444,13,18,16,12,-11.568229122492735,6
2445,48,22,74,14,-11.585683993127107,8
2446,18,16,65,11,-11.593628436717696,5
2447,103,26,30,18,-11.594512781464298,8
2448,85,10,93,7,-11.596564222959241,3
2449,18,11,91,7,-11.600004781918232,4
2450,88,15,32,11,-11.622595612385652,4
2451,15,17,98,11,-11.628891195956705,6
2452,55,18,10,11,-11.634204977110194,7
2453,93,13,73,9,-11.6698926319616,4
2454,1,15,93,11,-11.687642643688712,4
2455,75,13,93,8,-11.701725422413729,5
2456,86,11,46,8,-11.702567693743317,3
2457,20,13,18,8,-11.715025972179685,5
2458,62,13,70,8,-11.719880801732709,5
2459,26,15,23,10,-11.729655071897735,5
2460,48,15,93,11,-11.743861625157338,4
2461,79,10,15,7,-11.756403792330063,3
2462,98,18,104,11,-11.758094591275455,7
2463,107,14,1,9,-11.758251767033554,5
2464,46,14,26,9,-11.785571142877396,5
2465,63,14,37,9,-11.788951691627307,5
2466,37,11,50,7,-11.791517943036679,4
2467,103,29,93,19,-11.801085216233043,10
2468,112,14,28,9,-11.811196680681133,5
2469,9,11,58,8,-11.82226661915616,3
2470,62,15,23,11,-11.828374088275872,4
2471,37,17,85,13,-11.836833776252561,4
2472,109,14,43,9,-11.866460109925436,5
2473,106,13,55,9,-11.870951241031618,4
2474,87,44,26,29,-11.871386146117102,15
2475,1,11,9,7,-11.88637849875501,4
2476,106,15,16,10,-11.89377453971796,5
2477,17,13,18,8,-11.905263091036245,5
2478,76,10,93,7,-11.923250604262599,3
2479,65,11,14,8,-11.952914938466222,3
2480,86,33,2,23,-11.955848930517432,10
2481,65,22,49,14,-11.960634834980652,8
2482,109,19,74,12,-11.981116452380181,7
2483,79,21,63,14,-11.98930110715289,7
2484,70,11,29,8,-12.030336124564109,3
2485,30,15,93,10,-12.041707290163442,5
2486,6,18,18,12,-12.078104024118801,6
2487,112,11,79,8,-12.089617166544242,3
2488,109,15,91,10,-12.09037191037832,5
2489,103,11,58,8,-12.093407699535737,3
2490,109,27,54,18,-12.131563798369134,9
2491,41,20,93,15,-12.152619394683914,5
2492,109,11,10,7,-12.166039484484626,4
2493,9,16,63,10,-12.275723948784513,6
2494,41,24,32,15,-12.295470101415006,9
2495,50,17,93,11,-12.303370496346982,6
2496,26,12,93,8,-12.342400061412198,4
2497,97,11,9,7,-12.349501112253755,4
2498,23,18,20,13,-12.419097927334022,5
2499,62,22,93,15,-12.439036445917942,7
2500,50,17,30,11,-12.478426478717187,6
2501,84,14,15,10,-12.488568021465507,4
2502,48,12,104,9,-12.498145078794368,3
2503,86,10,13,7,-12.514933779078893,3
2504,109,13,86,8,-12.564742847433582,5
2505,66,15,8,11,-12.57730249455607,4
2506,98,41,55,29,-12.606268888418896,12
2507,98,25,32,17,-12.60897292614075,8
2508,9,21,46,13,-12.652533384487015,8
2509,103,33,20,24,-12.666531668869954,9
2510,90,11,73,8,-12.699639901607055,3
2511,62,23,55,15,-12.723053800596206,8
2512,111,21,73,14,-12.761253099258202,7
2513,17,14,86,10,-12.845058614378045,4
2514,9,37,93,26,-12.871076607744827,11
2515,8,11,3,8,-12.917286316124729,3
2516,48,17,51,13,-12.926828220690846,4
2517,43,18,55,12,-13.012921035450152,6
2518,11,10,50,7,-13.016746288382762,3
2519,70,15,107,10,-13.053888487638648,5
2520,9,24,30,17,-13.086601208658113,7
2521,109,17,55,12,-13.091080409868953,5
2522,41,30,107,19,-13.154593566297324,11
2523,103,11,43,7,-13.18571482888933,4
2524,17,25,28,18,-13.189393025867652,7
2525,107,17,32,13,-13.233625998220862,4
2526,89,10,58,7,-13.242354787086834,3
2527,109,24,26,17,-13.281044125686407,7
2528,73,12,89,8,-13.292782754035754,4
2529,62,12,30,8,-13.325811773490164,4
2530,109,22,32,15,-13.338298268264783,7
2531,91,10,112,7,-13.34887289439105,3
2532,73,15,13,10,-13.471561712276635,5
2533,62,27,107,18,-13.491527071908129,9
2534,38,23,74,15,-13.50724395592576,8
2535,37,20,111,13,-13.57504840749371,7
2536,5,12,37,9,-13.593067112324485,3
2537,43,17,26,13,-13.59933768355571,4
2538,13,17,84,11,-13.614397809771184,6
2539,13,10,37,7,-13.71058873552403,3
2540,71,20,8,13,-13.739907398566018,7
2541,73,16,38,10,-13.771113964229546,6
2542,8,12,77,9,-13.772928583045534,3
2543,43,14,93,10,-13.775006273083642,4
2544,51,10,34,7,-13.832212239769484,3
2545,50,11,26,8,-13.83833866908602,3
2546,2,22,55,15,-13.871872112800904,7
2547,109,12,70,9,-13.902253335630233,3
2548,54,27,30,19,-13.923397923845725,8
2549,107,35,26,27,-13.95146533006327,8
2550,9,20,57,15,-13.952239963411907,5
2551,85,14,30,10,-14.008346410378737,4
2552,76,14,57,10,-14.156354151485946,4
2553,38,12,48,9,-14.205802555452095,3
2554,109,12,50,8,-14.261856398454313,4
2555,8,10,60,7,-14.262033464961128,3
2556,70,12,90,9,-14.290264472561063,3
2557,91,11,46,8,-14.304066831342237,3
2558,50,10,104,7,-14.369017199502489,3
2559,38,26,55,18,-14.425488233223774,8
2560,20,26,29,18,-14.478890408494554,8
2561,11,15,55,11,-14.552741756285249,4
2562,73,11,48,8,-14.582237633015302,3
2563,20,19,62,14,-14.584809923949425,5
2564,13,14,88,8,-14.636848081546901,6
2565,74,16,34,11,-14.640026082092419,5
2566,59,14,65,9,-14.654063925888893,5
2567,93,11,90,7,-14.682520064465665,4
2568,62,11,49,7,-14.691411076024673,4
2569,38,25,93,17,-14.706979782976546,8
2570,17,11,93,8,-14.792328082005685,3
2571,41,13,13,9,-14.878152444409187,4
2572,37,15,57,11,-15.067776643574774,4
2573,40,14,84,9,-15.139436492633186,5
2574,18,11,90,8,-15.206260273523743,3
2575,28,26,26,19,-15.211295764909368,7
2576,6,31,2,22,-15.303923962237263,9
2577,76,16,63,13,-15.315183161564981,3
2578,57,23,8,16,-15.346450747313162,7
2579,88,12,106,10,-15.367046226675955,2
2580,23,24,10,16,-15.417351314064488,8
2581,88,13,70,10,-15.445871190573264,3
2582,11,12,106,10,-15.453171865714518,2
2583,66,11,28,7,-15.514046365780626,4
2584,54,11,39,8,-15.528226686771598,3
2585,59,10,16,6,-15.561569445873218,4
2586,87,20,106,16,-15.583574530645649,4
2587,107,10,46,8,-15.65139707745225,2
2588,73,12,29,9,-15.669782329836792,3
2589,38,15,17,11,-15.678044683298898,4
2590,79,15,46,10,-15.695062063539162,5
2591,62,31,111,23,-15.780695907166118,8
2592,66,14,6,11,-15.817538028688281,3
2593,76,21,2,15,-15.887194817597921,6
2594,91,12,90,8,-16.09870244517901,4
2595,88,18,90,13,-16.196945416210344,5
2596,65,25,30,19,-16.220777761486307,6
2597,37,14,17,9,-16.224073122382876,5
2598,85,14,87,11,-16.255207936397188,3
2599,75,14,55,11,-16.26512819390793,3
2600,103,11,59,8,-16.266656443008642,3
2601,9,12,5,9,-16.296173952922768,3
2602,103,13,62,9,-16.299156500586875,4
2603,96,10,49,7,-16.466804604951104,3
2604,69,13,26,10,-16.625965123271836,3
2605,41,10,69,7,-16.634275461416582,3
2606,109,16,73,12,-16.722107664046142,4
2607,86,18,70,13,-16.806348175717314,5
2608,109,31,41,26,-16.84086997358483,5
2609,23,15,73,11,-16.845082586610527,4
2610,15,12,38,9,-16.880495720481193,3
2611,54,13,26,8,-16.93978716229654,5
2612,86,21,63,17,-16.962373206073654,4
2613,70,10,46,7,-17.153485710664995,3
2614,89,10,37,8,-17.418835616565143,2
2615,55,10,39,7,-17.520622017928282,3
2616,49,19,88,15,-17.53203455274144,4
2617,28,19,57,15,-17.55982008462565,4
2618,110,10,41,9,-17.607251464829996,1
2619,70,16,63,12,-17.68149233309164,4
2620,9,11,64,8,-17.70787325437998,3
2621,73,12,107,9,-18.009767759901283,3
2622,10,15,38,12,-18.015221595889397,3
2623,87,13,58,11,-18.244104920146572,2
2624,1,19,10,15,-18.36953895818594,4
2625,7,13,79,10,-18.40480150019194,3
2626,91,15,34,11,-18.43501821510385,4
2627,75,15,88,12,-18.46157402080457,3
2628,6,15,109,11,-18.568483421277442,4
2629,38,24,26,18,-18.614524044017738,6
2630,2,13,18,10,-18.666944559681195,3
2631,88,11,26,8,-18.785991491960512,3
2632,109,16,111,12,-18.82454889767414,4
2633,71,12,62,11,-19.04348733516107,1
2634,28,15,63,12,-19.065782846243966,3
2635,16,17,49,13,-19.10499490357724,4
2636,29,12,110,10,-19.248543702222975,2
2637,38,14,43,10,-19.328461951187712,4
2638,109,30,87,23,-19.45596890113393,7
2639,10,19,20,15,-19.474906343573682,4
2640,109,29,28,22,-19.49991563999526,7
2641,50,15,62,12,-19.69258957665125,3
2642,10,13,41,11,-19.737157878272868,2
2643,76,12,90,8,-19.849308288721737,4
2644,103,10,34,9,-19.87880862427678,1
2645,98,12,51,9,-20.0679948728163,3
2646,109,12,110,10,-20.16933250309851,2
2647,10,10,17,8,-20.222695302818984,2
2648,37,11,18,9,-20.496733536799674,2
2649,71,10,28,9,-20.618030954774138,1
2650,104,10,37,8,-20.681486856575923,2
2651,110,14,74,11,-20.875047711546735,3
2652,70,25,111,19,-21.761941281988644,6
2653,44,11,17,9,-22.072912946241182,2
2654,85,13,55,10,-22.50219401266605,3
2655,46,19,87,15,-22.516958582894237,4
2656,85,11,20,9,-22.58682017719025,2
2657,94,10,84,9,-22.762013140609877,1
2658,10,10,26,8,-22.77202326046866,2
2659,41,13,57,11,-23.156162131875274,2
2660,12,10,6,7,-23.420786535379097,3
2661,50,10,106,9,-23.514739146454776,1
2662,97,10,65,7,-23.53209680517744,3
2663,86,15,103,13,-23.967936503754764,2
2664,10,11,63,9,-24.09658997724639,2
2665,89,11,55,9,-24.169792122479972,2
2666,112,11,74,9,-24.423385588541223,2
2667,30,11,46,9,-24.436531907478123,2
2668,49,11,26,8,-26.831812890773925,3
2669,43,10,91,10,-27.34458455824453,0
2670,65,11,64,9,-27.72714931249874,2
2671,107,10,19,9,-28.256315341969913,1
