,againstHero,games,hero,losses,shift,wins
0,112,16,102,1,31.192976791251173,15
1,44,11,37,0,29.883498899257123,11
2,90,13,23,1,28.3624814299098,12
3,98,10,61,0,28.323329566102483,10
4,69,10,38,1,27.695920761479563,9
5,11,11,89,1,25.07677406541354,10
6,104,11,42,1,24.55480599508645,10
7,100,10,33,1,24.40727081526952,9
8,75,19,77,3,23.528365703077363,16
9,58,10,66,1,23.43526848489906,9
10,4,11,8,1,23.177905083651492,10
11,3,10,1,2,22.67051623941871,8
12,19,13,109,2,22.638381086719185,11
13,91,12,97,2,22.175648770183788,10
14,112,14,57,3,22.163408269660163,11
15,55,12,38,2,22.071024000200875,10
16,62,12,31,3,21.79094106777599,9
17,26,13,57,3,21.519388702063118,10
18,41,15,4,5,21.480590173913868,10
19,25,13,4,2,21.42004260246313,11
20,104,16,91,1,21.319718278752113,15
21,101,11,51,2,21.22662017561448,9
22,57,11,72,0,21.2224791597557,11
23,19,10,37,1,21.121276459586674,9
24,80,16,112,4,21.10879540796462,12
25,110,10,43,2,21.055981543018305,8
26,112,14,10,3,21.02177070913973,11
27,34,11,62,2,20.901478916088546,9
28,75,17,3,3,20.897191698320935,14
29,90,11,68,2,20.787956198015944,9
30,17,11,79,2,20.721013165555437,9
31,48,12,94,2,20.576242864974443,10
32,81,23,94,6,20.51779847980575,17
33,48,17,3,4,20.44256641492949,13
34,13,11,66,2,20.385605001870267,9
35,51,15,10,3,20.332726180509006,12
36,75,10,103,1,20.241991505098973,9
37,64,10,34,2,20.22471209152634,8
38,112,38,68,8,20.161440612174857,30
39,7,12,84,2,20.160900959942534,10
40,73,13,97,4,19.966763707753135,9
41,95,12,32,2,19.760326388824463,10
42,15,11,31,3,19.73878794252568,8
43,64,11,5,2,19.698196874853632,9
44,114,12,108,3,19.622938702057745,9
45,30,11,6,2,19.605882514870544,9
46,114,11,29,3,19.428812885704772,8
47,30,19,36,2,19.30529767168729,17
48,109,16,29,5,19.293843958416073,11
49,99,14,18,3,19.290873438644514,11
50,4,16,54,2,19.2440876038421,14
51,45,12,43,3,19.04326521517843,9
52,92,10,106,2,19.041690772468705,8
53,89,11,106,4,18.95338953455919,7
54,98,13,4,2,18.936498509144613,11
55,34,12,97,3,18.831202908180156,9
56,87,15,35,4,18.8244045658863,11
57,27,12,102,2,18.772173343475483,10
58,49,12,58,3,18.76050052933211,9
59,99,17,28,4,18.754584808369174,13
60,45,10,12,2,18.653807119995122,8
61,72,13,29,3,18.568703052277588,10
62,55,19,33,4,18.562648470025508,15
63,106,15,31,4,18.52908676481624,11
64,5,10,18,2,18.464269170029823,8
65,34,12,54,2,18.362976743969615,10
66,80,20,13,6,18.33580484931627,14
67,19,11,6,3,18.335706204340305,8
68,81,12,43,3,18.327617727929386,9
69,75,10,79,2,18.18520074819613,8
70,67,10,54,2,18.121548101252507,8
71,78,17,62,4,18.093769732536938,13
72,95,15,30,4,17.919901608832813,11
73,35,10,41,3,17.84884882348167,7
74,111,11,114,3,17.846918134233796,8
75,32,17,88,4,17.82459413467382,13
76,30,18,5,3,17.81053305502534,15
77,44,12,55,3,17.77184716319356,9
78,90,23,51,5,17.7178788097309,18
79,86,23,58,5,17.708236566074184,18
80,5,11,3,4,17.694163901939547,7
81,108,12,9,4,17.68902181325234,8
82,20,10,67,2,17.6724550880506,8
83,110,11,83,2,17.575104905290946,9
84,47,10,57,3,17.50280540505226,7
85,23,14,18,4,17.468338798211544,10
86,80,10,29,2,17.457200220457587,8
87,60,10,35,3,17.41812694726481,7
88,35,10,106,3,17.319051156851785,7
89,27,22,5,6,17.18696709990766,16
90,6,10,41,3,17.168490702692317,7
91,72,13,23,3,17.14817782244225,10
92,60,11,2,3,17.11684300008854,8
93,27,29,9,8,17.072056537621453,21
94,18,14,1,3,17.058153705270225,11
95,29,12,102,2,17.056577765128154,10
96,48,11,70,3,17.04295857723929,8
97,12,15,109,3,17.036286111783692,12
98,43,11,46,3,16.991693442801246,8
99,38,10,31,4,16.97274158238424,6
100,20,19,112,4,16.964936240764274,15
101,13,12,10,3,16.892767460419815,9
102,78,14,48,3,16.88793509976696,11
103,7,21,57,7,16.868380359502744,14
104,88,27,29,7,16.852047860671817,20
105,72,14,69,3,16.843378758894527,11
106,38,14,97,3,16.838290194315167,11
107,1,10,76,3,16.815372977495876,7
108,23,13,83,3,16.744700089549806,10
109,95,15,71,5,16.72675418994599,10
110,109,13,103,4,16.721514619556498,9
111,55,11,12,3,16.703609425323116,8
112,78,28,112,7,16.679149831728484,21
113,53,23,69,6,16.67657945090473,17
114,101,10,36,2,16.6279467044195,8
115,95,22,68,4,16.550204863156036,18
116,49,17,81,5,16.548537671207544,12
117,16,20,83,5,16.531803021169058,15
118,66,10,64,2,16.526342406123636,8
119,61,10,87,3,16.482333693393567,7
120,14,15,55,3,16.464885141480416,12
121,11,25,25,5,16.429746187224733,20
122,99,19,39,4,16.42872930905631,15
123,29,10,40,2,16.378294184390825,8
124,27,13,83,2,16.368092522641092,11
125,100,22,57,6,16.35292952819185,16
126,104,19,2,6,16.352388003055783,13
127,65,16,33,4,16.28612136110108,12
128,34,12,80,2,16.269229317512288,10
129,29,16,57,4,16.251057006057927,12
130,16,31,77,8,16.212880673456585,23
131,102,16,60,5,16.199085660218575,11
132,48,12,35,3,16.1584671300222,9
133,43,10,102,3,16.154622115934178,7
134,98,13,46,4,16.128351252027375,9
135,71,15,112,4,16.116875921028473,11
136,50,11,103,3,16.107700105307455,8
137,41,18,5,6,16.05037708250146,12
138,15,14,37,3,16.033544043199246,11
139,30,17,85,5,15.962999516967606,12
140,14,13,63,4,15.961958621197992,9
141,30,18,41,5,15.955365157993047,13
142,54,18,76,5,15.916701819672271,13
143,2,18,51,6,15.905597113130021,12
144,80,13,70,2,15.901333417895936,11
145,53,30,9,8,15.894615033798411,22
146,43,12,28,4,15.894105628705272,8
147,94,18,57,5,15.891839037049907,13
148,90,29,28,7,15.880089586771653,22
149,94,23,51,6,15.876961640520744,17
150,16,45,31,12,15.837412153743443,33
151,15,12,41,3,15.833444649300692,9
152,95,22,17,5,15.80262158037718,17
153,80,19,88,6,15.782107491065846,13
154,30,11,93,3,15.777207362300766,8
155,75,10,35,2,15.755761764469415,8
156,93,16,96,4,15.733194627661211,12
157,37,14,77,4,15.73169378416834,10
158,80,12,35,3,15.72406211872363,9
159,98,14,88,3,15.721203352726127,11
160,75,13,80,3,15.718052052365534,10
161,45,20,51,5,15.703190735785382,15
162,8,13,1,3,15.702434313684373,10
163,15,14,112,4,15.700949053545523,10
164,14,12,97,2,15.664913845649806,10
165,90,13,97,4,15.621888085765939,9
166,106,11,85,3,15.60573196351404,8
167,23,10,69,2,15.603167423944376,8
168,4,14,45,4,15.600891470448106,10
169,23,20,5,5,15.563915929412016,15
170,104,12,31,4,15.561592201078605,8
171,48,16,9,4,15.537621007215709,12
172,25,11,14,2,15.536643242754739,9
173,37,11,10,4,15.516949569025604,7
174,64,20,104,5,15.515264160119225,15
175,69,15,31,5,15.502962092044205,10
176,112,22,84,6,15.486639525748984,16
177,2,12,39,3,15.473797666414955,9
178,74,12,103,3,15.463990000688314,9
179,73,25,107,8,15.460672720698525,17
180,62,15,94,4,15.456678982493088,11
181,49,14,25,4,15.43786379260084,10
182,100,15,2,5,15.363858490781988,10
183,41,15,84,4,15.33074063826509,11
184,104,12,94,3,15.27233865597327,9
185,93,14,46,3,15.251126640356864,11
186,109,16,98,4,15.216713921072742,12
187,71,10,29,2,15.143188317628589,8
188,100,29,68,9,15.127566113231639,20
189,78,13,47,4,15.091757543510106,9
190,15,16,77,4,15.070938038619209,12
191,54,10,77,1,15.067841236649627,9
192,104,16,79,5,15.054954882421578,11
193,38,10,93,4,15.046407356806796,6
194,25,18,99,5,15.014737107768298,13
195,45,10,75,2,15.003649946946844,8
196,13,12,22,3,14.994671319317485,9
197,16,42,94,11,14.87192057190217,31
198,110,12,28,4,14.860268273313302,8
199,87,13,38,4,14.859584047072822,9
200,15,13,76,4,14.81353391108204,9
201,102,11,35,4,14.787485364380148,7
202,72,14,109,3,14.772801167610016,11
203,72,22,51,7,14.75505634651796,15
204,32,14,106,3,14.741977351969275,11
205,100,10,31,3,14.730848989291463,7
206,74,10,29,3,14.72390247298373,7
207,114,19,83,5,14.712530964906872,14
208,17,19,78,6,14.709203332504181,13
209,55,16,19,5,14.687783547200532,11
210,27,34,109,11,14.672056456650022,23
211,50,12,99,4,14.581629542155014,8
212,80,19,50,4,14.554439051919097,15
213,73,12,37,4,14.533349572792922,8
214,12,11,62,3,14.509530975721361,8
215,34,12,25,3,14.468789684868277,9
216,80,10,76,3,14.461464881129865,7
217,73,10,2,3,14.457830254043136,7
218,63,13,35,4,14.450412261730216,9
219,44,12,5,3,14.447481002517355,9
220,97,13,35,3,14.444551731599502,10
221,80,11,14,4,14.435345395194508,7
222,108,26,70,7,14.42739364927628,19
223,100,15,81,5,14.382694095158195,10
224,40,10,83,2,14.347262135245902,8
225,7,27,77,8,14.33556677589385,19
226,26,25,86,6,14.322036756570222,19
227,31,12,57,4,14.310689026630849,8
228,46,11,102,3,14.30749471315205,8
229,61,17,7,6,14.21770274028152,11
230,72,10,75,3,14.207053385683187,7
231,41,30,9,9,14.113579732248976,21
232,104,22,38,7,14.071473191155556,15
233,40,29,77,8,14.048771071022596,21
234,15,23,109,5,14.044569549955568,18
235,45,11,39,4,14.033377854173942,7
236,55,16,103,4,14.032110996505947,12
237,48,29,54,9,14.01975726236914,20
238,111,12,75,4,13.972281809419963,8
239,114,29,109,7,13.96133653890184,22
240,108,21,39,7,13.948334466983779,14
241,40,24,71,7,13.948125771645659,17
242,91,11,109,3,13.946188604720339,8
243,75,19,69,5,13.942304484906579,14
244,60,14,20,4,13.93992645286088,10
245,37,11,112,3,13.937736127059294,8
246,100,31,3,9,13.921725717823312,22
247,25,10,112,3,13.919292260310076,7
248,53,19,50,6,13.883151416746285,13
249,34,14,104,4,13.86429846409272,10
250,77,18,50,4,13.854547351284703,14
251,100,30,103,9,13.847875266312382,21
252,38,14,112,3,13.819485047030144,11
253,98,17,31,6,13.805084918983171,11
254,13,74,31,23,13.800549608099516,51
255,97,11,112,2,13.794615799527321,9
256,7,19,76,7,13.79135600101831,12
257,34,16,20,4,13.763107006170879,12
258,95,37,88,11,13.752013257016605,26
259,97,10,27,4,13.735152835550483,6
260,63,25,31,7,13.714594813504092,18
261,104,14,44,4,13.703910249073422,10
262,47,13,49,3,13.686396277061283,10
263,49,11,18,3,13.655065375637422,8
264,17,12,94,4,13.646957443918598,8
265,34,18,60,5,13.644836415292456,13
266,9,13,12,4,13.614723999539923,9
267,34,20,57,6,13.584679931175105,14
268,104,31,11,9,13.572205348595668,22
269,15,10,74,3,13.569326307429137,7
270,76,12,91,3,13.563460914482881,9
271,57,17,109,5,13.55588836432437,12
272,80,10,6,3,13.522871173076249,7
273,13,27,29,9,13.513958263485302,18
274,55,13,112,3,13.498405767917479,10
275,30,32,63,10,13.498171962188783,22
276,84,12,108,3,13.488009207908556,9
277,27,24,69,8,13.48310441915363,16
278,43,19,77,6,13.44590515078262,13
279,36,15,35,4,13.440272285829963,11
280,43,19,53,5,13.438033142991653,14
281,23,15,45,4,13.436468047997268,11
282,25,12,32,5,13.427877456338663,7
283,61,16,68,5,13.424919545398375,11
284,75,15,53,5,13.423496737137006,10
285,91,11,112,3,13.423237527272482,8
286,18,15,19,4,13.380338986795525,11
287,104,12,35,4,13.369677424437178,8
288,55,11,32,4,13.36363963009391,7
289,18,12,46,3,13.322032493347338,9
290,50,17,46,6,13.310329365776974,11
291,64,19,106,6,13.295192075566398,13
292,7,12,99,4,13.274517260788409,8
293,102,31,5,10,13.269431869962297,21
294,95,23,11,6,13.26328800508424,17
295,75,37,54,12,13.241406019841682,25
296,36,18,54,6,13.217744798273172,12
297,27,17,89,5,13.200102555354913,12
298,47,17,112,6,13.195058355865363,11
299,95,28,37,7,13.149042342745604,21
300,63,30,3,7,13.13647260700251,23
301,83,10,70,4,13.118339150755117,6
302,21,11,87,3,13.114631052870209,8
303,11,41,37,12,13.080901694615491,29
304,84,28,3,10,13.06598659051468,18
305,15,12,79,4,13.059472232177564,8
306,85,17,94,5,12.991600312687373,12
307,79,26,87,7,12.9643816213658,19
308,91,29,60,10,12.952631394075715,19
309,114,15,12,6,12.94950946807653,9
310,9,13,94,5,12.936870793436032,8
311,100,46,65,13,12.91328144209294,33
312,17,19,109,6,12.911257852793495,13
313,2,21,65,5,12.890027578518202,16
314,39,25,94,8,12.842801062921897,17
315,30,20,43,5,12.838886769237316,15
316,104,40,46,13,12.826160652792534,27
317,48,16,49,4,12.810788363261889,12
318,19,10,89,3,12.799215483528108,7
319,108,14,11,4,12.798974196396989,10
320,80,21,51,7,12.779249811641693,14
321,54,12,81,4,12.757047966098476,8
322,109,14,64,6,12.75697214661366,8
323,100,15,1,5,12.750379039232412,10
324,95,10,36,3,12.746346244298937,7
325,33,14,106,4,12.736963404825662,10
326,80,13,49,5,12.731038457974943,8
327,46,24,106,9,12.725492516069492,15
328,98,12,48,3,12.72400980532305,9
329,111,16,88,4,12.710530076381987,12
330,11,19,9,6,12.708684805193935,13
331,57,12,2,4,12.707474284723991,8
332,62,16,57,4,12.692635812852643,12
333,80,40,63,12,12.682443988429272,28
334,48,15,5,4,12.675358072710548,11
335,100,13,38,3,12.63848236927713,10
336,76,20,78,5,12.633094549652569,15
337,39,20,85,7,12.618845399489867,13
338,107,38,109,11,12.598174280709069,27
339,15,12,102,3,12.597866884640938,9
340,57,27,5,8,12.572003913811171,19
341,41,18,71,5,12.55777326700885,13
342,75,27,5,10,12.535083552437033,17
343,104,33,27,10,12.514336487582195,23
344,64,15,92,7,12.492372460791035,8
345,28,12,81,4,12.485800898870087,8
346,41,10,85,4,12.470634664927642,6
347,15,30,9,12,12.451949073593187,18
348,18,14,37,4,12.43883359344357,10
349,98,31,87,9,12.43458344819276,22
350,65,27,58,9,12.431650709075084,18
351,30,32,3,9,12.423744912282858,23
352,36,17,50,7,12.423703215189779,10
353,39,17,72,5,12.403927129005272,12
354,8,22,77,7,12.389831393600819,15
355,75,14,12,5,12.356839423121745,9
356,67,12,97,3,12.35346782744064,9
357,49,23,104,7,12.322985298305156,16
358,100,26,77,8,12.309763357901781,18
359,75,14,57,4,12.306540056833526,10
360,98,29,96,9,12.301665445316493,20
361,41,22,49,7,12.296817896590063,15
362,72,12,12,3,12.291429668749544,9
363,51,29,19,8,12.290136577107425,21
364,69,15,18,5,12.281407888329312,10
365,109,21,39,6,12.264003725130953,15
366,37,18,60,7,12.263894360602315,11
367,34,13,41,5,12.262731570966233,8
368,32,10,39,3,12.25900875776762,7
369,71,11,84,3,12.255989147154674,8
370,9,16,19,5,12.252328421645835,11
371,58,11,29,3,12.250932195859464,8
372,74,22,60,8,12.230302476711508,14
373,75,19,43,5,12.224767647713705,14
374,64,19,37,6,12.216856507558587,13
375,78,11,106,3,12.210243252742755,8
376,42,11,13,3,12.203174115394757,8
377,13,83,88,25,12.195764790442615,58
378,11,35,84,11,12.189911906563859,24
379,70,25,57,10,12.177083859404236,15
380,107,21,99,7,12.174640608684571,14
381,2,22,70,8,12.153236389251056,14
382,11,40,96,13,12.141028508791658,27
383,55,13,47,5,12.137143102946048,8
384,92,12,63,5,12.136993324985582,7
385,15,10,4,4,12.1242208434208,6
386,34,12,70,4,12.123530804367727,8
387,28,20,72,6,12.11934808588004,14
388,8,11,35,3,12.093356369533685,8
389,72,21,19,6,12.088885005162663,15
390,53,20,3,6,12.068087567340713,14
391,104,22,71,8,12.060518806565575,14
392,1,18,63,7,12.054495717242014,11
393,10,10,89,3,12.051235053807009,7
394,7,10,89,3,12.029257289487047,7
395,1,12,104,4,12.020108292717422,8
396,87,29,81,11,12.01535695996611,18
397,64,16,29,4,12.010507228979476,12
398,102,18,55,6,11.983866194974436,12
399,95,27,18,9,11.951490678023532,18
400,114,46,65,16,11.938229846486395,30
401,94,30,12,11,11.933387464684667,19
402,71,17,77,5,11.915487518479784,12
403,2,13,11,4,11.88450219450607,9
404,79,11,12,4,11.86694352900842,7
405,111,22,41,8,11.859477089655313,14
406,57,45,107,15,11.845167977874892,30
407,74,34,28,11,11.834419909257846,23
408,92,17,86,6,11.833574375075667,11
409,63,47,28,14,11.8288664237163,33
410,74,10,64,4,11.828764368523546,6
411,28,16,111,5,11.82030122340792,11
412,83,10,17,4,11.812775268760372,6
413,53,10,91,3,11.811611902058761,7
414,8,11,108,3,11.805411430354427,8
415,8,21,40,6,11.791921402372775,15
416,44,10,54,3,11.791894285038754,7
417,91,12,65,4,11.784658313781675,8
418,112,10,62,3,11.78047192200998,7
419,54,20,43,7,11.759609270938485,13
420,34,12,69,2,11.742698738008178,10
421,91,13,96,4,11.692854193124042,9
422,34,23,28,7,11.682170467841415,16
423,8,10,81,3,11.678569579324554,7
424,21,10,88,3,11.677382922456276,7
425,93,11,104,4,11.670878710804793,7
426,107,17,83,5,11.644521740420231,12
427,100,12,40,4,11.638460148115906,8
428,75,17,38,4,11.628826987325246,13
429,11,23,70,7,11.609570033059049,16
430,90,15,39,5,11.57797650142359,10
431,36,16,104,6,11.564722196156039,10
432,111,10,71,3,11.563837134119533,7
433,108,13,3,4,11.562059375800661,9
434,38,15,3,5,11.55575224939262,10
435,74,15,76,6,11.544600382799558,9
436,110,12,7,5,11.526061320417648,7
437,7,15,81,6,11.525413070422038,9
438,98,14,75,5,11.49709370731317,9
439,68,12,37,4,11.496583691347082,8
440,11,15,18,5,11.49652383906797,10
441,114,41,106,14,11.462749893343952,27
442,50,18,68,7,11.447393428752163,11
443,13,47,18,16,11.43817217657445,31
444,41,26,12,8,11.414617123719323,18
445,47,17,18,5,11.411676107822029,12
446,4,11,38,3,11.395009854616484,8
447,107,14,10,5,11.38119632500004,9
448,39,28,78,9,11.374922957505097,19
449,28,22,112,7,11.372427658976592,15
450,75,15,102,4,11.357902372458398,11
451,74,21,62,7,11.355871307801836,14
452,104,30,77,10,11.335858846829385,20
453,108,11,112,4,11.33560335683198,7
454,64,12,20,3,11.33130846260478,9
455,7,25,96,7,11.300422106484014,18
456,80,10,5,3,11.295210617596885,7
457,75,10,61,4,11.283854363299362,6
458,47,25,60,8,11.283162005417626,17
459,111,11,27,3,11.279710088837586,8
460,2,14,55,5,11.276816159574059,9
461,75,52,7,17,11.274663385996204,35
462,68,21,109,6,11.251244714581786,15
463,40,13,81,4,11.249205674756393,9
464,25,25,68,8,11.235607083018873,17
465,98,16,77,5,11.231262510023573,11
466,46,20,96,8,11.223825219116966,12
467,75,36,8,11,11.220741251540183,25
468,73,13,51,4,11.219804453521853,9
469,98,18,106,6,11.217270403208776,12
470,25,15,3,5,11.214634960222732,10
471,100,12,46,4,11.210309669403356,8
472,89,11,1,4,11.209011069389932,7
473,11,18,38,6,11.204555428907188,12
474,78,13,1,4,11.156578268103178,9
475,108,31,13,10,11.148353863265479,21
476,43,16,91,5,11.128114127049443,11
477,46,15,70,5,11.123543654837002,10
478,48,11,102,3,11.116814719382416,8
479,72,18,65,6,11.109219542203151,12
480,74,13,32,4,11.101664191982366,9
481,62,15,104,4,11.098747349135207,11
482,99,11,11,4,11.04788337752713,7
483,55,39,1,12,11.047135752371082,27
484,32,12,114,4,11.045874107216177,8
485,16,17,32,6,11.04556139119038,11
486,7,13,66,5,11.034566799554375,8
487,41,14,92,5,11.016394202336144,9
488,34,17,103,5,11.01488088004568,12
489,15,13,71,4,11.00914391321026,9
490,30,19,46,6,11.008568666826076,13
491,40,26,3,8,11.00717769248795,18
492,51,20,110,6,11.000148170458745,14
493,100,34,49,12,10.999204490394831,22
494,13,25,97,9,10.985857531237675,16
495,103,15,60,5,10.955343329408253,10
496,78,10,66,4,10.92721209874227,6
497,73,17,5,6,10.907383059794872,11
498,11,10,66,4,10.898142591848796,6
499,86,17,67,6,10.856458271232285,11
500,87,31,114,12,10.855794018644565,19
501,62,14,15,5,10.843943580538047,9
502,38,26,65,10,10.83463870682702,16
503,106,17,81,7,10.816681182916202,10
504,63,12,89,3,10.81666968039275,9
505,55,25,91,7,10.791612827626562,18
506,7,25,19,7,10.775977198177877,18
507,59,11,7,3,10.771239818059199,8
508,55,24,43,6,10.765561111805056,18
509,65,21,57,7,10.760244548071402,14
510,53,23,108,9,10.749834986479383,14
511,23,10,11,3,10.736120462067522,7
512,53,22,17,7,10.72338378113649,15
513,54,11,111,3,10.714143810197228,8
514,43,13,36,5,10.713552025008548,8
515,75,13,76,5,10.684711333832391,8
516,20,21,9,7,10.676297323703045,14
517,47,11,100,4,10.66425762434052,7
518,5,25,98,9,10.66291868554062,16
519,26,11,16,4,10.64146366009584,7
520,3,11,35,4,10.637414854102067,7
521,98,18,71,6,10.627953776602759,12
522,69,12,91,5,10.61284501210675,7
523,28,13,103,4,10.6092467019397,9
524,7,31,91,9,10.609100286101588,22
525,11,38,109,12,10.59201718767136,26
526,49,16,37,6,10.578750157819185,10
527,104,26,75,9,10.57435391669422,17
528,95,15,9,6,10.569002592922953,9
529,71,19,54,7,10.563773271372229,12
530,28,17,40,7,10.551622113062637,10
531,19,13,79,5,10.549815768045493,8
532,28,26,3,9,10.544965513227709,17
533,49,15,11,5,10.54175783006079,10
534,50,39,20,13,10.540260354284218,26
535,76,13,108,4,10.539317855686345,9
536,41,16,17,5,10.533333329606137,11
537,100,26,41,9,10.528975782655802,17
538,71,19,97,6,10.5235339621969,13
539,27,27,36,10,10.523349599331352,17
540,89,14,37,6,10.519274673853001,8
541,63,16,102,6,10.517349087153976,10
542,54,29,27,10,10.506022353115851,19
543,47,14,3,5,10.496343519851868,9
544,64,27,9,8,10.495957554452968,19
545,62,10,48,4,10.487894133335649,6
546,63,37,48,12,10.480037623792745,25
547,94,14,49,4,10.474432971630803,10
548,6,10,31,4,10.459894630543896,6
549,48,17,108,5,10.443613045373397,12
550,77,10,94,3,10.443428313097055,7
551,43,17,9,7,10.435718767902006,10
552,44,16,39,6,10.434810009571377,10
553,72,14,103,5,10.391960458595063,9
554,76,26,35,9,10.390096019432455,17
555,16,14,92,3,10.381584875368542,11
556,106,16,93,6,10.37915501513517,10
557,15,16,55,4,10.37053728825799,12
558,63,24,69,8,10.366973166191581,16
559,50,39,88,14,10.364860984100916,25
560,94,10,7,3,10.355621654064773,7
561,17,15,27,6,10.35454909958829,9
562,40,16,102,6,10.346146758066935,10
563,37,13,1,5,10.342164269053148,8
564,35,10,65,3,10.321578642281732,7
565,108,13,15,4,10.31501087444828,9
566,53,43,88,14,10.308417089519107,29
567,107,29,31,13,10.30345756995746,16
568,45,23,107,8,10.289536165233189,15
569,60,24,112,8,10.282975838759185,16
570,72,22,68,7,10.275897741373274,15
571,103,16,84,7,10.26661061026012,9
572,18,43,39,14,10.257246202371954,29
573,67,16,106,6,10.252161434234207,10
574,49,21,23,7,10.242959754676484,14
575,34,13,37,4,10.225834586393084,9
576,63,35,91,11,10.225389928816243,24
577,30,17,31,7,10.214096274935343,10
578,10,14,28,4,10.207926130943799,10
579,91,24,39,8,10.206322081312438,16
580,90,19,104,7,10.205908373136607,12
581,98,15,2,6,10.198603389321667,9
582,71,13,33,4,10.195530501937561,9
583,97,41,37,14,10.190687502541845,27
584,27,46,60,14,10.177471149675247,32
585,6,12,9,5,10.175309866966636,7
586,98,27,49,9,10.169586744689958,18
587,51,32,81,12,10.158277615855118,20
588,30,43,13,15,10.148212403247415,28
589,92,16,68,5,10.14730683848729,11
590,96,11,23,4,10.143008283174426,7
591,79,21,57,8,10.139577379833113,13
592,53,37,31,14,10.136338371296793,23
593,92,10,109,3,10.132066653367776,7
594,78,12,114,5,10.123963867745248,7
595,53,36,36,11,10.114732824687987,25
596,87,30,70,12,10.114463896406379,18
597,17,15,3,6,10.104489232217418,9
598,23,32,76,12,10.095144638641568,20
599,23,17,17,6,10.090670558592322,11
600,79,12,106,4,10.079963228120917,8
601,40,16,49,6,10.077718304922938,10
602,49,37,69,15,10.07650924818243,22
603,27,41,19,13,10.068063409604914,28
604,13,23,83,8,10.067954696106945,15
605,44,10,38,3,10.048373138060269,7
606,78,14,46,6,10.036009292919493,8
607,110,13,107,4,10.03472132274693,9
608,30,19,91,6,10.028289002870832,13
609,30,27,84,8,10.023299208241367,19
610,95,25,65,9,9.987438820754939,16
611,53,21,12,8,9.979940044053077,13
612,73,18,88,6,9.974203425238965,12
613,87,10,85,3,9.971655390565866,7
614,13,32,94,11,9.96712478671203,21
615,46,14,90,5,9.960134782518512,9
616,75,15,29,6,9.923300198268764,9
617,95,10,2,3,9.920312629990502,7
618,63,50,84,19,9.919938234846502,31
619,1,11,57,4,9.916035104284743,7
620,30,26,109,8,9.914816400266734,18
621,30,18,70,7,9.913973705469937,11
622,54,34,60,11,9.913747967452048,23
623,28,35,75,12,9.910859132469223,23
624,103,21,68,8,9.904114100948439,13
625,100,32,43,12,9.897954228241396,20
626,37,47,54,16,9.896946296790851,31
627,11,14,83,4,9.89615191909491,10
628,79,18,51,8,9.895968302837433,10
629,110,20,16,7,9.893450419413208,13
630,20,14,29,5,9.888770035938014,9
631,2,17,54,5,9.883928701627934,12
632,17,15,71,6,9.874078720771614,9
633,75,17,1,5,9.87310906944801,12
634,22,12,27,4,9.866452926590915,8
635,38,14,57,6,9.862555383696968,8
636,60,34,29,13,9.857156403230201,21
637,104,20,12,7,9.854826291134748,13
638,51,26,33,7,9.853114112635922,19
639,8,23,41,7,9.850013092502921,16
640,44,21,13,7,9.844973608163798,14
641,74,10,3,3,9.841517466916372,7
642,53,10,98,4,9.839111782848335,6
643,9,17,47,6,9.833363334347146,11
644,47,17,69,6,9.824856595944096,11
645,54,13,57,3,9.824315369895016,10
646,40,24,17,8,9.815776001763279,16
647,27,20,55,6,9.8088649644787,14
648,114,16,62,6,9.799890996069497,10
649,62,10,93,4,9.798162399200404,6
650,37,24,83,9,9.783726366978417,15
651,95,30,51,9,9.77001175442697,21
652,15,14,53,5,9.759389882181187,9
653,16,49,18,16,9.751591518104966,33
654,72,20,3,8,9.745718908399102,12
655,43,19,31,10,9.720852773553682,9
656,78,12,37,4,9.719307443467272,8
657,52,15,8,5,9.715026692600487,10
658,75,18,11,7,9.71088785220573,11
659,8,30,84,10,9.700360955856537,20
660,8,34,114,11,9.69923185832115,23
661,16,64,106,21,9.698477969183921,43
662,64,47,60,15,9.66174772613163,32
663,100,12,71,4,9.66068752031631,8
664,101,10,13,3,9.652646543094525,7
665,85,11,75,3,9.651599660168166,8
666,22,10,114,5,9.649313306364819,5
667,41,23,53,8,9.631953807885303,15
668,103,18,12,8,9.627784072806602,10
669,70,17,109,6,9.623350653501726,11
670,99,14,8,6,9.61106559286031,8
671,83,18,84,7,9.609473734372159,11
672,8,13,53,4,9.596286006275326,9
673,64,27,112,8,9.595012833071515,19
674,73,20,7,8,9.582485903794176,12
675,17,12,48,5,9.570482008629265,7
676,27,28,31,12,9.569633624787398,16
677,26,23,13,7,9.562123129591575,16
678,18,13,34,4,9.550016463821068,9
679,33,25,107,10,9.539564483245071,15
680,106,13,108,4,9.535201707134298,9
681,20,11,75,4,9.527707505687719,7
682,48,15,51,7,9.527077025607761,8
683,1,22,31,9,9.525804060927038,13
684,20,32,25,11,9.520523686179052,21
685,18,27,9,9,9.520249042639604,18
686,62,14,64,6,9.515284324050944,8
687,8,17,36,6,9.51236026695053,11
688,33,13,69,5,9.511158026464036,8
689,90,14,80,4,9.509239360264802,10
690,114,13,2,5,9.509158562417847,8
691,15,35,51,13,9.503627084553731,22
692,37,22,99,7,9.502759058160713,15
693,18,11,84,4,9.493458888054228,7
694,15,40,88,12,9.492555782468358,28
695,37,10,3,4,9.485691026106416,6
696,3,11,85,5,9.478406721140292,6
697,72,15,77,6,9.475978955314686,9
698,13,22,98,7,9.474726692398685,15
699,23,16,57,6,9.474501256774838,10
700,43,23,15,8,9.471477205647831,15
701,100,29,60,10,9.465662133176442,19
702,16,47,96,14,9.46295382882651,33
703,48,13,15,5,9.46006019231802,8
704,13,56,3,19,9.453405155999336,37
705,41,19,89,6,9.453124323035377,13
706,32,11,63,4,9.44232166344675,7
707,13,15,2,6,9.422510080465486,9
708,103,17,57,6,9.414120229975815,11
709,27,16,38,5,9.401601002215301,11
710,109,11,36,3,9.390936468630548,8
711,60,31,12,14,9.384631824700898,17
712,81,25,16,9,9.384174025613888,16
713,27,16,4,6,9.3787154159821,10
714,104,21,84,8,9.37162724208143,13
715,55,19,23,8,9.354242967773875,11
716,26,12,28,4,9.352858082446945,8
717,1,20,87,8,9.344990956449259,12
718,28,29,2,10,9.34282167881126,19
719,77,10,84,3,9.326879307665175,7
720,29,26,86,9,9.312176261822101,17
721,45,10,38,3,9.31109379184883,7
722,100,17,18,7,9.297622647277194,10
723,70,14,29,6,9.28377551108064,8
724,20,16,90,6,9.25670480461804,10
725,34,22,51,8,9.254702967852264,14
726,78,15,53,6,9.245467105519944,9
727,18,12,62,4,9.234800982158584,8
728,91,23,20,9,9.233435902067152,14
729,54,17,3,7,9.232444908063068,10
730,34,21,49,8,9.230991761756373,13
731,70,16,69,5,9.227346228401574,11
732,78,27,12,8,9.208018205719986,19
733,93,11,90,4,9.204947446014161,7
734,73,17,40,6,9.199997222971483,11
735,63,36,76,12,9.19742593219103,24
736,95,21,114,8,9.195016624238182,13
737,81,16,63,6,9.19342956994627,10
738,23,14,91,6,9.188824217195519,8
739,53,14,38,5,9.17946873124013,9
740,15,13,91,6,9.175439096539632,7
741,102,37,86,13,9.175322859485366,24
742,112,22,29,8,9.174610307731975,14
743,92,15,40,5,9.168940871834318,10
744,63,14,72,4,9.168022793278983,10
745,62,21,63,8,9.161474645821363,13
746,50,43,5,17,9.156049369840707,26
747,39,25,106,10,9.155969378752744,15
748,92,11,17,4,9.114563540800457,7
749,109,15,31,5,9.11388757240418,10
750,94,12,75,4,9.080901166069644,8
751,95,34,8,13,9.079209474058969,21
752,89,11,55,4,9.077967122900679,7
753,57,16,40,6,9.075047590769472,10
754,80,39,107,13,9.074881524481428,26
755,44,29,86,10,9.073857704921485,19
756,49,14,103,6,9.061871169842822,8
757,35,16,45,7,9.040031591861501,9
758,63,16,33,6,9.020049921268521,10
759,28,18,12,6,9.017903873482359,12
760,5,15,36,6,9.008614310253613,9
761,30,30,88,12,9.008031571554382,18
762,38,10,72,4,8.999506480702253,6
763,78,15,80,5,8.990142670025005,10
764,48,10,81,3,8.989696104511108,7
765,28,15,52,6,8.975367013246691,9
766,88,20,112,7,8.974262508725223,13
767,49,17,43,6,8.971053579217557,11
768,97,18,36,7,8.970668153566264,11
769,47,20,114,8,8.969382880850322,12
770,11,14,81,5,8.967824856070845,9
771,28,11,32,4,8.963821007682872,7
772,68,30,18,11,8.962998195734913,19
773,78,15,104,5,8.957766332972092,10
774,107,23,103,8,8.947816508283685,15
775,53,20,109,7,8.945178102898183,13
776,51,26,74,8,8.938947542412073,18
777,73,12,31,4,8.938919570135752,8
778,98,14,12,5,8.92802355273952,9
779,13,22,84,7,8.92622496976615,15
780,11,10,91,3,8.923724837318142,7
781,58,27,13,8,8.921844647619922,19
782,26,10,88,4,8.919527282390282,6
783,110,19,25,6,8.917701672558222,13
784,17,22,60,8,8.913811593594374,14
785,48,12,104,4,8.912185347145057,8
786,69,12,97,4,8.888377862411462,8
787,75,18,109,6,8.883837567249163,12
788,90,23,13,8,8.88376435292604,15
789,49,11,53,4,8.876928289416245,7
790,6,15,12,7,8.873687126500897,8
791,107,22,66,8,8.85129730206017,14
792,35,16,51,6,8.849945437990401,10
793,32,15,87,5,8.84415502943487,10
794,20,10,12,4,8.842914423325947,6
795,85,17,50,6,8.828432540960762,11
796,63,19,36,7,8.822881427312195,12
797,63,22,77,7,8.81999753264251,15
798,43,41,87,15,8.818073788670254,26
799,36,18,47,6,8.810892372607714,12
800,57,24,63,10,8.808573587871942,14
801,106,10,42,3,8.802546839644418,7
802,41,17,28,6,8.792780130820773,11
803,26,11,107,4,8.789963547813727,7
804,77,14,99,4,8.784719144285264,10
805,30,51,39,20,8.783045292899407,31
806,94,16,37,6,8.782776933637448,10
807,106,23,18,8,8.778191080978742,15
808,16,27,1,8,8.777340054296328,19
809,70,17,64,5,8.763483643924099,12
810,17,15,19,5,8.75767346175458,10
811,38,14,106,7,8.74501943352997,7
812,4,22,17,7,8.727735068009611,15
813,62,20,8,6,8.725180325771555,14
814,27,59,87,22,8.722585860088165,37
815,58,10,45,4,8.721721801464442,6
816,45,15,86,6,8.710518828201982,9
817,34,20,19,7,8.700573651484502,13
818,86,49,76,19,8.683760649202954,30
819,39,41,20,17,8.683414479878408,24
820,39,67,68,26,8.679610428054557,41
821,9,31,31,11,8.678153869820548,20
822,19,12,31,4,8.676840084796211,8
823,53,11,54,4,8.670288326383611,7
824,70,12,58,4,8.662523092509444,8
825,27,17,35,6,8.6459310555496,11
826,1,24,65,10,8.63311694974403,14
827,13,54,43,23,8.59811837894066,31
828,65,44,93,18,8.591281807406075,26
829,108,13,68,5,8.580585833252007,8
830,53,18,77,7,8.57678025133703,11
831,95,23,55,8,8.575006509864881,15
832,49,10,93,4,8.572163796775682,6
833,41,12,80,4,8.558761558111074,8
834,65,15,66,5,8.555650294431567,10
835,78,11,36,4,8.552435160203329,7
836,94,11,2,4,8.55058688518052,7
837,16,15,67,5,8.550473387804695,10
838,93,11,63,4,8.547776338932225,7
839,94,12,35,5,8.545638882275087,7
840,110,11,63,4,8.534985747455593,7
841,53,20,61,6,8.524850655507478,14
842,81,22,69,9,8.51799786685539,13
843,13,21,6,8,8.50747605743762,13
844,62,23,40,11,8.506273692628868,12
845,91,10,45,4,8.504304930616431,6
846,29,18,34,7,8.499963472080458,11
847,64,28,40,10,8.496071624321134,18
848,74,14,77,5,8.485489523270209,9
849,55,14,85,5,8.476039600481302,9
850,112,13,79,5,8.473860498540246,8
851,39,26,112,10,8.464674026518862,16
852,63,37,20,15,8.46447340208147,22
853,48,39,107,15,8.46425442284703,24
854,12,16,106,5,8.461406597257813,11
855,95,14,96,5,8.45037398259218,9
856,29,11,95,4,8.438441558722083,7
857,96,24,70,11,8.437417991026262,13
858,55,20,114,7,8.432483182241098,13
859,88,14,103,5,8.430464226549898,9
860,73,19,90,7,8.424101991862472,12
861,41,12,102,4,8.421036787338009,8
862,50,21,102,9,8.41869338516401,12
863,109,14,67,7,8.410228891959628,7
864,63,17,19,6,8.404706837961042,11
865,43,10,62,4,8.394379014204608,6
866,62,25,68,10,8.38261509800727,15
867,7,45,25,16,8.37280661834829,29
868,19,28,3,11,8.369074412898637,17
869,7,22,5,8,8.357081514884824,14
870,41,32,31,12,8.353957395244583,20
871,48,25,96,9,8.343995751105187,16
872,48,12,89,3,8.328549669565296,9
873,25,15,9,5,8.323455878342044,10
874,19,16,108,6,8.312758842928977,10
875,57,18,43,5,8.312131327998166,13
876,90,13,48,5,8.30973168111364,8
877,104,15,81,7,8.308547186806486,8
878,86,17,56,6,8.300855291965847,11
879,90,31,106,10,8.283845461248372,21
880,41,18,91,6,8.276671952774393,12
881,37,12,14,5,8.266467835075433,7
882,103,12,94,5,8.264881457481591,7
883,81,11,109,4,8.25829814590215,7
884,8,29,15,12,8.254756555500956,17
885,69,21,106,8,8.230262561693124,13
886,99,10,71,4,8.22496630028886,6
887,76,18,57,6,8.224487012675363,12
888,112,14,40,6,8.221202026655053,8
889,34,12,15,4,8.217126810746985,8
890,16,75,63,28,8.205892894816376,47
891,64,42,51,16,8.201880887276834,26
892,87,24,93,9,8.20135369004028,15
893,74,25,39,10,8.195535087876927,15
894,16,122,88,44,8.186735552225068,78
895,47,15,81,5,8.165398445346261,10
896,76,20,9,7,8.161384986883023,13
897,33,17,20,6,8.157924685534635,11
898,18,16,112,5,8.155957753880719,11
899,68,31,8,12,8.152272734975385,19
900,76,49,51,17,8.147426040460967,32
901,4,10,112,4,8.145974306589784,6
902,56,14,107,6,8.142413744294045,8
903,11,33,41,11,8.13470175881012,22
904,34,27,87,10,8.127230126349964,17
905,20,11,110,4,8.125291114928716,7
906,81,11,111,3,8.120062859865854,8
907,34,16,74,5,8.118744758398414,11
908,74,15,48,7,8.108554922899495,8
909,30,31,55,11,8.098468910297374,20
910,84,28,29,11,8.097345709310336,17
911,100,27,29,11,8.09653836783874,16
912,95,11,49,3,8.095998639719067,8
913,37,42,46,14,8.09589581959515,28
914,27,45,78,15,8.094234380040165,30
915,109,44,8,18,8.084532850874995,26
916,43,17,4,7,8.083539648296872,10
917,8,61,5,24,8.080732178020162,37
918,89,12,74,5,8.079770785030162,7
919,110,16,97,6,8.077466293642946,10
920,86,35,48,13,8.077263763613383,22
921,28,23,19,8,8.074139814737295,15
922,50,18,70,8,8.072010588554935,10
923,76,38,68,11,8.067259765332079,27
924,53,13,46,5,8.064750592390656,8
925,12,15,15,6,8.061809473862589,9
926,35,10,15,5,8.056529361763387,5
927,100,36,11,13,8.056267972110494,23
928,20,36,84,11,8.04861670328596,25
929,87,13,66,5,8.030847362070954,8
930,75,41,50,14,8.02466935745211,27
931,63,12,52,5,8.015196003418383,7
932,35,11,9,5,8.012816785902409,6
933,63,47,88,16,8.011636403272151,31
934,91,31,98,12,8.010154956050265,19
935,41,18,81,6,8.009042710590082,12
936,39,42,88,16,8.004378009209994,26
937,16,94,39,36,8.001675530050077,58
938,102,19,96,7,7.9956311609664965,12
939,44,22,6,7,7.994067314889742,15
940,98,16,40,7,7.9934169616460915,9
941,13,16,70,6,7.990308468406848,10
942,20,19,3,7,7.987586080022351,12
943,5,28,84,11,7.986435375626319,17
944,112,26,76,11,7.979151678151438,15
945,34,20,68,8,7.978044783319167,12
946,65,25,5,10,7.967561696591304,15
947,23,21,39,8,7.9630880242589255,13
948,111,17,63,7,7.959677987637777,10
949,54,53,109,19,7.951130265295214,34
950,16,34,64,12,7.9483185367042495,22
951,73,17,87,5,7.942207150258419,12
952,18,11,103,3,7.9353135943847235,8
953,30,12,2,5,7.930773013016298,7
954,30,12,58,4,7.929379399940001,8
955,49,32,3,13,7.921458159088596,19
956,12,38,107,13,7.919995318333911,25
957,54,22,18,9,7.917650548154775,13
958,6,14,61,5,7.915350050859163,9
959,88,10,82,4,7.912578083642496,6
960,71,13,38,4,7.906029048659733,9
961,78,11,31,5,7.904414780494012,6
962,53,14,90,5,7.90103229929259,9
963,17,16,29,7,7.899676305324427,9
964,111,16,51,6,7.8926133994028564,10
965,16,75,27,28,7.890270543396147,47
966,104,35,100,13,7.883509665470489,22
967,114,25,90,10,7.8701656835045455,15
968,27,26,53,9,7.864216242382974,17
969,108,15,98,6,7.863072789163925,9
970,44,12,35,5,7.859665557157517,7
971,106,26,91,9,7.859341034872018,17
972,54,80,88,30,7.854553313400374,50
973,114,20,1,7,7.837742070296788,13
974,78,36,87,14,7.836795174171341,22
975,2,33,107,12,7.828664599470127,21
976,13,63,106,24,7.824636159857552,39
977,25,46,46,19,7.8204011950255445,27
978,114,12,110,4,7.80031681097971,8
979,108,11,78,4,7.797957113003336,7
980,47,10,111,4,7.786638633209644,6
981,92,14,114,4,7.774797164908212,10
982,53,11,73,4,7.756297558195456,7
983,37,49,25,20,7.755599308877524,29
984,28,29,68,10,7.74899303896736,19
985,73,13,54,5,7.746921178252216,8
986,30,10,111,3,7.744421754490768,7
987,44,11,84,5,7.741464370739849,6
988,49,20,29,8,7.741005146754658,12
989,46,18,29,9,7.738693511487549,9
990,65,41,29,16,7.736031171751761,25
991,76,12,72,4,7.731997605583364,8
992,87,10,26,4,7.730492735259905,6
993,16,14,101,5,7.729447625525014,9
994,30,28,94,11,7.7213771310551085,17
995,75,61,68,22,7.698232004910781,39
996,86,28,1,11,7.69668031791366,17
997,111,25,7,10,7.69032342577198,15
998,5,32,11,12,7.687442157533876,20
999,23,24,100,9,7.6843054866955915,15
1000,27,26,103,10,7.6817803705818655,16
1001,50,35,55,15,7.677574556383833,20
1002,72,10,104,4,7.673968450836452,6
1003,103,27,19,11,7.669020445123164,16
1004,37,29,38,11,7.668156637885108,18
1005,28,22,62,9,7.6671820736148195,13
1006,37,24,96,10,7.665844925696509,14
1007,16,44,69,16,7.665479946548734,28
1008,27,29,112,11,7.66149470567157,18
1009,107,27,35,9,7.659745377736294,18
1010,104,11,66,3,7.6588091193640615,8
1011,104,39,60,12,7.6559666324409426,27
1012,33,13,31,6,7.647223417443057,7
1013,70,11,60,4,7.6464357490262,7
1014,97,29,5,10,7.639418302115124,19
1015,69,11,61,3,7.633216471104325,8
1016,71,14,27,5,7.62097447229337,9
1017,54,22,72,8,7.618738189484298,14
1018,60,32,69,14,7.613845124007755,18
1019,108,25,88,9,7.612957755702022,16
1020,54,18,58,8,7.606404400860017,10
1021,37,30,7,12,7.598616530184265,18
1022,18,20,36,8,7.5949028785012285,12
1023,87,38,9,16,7.592453429043002,22
1024,55,24,64,8,7.5905103785531685,16
1025,11,36,57,16,7.587225628637277,20
1026,11,24,103,8,7.585830317962976,16
1027,72,10,36,4,7.585561627806539,6
1028,28,31,114,13,7.584853881328923,18
1029,46,12,77,5,7.574271980014295,7
1030,34,14,5,4,7.5706698448560905,10
1031,75,23,49,9,7.565086245339055,14
1032,60,19,45,8,7.562934672858015,11
1033,87,38,40,16,7.562449238427529,22
1034,16,47,46,17,7.556284800209043,30
1035,9,21,104,8,7.555832585448778,13
1036,107,42,49,16,7.548694167024411,26
1037,49,13,55,5,7.545834219734257,8
1038,78,28,69,11,7.539471489927139,17
1039,85,10,46,3,7.538229298143679,7
1040,34,22,55,9,7.534603126846274,13
1041,17,15,77,6,7.533332094576503,9
1042,33,16,7,7,7.532188482638043,9
1043,6,11,55,3,7.526848268362216,8
1044,19,16,81,6,7.526775736263618,10
1045,7,52,87,19,7.517208318589072,33
1046,85,11,47,3,7.514718359567323,8
1047,104,18,69,6,7.510735223332435,12
1048,107,16,61,7,7.509321940652876,9
1049,7,21,109,8,7.493740572538848,13
1050,70,14,36,6,7.476080415111229,8
1051,108,15,63,6,7.475559971035058,9
1052,64,37,31,14,7.4738922265185375,23
1053,110,18,39,6,7.464111416570426,12
1054,45,12,53,5,7.463487107897495,7
1055,100,12,70,5,7.458777129644957,7
1056,37,21,110,9,7.457046552670356,12
1057,11,12,71,5,7.444969376445684,7
1058,41,23,19,8,7.443816997766066,15
1059,16,46,9,16,7.440540686759275,30
1060,9,15,57,6,7.427077607114284,9
1061,36,34,41,16,7.412500474371832,18
1062,70,30,20,11,7.408681007686702,19
1063,20,11,94,4,7.404911652749632,7
1064,1,10,5,4,7.391988711274886,6
1065,50,29,71,12,7.386130219514862,17
1066,27,31,94,12,7.381571713402093,19
1067,34,21,30,8,7.377448858621609,13
1068,71,19,81,7,7.374213709282583,12
1069,73,10,71,4,7.37323406519455,6
1070,100,24,114,9,7.3724280838709575,15
1071,16,48,3,18,7.371656996223411,30
1072,107,23,102,10,7.368219185837454,13
1073,31,14,80,4,7.367135464628976,10
1074,16,72,55,26,7.36707211993361,46
1075,25,16,33,5,7.36592627296452,11
1076,73,25,8,10,7.35879002547718,15
1077,17,19,9,8,7.3581791578689,11
1078,19,17,12,8,7.3489102504137485,9
1079,48,24,79,9,7.345817828277461,15
1080,23,18,114,6,7.344942637597016,12
1081,40,41,104,15,7.342291894534163,26
1082,78,24,34,10,7.336336560215481,14
1083,75,16,2,7,7.332326563651873,9
1084,62,30,88,12,7.323841783087014,18
1085,70,42,5,17,7.323141246130927,25
1086,16,20,93,9,7.319623013756245,11
1087,49,28,65,11,7.3155772597941535,17
1088,54,33,40,13,7.298767912387551,20
1089,43,31,40,13,7.2876910701836355,18
1090,97,16,29,6,7.284915525257299,10
1091,55,20,68,7,7.273979151335479,13
1092,106,13,57,6,7.272492874678534,7
1093,62,10,96,3,7.268496266352443,7
1094,110,16,70,6,7.267896542251015,10
1095,20,17,98,6,7.267496359610282,11
1096,100,14,48,6,7.263809625362937,8
1097,63,14,10,5,7.2617205803599045,9
1098,75,19,81,7,7.259552889264539,12
1099,86,30,79,11,7.258463117259926,19
1100,87,29,91,11,7.256753645120718,18
1101,69,12,96,4,7.252755690648875,8
1102,31,14,5,5,7.246607645789562,9
1103,114,27,40,9,7.240772461331043,18
1104,100,21,76,9,7.2254782257625605,12
1105,18,27,8,9,7.2072418633828494,18
1106,86,22,52,8,7.203855363753254,14
1107,72,28,27,12,7.198042760659784,16
1108,109,13,22,5,7.1904728762162415,8
1109,112,15,43,6,7.1893251112725896,9
1110,107,41,43,16,7.1853889491968825,25
1111,36,16,112,6,7.175574629533441,10
1112,98,41,86,17,7.171894084868247,24
1113,30,13,61,5,7.1697153559652405,8
1114,114,19,57,7,7.16817977917647,12
1115,104,39,55,15,7.167673821947762,24
1116,69,13,48,6,7.158814996268266,7
1117,80,13,30,5,7.153305949978541,8
1118,114,25,3,9,7.15288918093006,16
1119,104,26,3,10,7.150574726677238,16
1120,29,14,37,6,7.147246302868531,8
1121,84,18,19,7,7.145362039647056,11
1122,97,26,51,9,7.145200913148902,17
1123,111,12,69,5,7.144443379259755,7
1124,5,17,60,6,7.144002600647477,11
1125,40,50,55,19,7.142420946012768,31
1126,33,13,78,5,7.142209395263033,8
1127,97,28,68,11,7.141635420047943,17
1128,27,39,15,17,7.136849333339997,22
1129,62,11,38,4,7.131662703916968,7
1130,67,12,107,4,7.124134838046416,8
1131,65,27,76,9,7.121500914302366,18
1132,86,30,83,10,7.114862976089345,20
1133,45,33,7,13,7.114147641228475,20
1134,100,32,54,12,7.106265052685038,20
1135,1,10,45,4,7.100044646871245,6
1136,38,14,17,6,7.099034060595348,8
1137,30,26,64,10,7.0955835601535755,16
1138,16,37,76,17,7.08252034451718,20
1139,28,35,70,14,7.078735797739843,21
1140,85,10,53,3,7.0781457464371815,7
1141,52,11,12,5,7.062340699088407,6
1142,98,27,63,11,7.061533653908023,16
1143,99,18,36,6,7.061516094995872,12
1144,65,16,73,6,7.056062739811479,10
1145,86,112,51,47,7.0451244059856455,65
1146,55,25,97,9,7.041738062020972,16
1147,72,11,114,5,7.039741382461145,6
1148,94,18,60,7,7.035159972468677,11
1149,37,19,27,7,7.034792767414984,12
1150,76,15,48,5,7.031929988428476,10
1151,38,12,78,4,7.0314833130695105,8
1152,89,13,13,6,7.027546797235386,7
1153,95,15,40,6,7.026458120737083,9
1154,87,27,53,12,7.022639512769477,15
1155,12,15,43,5,7.021564164922878,10
1156,3,23,57,9,7.014479906982347,14
1157,63,25,38,8,7.013791456544735,17
1158,107,47,53,18,7.009171118597258,29
1159,40,13,69,4,7.0067178601682825,9
1160,93,26,54,9,7.002072182522706,17
1161,8,33,57,12,6.998719542214547,21
1162,79,14,54,5,6.993661154009002,9
1163,4,21,87,7,6.993636995986407,14
1164,62,15,5,6,6.992708759597391,9
1165,111,23,13,10,6.988942249892523,13
1166,17,20,55,9,6.987444025974705,11
1167,53,30,30,12,6.984989750265453,18
1168,29,22,68,8,6.975698761703106,14
1169,13,78,87,29,6.974390710890814,49
1170,18,23,97,9,6.965163575719862,14
1171,16,34,36,13,6.9623095532486845,21
1172,111,15,39,6,6.960860011711801,9
1173,32,18,104,6,6.95922508638955,12
1174,90,20,63,8,6.95733483322538,12
1175,109,30,55,14,6.952801077513017,16
1176,4,25,51,9,6.952578906103857,16
1177,58,20,88,8,6.951724289335949,12
1178,60,33,50,15,6.944865376684973,18
1179,99,12,88,5,6.93913123202866,7
1180,100,36,12,15,6.939039730779679,21
1181,39,33,29,15,6.938842255810812,18
1182,30,15,57,6,6.917301673221197,9
1183,13,36,37,14,6.91476424958532,22
1184,27,33,77,13,6.913052068345057,20
1185,28,17,29,7,6.905526522456791,10
1186,58,21,68,8,6.90465268486649,13
1187,107,33,62,15,6.902263747551283,18
1188,88,13,67,4,6.891493842154356,9
1189,29,28,15,11,6.8827126956662426,17
1190,106,15,99,5,6.882359612487447,10
1191,34,12,38,4,6.8714448233593854,8
1192,29,19,69,8,6.87026975866342,11
1193,30,27,77,10,6.867946363500201,17
1194,68,58,87,23,6.867242541807757,35
1195,3,12,98,6,6.866274172778351,6
1196,60,43,4,19,6.864343045215706,24
1197,41,47,86,17,6.858675087687563,30
1198,108,18,60,7,6.856532886501664,11
1199,81,46,13,17,6.853380616803494,29
1200,30,25,37,9,6.853302921187576,16
1201,7,99,51,37,6.849475435937799,62
1202,107,24,77,10,6.845732737502616,14
1203,62,28,51,11,6.837263314130049,17
1204,95,25,106,9,6.830338155584792,16
1205,79,14,65,6,6.821859416038811,8
1206,68,69,31,28,6.821634358561019,41
1207,56,13,4,6,6.816273515879696,7
1208,39,101,51,40,6.813283084723181,61
1209,8,32,9,15,6.810878783728151,17
1210,86,25,103,9,6.80663720503749,16
1211,71,50,13,21,6.804323620324037,29
1212,3,17,50,7,6.801357099943921,10
1213,28,16,49,7,6.801284823553003,9
1214,108,23,87,9,6.799580586486788,14
1215,55,10,31,4,6.798197972656263,6
1216,86,34,81,11,6.793767976423695,23
1217,2,14,38,6,6.792448237787324,8
1218,8,10,42,5,6.78054178477664,5
1219,51,63,63,28,6.773843003389743,35
1220,86,82,96,32,6.757041595559335,50
1221,13,39,8,15,6.751757053519925,24
1222,33,17,50,7,6.750798742645294,10
1223,63,27,109,12,6.749986635160668,15
1224,86,54,97,22,6.749652418711037,32
1225,94,10,71,4,6.748460655059317,6
1226,45,13,68,5,6.747691137383071,8
1227,84,26,48,10,6.7407911051084906,16
1228,18,10,29,3,6.739197778395282,7
1229,50,13,19,5,6.73847926630575,8
1230,15,20,69,7,6.736896270525392,13
1231,74,38,96,14,6.731828732252355,24
1232,14,13,95,5,6.731405281187272,8
1233,65,10,32,4,6.718474357729474,6
1234,28,35,97,13,6.716635909782017,22
1235,83,15,74,7,6.703298030488857,8
1236,108,11,38,4,6.702463242169258,7
1237,63,25,23,9,6.701335055503612,16
1238,10,18,86,8,6.698064905065153,10
1239,111,11,106,3,6.697425895741327,8
1240,104,54,28,22,6.6974143097234355,32
1241,11,24,98,10,6.689063597940294,14
1242,58,27,69,12,6.683019197918344,15
1243,23,31,68,14,6.676959480055366,17
1244,85,20,54,7,6.664179187550933,13
1245,10,12,57,4,6.658857003244836,8
1246,19,13,80,5,6.6570365011750905,8
1247,83,11,71,5,6.656205380333864,6
1248,71,19,37,8,6.653996053488669,11
1249,8,59,63,25,6.653552632837189,34
1250,32,26,5,10,6.647447060451906,16
1251,86,38,17,17,6.641619574926921,21
1252,102,19,88,6,6.636908554010758,13
1253,4,30,65,12,6.6356003955737535,18
1254,39,22,37,9,6.632156694863052,13
1255,47,43,13,17,6.630254291387857,26
1256,25,48,5,19,6.626414170343125,29
1257,74,38,46,14,6.622188071735937,24
1258,12,17,38,7,6.620249174021179,10
1259,20,21,68,9,6.619136630374984,12
1260,23,14,30,6,6.618468991829208,8
1261,102,12,77,5,6.618078815941928,7
1262,23,44,60,17,6.614448682314054,27
1263,11,25,35,10,6.6098986532599575,15
1264,72,18,49,7,6.605946936757428,11
1265,65,28,102,10,6.598986547888404,18
1266,64,31,63,13,6.5953519944401675,18
1267,30,20,79,7,6.592079457136293,13
1268,34,16,67,8,6.58685136756142,8
1269,27,11,101,4,6.582303845846212,7
1270,77,12,81,5,6.5752456736487765,7
1271,53,26,114,11,6.571088082289226,15
1272,75,31,63,13,6.570041946714378,18
1273,112,15,30,5,6.562692428407148,10
1274,78,17,50,6,6.562139985257883,11
1275,64,22,19,7,6.56099923334209,15
1276,106,32,23,15,6.549055396089171,17
1277,58,16,112,7,6.546457957272807,9
1278,54,58,70,23,6.543056803225659,35
1279,78,27,8,10,6.539735477431524,17
1280,94,14,34,6,6.5316475345753995,8
1281,98,23,29,9,6.531113392896418,14
1282,91,13,80,5,6.531108694088673,8
1283,102,12,38,3,6.529266346603461,9
1284,39,69,49,26,6.526866682554677,43
1285,94,16,109,7,6.521911813319809,9
1286,60,20,66,7,6.515171561917162,13
1287,76,15,79,5,6.514592595269538,10
1288,41,24,77,9,6.512816462619647,15
1289,74,29,55,12,6.503619546467787,17
1290,90,11,102,6,6.502237322589002,5
1291,70,20,9,7,6.477071321597407,13
1292,98,11,68,4,6.4699276959750645,7
1293,15,16,50,6,6.468981109168021,10
1294,97,19,57,8,6.465009515620626,11
1295,11,15,10,6,6.454288934219365,9
1296,8,20,91,8,6.453847873736644,12
1297,50,23,18,10,6.452668500546503,13
1298,6,10,28,4,6.452419128804086,6
1299,68,16,33,6,6.451134609706936,10
1300,13,47,23,21,6.43409734894195,26
1301,69,18,94,7,6.432434124144747,11
1302,89,16,107,6,6.429821795264183,10
1303,75,21,100,10,6.426877840881264,11
1304,96,23,80,9,6.423400971659428,14
1305,61,10,23,4,6.419517618014351,6
1306,91,18,54,8,6.414686940093468,10
1307,80,20,37,8,6.401050818487373,12
1308,33,13,96,7,6.392035038140808,6
1309,108,29,51,12,6.386940693154832,17
1310,28,16,27,5,6.382931621067471,11
1311,87,35,57,14,6.372641139100552,21
1312,33,15,102,6,6.371524301983966,9
1313,57,12,50,4,6.36698198689182,8
1314,30,14,12,5,6.364011187574048,9
1315,7,21,56,9,6.361794853449644,12
1316,64,19,43,8,6.3596171770522805,11
1317,47,18,15,8,6.359572158435766,10
1318,92,13,27,6,6.356396578041118,7
1319,84,35,39,15,6.3525949898803695,20
1320,30,58,65,23,6.347486219256747,35
1321,85,17,96,5,6.345069391274802,12
1322,12,10,17,4,6.340271038954066,6
1323,43,22,109,8,6.337734890860963,14
1324,15,11,96,4,6.332542018308189,7
1325,77,37,51,16,6.323702748298248,21
1326,70,18,98,6,6.319051319272616,12
1327,76,21,19,8,6.301901405511211,13
1328,76,20,94,7,6.29880756689131,13
1329,43,16,8,7,6.297331254782462,9
1330,28,36,102,15,6.294379170221602,21
1331,40,68,68,26,6.288399173895765,42
1332,54,13,108,4,6.288035508418625,9
1333,12,15,4,5,6.285579029533408,10
1334,47,21,86,8,6.282505529772493,13
1335,50,15,72,6,6.282212191469298,9
1336,29,14,93,6,6.281843189307092,8
1337,11,35,68,15,6.280005613646359,20
1338,86,21,4,8,6.2794844995496994,13
1339,20,45,5,17,6.270373633442785,28
1340,15,12,95,5,6.265255655621163,7
1341,107,65,55,27,6.2629651896189,38
1342,114,48,5,20,6.237633533478721,28
1343,19,14,46,6,6.236350596990492,8
1344,7,39,3,15,6.232217973074318,24
1345,104,41,50,16,6.230364171354915,25
1346,16,42,91,15,6.227187272730326,27
1347,54,25,49,11,6.225454221982543,14
1348,114,24,70,9,6.2146226206029915,15
1349,18,23,65,10,6.210994598557502,13
1350,35,15,84,6,6.209299301194261,9
1351,63,14,12,7,6.204748395941864,7
1352,74,28,70,13,6.203999405338755,15
1353,41,21,37,8,6.201755384784586,13
1354,65,49,20,18,6.200424954113156,31
1355,63,28,2,12,6.200018491851485,16
1356,50,18,48,7,6.197823593871153,11
1357,27,54,65,21,6.196724957991716,33
1358,87,26,97,9,6.1908682502181325,17
1359,91,12,71,5,6.187474142289449,7
1360,114,16,94,7,6.184621239792869,9
1361,114,17,81,8,6.179669023614306,9
1362,80,10,93,5,6.175234905241036,5
1363,78,25,3,11,6.175218404211584,14
1364,13,47,36,18,6.167141158071529,29
1365,50,11,81,5,6.158903696641065,6
1366,75,27,47,9,6.156969718274411,18
1367,41,20,97,8,6.148946376824954,12
1368,25,35,88,12,6.123879676950231,23
1369,81,13,31,4,6.117159791325403,9
1370,90,12,7,5,6.108519045195328,7
1371,54,32,90,13,6.104592167356709,19
1372,16,13,10,5,6.102410867550438,8
1373,84,12,15,5,6.09892148672844,7
1374,62,16,69,7,6.098141811871047,9
1375,54,11,47,5,6.095812400128514,6
1376,57,24,46,10,6.094749729993643,14
1377,96,14,108,6,6.092516088942792,8
1378,111,23,107,11,6.08814286411973,12
1379,23,13,102,6,6.080684731147943,7
1380,6,23,16,11,6.074728029131809,12
1381,65,64,88,24,6.068722517026158,40
1382,23,27,41,11,6.068042449918637,16
1383,13,20,103,7,6.058512514971597,13
1384,39,14,14,6,6.04933667985342,8
1385,63,24,18,9,6.046455003215173,15
1386,53,30,112,14,6.044976838822192,16
1387,70,15,93,6,6.04469500542117,9
1388,76,18,88,8,6.043471817882154,10
1389,8,16,32,7,6.041444852098721,9
1390,7,24,98,9,6.0336860037819795,15
1391,75,31,31,14,6.033482134287373,17
1392,26,10,68,4,6.030745942778486,6
1393,91,17,50,6,6.027790824025911,11
1394,34,32,8,13,6.025162795851977,19
1395,100,62,86,27,6.024521465285827,35
1396,98,24,37,10,6.023716027404386,14
1397,103,17,17,6,6.022913063656272,11
1398,29,15,48,6,6.020141509256061,9
1399,87,60,37,24,6.011896680172788,36
1400,29,34,19,13,6.006279537520525,21
1401,112,11,98,4,6.005421104961224,7
1402,94,21,54,9,6.000772945562409,12
1403,114,25,31,11,5.991876520395493,14
1404,78,19,77,8,5.989483896239347,11
1405,98,20,84,7,5.988889731578423,13
1406,3,25,77,11,5.98288839075645,14
1407,64,20,18,8,5.974775055211904,12
1408,102,21,87,8,5.971447061156249,13
1409,97,18,40,7,5.966918416140386,11
1410,89,16,16,7,5.966481911201795,9
1411,49,28,77,10,5.96535125721377,18
1412,68,52,53,21,5.964244334939563,31
1413,30,69,16,27,5.956505821437065,42
1414,78,15,103,4,5.9522848604888905,11
1415,97,12,10,6,5.950831581917705,6
1416,28,31,76,14,5.950271226300689,17
1417,28,15,53,6,5.9457443646332715,9
1418,34,17,3,7,5.941229806680978,10
1419,12,20,77,9,5.936585739129091,11
1420,73,20,114,8,5.924435121305103,12
1421,34,33,86,14,5.924341860840786,19
1422,27,47,49,19,5.9233145844446,28
1423,75,14,93,6,5.923243043930715,8
1424,78,23,7,11,5.919551023484503,12
1425,104,82,65,35,5.912154582043187,47
1426,84,27,57,13,5.910397185802947,14
1427,50,12,29,5,5.9053142051653245,7
1428,75,59,107,20,5.896729059645907,39
1429,54,12,103,4,5.896465334872947,8
1430,51,16,91,6,5.895842800786141,10
1431,39,34,43,15,5.893766912543444,19
1432,101,15,68,5,5.8919398867497925,10
1433,74,34,84,16,5.891399521581718,18
1434,17,16,43,7,5.888801333071096,9
1435,39,18,103,7,5.887093677643695,11
1436,75,17,108,7,5.885506345854971,10
1437,46,12,36,5,5.882094180819339,7
1438,28,12,31,5,5.87633787823225,7
1439,87,50,19,20,5.875904223711485,30
1440,16,105,87,43,5.874599895224254,62
1441,54,36,95,16,5.865979569344106,20
1442,34,17,7,7,5.863504951401833,10
1443,7,21,112,8,5.8633899504874805,13
1444,55,61,65,26,5.858765777581566,35
1445,80,12,79,6,5.851472407179256,6
1446,108,10,65,5,5.847992745343311,5
1447,13,40,69,16,5.843363292908418,24
1448,40,16,5,7,5.820527251695649,9
1449,19,13,85,5,5.818975421540376,8
1450,79,13,20,5,5.810117746469002,8
1451,8,19,98,7,5.806615359942183,12
1452,10,11,106,3,5.8036728949329275,8
1453,91,19,31,7,5.801858258461766,12
1454,78,45,51,21,5.800274453414972,24
1455,48,13,19,6,5.792431440588199,7
1456,16,95,8,38,5.790022879474908,57
1457,16,45,17,16,5.775641546561411,29
1458,13,19,76,8,5.766341264416831,11
1459,61,10,54,4,5.763750710129652,6
1460,80,15,68,6,5.759836210772863,9
1461,100,20,109,7,5.759474346902359,13
1462,58,13,53,7,5.756559382638666,6
1463,23,13,47,5,5.755142063292807,8
1464,104,13,19,5,5.751508534333886,8
1465,36,12,77,5,5.751140829309578,7
1466,25,42,106,16,5.73768822242091,26
1467,29,24,30,9,5.734998612686146,15
1468,100,46,27,20,5.732603402856776,26
1469,107,31,47,13,5.730039668040246,18
1470,13,48,25,22,5.729332953997915,26
1471,45,14,9,5,5.727853500458987,9
1472,25,26,51,11,5.72613511284895,15
1473,98,13,17,6,5.723425305113809,7
1474,100,25,102,9,5.719538880425677,16
1475,69,16,12,8,5.715951067980107,8
1476,11,14,47,5,5.7112915010697805,9
1477,107,16,72,7,5.708684864640732,9
1478,64,37,65,16,5.704413748738564,21
1479,53,17,62,7,5.701449545318567,10
1480,23,13,50,4,5.694114757145069,9
1481,70,10,32,5,5.692479372096213,5
1482,106,46,5,18,5.689619439430471,28
1483,35,21,40,8,5.6891402135768585,13
1484,76,17,114,6,5.686109810518628,11
1485,28,37,9,17,5.685359581946875,20
1486,102,10,95,4,5.685319962340818,6
1487,63,37,13,16,5.677540897301027,21
1488,94,10,25,5,5.671887186214519,5
1489,75,39,37,14,5.670197882049105,25
1490,100,22,74,9,5.666768329458076,13
1491,16,31,99,13,5.665818337043021,18
1492,54,11,82,4,5.664278302313932,7
1493,100,56,87,25,5.6583910079024315,31
1494,46,31,75,13,5.654705399493307,18
1495,20,44,16,16,5.653886889078911,28
1496,9,13,61,5,5.652969843590383,8
1497,49,32,60,13,5.652266603264943,19
1498,4,10,97,4,5.649870700339136,6
1499,39,13,97,5,5.649731064357227,8
1500,73,23,74,9,5.649045009007229,14
1501,109,16,46,7,5.636528034552769,9
1502,75,43,9,17,5.6326941278183265,26
1503,15,11,6,4,5.630932126309074,7
1504,78,16,20,7,5.6294679305494935,9
1505,86,28,73,13,5.62531345595925,15
1506,5,21,17,7,5.625033929201379,14
1507,19,10,5,4,5.623378775596127,6
1508,9,24,84,10,5.622843694169622,14
1509,51,10,22,4,5.620245273736575,6
1510,95,26,50,11,5.619957219349123,15
1511,68,26,91,12,5.61946637277209,14
1512,30,51,19,21,5.61733531084903,30
1513,30,14,90,6,5.614315415339312,8
1514,72,13,60,5,5.611432015329071,8
1515,23,11,10,5,5.611414438981715,6
1516,80,17,64,8,5.593698551425534,9
1517,20,38,96,15,5.591064360306499,23
1518,102,14,34,5,5.587343030075011,9
1519,16,23,58,9,5.587223743497611,14
1520,89,13,53,6,5.5817208357882135,7
1521,14,14,88,6,5.580858903619985,8
1522,69,38,86,16,5.577802432439769,22
1523,20,22,44,9,5.576158683247874,13
1524,7,23,38,10,5.57543888103377,13
1525,30,12,33,4,5.573632303680849,8
1526,100,69,51,32,5.571831001302534,37
1527,86,98,88,41,5.562390170991596,57
1528,107,63,20,27,5.562332766197254,36
1529,31,10,95,4,5.5581891593402775,6
1530,13,72,40,31,5.55717975004481,41
1531,13,30,95,13,5.556983808516705,17
1532,46,11,4,5,5.55622187464566,6
1533,8,44,46,20,5.553053726096314,24
1534,41,20,50,8,5.552926820113501,12
1535,69,16,54,7,5.552096999235811,9
1536,8,41,25,16,5.550067480025434,25
1537,36,53,31,23,5.548564460468652,30
1538,25,18,84,7,5.5466876181289715,11
1539,18,42,75,18,5.546579166688546,24
1540,20,22,2,9,5.544865436021075,13
1541,64,21,23,9,5.538877575953661,12
1542,16,22,14,9,5.533520092369799,13
1543,72,19,100,7,5.526643412544751,12
1544,64,11,102,4,5.525256448935202,7
1545,28,33,7,13,5.522079859732702,20
1546,114,47,68,20,5.519247268707076,27
1547,80,28,87,11,5.518166010205808,17
1548,45,23,65,11,5.510611418282091,12
1549,95,19,83,7,5.510188596504647,12
1550,80,10,81,5,5.509744831821596,5
1551,32,13,109,6,5.5080518973086185,7
1552,40,14,19,5,5.507682773045995,9
1553,2,13,40,5,5.504797437287729,8
1554,44,15,64,6,5.503275136525506,9
1555,16,27,38,9,5.5014358332432725,18
1556,67,10,102,4,5.49724656177184,6
1557,111,27,55,11,5.4926637972483,16
1558,100,22,25,10,5.476003695191372,12
1559,31,13,74,5,5.468299370651384,8
1560,5,31,51,11,5.465657211287606,20
1561,71,14,76,7,5.456476326439047,7
1562,65,33,3,13,5.455652683559951,20
1563,75,43,71,16,5.454468163058883,27
1564,100,31,63,14,5.452576532321479,17
1565,85,25,84,9,5.439743670520439,16
1566,87,41,41,17,5.4376307202585155,24
1567,71,29,68,11,5.435653336862236,18
1568,42,13,69,6,5.432900919803646,7
1569,104,33,63,14,5.422500590286895,19
1570,104,38,25,17,5.422383455319629,21
1571,98,27,76,11,5.421334528995661,16
1572,11,32,19,12,5.420057417715361,20
1573,4,11,58,4,5.405037105567146,7
1574,8,20,33,8,5.397787705463012,12
1575,64,40,86,17,5.391204217901304,23
1576,65,16,103,6,5.377768524309904,10
1577,15,25,18,10,5.370261713586338,15
1578,90,24,50,10,5.361711287754659,14
1579,34,17,43,7,5.36097622234483,10
1580,7,35,97,16,5.356987360153851,19
1581,81,15,65,6,5.355649781765623,9
1582,50,26,30,11,5.354360679381176,15
1583,37,47,63,19,5.351566239537104,28
1584,7,19,62,8,5.339510147514967,11
1585,16,21,12,9,5.337506727804561,12
1586,97,14,102,5,5.335160623731844,9
1587,38,19,19,6,5.3155517588149985,13
1588,86,15,61,6,5.314125600249351,9
1589,27,16,98,7,5.307731237447107,9
1590,12,18,8,7,5.299832726924706,11
1591,10,15,87,6,5.299026363997259,9
1592,99,21,86,8,5.291638236148403,13
1593,14,19,28,7,5.288795345484194,12
1594,62,13,109,7,5.284405260681885,6
1595,56,11,88,5,5.280224334897691,6
1596,13,23,62,10,5.279557581763118,13
1597,45,15,87,6,5.278722468966396,9
1598,51,42,109,15,5.273970080829758,27
1599,28,11,92,4,5.26619903758234,7
1600,86,55,75,25,5.26427494208678,30
1601,107,67,104,28,5.260319067961473,39
1602,34,11,1,3,5.259854618241473,8
1603,35,11,31,5,5.255104723881263,6
1604,85,14,65,6,5.254482148208556,8
1605,102,21,51,9,5.246852253062099,12
1606,25,26,40,11,5.242222631716463,15
1607,52,14,16,6,5.238731564661996,8
1608,91,21,25,9,5.236778929543691,12
1609,9,12,23,5,5.231512665759894,7
1610,16,127,107,49,5.230248987064316,78
1611,35,11,5,5,5.226534281744142,6
1612,92,23,39,11,5.22393109782644,12
1613,54,54,106,25,5.222938310920249,29
1614,40,22,37,10,5.2189812618502875,12
1615,20,18,76,9,5.218902337593747,9
1616,69,14,8,6,5.216534828858885,8
1617,33,12,91,6,5.213867650447791,6
1618,50,22,109,9,5.207842202449344,13
1619,63,21,43,9,5.207688448634706,12
1620,16,106,7,46,5.201721932894633,60
1621,16,36,53,14,5.201094174764711,22
1622,64,26,8,10,5.1977394093405085,16
1623,46,25,39,13,5.196853389468722,12
1624,104,18,80,8,5.194103195079234,10
1625,40,13,113,5,5.193726392686624,8
1626,6,10,71,4,5.193692278292729,6
1627,23,14,43,6,5.1891207532463,8
1628,75,17,97,7,5.183439015487436,10
1629,27,10,80,4,5.166088753800779,6
1630,65,29,96,13,5.165027076154164,16
1631,114,20,96,8,5.164351476040407,12
1632,91,11,56,5,5.1601828143932735,6
1633,98,13,93,6,5.160023067123591,7
1634,67,12,5,5,5.159840528973067,7
1635,35,16,28,8,5.153123660542302,8
1636,106,24,9,10,5.150083731218861,14
1637,16,51,50,21,5.149610319436332,30
1638,11,13,97,6,5.149154391162879,7
1639,27,55,86,23,5.148010188474065,32
1640,16,110,65,47,5.145171506502089,63
1641,72,17,8,8,5.13781996064983,9
1642,36,21,3,8,5.136055944816986,13
1643,40,30,58,14,5.133397385337812,16
1644,64,14,33,5,5.132334361355246,9
1645,75,18,4,7,5.112428644465592,11
1646,30,10,1,4,5.107240382060611,6
1647,9,30,54,13,5.106575143785501,17
1648,55,23,70,10,5.1032220329288345,13
1649,28,13,108,6,5.102919930198642,7
1650,53,25,104,11,5.0942603831986055,14
1651,90,23,65,11,5.084911236528136,12
1652,8,70,87,30,5.084902312273525,40
1653,32,10,20,3,5.082163415292109,7
1654,3,23,64,10,5.079848362911411,13
1655,47,16,28,7,5.079195021327368,9
1656,41,27,109,10,5.069522776777775,17
1657,41,10,61,4,5.060781095904467,6
1658,7,16,10,7,5.060407065651958,9
1659,95,20,75,8,5.050260152484931,12
1660,104,48,51,18,5.045842035260691,30
1661,39,27,77,12,5.045469290606398,15
1662,63,15,85,7,5.044437930195333,8
1663,39,31,38,13,5.039769505176328,18
1664,65,12,52,4,5.0369958566437525,8
1665,43,18,84,8,5.034570350714234,10
1666,20,24,41,11,5.031440077185285,13
1667,94,36,87,16,5.028702412089722,20
1668,13,49,64,23,5.026699897179315,26
1669,7,100,88,43,5.012449658177523,57
1670,112,17,94,6,5.010192110959217,11
1671,72,17,17,7,5.00861905737698,10
1672,41,27,3,9,5.008050046100229,18
1673,102,13,83,5,5.0053275745844825,8
1674,93,26,5,10,5.004460526821323,16
1675,7,41,106,20,5.003800212982272,21
1676,74,15,71,7,4.993812181109021,8
1677,50,23,31,10,4.99199978599778,13
1678,63,19,94,8,4.988953899876626,11
1679,80,34,55,16,4.987967529735275,18
1680,80,10,44,5,4.9735414138069105,5
1681,98,11,23,5,4.969965161139006,6
1682,27,21,114,9,4.967571693509977,12
1683,96,23,90,9,4.963939687748078,14
1684,76,44,107,16,4.963511886446058,28
1685,85,10,64,4,4.962701184974938,6
1686,64,33,41,13,4.951397157092105,20
1687,20,12,100,5,4.9486843519072865,7
1688,56,19,68,9,4.94813216675333,10
1689,76,14,18,6,4.948055179076069,8
1690,48,35,87,14,4.946418242596833,21
1691,80,29,106,12,4.946009667025365,17
1692,39,23,81,9,4.943832581007466,14
1693,40,15,78,5,4.942465399220729,10
1694,93,27,28,10,4.941127481170006,17
1695,49,11,71,5,4.940945789460408,6
1696,62,18,9,8,4.931496627802286,10
1697,114,22,9,7,4.931319071415342,15
1698,86,40,36,17,4.927433251240005,23
1699,74,56,106,24,4.924754963776778,32
1700,72,20,11,9,4.923870308975731,11
1701,43,41,86,17,4.923382575057013,24
1702,38,12,28,6,4.907164394244691,6
1703,15,32,11,13,4.9040772238924895,19
1704,9,15,29,6,4.900194767905049,9
1705,38,14,54,6,4.897121063973306,8
1706,11,24,102,11,4.8933993430696106,13
1707,23,16,77,7,4.892331871891681,9
1708,75,47,51,21,4.890410363576286,26
1709,39,10,101,4,4.889741278103363,6
1710,69,11,95,4,4.882909765417961,7
1711,23,44,88,17,4.876485476342163,27
1712,100,17,84,6,4.87641516703203,11
1713,88,26,57,12,4.870812248870149,14
1714,13,20,79,8,4.869950872786802,12
1715,19,39,107,15,4.867116029370308,24
1716,29,11,1,4,4.86693457558879,7
1717,37,54,106,25,4.865641247327302,29
1718,5,10,89,3,4.86246564090175,7
1719,52,12,107,4,4.861262849981809,8
1720,81,24,3,10,4.860040341211912,14
1721,100,31,112,14,4.858414274039212,17
1722,58,38,107,15,4.857008495705362,23
1723,77,11,114,5,4.854209160918298,6
1724,100,11,79,4,4.852268357181291,7
1725,97,12,32,5,4.851459349576839,7
1726,39,17,83,7,4.845386042652696,10
1727,83,20,64,9,4.840996077098241,11
1728,8,15,67,6,4.831909846155583,9
1729,41,13,90,6,4.828201040811693,7
1730,65,47,9,19,4.826128695703039,28
1731,31,19,25,9,4.823839301099763,10
1732,14,15,54,5,4.820525855929132,10
1733,30,58,107,24,4.820148690247347,34
1734,74,11,85,5,4.812388004493803,6
1735,6,12,106,5,4.810944704219048,7
1736,2,25,106,11,4.808494527305082,14
1737,75,44,88,18,4.804702938088107,26
1738,1,16,12,7,4.804302234326601,9
1739,16,11,56,4,4.8021414027227,7
1740,75,22,96,7,4.801381492311931,15
1741,34,14,88,6,4.799596567728287,8
1742,7,23,46,8,4.79766101758117,15
1743,111,11,25,5,4.797175922879397,6
1744,52,13,20,5,4.795236183864801,8
1745,9,17,1,9,4.794059502939978,8
1746,97,24,76,11,4.789197045000655,13
1747,76,33,5,14,4.788314400539968,19
1748,72,22,87,10,4.7870712017642,12
1749,15,25,81,11,4.783657780343267,14
1750,100,25,55,12,4.783496502583423,13
1751,86,57,104,25,4.778923035703435,32
1752,9,12,5,5,4.777710715122403,7
1753,30,17,108,7,4.7770363391373785,10
1754,33,14,23,6,4.772846471482118,8
1755,9,10,37,4,4.7723167368365935,6
1756,90,13,70,6,4.771084444295362,7
1757,12,15,31,7,4.770632464521183,8
1758,55,16,94,7,4.767452995148861,9
1759,76,23,60,8,4.763967746356446,15
1760,55,12,79,5,4.763372141256469,7
1761,107,42,3,20,4.760146320288785,22
1762,93,16,50,6,4.755526241513054,10
1763,7,23,50,10,4.754905099968965,13
1764,90,30,5,12,4.752640516818983,18
1765,25,16,77,7,4.745845616411638,9
1766,13,82,55,35,4.7339588356712445,47
1767,6,11,46,5,4.730994669309113,6
1768,15,14,75,5,4.729161606780822,9
1769,11,83,86,36,4.7187425845588225,47
1770,20,23,46,8,4.708713070266485,15
1771,3,21,112,10,4.705334593377522,11
1772,16,36,84,15,4.697024903080797,21
1773,71,16,5,7,4.686451238703377,9
1774,85,22,72,8,4.685894776044266,14
1775,40,51,39,21,4.685059105758996,30
1776,109,19,38,7,4.6680162036882455,12
1777,25,15,47,7,4.655390231832646,8
1778,63,62,54,26,4.652017262215903,36
1779,27,13,79,6,4.651583262533671,7
1780,15,16,1,6,4.649350840919029,10
1781,63,39,96,15,4.649023449526137,24
1782,73,14,13,6,4.642713338622983,8
1783,48,13,25,6,4.64169889765536,7
1784,80,11,69,5,4.638884395252678,6
1785,73,19,109,8,4.637139105733967,11
1786,60,22,25,10,4.636282806493916,12
1787,106,15,110,7,4.633960085739299,8
1788,65,13,89,6,4.632113459581728,7
1789,51,15,92,7,4.630319337525281,8
1790,3,16,94,7,4.629270425756285,9
1791,100,37,88,15,4.625717286575204,22
1792,60,20,58,9,4.621481714021651,11
1793,72,10,40,4,4.6161082317709115,6
1794,85,20,68,7,4.615895850726342,13
1795,37,72,86,32,4.607837359690983,40
1796,38,15,18,7,4.6074157564111795,8
1797,19,14,102,5,4.6003035981048885,9
1798,50,32,96,14,4.592653394244439,18
1799,78,26,54,11,4.592600537057518,15
1800,28,25,71,10,4.584215619303489,15
1801,99,16,65,7,4.579704538683142,9
1802,7,23,58,11,4.575034525669344,12
1803,39,56,60,25,4.573736342935889,31
1804,99,14,95,6,4.572737764013027,8
1805,99,16,104,8,4.5627492392393,8
1806,74,23,109,9,4.562525277723523,14
1807,43,18,5,8,4.5592775438308895,10
1808,70,15,23,7,4.554568026577778,8
1809,83,15,46,7,4.551826612706301,8
1810,99,18,15,7,4.551461310618723,11
1811,100,74,107,35,4.53492054534351,39
1812,106,23,75,11,4.532198108241345,12
1813,50,71,28,30,4.530365152854881,41
1814,13,19,48,8,4.529838045170983,11
1815,61,17,60,8,4.527394085824659,9
1816,54,64,51,28,4.522639648916932,36
1817,74,23,50,10,4.520207268757788,13
1818,49,18,112,8,4.517911222226066,10
1819,23,41,87,17,4.512300706037799,24
1820,49,30,51,13,4.504127532693048,17
1821,76,12,69,4,4.499300236532236,8
1822,16,73,100,31,4.496116763819155,42
1823,55,47,60,21,4.496007919155317,26
1824,8,16,79,8,4.494949825171058,8
1825,58,21,39,9,4.494576390875354,12
1826,93,15,37,6,4.493445665639034,9
1827,65,50,40,22,4.488092661947342,28
1828,7,46,64,21,4.481240056988839,25
1829,100,30,7,13,4.479542671667203,17
1830,56,12,8,5,4.475636615156396,7
1831,95,33,107,15,4.475609109265348,18
1832,62,26,3,11,4.4730367718288155,15
1833,96,31,25,14,4.4728328775528,17
1834,91,10,57,5,4.468260927215541,5
1835,37,18,32,8,4.466542082918521,10
1836,77,11,97,4,4.4549011553839994,7
1837,50,12,73,4,4.454782630059153,8
1838,95,44,16,20,4.453378575583387,24
1839,95,15,109,6,4.444131433700797,9
1840,108,17,27,7,4.430289870166569,10
1841,23,14,20,6,4.42777867543601,8
1842,57,11,98,5,4.422154501358108,6
1843,99,30,13,13,4.420966828834258,17
1844,13,42,77,18,4.419681112621033,24
1845,71,29,87,13,4.418670539958073,16
1846,29,17,23,8,4.418393467914156,9
1847,7,64,53,28,4.416213736910661,36
1848,50,24,64,11,4.4155104994189385,13
1849,34,16,76,8,4.406030161353482,8
1850,12,38,13,13,4.404764592205934,25
1851,71,14,108,6,4.402422140240549,8
1852,62,18,11,8,4.400361109158305,10
1853,16,22,2,9,4.395353237879593,13
1854,12,12,64,5,4.3938981464127,7
1855,99,10,54,4,4.3797228746123675,6
1856,87,33,25,15,4.379098196808542,18
1857,49,24,8,10,4.374514809997584,14
1858,55,24,9,10,4.371040618945099,14
1859,55,13,58,6,4.369004483506264,7
1860,40,23,23,10,4.368423326803309,13
1861,74,15,9,6,4.367415226980942,9
1862,95,20,23,9,4.3618962627692595,11
1863,64,31,71,12,4.35947313780117,19
1864,19,11,83,5,4.3593981927010494,6
1865,76,24,39,9,4.354774512936871,15
1866,28,30,48,13,4.353346769104992,17
1867,65,16,6,7,4.346168811124812,9
1868,70,29,65,11,4.343984179663613,18
1869,34,20,48,9,4.343261719849951,11
1870,60,12,22,5,4.334241842742782,7
1871,95,19,41,8,4.332143979792177,11
1872,19,29,65,13,4.323452850174734,16
1873,47,21,41,10,4.32003722756243,11
1874,15,15,103,7,4.31675719046778,8
1875,4,22,40,10,4.316643149060896,12
1876,70,14,71,7,4.315612188206775,7
1877,11,53,88,22,4.315288914266512,31
1878,104,27,98,14,4.313899934387766,13
1879,97,23,17,10,4.3134285513049555,13
1880,76,13,90,5,4.309550016746244,8
1881,31,10,8,4,4.309099443279478,6
1882,50,10,52,5,4.308197298973349,5
1883,100,29,78,12,4.306504123439813,17
1884,106,27,53,13,4.302319600135898,14
1885,37,45,55,21,4.301001080588836,24
1886,75,18,84,8,4.30081159040195,10
1887,25,28,54,12,4.300413553073274,16
1888,13,12,35,5,4.29516454019383,7
1889,85,11,98,4,4.293458254788545,7
1890,114,20,15,9,4.283176268910449,11
1891,19,27,57,12,4.280011891536446,15
1892,29,15,55,6,4.26601507571376,9
1893,12,13,7,6,4.264845867192969,7
1894,91,30,107,12,4.264126621091653,18
1895,94,11,18,5,4.250781715158486,6
1896,6,10,72,5,4.248570153213718,5
1897,106,14,34,7,4.243674039664675,7
1898,16,44,71,18,4.241804878716306,26
1899,71,12,109,5,4.235965151087515,7
1900,29,11,104,5,4.232469176091455,6
1901,9,21,38,9,4.224156596688182,12
1902,71,11,44,5,4.223524348839462,6
1903,97,37,16,17,4.222715093786658,20
1904,28,29,100,12,4.221129674472951,17
1905,4,19,18,8,4.220670692754494,11
1906,17,20,63,9,4.217095300732271,11
1907,90,28,87,12,4.209781806456323,16
1908,65,56,36,24,4.205692860728479,32
1909,108,18,74,7,4.201041319943183,11
1910,51,26,29,12,4.200611882951569,14
1911,112,12,103,5,4.192929666832579,7
1912,13,36,1,14,4.1879984611154635,22
1913,23,27,25,12,4.182190113226028,15
1914,107,53,23,24,4.172486813229872,29
1915,60,24,96,8,4.164982345638211,16
1916,83,40,5,19,4.163709904424501,21
1917,27,24,84,11,4.156059221916357,13
1918,27,55,3,25,4.152670678405782,30
1919,28,60,84,26,4.150279635735803,34
1920,99,12,17,5,4.14837583337694,7
1921,84,18,76,8,4.146116027740745,10
1922,20,13,73,5,4.146065391689569,8
1923,100,12,95,6,4.142851413596655,6
1924,23,49,65,23,4.1421094853825435,26
1925,53,47,71,20,4.141303557057986,27
1926,71,11,20,4,4.13643055739397,7
1927,7,51,27,23,4.136091254496649,28
1928,58,23,87,10,4.119284370275493,13
1929,55,38,54,18,4.11778307869689,20
1930,7,12,2,5,4.115660194227726,7
1931,100,46,19,20,4.1124549471418,26
1932,97,30,63,13,4.107378727934806,17
1933,16,60,49,25,4.104686156783943,35
1934,104,35,74,14,4.104594141618063,21
1935,93,14,109,6,4.103558953267082,8
1936,16,54,37,24,4.101602264091046,30
1937,83,20,93,9,4.100880722204593,11
1938,30,15,62,7,4.099340749559774,8
1939,20,24,35,10,4.098728722002914,14
1940,104,33,54,15,4.09448807738149,18
1941,69,25,43,11,4.093607533799894,14
1942,80,17,39,8,4.091599339844535,9
1943,13,67,46,28,4.091227749409544,39
1944,17,51,51,24,4.088673144397257,27
1945,36,11,19,5,4.088590218421688,6
1946,78,17,98,8,4.084899624702042,9
1947,86,117,5,51,4.074944655375778,66
1948,95,21,46,9,4.071848693893575,12
1949,60,38,8,18,4.06951058040077,20
1950,7,68,31,30,4.069172309295859,38
1951,28,38,18,18,4.067881996028203,20
1952,20,12,38,4,4.067291998076464,8
1953,43,10,95,4,4.063398320607949,6
1954,56,11,39,6,4.061429150921739,5
1955,79,20,11,8,4.052675901080834,12
1956,14,10,20,4,4.051966837258039,6
1957,94,11,50,4,4.051144013437595,7
1958,32,10,40,5,4.050021677419869,5
1959,84,12,69,5,4.04678242799089,7
1960,71,25,51,11,4.043275219347798,14
1961,1,10,43,5,4.038976715758721,5
1962,63,41,114,15,4.037972989054352,26
1963,104,10,10,5,4.031221485043642,5
1964,71,13,47,6,4.030916530509353,7
1965,60,42,114,22,4.0291749332243,20
1966,7,31,47,13,4.025431088719289,18
1967,39,21,96,8,4.016816457185763,13
1968,16,21,35,8,4.016361918873651,13
1969,8,20,110,8,4.013172679497404,12
1970,66,12,31,5,4.008754872558654,7
1971,30,33,71,15,4.006253796204616,18
1972,13,40,54,17,4.002518666516472,23
1973,31,16,112,6,4.001730552260451,10
1974,9,18,100,7,3.99532686001692,11
1975,89,13,68,6,3.99200348329726,7
1976,30,17,102,8,3.9885406117931677,9
1977,106,12,3,5,3.9869286680549822,7
1978,88,18,6,8,3.98561022572369,10
1979,41,29,69,11,3.9797729258891983,18
1980,60,18,97,9,3.9792005525226366,9
1981,96,12,14,5,3.975747798085754,7
1982,78,15,96,6,3.961613354196041,9
1983,74,24,93,11,3.9601017688790825,13
1984,78,26,49,12,3.9527522510286133,14
1985,67,11,104,5,3.9505697623954914,6
1986,28,61,65,26,3.946950789839023,35
1987,35,19,43,9,3.946831407739413,10
1988,6,11,40,5,3.9442678680230823,6
1989,102,15,98,7,3.939114797619031,8
1990,80,10,97,4,3.9365866928471034,6
1991,60,30,15,14,3.9345392656992946,16
1992,85,15,20,7,3.9254254916442872,8
1993,5,28,2,12,3.923277825320168,16
1994,37,38,70,16,3.9227382855891664,22
1995,15,32,3,14,3.9210667133256685,18
1996,95,38,87,17,3.915668057739163,21
1997,51,50,46,22,3.9127315336646564,28
1998,30,14,52,6,3.910728614777823,8
1999,64,11,90,5,3.90210878186129,6
2000,102,26,37,11,3.9015784283610255,15
2001,102,15,91,7,3.9012134006248127,8
2002,55,30,63,14,3.9003771949657002,16
2003,87,110,107,48,3.8998993051366493,62
2004,51,51,84,22,3.8997018485628683,29
2005,77,13,58,6,3.8981506835692437,7
2006,28,23,57,10,3.897117570901977,13
2007,1,25,54,11,3.892988653897817,14
2008,76,19,29,10,3.891834089248111,9
2009,41,33,104,16,3.881745214521683,17
2010,15,18,78,9,3.8743903606720744,9
2011,65,86,41,35,3.873081236904718,51
2012,39,52,27,21,3.8705079550154746,31
2013,74,41,63,19,3.86350929161903,22
2014,30,29,104,14,3.8618412248829026,15
2015,86,33,62,15,3.8579815466758847,18
2016,40,50,107,20,3.857060552716014,30
2017,109,12,47,5,3.856660461158829,7
2018,30,21,38,8,3.844758917902768,13
2019,72,20,15,10,3.843478882303784,10
2020,18,23,31,11,3.843025830767866,12
2021,20,26,7,12,3.839940256500117,14
2022,47,11,12,5,3.8390154161535577,6
2023,38,13,46,5,3.833859769343221,8
2024,16,45,109,19,3.833289533054693,26
2025,7,44,55,18,3.8332053851440007,26
2026,13,77,60,32,3.8326689716078346,45
2027,91,26,13,12,3.831748260733109,14
2028,4,11,3,5,3.825046392091852,6
2029,62,19,60,9,3.822113325977996,10
2030,16,31,79,13,3.819316250104341,18
2031,5,28,91,11,3.8146250930665166,17
2032,110,16,5,7,3.8138584796050923,9
2033,72,22,78,11,3.8085176531004064,11
2034,62,16,102,7,3.80648773210449,9
2035,60,80,16,36,3.805678741226446,44
2036,6,11,39,5,3.796620754703807,6
2037,78,39,19,16,3.787938218331084,23
2038,7,10,93,5,3.7802315490169653,5
2039,104,13,92,7,3.7768187223532306,6
2040,114,47,13,24,3.7759149187311776,23
2041,39,39,19,15,3.772327105389409,24
2042,102,14,17,6,3.7656274901945017,8
2043,107,23,81,10,3.7509673958242833,13
2044,41,21,76,11,3.7501063090537037,10
2045,76,28,109,11,3.7436675718552475,17
2046,53,42,40,19,3.7429391558119995,23
2047,15,31,7,16,3.741081293807926,15
2048,1,13,4,5,3.736039087851971,8
2049,86,65,25,30,3.735239092039536,35
2050,60,59,40,26,3.7350164129782777,33
2051,54,14,12,7,3.727845074231434,7
2052,15,13,40,6,3.725578311667862,7
2053,87,47,20,22,3.7242304000917286,25
2054,76,24,27,10,3.7240927829041777,14
2055,89,14,60,7,3.7237634526579124,7
2056,20,64,54,31,3.7237387131550506,33
2057,89,15,104,7,3.7197091727483307,8
2058,85,14,11,6,3.7190747038473155,8
2059,15,21,5,8,3.714734226349825,13
2060,1,21,64,10,3.714096825641643,11
2061,77,18,11,8,3.711392742612506,10
2062,65,16,14,8,3.7073397651844364,8
2063,57,46,15,21,3.7066394769889324,25
2064,112,10,35,5,3.7046440124812348,5
2065,23,19,28,9,3.6970356039584393,10
2066,27,55,88,26,3.6892145620737318,29
2067,65,23,109,12,3.6820630235649316,11
2068,87,54,50,25,3.6738110241503925,29
2069,38,21,84,10,3.6699802067032476,11
2070,107,38,38,16,3.669594298718899,22
2071,51,80,65,35,3.664771412812795,45
2072,39,24,31,10,3.6610558433956157,14
2073,49,27,15,13,3.6591495913830623,14
2074,90,10,71,5,3.6561036030201253,5
2075,107,21,32,10,3.6546977761524686,11
2076,55,20,77,9,3.6546881978963213,11
2077,30,45,60,17,3.65390835767515,28
2078,109,15,9,8,3.6538651478462696,7
2079,62,11,20,5,3.653244367006128,6
2080,17,11,18,6,3.651905683853181,5
2081,16,34,80,14,3.650847383014163,20
2082,63,16,66,7,3.650382654951077,9
2083,14,10,70,5,3.647042134114848,5
2084,50,19,49,9,3.6450493959827224,10
2085,49,22,9,11,3.6412924336451584,11
2086,41,57,107,23,3.6390090882392983,34
2087,54,36,68,15,3.638947721326894,21
2088,20,52,28,23,3.6380228467997373,29
2089,33,15,11,8,3.6324699886469727,7
2090,43,19,18,10,3.6267699505365183,9
2091,62,23,19,9,3.6244910416057854,14
2092,80,26,28,12,3.6230809501897743,14
2093,28,18,85,8,3.621306171580702,10
2094,1,36,88,17,3.612486249864136,19
2095,69,17,39,8,3.6024816939136075,9
2096,91,19,18,8,3.601007419787661,11
2097,75,57,16,26,3.59529020803502,31
2098,17,12,30,6,3.5949084621895344,6
2099,97,10,95,4,3.58943247133478,6
2100,14,22,87,9,3.574657228905801,13
2101,25,19,43,7,3.573077352948075,12
2102,62,13,84,6,3.5672380956620353,7
2103,6,28,7,15,3.5631855242339143,13
2104,79,13,108,5,3.562523700236059,8
2105,107,41,64,19,3.561300386963443,22
2106,34,35,16,15,3.5563841382415777,20
2107,60,12,79,5,3.555370933230565,7
2108,28,19,36,9,3.5549996153541237,10
2109,114,15,30,7,3.554559185886989,8
2110,53,49,65,23,3.552341058928982,26
2111,75,25,74,10,3.5502981320595755,15
2112,114,17,49,9,3.5487282111911393,8
2113,33,11,70,5,3.5452850377562317,6
2114,13,31,19,13,3.544087166327379,18
2115,47,29,27,13,3.5439664319349258,16
2116,40,65,36,28,3.5400829247343655,37
2117,44,15,7,7,3.5352660207554516,8
2118,6,10,62,4,3.534555615892033,6
2119,93,17,25,8,3.5300397889756283,9
2120,109,25,34,11,3.528628974498499,14
2121,76,13,103,5,3.521454752878398,8
2122,53,14,100,6,3.5195197890566727,8
2123,43,18,50,7,3.5141816448286636,11
2124,23,21,3,9,3.512809694387383,12
2125,74,16,23,7,3.505315761927058,9
2126,25,27,109,12,3.504136926234727,15
2127,37,13,108,6,3.501919723771849,7
2128,100,63,13,29,3.5005116822740514,34
2129,23,22,15,10,3.500162602109348,12
2130,58,12,47,5,3.4979705643460672,7
2131,114,39,51,19,3.4973322349486486,20
2132,97,36,114,16,3.4948097299506915,20
2133,48,19,55,8,3.494162257250903,11
2134,20,26,109,10,3.492917739743869,16
2135,62,13,36,6,3.489528327052378,7
2136,36,30,51,14,3.4874600225025074,16
2137,41,16,45,6,3.485066668867455,10
2138,25,20,70,9,3.484518115943736,11
2139,13,42,78,19,3.483470308077065,23
2140,55,16,18,8,3.4810467173744706,8
2141,96,57,54,28,3.4766133859583515,29
2142,51,44,11,19,3.4727761280704854,25
2143,74,60,5,28,3.469996146708342,32
2144,46,53,54,24,3.462224315333584,29
2145,33,23,5,11,3.454327509177194,12
2146,37,21,23,10,3.453043705748743,11
2147,112,14,114,7,3.4529529803290635,7
2148,86,63,46,26,3.4473674168834294,37
2149,87,35,49,17,3.445580726430241,18
2150,76,28,55,11,3.4438952481653065,17
2151,78,11,81,6,3.4320246992935264,5
2152,34,35,27,16,3.4292031635096016,19
2153,55,49,11,20,3.4281320850013377,29
2154,108,10,69,6,3.4269138907252144,4
2155,4,12,37,5,3.421871703775507,7
2156,54,17,112,7,3.420370975960876,10
2157,17,11,36,6,3.4172736451567545,5
2158,3,15,102,7,3.413104863312669,8
2159,55,29,84,13,3.40123055779696,16
2160,16,142,86,61,3.396117761292696,81
2161,4,13,28,6,3.3940824912486867,7
2162,55,50,5,22,3.393419962444802,28
2163,73,10,104,4,3.391491099464731,6
2164,60,31,9,13,3.3853349951371747,18
2165,36,28,55,13,3.383336577257353,15
2166,73,15,98,7,3.380055365181917,8
2167,64,40,39,18,3.377216491809078,22
2168,15,32,87,15,3.3708140690978814,17
2169,69,27,57,11,3.36716622165523,16
2170,40,17,20,7,3.3649339637959645,10
2171,54,25,97,12,3.3648153427656755,13
2172,14,23,8,10,3.3634201583462158,13
2173,14,17,106,7,3.360059412826609,10
2174,88,85,51,42,3.3509269089088347,43
2175,83,10,20,5,3.3478898251644025,5
2176,94,20,65,10,3.3472699488499082,10
2177,51,61,60,24,3.3463130273558974,37
2178,40,15,91,7,3.345577169162442,8
2179,54,20,98,9,3.3414082574982986,11
2180,68,13,5,6,3.3380294056441144,7
2181,68,44,3,21,3.331199454130326,23
2182,28,46,51,22,3.330644392104213,24
2183,98,14,97,7,3.3185319117606187,7
2184,97,16,84,6,3.316428205809935,10
2185,60,31,75,14,3.3139158628036856,17
2186,63,19,79,8,3.3134147957453677,11
2187,41,14,96,5,3.3088942892360285,9
2188,88,12,66,5,3.305300021832229,7
2189,114,21,64,9,3.3046667254482847,12
2190,3,30,29,13,3.304635369456712,17
2191,47,13,61,6,3.3043540506366424,7
2192,104,60,5,28,3.3007473735225052,32
2193,55,15,35,7,3.289902790162483,8
2194,90,25,60,10,3.288918313106561,15
2195,68,31,78,14,3.285372327961691,17
2196,19,31,68,13,3.2786498819088243,18
2197,39,50,53,22,3.277161726088194,28
2198,114,13,67,6,3.2746706512348434,7
2199,85,20,13,8,3.2720772589350196,12
2200,8,57,65,26,3.2717260560147303,31
2201,28,56,54,25,3.2622780281799852,31
2202,18,56,53,26,3.2615252410170665,30
2203,86,34,77,15,3.2597638921767618,19
2204,7,24,74,9,3.257493143792888,15
2205,29,11,108,5,3.254331422994322,6
2206,114,47,25,20,3.2540864225169766,27
2207,100,38,15,17,3.252832450403913,21
2208,64,10,96,4,3.247034103841879,6
2209,23,12,81,5,3.240703587077002,7
2210,99,25,60,11,3.2381944591027096,14
2211,9,18,34,8,3.2368917561941424,10
2212,63,93,86,39,3.2368352705177204,54
2213,107,49,36,23,3.234838704648264,26
2214,12,12,58,5,3.234783078384576,7
2215,13,103,51,49,3.2275562894340544,54
2216,23,55,7,25,3.2229283053761675,30
2217,55,39,28,16,3.2184704312839787,23
2218,17,16,74,7,3.211770551027832,9
2219,50,19,97,8,3.210625734622642,11
2220,37,64,104,28,3.210594247711222,36
2221,60,47,31,24,3.2094707274879264,23
2222,56,12,97,6,3.2085312435870676,6
2223,106,51,51,23,3.207475581757835,28
2224,15,18,20,8,3.2047440335755613,10
2225,106,28,17,11,3.2039846830051117,17
2226,7,93,86,40,3.2025353891099297,53
2227,100,22,34,11,3.2008994723402293,11
2228,36,41,39,18,3.1998605067578225,23
2229,88,61,5,29,3.1946532218196624,32
2230,37,54,50,26,3.188335276013606,28
2231,54,31,114,15,3.1847921316014234,16
2232,100,21,50,9,3.182484639829971,12
2233,30,29,11,13,3.1818482711889744,16
2234,72,14,47,7,3.1816598855809173,7
2235,103,16,69,8,3.1785957104061198,8
2236,74,12,30,6,3.175828716417199,6
2237,57,39,51,18,3.1757178835501545,21
2238,106,25,60,10,3.171261503808182,15
2239,11,28,3,12,3.170749513155223,16
2240,90,14,74,5,3.1680613510289204,9
2241,86,25,72,11,3.165324666924235,14
2242,86,21,82,9,3.1586560919846263,12
2243,104,51,7,23,3.158219418007504,28
2244,54,39,19,16,3.155838623626436,23
2245,75,23,23,12,3.1487336010920157,11
2246,112,12,45,6,3.1460936650177542,6
2247,76,15,2,6,3.1350168634931235,9
2248,51,15,61,5,3.1232056571511686,10
2249,34,26,11,11,3.1224893996672787,15
2250,43,42,94,19,3.1211209425263533,23
2251,36,11,80,5,3.115857421175661,6
2252,25,25,17,11,3.1106502600539105,14
2253,50,24,4,12,3.110559237136959,12
2254,111,21,86,9,3.103761182763341,12
2255,29,38,87,16,3.1016615879853475,22
2256,92,15,60,6,3.101629065738582,9
2257,74,13,27,7,3.1002755903304404,6
2258,99,14,68,6,3.1001036150844663,8
2259,88,16,74,6,3.100015176246556,10
2260,64,10,91,4,3.0993479020870796,6
2261,85,10,109,3,3.095406882310695,7
2262,6,17,27,8,3.094787186521294,9
2263,13,91,107,42,3.0922668849055963,49
2264,51,22,96,10,3.0911457625040346,12
2265,107,59,37,27,3.0878586600356255,32
2266,76,35,87,15,3.0781518481988153,20
2267,19,29,60,14,3.0741844930514626,15
2268,57,12,95,4,3.0723044699630684,8
2269,75,30,25,13,3.069551733540898,17
2270,71,18,25,8,3.0644100067848146,10
2271,60,34,41,17,3.06259969646343,17
2272,71,42,86,20,3.060669361739169,22
2273,6,11,57,5,3.0567504666964656,6
2274,10,17,8,7,3.0558998323304003,10
2275,78,32,60,15,3.0527314456618035,17
2276,15,37,107,14,3.0494114346230567,23
2277,38,13,96,6,3.0422152322461717,7
2278,68,30,12,14,3.041358769608483,16
2279,25,39,65,16,3.0368934823131175,23
2280,39,13,98,5,3.03323231697735,8
2281,40,17,33,6,3.0217035797006933,11
2282,47,29,88,14,3.0208806441241434,15
2283,98,10,30,5,3.0203430373274287,5
2284,76,26,102,11,3.0198988245621554,15
2285,30,20,48,8,3.014647330297821,12
2286,9,43,39,21,3.012148514540607,22
2287,20,47,37,22,3.004985214474966,25
2288,96,14,34,6,3.0017630147825622,8
2289,4,11,69,5,2.999484176661719,6
2290,62,27,65,13,2.999159330673646,14
2291,23,22,12,10,2.99823920673762,12
2292,86,47,90,20,2.997206734082279,27
2293,76,33,49,15,2.991297986979845,18
2294,114,11,34,6,2.9884829411181797,5
2295,88,31,3,14,2.986294279818389,17
2296,80,15,48,6,2.985401033694241,9
2297,46,13,1,7,2.97710684527845,6
2298,84,36,106,18,2.9754739608250116,18
2299,36,32,4,13,2.9739066740354185,19
2300,2,21,37,10,2.9697580112694486,11
2301,26,10,17,5,2.965521786469379,5
2302,25,18,57,8,2.964934950553875,10
2303,114,23,46,10,2.9631435316072405,13
2304,60,51,86,23,2.958155015888653,28
2305,6,18,87,8,2.9548534484805398,10
2306,29,15,43,7,2.9535515101680896,8
2307,54,19,29,8,2.9499144478753014,11
2308,17,29,49,15,2.9496843975083924,14
2309,18,37,87,16,2.947620136311876,21
2310,71,18,46,9,2.944852774193542,9
2311,72,10,9,5,2.940516873871124,5
2312,83,27,65,13,2.938404758323202,14
2313,68,27,49,12,2.936319937393299,15
2314,36,20,87,8,2.935573250897663,12
2315,33,21,28,11,2.9340033560517895,10
2316,88,25,78,11,2.9333918667099628,14
2317,9,12,66,6,2.9315079085260156,6
2318,12,18,40,9,2.9302897037093327,9
2319,3,10,33,4,2.9276582214647853,6
2320,1,14,62,7,2.9215215839903848,7
2321,104,32,109,15,2.9214017982197693,17
2322,74,82,86,39,2.921287780715151,43
2323,102,19,106,10,2.9207255392565097,9
2324,37,10,33,4,2.9157377490462175,6
2325,25,12,108,5,2.9132670669268244,7
2326,86,100,28,44,2.9116733038896876,56
2327,80,36,54,18,2.9116630961094696,18
2328,91,19,37,9,2.9050960547005245,10
2329,70,31,51,15,2.904546585958992,16
2330,50,27,9,12,2.8991061521351407,15
2331,44,10,70,5,2.8975248911261433,5
2332,50,17,89,7,2.8953311273035705,10
2333,11,27,43,13,2.889899285402211,14
2334,16,139,51,65,2.886532733555119,74
2335,83,23,87,11,2.8800534941463094,12
2336,106,14,77,7,2.8755893681261506,7
2337,75,21,30,10,2.8743282279457354,11
2338,57,12,53,6,2.8739584447786424,6
2339,112,14,1,5,2.872325056767924,9
2340,88,10,17,6,2.869337502995377,4
2341,46,23,63,12,2.867241869896345,11
2342,72,14,88,6,2.8660882603566415,8
2343,69,25,28,12,2.86191295640514,13
2344,88,15,94,8,2.8588031686479414,7
2345,109,21,3,10,2.8572484191290477,11
2346,79,10,49,4,2.8563921563379937,6
2347,74,11,43,6,2.853777373816176,5
2348,73,16,96,7,2.8534303980093814,9
2349,3,21,61,7,2.8504924308729236,14
2350,97,13,33,6,2.8486496222061595,7
2351,28,13,44,7,2.8461398630992765,6
2352,8,25,102,12,2.8455510764088037,13
2353,95,33,39,15,2.841495525954098,18
2354,4,25,16,13,2.8411046840521443,12
2355,107,51,106,24,2.8408623146416327,27
2356,28,28,17,13,2.836983407123188,15
2357,78,21,43,9,2.8365700958138986,12
2358,39,11,35,5,2.836154761931759,6
2359,30,41,49,18,2.8331832725913193,23
2360,53,23,81,10,2.832269045840245,13
2361,114,61,86,29,2.8307983943039856,32
2362,107,49,9,24,2.8292011367922663,25
2363,2,44,50,20,2.824465738990298,24
2364,75,21,112,9,2.824219405034075,12
2365,54,18,62,8,2.824080555827827,10
2366,18,13,71,6,2.821320109059578,7
2367,68,14,48,7,2.8206443314688054,7
2368,34,18,39,9,2.816812397698094,9
2369,1,32,36,16,2.8095303452930684,16
2370,46,26,76,12,2.809518783996083,14
2371,99,15,41,7,2.8081672918617278,8
2372,20,11,72,5,2.807407936668827,6
2373,106,14,112,7,2.805082024542767,7
2374,83,32,8,16,2.795775595052067,16
2375,68,14,44,7,2.7953277213928303,7
2376,7,26,1,12,2.7932054952385035,14
2377,100,13,36,6,2.7923934619121087,7
2378,70,12,102,7,2.7906887378625402,5
2379,85,14,112,6,2.7888570708398026,8
2380,51,58,41,27,2.7880359032469983,31
2381,28,31,91,14,2.785819668061851,17
2382,77,11,103,5,2.7849069943634923,6
2383,49,43,19,20,2.774345326212919,23
2384,5,11,10,6,2.7716738654503197,5
2385,5,17,77,8,2.765837567194589,9
2386,1,17,94,9,2.762381009801199,8
2387,97,34,96,17,2.7556888339056806,17
2388,70,14,43,6,2.753352748891417,8
2389,43,36,65,18,2.7525986025329345,18
2390,16,45,62,18,2.7487915093897555,27
2391,69,31,68,14,2.743936079051885,17
2392,97,22,104,11,2.7396377781056174,11
2393,99,12,63,6,2.7377253409939364,6
2394,47,21,63,11,2.7370968886641944,10
2395,65,50,106,23,2.735321183024918,27
2396,15,25,54,13,2.735147263925595,12
2397,107,35,112,17,2.734188301207242,18
2398,51,22,98,10,2.7293697926794462,12
2399,81,18,27,8,2.728809971625027,10
2400,44,16,88,8,2.7255415222047024,8
2401,58,17,51,8,2.722040354038644,9
2402,41,19,54,9,2.720244948724289,10
2403,95,11,80,5,2.7197438471090796,6
2404,77,22,87,10,2.7188951372091026,12
2405,49,13,33,5,2.7186925494377565,8
2406,63,20,4,9,2.717031964261833,11
2407,49,16,70,8,2.713121422106841,8
2408,43,39,60,18,2.711882588615369,21
2409,90,14,33,6,2.70862298496318,8
2410,87,62,54,27,2.7078927354800784,35
2411,39,11,79,4,2.7039365709334446,7
2412,70,30,76,15,2.700930448558258,15
2413,47,27,68,12,2.7008094429751086,15
2414,12,37,3,16,2.6999409236974614,21
2415,9,17,30,7,2.6960180413408095,10
2416,87,22,31,11,2.6915087275033076,11
2417,13,20,102,8,2.6891186576501753,12
2418,65,40,71,17,2.686780335165667,23
2419,28,26,30,13,2.6864332481864475,13
2420,43,14,58,6,2.6806335210316137,8
2421,39,25,5,12,2.679132217269287,13
2422,60,66,88,29,2.676500890728166,37
2423,78,18,94,8,2.675832304313798,10
2424,48,10,12,4,2.6757754483893885,6
2425,25,17,44,8,2.673535476281759,9
2426,13,118,7,55,2.670897317194474,63
2427,41,29,1,12,2.6671220598664953,17
2428,74,13,91,6,2.658254293210725,7
2429,11,33,20,14,2.6580258548377698,19
2430,40,24,27,13,2.656317602946661,11
2431,51,13,89,6,2.656220632059645,7
2432,92,29,88,13,2.6541256559252315,16
2433,57,13,36,5,2.6531160901053807,8
2434,19,20,20,10,2.6469332931574003,10
2435,54,32,102,15,2.64556958210047,17
2436,16,60,5,25,2.6435184456824317,35
2437,100,24,69,11,2.641711217702834,13
2438,13,40,11,18,2.637307973213511,22
2439,110,13,54,6,2.63588490299345,7
2440,91,36,86,17,2.627461430980282,19
2441,23,33,8,15,2.626483448480395,18
2442,8,10,85,4,2.6233679922969846,6
2443,39,42,28,20,2.6233394077803616,22
2444,39,10,89,4,2.6189716831037586,6
2445,75,28,64,13,2.6143964254367047,15
2446,94,33,107,13,2.613370215138467,20
2447,40,29,1,13,2.608102727316189,16
2448,43,39,19,18,2.603005615202756,21
2449,36,23,91,10,2.600483205457648,13
2450,86,124,87,61,2.5999036840085092,63
2451,43,15,103,6,2.598864943032298,9
2452,65,32,80,15,2.598635692200407,17
2453,41,44,27,19,2.596716183086402,25
2454,1,10,109,5,2.5929606771402254,5
2455,86,33,18,14,2.5923706641316473,19
2456,16,42,48,20,2.585222263767632,22
2457,41,20,29,9,2.5826644120051876,11
2458,33,15,88,6,2.5811780228440964,9
2459,50,22,112,9,2.578275791966445,13
2460,62,10,47,4,2.5775304802735826,6
2461,78,14,109,7,2.5746481317517187,7
2462,1,29,51,14,2.5741193049184687,15
2463,27,14,61,7,2.57284080053487,7
2464,21,10,65,4,2.5701476719258265,6
2465,43,34,7,14,2.561547699430643,20
2466,16,71,68,30,2.561472821191339,41
2467,88,25,38,10,2.560016870827125,15
2468,90,10,43,5,2.5580681557920104,5
2469,86,14,14,7,2.5565201304900333,7
2470,7,21,11,9,2.554018943860651,12
2471,73,19,1,8,2.55342910039073,11
2472,16,33,47,15,2.5520888385498686,18
2473,47,12,30,7,2.551854085041667,5
2474,44,14,76,6,2.5504141931433355,8
2475,7,74,36,34,2.5493587507973596,40
2476,60,22,38,11,2.544970231368338,11
2477,77,14,95,7,2.54103355873523,7
2478,97,35,65,16,2.5397394280205696,19
2479,41,24,43,11,2.539235483156344,13
2480,20,20,95,9,2.532527406942274,11
2481,7,29,17,13,2.532089441361392,16
2482,44,15,107,7,2.530544567099409,8
2483,99,19,30,8,2.530388293684779,11
2484,36,33,9,15,2.5279240780374668,18
2485,39,18,4,8,2.5267698999647226,10
2486,14,17,11,7,2.5264878637219237,10
2487,57,35,39,17,2.520423465219732,18
2488,12,15,36,7,2.516319942513749,8
2489,86,42,78,20,2.5078833022467655,22
2490,37,18,109,8,2.501013404341532,10
2491,84,13,67,7,2.500709874534183,6
2492,57,17,20,8,2.498936131760151,9
2493,65,37,111,16,2.496427849114077,21
2494,34,44,107,19,2.4944218711973374,25
2495,88,43,109,18,2.493468216162424,25
2496,64,21,11,8,2.490493863054093,13
2497,18,11,111,5,2.4899108726358863,6
2498,16,35,29,17,2.483874524711147,18
2499,19,23,77,11,2.4816175382976247,12
2500,17,20,20,9,2.47595507024807,11
2501,30,11,72,5,2.4724333071348408,6
2502,30,17,103,7,2.4703689712282215,10
2503,4,17,81,7,2.4678124777063273,10
2504,74,17,69,9,2.4664972820824542,8
2505,17,17,1,8,2.462761073509877,9
2506,102,32,25,15,2.4608896969250456,17
2507,110,17,86,8,2.45971246028376,9
2508,8,53,51,25,2.4557729112904,28
2509,63,15,61,6,2.4454100802634517,9
2510,32,10,50,6,2.444054190716271,4
2511,8,30,27,14,2.442573328602831,16
2512,64,15,47,6,2.4412017315333236,9
2513,109,24,102,11,2.437458896467388,13
2514,14,19,51,7,2.4338441230915158,12
2515,16,54,23,25,2.4326142049861326,29
2516,91,20,75,13,2.432369433261267,7
2517,8,17,38,8,2.427267079299572,9
2518,87,86,65,40,2.426351359029445,46
2519,88,56,9,26,2.4233671798250107,30
2520,55,23,4,11,2.4222288362060125,12
2521,60,68,77,32,2.421821816507846,36
2522,109,11,99,5,2.4195174025010595,6
2523,108,28,86,12,2.416374005048123,16
2524,28,19,94,8,2.414960475317553,11
2525,60,28,28,15,2.4122250218340917,13
2526,65,11,92,5,2.4112859752548714,6
2527,8,33,93,16,2.4111455321691304,17
2528,78,46,16,21,2.4095230161360504,25
2529,107,117,86,54,2.409383648607946,63
2530,106,13,66,5,2.4075033563299866,8
2531,9,18,69,8,2.405000245398061,10
2532,20,26,80,12,2.4033351571638564,14
2533,114,15,98,7,2.3992721750256902,8
2534,46,38,28,16,2.3990178798165633,22
2535,97,21,109,10,2.398141101921526,11
2536,20,37,51,19,2.3967661114188874,18
2537,16,22,45,9,2.3925466679441416,13
2538,23,13,48,6,2.3894452247322273,7
2539,104,40,95,18,2.3890342183876085,22
2540,4,21,71,8,2.3871750117365993,13
2541,96,25,104,11,2.3866419839158346,14
2542,75,13,56,5,2.3840139649043497,8
2543,88,35,18,17,2.3825741558006097,18
2544,8,14,112,6,2.3798297239108352,8
2545,78,11,79,5,2.3765297335861715,6
2546,71,40,107,17,2.3760609676092463,23
2547,49,29,12,17,2.3757535970577623,12
2548,53,31,55,14,2.3720895326624127,17
2549,25,32,63,16,2.3688265373602615,16
2550,40,24,50,10,2.3671440474550507,14
2551,49,13,97,5,2.366826181424206,8
2552,99,23,5,11,2.3616219022642833,12
2553,64,44,88,19,2.3590830036125556,25
2554,100,14,97,6,2.3583259709010775,8
2555,96,14,109,6,2.3566759619593642,8
2556,99,12,33,5,2.354570382478157,7
2557,4,36,31,15,2.3535355966794667,21
2558,16,50,43,22,2.3507433165143348,28
2559,114,12,38,6,2.341526377437994,6
2560,6,13,50,6,2.3414923323310646,7
2561,90,19,17,10,2.330539928781357,9
2562,25,28,53,14,2.3301510854690854,14
2563,109,51,5,25,2.3285813949081655,26
2564,72,10,42,4,2.3285230567907305,6
2565,77,21,88,10,2.324899205812,11
2566,104,21,102,11,2.320627297470276,10
2567,88,32,91,15,2.315767764685104,17
2568,71,31,63,14,2.311262987331465,17
2569,57,23,37,11,2.3105129908375908,12
2570,103,16,3,9,2.306139458514917,7
2571,60,26,95,12,2.300035058084817,14
2572,87,24,112,12,2.2999950950763304,12
2573,86,21,32,10,2.2989864902239003,11
2574,80,20,7,9,2.298668986127333,11
2575,100,24,5,11,2.2932427434044684,13
2576,86,38,112,17,2.2924646864380605,21
2577,106,13,4,7,2.287883468044352,6
2578,81,26,88,12,2.2857834835265285,14
2579,86,88,84,44,2.2844335131903772,44
2580,38,10,81,5,2.2819621266449914,5
2581,48,19,65,10,2.2816603054261093,9
2582,9,47,40,21,2.2806450266015683,26
2583,77,12,69,6,2.2797993708458963,6
2584,49,44,86,23,2.272809252757546,21
2585,16,29,108,12,2.2725919431060206,17
2586,7,108,68,50,2.2702884441480373,58
2587,61,10,31,5,2.2696136748473603,5
2588,86,84,8,42,2.2684162276686486,42
2589,28,66,96,31,2.267406944603933,35
2590,85,12,7,5,2.2672729351147445,7
2591,87,11,42,5,2.2670677132557686,6
2592,106,45,88,19,2.2639858690375614,26
2593,87,62,106,30,2.2622041017840115,32
2594,65,89,107,42,2.2617794598126375,47
2595,74,13,41,7,2.254565024803335,6
2596,95,30,25,14,2.25397314365567,16
2597,63,11,83,4,2.2518527555221,7
2598,87,36,69,15,2.246850810864759,21
2599,88,38,4,18,2.2459217004175493,20
2600,70,10,27,5,2.243263258457552,5
2601,104,65,13,30,2.2428038741485183,35
2602,64,21,49,9,2.2416010602386143,12
2603,8,89,55,44,2.240032474519914,45
2604,68,61,107,30,2.2392858218745855,31
2605,27,17,48,7,2.2349641271706275,10
2606,4,26,114,13,2.234564836857367,13
2607,18,14,20,6,2.2334528603958916,8
2608,46,18,65,7,2.232998478058102,11
2609,68,107,13,50,2.226955311742634,57
2610,90,16,25,7,2.2261576936837058,9
2611,75,43,39,22,2.2252173665323527,21
2612,112,11,12,6,2.2247336886150633,5
2613,98,13,99,7,2.2212581677933785,6
2614,18,14,98,8,2.221147797140808,6
2615,29,35,107,13,2.217736121602627,22
2616,72,11,62,5,2.217469660829094,6
2617,93,12,51,6,2.2166321429168523,6
2618,5,50,96,22,2.2114271922507607,28
2619,17,32,39,14,2.206086386357858,18
2620,75,27,27,12,2.203651126537084,15
2621,96,10,49,5,2.2013596017058843,5
2622,104,72,16,33,2.198861242302897,39
2623,7,75,40,33,2.1957521283064803,42
2624,8,60,11,28,2.1947518664362273,32
2625,68,35,106,16,2.1936858069827965,19
2626,41,33,40,16,2.1935807772699496,17
2627,72,12,43,5,2.1927570530466096,7
2628,19,13,47,6,2.1915786077930712,7
2629,86,33,12,15,2.1894855932114767,18
2630,31,10,54,5,2.186668926147148,5
2631,8,64,74,28,2.186622040651489,36
2632,58,17,3,7,2.1750406456469484,10
2633,84,16,93,8,2.173203038685072,8
2634,41,46,68,22,2.171804807510051,24
2635,60,30,81,14,2.1697382345262226,16
2636,19,32,94,15,2.165510462778429,17
2637,23,13,53,6,2.1639220781507627,7
2638,55,16,98,7,2.1617935333932947,9
2639,6,14,86,6,2.158350497876564,8
2640,89,11,49,5,2.155221325127322,6
2641,55,11,69,5,2.141856565606557,6
2642,71,39,39,18,2.140211900940766,21
2643,102,22,74,10,2.1384304011801047,12
2644,7,20,30,11,2.1356884749054443,9
2645,11,30,74,14,2.1347610080309107,16
2646,2,12,61,5,2.1331085158076015,7
2647,102,32,114,14,2.124084287601509,18
2648,7,62,9,31,2.12190310948229,31
2649,49,24,63,12,2.1212323385530327,12
2650,53,11,70,5,2.117480208536356,6
2651,7,17,72,8,2.1143024060967655,9
2652,69,11,25,5,2.1120597510852464,6
2653,57,38,13,19,2.1070868819342965,19
2654,68,28,94,13,2.1065110625469545,15
2655,108,32,107,15,2.1055805043927105,17
2656,112,19,23,8,2.1018527652621173,11
2657,84,18,79,9,2.0988599029371873,9
2658,83,34,55,17,2.0962093979720215,17
2659,97,22,8,11,2.094799206270941,11
2660,17,12,91,5,2.0932516032559634,7
2661,54,74,8,32,2.0896219581372892,42
2662,40,18,11,9,2.089442100461012,9
2663,64,43,68,18,2.086424402801588,25
2664,15,49,39,21,2.085527392017013,28
2665,44,14,51,5,2.084874228955972,9
2666,74,47,65,23,2.0847963525870914,24
2667,82,10,63,5,2.077975861296688,5
2668,17,32,34,16,2.061414706570037,16
2669,39,43,104,20,2.0501021472527095,23
2670,93,21,88,9,2.047097578055209,12
2671,114,63,88,30,2.046831677278045,33
2672,37,21,100,9,2.035973234211067,12
2673,40,59,88,27,2.0357313010299647,32
2674,83,13,50,7,2.034563553464953,6
2675,104,21,17,10,2.0345116655508866,11
2676,8,41,104,19,2.032634893277435,22
2677,112,11,34,5,2.0324399383154272,6
2678,33,25,13,12,2.031483396821484,13
2679,91,14,114,7,2.0312426341433967,7
2680,39,33,12,15,2.0291858494857125,18
2681,32,11,13,5,2.026181507027534,6
2682,50,53,107,26,2.025793662275193,27
2683,114,27,17,11,2.0211590753648707,16
2684,8,37,90,16,2.0194647820717804,21
2685,93,11,60,4,2.018629631632218,7
2686,69,14,37,7,2.015512849900141,7
2687,68,29,70,14,2.0151181581046385,15
2688,23,47,86,22,2.0116860012086675,25
2689,15,23,30,11,2.0093044010429217,12
2690,6,10,100,5,2.0077049362027837,5
2691,83,22,97,12,2.007636873207567,10
2692,68,26,46,12,2.0015169846627185,14
2693,75,32,87,15,2.0004298974911783,17
2694,87,56,11,24,2.000245875012726,32
2695,66,11,27,5,1.9992664520674261,6
2696,114,26,74,13,1.9975972531686872,13
2697,34,11,22,5,1.9956328574207176,6
2698,104,15,112,7,1.99393597279257,8
2699,85,15,88,7,1.992964557457929,8
2700,28,16,15,8,1.9904779382853452,8
2701,12,23,11,12,1.9877128155591925,11
2702,53,19,4,9,1.987694792892671,10
2703,30,15,4,7,1.9875071363114756,8
2704,28,38,25,16,1.9833898911599184,22
2705,3,20,18,8,1.9827434721081498,12
2706,95,28,53,11,1.9769373995573185,17
2707,88,31,70,14,1.9762934359596283,17
2708,39,46,3,23,1.973168826489564,23
2709,28,17,78,9,1.9711388035219528,8
2710,54,10,35,4,1.9706076038783524,6
2711,72,36,16,16,1.9684192720116822,20
2712,16,49,70,22,1.9664047334731982,27
2713,41,24,112,11,1.9642201479007217,13
2714,87,42,84,19,1.9615694257244276,23
2715,39,14,33,7,1.9600955952261434,7
2716,50,11,35,5,1.9581460146246747,6
2717,51,34,43,17,1.9576260367562015,17
2718,27,34,57,17,1.9534766566361748,17
2719,36,34,64,17,1.9485056781764598,17
2720,7,16,48,8,1.9478692265013036,8
2721,33,15,94,7,1.9451389474962026,8
2722,25,20,55,9,1.9429576796619945,11
2723,23,14,31,6,1.9392936999416424,8
2724,110,13,104,5,1.9388474450810558,8
2725,71,49,7,25,1.9387153694352777,24
2726,32,10,98,5,1.9380052263831626,5
2727,23,14,97,7,1.9330528734436567,7
2728,54,103,65,49,1.9285945616026123,54
2729,70,19,40,8,1.9276789997691202,11
2730,17,28,54,14,1.9259736473512523,14
2731,16,89,28,41,1.923978729516393,48
2732,114,21,18,10,1.923577249757446,11
2733,63,40,50,18,1.9230864117365438,22
2734,9,10,79,4,1.9224211679655938,6
2735,104,32,70,15,1.9224071285610203,17
2736,55,56,88,24,1.9221308051774735,32
2737,98,18,100,8,1.9217645875630163,10
2738,53,43,64,20,1.921457820047301,23
2739,99,11,76,6,1.9173589523208343,5
2740,97,32,106,16,1.9159665785715099,16
2741,110,11,17,5,1.9155371371930665,6
2742,88,67,68,31,1.9148855278527728,36
2743,68,38,1,18,1.9099752765436664,20
2744,13,20,96,9,1.909192933945374,11
2745,8,67,28,31,1.9053784571291423,36
2746,55,27,99,12,1.8950724021518552,15
2747,20,35,106,16,1.890590591428699,19
2748,25,23,64,11,1.8857238852847684,12
2749,96,16,30,7,1.885074878690488,9
2750,2,41,8,20,1.8848654476169697,21
2751,29,33,27,14,1.878072452286703,19
2752,60,19,48,9,1.868377497336698,10
2753,37,95,5,46,1.8654288703425719,49
2754,43,21,114,11,1.8643335671695769,10
2755,13,20,61,8,1.8534850314433566,12
2756,11,42,54,20,1.8528374886785275,22
2757,53,22,97,10,1.849246682219108,12
2758,8,24,3,13,1.8480935801495006,11
2759,30,27,76,12,1.8425803619698342,15
2760,103,23,51,11,1.8411846957244378,12
2761,114,30,20,14,1.8395405662544742,16
2762,84,38,96,19,1.8356486827006797,19
2763,74,29,13,14,1.8278354237299064,15
2764,11,15,114,8,1.8276036019184323,7
2765,44,13,114,6,1.8263733365516701,7
2766,102,13,99,6,1.8212893413036875,7
2767,40,18,111,9,1.8104998545748818,9
2768,13,32,112,16,1.80903940686547,16
2769,36,22,25,11,1.8071440138268557,11
2770,70,57,86,26,1.8046372203949772,31
2771,89,16,86,9,1.8045740019354723,7
2772,51,34,31,14,1.8036645224364214,20
2773,18,32,41,16,1.8004819942826358,16
2774,112,50,16,24,1.7995643538534818,26
2775,63,10,103,4,1.799391808148132,6
2776,88,55,104,25,1.7934662263443764,30
2777,114,35,39,18,1.7909993968165117,17
2778,54,77,16,37,1.7894100662362948,40
2779,20,19,48,8,1.7888857426975076,11
2780,97,27,46,13,1.7888516310768017,14
2781,61,13,100,6,1.7880372053867657,7
2782,29,20,8,8,1.7818268121537417,12
2783,37,25,90,12,1.7816453937181782,13
2784,50,21,69,11,1.7758250016074648,10
2785,11,59,46,28,1.771019448583436,31
2786,68,18,43,9,1.7652060939878154,9
2787,88,11,110,6,1.7642228121429866,5
2788,78,45,57,21,1.7583662843402377,24
2789,84,26,70,12,1.7530345342228948,14
2790,104,21,43,9,1.750605109142023,12
2791,11,29,60,13,1.7486537890116287,16
2792,27,68,107,31,1.7445937022008349,37
2793,60,33,36,16,1.7416473627060747,17
2794,18,11,6,5,1.7414584600944751,6
2795,36,37,88,16,1.7392851936744347,21
2796,12,17,34,8,1.7370731920288973,9
2797,16,27,44,12,1.7334648777380295,15
2798,106,38,96,17,1.7318320126651918,21
2799,70,19,75,10,1.7314858975507377,9
2800,32,13,68,5,1.731166259808923,8
2801,77,10,28,5,1.727447904471638,5
2802,17,35,107,17,1.7269738989467152,18
2803,63,15,45,7,1.7260545689947924,8
2804,98,31,107,15,1.7124892646076504,16
2805,62,28,71,14,1.710784794078352,14
2806,48,10,37,5,1.7035937503192145,5
2807,85,15,57,7,1.7034495534090748,8
2808,20,16,102,8,1.6989391239814933,8
2809,36,15,23,9,1.6972875274185721,6
2810,3,63,51,32,1.6935910709708697,31
2811,28,64,5,31,1.6933141899778523,33
2812,88,59,28,27,1.6917395122237935,32
2813,47,29,51,15,1.6857225925039412,14
2814,55,40,106,18,1.6835382667235006,22
2815,17,18,64,8,1.6742261514283443,10
2816,63,45,7,18,1.6735738766299244,27
2817,45,28,31,13,1.6710870406691087,15
2818,17,17,112,8,1.6709980493790115,9
2819,87,48,60,24,1.6692465502528926,24
2820,54,19,33,8,1.668385392549265,11
2821,81,16,9,8,1.667141681490912,8
2822,85,16,17,7,1.6640468368595829,9
2823,88,77,107,35,1.6629099189655516,42
2824,37,47,74,23,1.6628163329711263,24
2825,36,23,68,11,1.6511686348202657,12
2826,86,14,66,7,1.6453880931803613,7
2827,86,34,38,16,1.64225948399023,18
2828,30,41,68,20,1.6397998764136266,21
2829,41,59,88,27,1.6397874376242199,32
2830,102,10,49,4,1.6394569107680623,6
2831,6,18,68,10,1.6346986227731553,8
2832,35,28,86,12,1.6302927109086067,16
2833,13,31,72,16,1.6241775993144327,15
2834,44,17,87,8,1.6239279411647842,9
2835,51,12,66,6,1.6170702618301573,6
2836,81,19,18,9,1.6163568658399623,10
2837,38,32,13,17,1.614314899085523,15
2838,30,29,69,14,1.613902271093239,15
2839,28,20,79,10,1.604902001664568,10
2840,18,33,60,16,1.596771934301811,17
2841,14,11,75,5,1.5947210222856318,6
2842,58,15,19,7,1.5924855336204529,8
2843,49,23,62,10,1.5851399264471633,13
2844,2,15,25,8,1.5845186001024008,7
2845,88,20,61,8,1.581947887543261,12
2846,58,12,100,6,1.5819008855655043,6
2847,55,22,90,12,1.578656952498874,10
2848,68,26,17,12,1.5761968862643292,14
2849,96,34,88,17,1.5755489762598085,17
2850,60,25,46,12,1.5735893742532674,13
2851,85,17,100,8,1.5724753567461298,9
2852,63,43,41,20,1.5704593108021436,23
2853,30,27,78,13,1.569607458561735,14
2854,50,16,12,10,1.5648641628940967,6
2855,9,14,111,7,1.5621342613374551,7
2856,109,26,106,13,1.562107287891286,13
2857,16,119,13,54,1.5620853320839594,65
2858,64,19,15,10,1.5585187752284797,9
2859,104,23,83,10,1.5563880557352996,13
2860,54,35,30,17,1.556335080451803,18
2861,75,44,55,19,1.5547955200380577,25
2862,80,20,11,10,1.553265227546683,10
2863,27,33,43,16,1.5525087019998642,17
2864,87,41,74,19,1.54873499555014,22
2865,57,25,102,12,1.5483760769806836,13
2866,50,46,11,22,1.543099478793574,24
2867,94,21,11,11,1.5369194320927215,10
2868,29,13,53,5,1.5317670028644748,8
2869,15,39,65,18,1.5316741612776013,21
2870,64,15,81,7,1.5315551836921653,8
2871,114,20,84,9,1.5282826629009798,11
2872,68,72,27,34,1.524949709281463,38
2873,3,17,76,8,1.5249357900982525,9
2874,35,14,37,7,1.523131742310598,7
2875,27,26,62,13,1.5182408665379923,13
2876,12,16,85,8,1.5174687419154698,8
2877,46,12,55,5,1.5148590180899557,7
2878,30,37,8,17,1.5081255824989244,20
2879,64,29,27,14,1.5066564848276938,15
2880,33,28,16,15,1.5061133339188528,13
2881,15,44,86,21,1.4999058240445284,23
2882,17,31,50,16,1.4997072054884293,15
2883,9,34,63,16,1.4983458266579124,18
2884,46,52,5,24,1.4974094901037487,28
2885,107,47,25,23,1.4967278623744356,24
2886,112,16,11,8,1.4950492246382476,8
2887,15,49,16,25,1.4933540884816012,24
2888,76,17,62,8,1.4886483429037691,9
2889,60,74,71,35,1.4843115108657077,39
2890,68,10,84,4,1.478899377350919,6
2891,109,20,69,10,1.4769023355605444,10
2892,103,17,79,8,1.4762996181953612,9
2893,73,15,63,8,1.4760785674332926,7
2894,106,20,43,10,1.4741650546799518,10
2895,11,17,32,9,1.4729852723414754,8
2896,35,24,7,12,1.4676220715119421,12
2897,6,13,69,7,1.4672562795661186,6
2898,71,24,3,11,1.4668209780059585,13
2899,40,64,51,31,1.4624658901194145,33
2900,31,21,47,10,1.4606130980712668,11
2901,25,23,83,10,1.4597201880554966,13
2902,39,73,13,34,1.450285772990473,39
2903,106,55,63,27,1.4485566818099482,28
2904,39,21,48,9,1.4474709554841443,12
2905,39,29,62,13,1.4474002147033354,16
2906,65,33,69,16,1.4425642416495132,17
2907,20,21,97,11,1.439527960881874,10
2908,50,28,25,14,1.4391705454909012,14
2909,36,35,45,19,1.423273124508123,16
2910,71,23,55,12,1.4219584840110406,11
2911,1,11,53,5,1.4196819324858228,6
2912,16,35,90,18,1.4190191744987382,17
2913,66,11,72,5,1.416761062195627,6
2914,100,29,62,15,1.4095954922785312,14
2915,12,20,71,10,1.4059148964814159,10
2916,46,25,9,13,1.4052752923291358,12
2917,87,36,64,18,1.4019068150674154,18
2918,70,17,95,9,1.4011695857654913,8
2919,75,12,44,5,1.399837377533035,7
2920,91,13,9,6,1.3946381880594532,7
2921,36,11,29,6,1.3837445576600587,5
2922,87,61,3,29,1.3817700433345628,32
2923,95,31,7,14,1.3809406634768675,17
2924,106,30,41,15,1.3806292559177733,15
2925,55,15,62,7,1.3800432063216206,8
2926,39,51,41,26,1.3725005678823716,25
2927,86,66,55,31,1.371489773467497,35
2928,75,10,48,5,1.3711471542080278,5
2929,25,26,30,14,1.363384718034577,12
2930,112,12,74,6,1.3616749140437374,6
2931,111,17,87,8,1.3561671479223418,9
2932,30,14,81,7,1.3508923221630351,7
2933,97,37,88,18,1.349074362930903,19
2934,108,17,40,9,1.3479697301696818,8
2935,57,53,86,26,1.3474253453353369,27
2936,107,72,63,38,1.346860465088752,34
2937,34,25,84,12,1.346258750306376,13
2938,3,38,60,18,1.3412010919461754,20
2939,6,10,23,5,1.3385415186806262,5
2940,39,49,54,24,1.3384616724370861,25
2941,108,13,81,6,1.3379621241230502,7
2942,50,43,13,21,1.3366507520453896,22
2943,50,32,51,16,1.3326103812189878,16
2944,12,27,87,12,1.3278353834684422,15
2945,8,57,96,27,1.3267739850117202,30
2946,74,18,80,9,1.3199661328668575,9
2947,32,12,51,6,1.314434714983352,6
2948,94,11,40,5,1.313173008584519,6
2949,112,32,65,16,1.312297716343953,16
2950,65,38,17,16,1.3107276954105338,22
2951,68,52,9,25,1.3104638696206772,27
2952,9,28,58,13,1.310268135821902,15
2953,41,28,114,14,1.30733810804357,14
2954,84,11,64,4,1.3059634387921,7
2955,27,23,50,9,1.3046741995517444,14
2956,5,44,13,21,1.302350985374302,23
2957,27,10,58,5,1.3013979379700955,5
2958,77,28,18,12,1.2955025967533476,16
2959,7,22,8,10,1.29527150144924,12
2960,50,18,98,8,1.2936360808559426,10
2961,57,15,48,7,1.2933503211639665,8
2962,2,22,74,10,1.2925512141562505,12
2963,51,19,99,10,1.289208240710456,9
2964,89,17,88,9,1.2888997749635156,8
2965,16,53,74,25,1.2870673809929651,28
2966,88,22,35,11,1.2841130433589263,11
2967,96,59,107,27,1.2779661064945949,32
2968,17,12,80,5,1.2769817296361932,7
2969,107,38,90,19,1.2750427230775991,19
2970,71,11,1,6,1.2732152302328,5
2971,50,19,108,10,1.2701675761997318,9
2972,30,73,86,33,1.2699879441923037,40
2973,73,15,16,8,1.2607482082851333,7
2974,27,10,46,4,1.255099102534174,6
2975,8,40,100,19,1.2550832379425967,21
2976,63,27,70,13,1.2550372321498742,14
2977,17,11,62,5,1.2486647888480191,6
2978,108,16,55,7,1.2425126869095338,9
2979,107,30,4,15,1.2387516471106226,15
2980,71,25,31,12,1.2380158081615504,13
2981,63,16,95,8,1.233969730193377,8
2982,51,88,107,38,1.2335246266798188,50
2983,71,26,9,12,1.2262156519313812,14
2984,86,92,65,47,1.2239963595428645,45
2985,55,17,41,8,1.2209745250839965,9
2986,107,63,60,31,1.219424890458466,32
2987,98,11,74,5,1.2137114800422117,6
2988,58,16,63,9,1.211674081917942,7
2989,25,33,97,16,1.211209753293348,17
2990,107,31,85,15,1.1983111993424351,16
2991,25,67,16,32,1.1932865297100665,35
2992,48,12,41,6,1.1910839111619824,6
2993,88,36,37,17,1.188834543043674,19
2994,87,16,110,7,1.187803786715121,9
2995,76,31,96,14,1.1853039288193825,17
2996,8,26,48,12,1.176757496258483,14
2997,33,12,77,6,1.17566757355006,6
2998,39,52,55,24,1.1740266098053433,28
2999,65,108,63,52,1.162387515885531,56
3000,104,16,23,9,1.1585628201755833,7
3001,111,13,8,7,1.1570953689507386,6
3002,17,10,33,5,1.1464162819529036,5
3003,64,20,45,9,1.1431500338693237,11
3004,36,26,106,13,1.1307287364062801,13
3005,3,26,31,14,1.130409883055894,12
3006,29,21,11,10,1.1293738650195786,11
3007,69,28,19,13,1.1227446471060287,15
3008,27,13,18,7,1.1211992327384535,6
3009,29,19,7,7,1.1170674633929263,12
3010,33,19,86,10,1.112984453857345,9
3011,40,16,109,7,1.1126467638961715,9
3012,51,16,6,7,1.1096986250731455,9
3013,73,13,55,6,1.1082443575059586,7
3014,91,12,47,6,1.1047106963660296,6
3015,40,19,45,9,1.1043531225931202,10
3016,96,18,2,9,1.1039761816908797,9
3017,107,35,46,18,1.1031099530770954,17
3018,70,39,106,20,1.1024614638047308,19
3019,68,83,51,38,1.0958426568834045,45
3020,40,13,74,6,1.0901529369074687,7
3021,50,29,65,14,1.0876879077972634,15
3022,75,54,65,27,1.0834874610355825,27
3023,17,14,15,6,1.0815196129384674,8
3024,64,19,97,9,1.0748997556854092,10
3025,107,41,70,21,1.0723253683389224,20
3026,9,16,97,9,1.0715415510849842,7
3027,67,20,37,9,1.0707700527635258,11
3028,58,14,71,7,1.0679524363994282,7
3029,33,12,60,7,1.060667602361241,5
3030,100,14,44,7,1.0590413147864144,7
3031,80,17,8,9,1.0587286140181775,8
3032,30,24,18,12,1.0579199601112552,12
3033,87,72,88,37,1.053038045091939,35
3034,71,18,45,10,1.0500246166344394,8
3035,39,69,107,34,1.0492738159328645,35
3036,13,65,27,32,1.048528133752184,33
3037,4,60,13,28,1.0440840904331967,32
3038,112,13,77,5,1.044011084095806,8
3039,18,35,51,18,1.0414861976482428,17
3040,104,16,33,7,1.0375486456158112,9
3041,7,59,18,30,1.0365595161190129,29
3042,45,14,3,7,1.0349134798027078,7
3043,46,16,64,8,1.031017738027725,8
3044,2,33,97,16,1.0254110764857562,17
3045,51,53,37,23,1.0249339808072997,30
3046,63,20,44,9,1.0233184771026502,11
3047,107,41,18,22,1.0183255345448823,19
3048,8,92,107,47,1.0168882870821125,45
3049,57,13,60,6,1.0152034376280954,7
3050,87,52,28,26,1.0126365910584707,26
3051,85,32,86,15,1.0113399236982092,17
3052,45,12,88,5,1.0058195203591582,7
3053,13,43,75,20,1.005364432264769,23
3054,41,73,13,36,1.0052100802031876,37
3055,114,11,93,6,1.004990658958168,5
3056,37,37,17,16,0.9978108601802018,21
3057,43,33,88,15,0.9947945347929831,18
3058,20,13,27,6,0.9871413726704231,7
3059,69,32,107,15,0.9867318989974736,17
3060,16,56,57,26,0.9788591489024684,30
3061,68,15,102,7,0.9774478191416366,8
3062,107,65,5,32,0.9748363761521144,33
3063,78,12,9,6,0.9745877106891208,6
3064,63,52,87,24,0.9694664805604959,28
3065,15,20,63,10,0.9688742288483304,10
3066,64,15,57,7,0.9686108755747862,8
3067,76,31,50,13,0.9653541591978417,18
3068,104,38,106,19,0.9604760273979323,19
3069,106,11,103,6,0.9583580547252424,5
3070,14,14,5,6,0.9561035605846475,8
3071,63,23,53,11,0.9461903574638922,12
3072,8,51,39,26,0.9395633007628413,25
3073,18,29,40,12,0.9358054757186772,17
3074,78,43,107,20,0.9215347139145763,23
3075,86,14,113,6,0.9183338417210537,8
3076,75,27,114,13,0.9181862737012574,14
3077,106,100,86,49,0.9173221659807225,51
3078,15,38,68,17,0.9158662466441888,21
3079,39,14,1,5,0.9120351629887077,9
3080,36,35,75,19,0.9076169876586753,16
3081,109,19,49,9,0.9031267273973521,10
3082,112,11,14,6,0.9022319115654415,5
3083,60,12,111,7,0.9019980300500788,5
3084,62,14,50,6,0.9017457082495502,8
3085,78,17,55,9,0.9002458878614071,8
3086,68,17,74,7,0.9001065237726507,10
3087,87,55,55,27,0.8964696013179044,28
3088,3,30,69,16,0.8962278395321787,14
3089,39,24,70,11,0.8958543413772138,13
3090,27,46,30,22,0.8932623709811494,24
3091,86,74,39,38,0.8920235918545375,36
3092,27,63,51,30,0.8881383616064773,33
3093,9,50,86,23,0.8880878607383526,27
3094,93,13,3,5,0.8808947328421439,8
3095,83,21,88,11,0.8798897555023182,10
3096,17,40,13,20,0.877187739086127,20
3097,84,17,91,8,0.8755346549877653,9
3098,27,15,1,6,0.8721383199452174,9
3099,60,17,84,10,0.871614356489069,7
3100,8,67,37,33,0.8700084298071539,34
3101,10,10,114,4,0.8617397018011257,6
3102,87,42,109,19,0.8557093365192048,23
3103,77,14,64,8,0.8550421959375887,6
3104,19,29,86,15,0.8547184874040823,14
3105,41,12,38,5,0.8514389884122232,7
3106,65,38,11,19,0.8512591605271688,19
3107,39,13,102,6,0.8492100400200487,7
3108,33,15,95,7,0.8491128905949191,8
3109,60,14,98,7,0.8439389777307171,7
3110,8,78,88,38,0.8346650298713422,40
3111,2,16,46,8,0.8285194662826778,8
3112,88,54,49,26,0.8267825014615151,28
3113,29,12,106,6,0.8264692442725535,6
3114,28,48,37,24,0.8263140292594408,24
3115,13,107,65,51,0.8251358063632331,56
3116,84,15,95,7,0.8218033746912388,8
3117,50,67,54,33,0.8208738895797709,34
3118,114,19,45,9,0.8205689132017492,10
3119,7,80,41,40,0.8113607765595663,40
3120,7,16,79,8,0.808566327439515,8
3121,84,31,50,16,0.8064114901977948,15
3122,56,14,40,7,0.8062835825274064,7
3123,30,26,40,13,0.8045580871786187,13
3124,41,18,78,8,0.8039593627471284,10
3125,98,11,62,5,0.7995773049352667,6
3126,2,22,88,11,0.7956469041111237,11
3127,28,16,89,7,0.7901986413516635,9
3128,75,14,33,6,0.7900898585820654,8
3129,96,15,3,8,0.788360761162582,7
3130,80,15,38,8,0.7882565864146641,7
3131,4,18,104,10,0.7872554057904764,8
3132,48,20,109,9,0.7860713609857797,11
3133,13,51,28,25,0.7790491963091711,26
3134,87,22,99,10,0.7762165713325069,12
3135,88,32,69,15,0.7753807063240761,17
3136,16,40,40,19,0.7743017001677523,21
3137,10,19,84,9,0.7730240789929571,10
3138,97,20,93,10,0.7717644600090583,10
3139,58,15,50,8,0.7660630045931245,7
3140,28,58,109,27,0.76448490134667,31
3141,34,19,65,10,0.7628058558484428,9
3142,86,83,20,40,0.7625493429797969,43
3143,109,69,86,34,0.7613768961042882,35
3144,9,28,3,14,0.7589069260840979,14
3145,14,15,13,6,0.7511854242648525,9
3146,39,64,65,33,0.7504610739617342,31
3147,107,85,28,40,0.7466282052500216,45
3148,16,59,19,27,0.744807436678833,32
3149,46,24,84,11,0.744605770354001,13
3150,11,32,78,17,0.7439751541430462,15
3151,36,13,74,5,0.7437175733038444,8
3152,38,22,64,11,0.741675899909912,11
3153,37,27,84,13,0.7406944026942688,14
3154,7,12,108,5,0.7404080910313953,7
3155,25,24,15,13,0.7394428200536315,11
3156,50,43,106,22,0.7389423076340088,21
3157,76,37,11,17,0.7368187666821265,20
3158,5,40,63,22,0.7358500176759455,18
3159,40,77,86,36,0.7352757671814381,41
3160,9,22,112,10,0.732655126226577,12
3161,95,41,5,21,0.731606653431554,20
3162,33,13,27,6,0.7289108112107202,7
3163,27,13,99,7,0.7284055341482095,6
3164,71,10,96,5,0.7278695572627789,5
3165,57,10,4,4,0.7276499847388471,6
3166,46,63,88,32,0.7264738004913415,31
3167,8,24,17,12,0.7243993806611897,12
3168,34,21,79,9,0.7201940806784457,12
3169,61,18,40,9,0.7154895706830828,9
3170,82,13,28,7,0.7153587234866209,6
3171,43,18,71,10,0.7122285277146704,8
3172,51,37,12,18,0.710191678656004,19
3173,97,13,3,6,0.7099885191404639,7
3174,106,18,27,7,0.7074485049679566,11
3175,94,23,29,11,0.7057962050625214,12
3176,55,64,51,31,0.7052787365416379,33
3177,103,25,87,11,0.7049312985026179,14
3178,63,49,11,21,0.7041449631736957,28
3179,47,23,65,11,0.7020951602660517,12
3180,38,11,91,5,0.7003822911270713,6
3181,61,11,39,6,0.6964131355147419,5
3182,3,30,43,14,0.6945065447681112,16
3183,11,17,93,10,0.6934063282822602,7
3184,68,69,86,35,0.6897584561737047,34
3185,88,17,48,7,0.6890250559346737,10
3186,8,30,76,14,0.6822031764790529,16
3187,18,19,25,10,0.6816652439852776,9
3188,109,14,23,7,0.6795387556597896,7
3189,79,16,3,9,0.6788187325928889,7
3190,50,39,39,19,0.6773303120820146,20
3191,29,13,79,5,0.67578388648967,8
3192,50,10,38,4,0.6752935140978018,6
3193,109,26,60,13,0.673756859043161,13
3194,109,19,77,10,0.6551340345633946,9
3195,63,32,78,15,0.651142744880651,17
3196,65,28,84,14,0.6478183306385065,14
3197,2,10,109,5,0.6444253237530958,5
3198,34,21,50,11,0.6437821636330864,10
3199,85,15,69,7,0.6408165415497267,8
3200,25,25,41,14,0.6394054706376684,11
3201,111,17,36,8,0.6365354853619557,9
3202,43,11,48,6,0.6335452834733647,5
3203,13,34,20,16,0.632497829596757,18
3204,4,28,64,13,0.6316212138641686,15
3205,87,30,47,15,0.6310013424305165,15
3206,60,23,1,11,0.6297573562891167,12
3207,38,20,29,10,0.6286324723530301,10
3208,109,30,84,14,0.6283430275726475,16
3209,65,40,37,21,0.6273579146862459,19
3210,54,42,74,21,0.6253470328077769,21
3211,36,33,71,17,0.6241330409639582,16
3212,39,45,47,21,0.62356950402588,24
3213,40,12,38,5,0.6179079194784384,7
3214,31,22,58,11,0.6168553703735019,11
3215,28,55,11,26,0.6161995497274562,29
3216,87,68,39,33,0.6125718981179333,35
3217,19,15,8,7,0.6107379580716764,8
3218,51,42,69,20,0.6101979768400004,22
3219,91,16,70,7,0.6063303701253773,9
3220,111,31,16,16,0.604864398590204,15
3221,63,15,34,7,0.6010869874219945,8
3222,71,32,106,15,0.6009609652453856,17
3223,111,10,12,6,0.6003907747378726,4
3224,71,10,23,4,0.6000287508458257,6
3225,65,25,78,11,0.5972758077920006,14
3226,76,13,36,4,0.5885035889042722,9
3227,55,24,20,12,0.5874553964616283,12
3228,63,28,112,14,0.5834223269951169,14
3229,81,16,68,8,0.5833845458965541,8
3230,94,24,100,14,0.5797620298141511,10
3231,90,18,84,9,0.5795253040496203,9
3232,80,35,86,17,0.5771607275339617,18
3233,46,32,87,14,0.5771141288489539,18
3234,114,40,7,19,0.5741553045041318,21
3235,104,24,15,12,0.5737247395128393,12
3236,60,49,65,27,0.5726413570677132,22
3237,69,15,71,8,0.5724150990318919,7
3238,71,13,78,6,0.5661963238744551,7
3239,37,16,43,7,0.562355471826647,9
3240,83,10,2,5,0.5594397265150824,5
3241,46,20,41,9,0.5567343104251282,11
3242,95,53,86,24,0.5540869121526225,29
3243,5,49,54,23,0.5526115688513309,26
3244,12,39,27,18,0.5523057634996393,21
3245,68,74,65,37,0.5506001841763745,37
3246,92,17,7,7,0.5480230211986101,10
3247,23,32,51,16,0.5473097590485475,16
3248,98,27,16,13,0.5462850233229243,14
3249,64,29,54,15,0.5456745481805155,14
3250,60,77,7,38,0.5423394255026432,39
3251,63,29,27,13,0.5399070299800365,16
3252,50,36,8,19,0.5398388863137726,17
3253,106,10,1,5,0.539652861011431,5
3254,11,18,17,9,0.5333410210662327,9
3255,87,61,30,30,0.5330009356036225,31
3256,86,78,13,40,0.5329870597409333,38
3257,107,20,6,10,0.5288105428737948,10
3258,4,24,77,12,0.5234491201479377,12
3259,73,19,28,10,0.5214155246375574,9
3260,60,18,83,9,0.5212906629660227,9
3261,30,22,106,11,0.5189588569615401,11
3262,84,27,78,13,0.5159724183872996,14
3263,112,10,66,4,0.5146742754382652,6
3264,112,20,51,10,0.5141422831615118,10
3265,4,18,9,9,0.5118055197130339,9
3266,54,41,7,20,0.5072416292031896,21
3267,111,51,68,26,0.5032623987050037,25
3268,90,13,91,6,0.5003235284827323,7
3269,23,20,54,10,0.5000451529620598,10
3270,88,35,31,18,0.4999807976090588,17
3271,5,59,87,29,0.4991669720547012,30
3272,74,22,18,12,0.49290222508995235,10
3273,86,24,93,12,0.49230543753796824,12
3274,62,12,97,6,0.4900514031250112,6
3275,57,14,104,5,0.4845128262229356,9
3276,88,40,20,21,0.48272225314993983,19
3277,109,46,13,22,0.4820337228682999,24
3278,84,10,94,5,0.4811703860633969,5
3279,95,28,74,13,0.47842550860281996,15
3280,75,31,41,14,0.47837138213253816,17
3281,86,58,50,27,0.4764833561290648,31
3282,25,51,39,26,0.4759465051184244,25
3283,65,54,31,26,0.46913887469692744,28
3284,29,21,77,11,0.46866904560211964,10
3285,104,38,76,20,0.4636043507636342,18
3286,65,58,12,30,0.462819528280172,28
3287,97,39,107,20,0.4513498337115768,19
3288,80,11,9,7,0.4439834453330457,4
3289,90,15,11,7,0.4409004522210816,8
3290,68,28,38,13,0.4389809843925625,15
3291,86,65,3,32,0.43154995855846584,33
3292,40,43,31,22,0.429627197462679,21
3293,29,23,78,11,0.4291222097543114,12
3294,49,32,7,15,0.42188009094911627,17
3295,112,18,69,10,0.41980133837250894,8
3296,5,14,38,7,0.4168378546295618,7
3297,54,34,84,17,0.4144322968093763,17
3298,20,16,69,8,0.4110151707783569,8
3299,31,33,86,17,0.4107692180392416,16
3300,96,39,55,20,0.409999012059578,19
3301,50,18,79,9,0.4091046493522828,9
3302,16,45,114,21,0.4068130302568852,24
3303,16,36,103,17,0.4066681393188066,19
3304,27,45,11,22,0.4058256777858905,23
3305,35,16,30,8,0.4016415319429745,8
3306,104,15,20,8,0.39743988488785953,7
3307,61,16,65,9,0.395050527419345,7
3308,102,14,84,7,0.3912018744364814,7
3309,8,13,44,6,0.3904420875790005,7
3310,7,89,65,47,0.39009225035654854,42
3311,65,26,77,12,0.3896670535480057,14
3312,95,17,76,8,0.3896119374242384,9
3313,69,30,36,15,0.38598798110099336,15
3314,114,28,71,14,0.3795577437704574,14
3315,70,22,97,12,0.3783758219642565,10
3316,14,18,84,8,0.37783903496494214,10
3317,63,27,60,13,0.3732661726653222,14
3318,40,21,75,10,0.36863713867004627,11
3319,94,19,41,10,0.36863478647370623,9
3320,95,26,28,12,0.36814720179538635,14
3321,92,18,13,7,0.36521745881563183,11
3322,17,19,87,10,0.3631074209821953,9
3323,57,32,41,16,0.35698645651571526,16
3324,68,49,63,24,0.3537099268739354,25
3325,34,13,75,6,0.35287672494658584,7
3326,49,10,5,5,0.3484948933204418,5
3327,19,45,15,22,0.3463649803634729,23
3328,53,41,51,21,0.3439811842946898,20
3329,17,12,69,6,0.33992057730208697,6
3330,109,13,4,6,0.3380907022892352,7
3331,83,20,106,11,0.33164456490941063,9
3332,108,17,64,8,0.3288515928978434,9
3333,3,13,46,7,0.32759691142996444,6
3334,87,26,2,13,0.3261916240593897,13
3335,55,23,57,10,0.32556856319928607,13
3336,80,17,71,9,0.3237123360021306,8
3337,86,34,2,18,0.32232529406269955,16
3338,83,25,28,14,0.3193130867023741,11
3339,114,22,69,10,0.31706249889901594,12
3340,60,48,53,25,0.3118269913878374,23
3341,64,12,28,6,0.30789275575683855,6
3342,23,19,111,11,0.30722018824927017,8
3343,1,35,107,18,0.30511491832295773,17
3344,51,17,38,8,0.3030848850194281,9
3345,16,52,41,24,0.30124505382531497,28
3346,11,26,69,12,0.29757549445255455,14
3347,98,16,19,7,0.29311592538168374,9
3348,27,17,25,9,0.2912949474117505,8
3349,87,18,33,9,0.2899071897038154,9
3350,13,46,15,24,0.2858651477398279,22
3351,68,63,60,33,0.28538797843058167,30
3352,88,22,90,10,0.28375513251826495,12
3353,67,12,25,6,0.2816428039469064,6
3354,96,12,67,7,0.27996501259109813,5
3355,104,40,68,19,0.2798877887850182,21
3356,7,20,70,8,0.27895885562124206,12
3357,53,18,5,8,0.2778213329671456,10
3358,13,87,49,39,0.27566807487151146,48
3359,7,77,39,40,0.2749189859757216,37
3360,87,18,52,10,0.2686604923430049,8
3361,36,11,38,4,0.26679215079866997,7
3362,84,75,107,37,0.26410914254599377,38
3363,37,22,76,12,0.2606095394442829,10
3364,54,80,107,41,0.25756345940778985,39
3365,71,36,88,16,0.25752053570309325,20
3366,4,32,68,16,0.25730955252799864,16
3367,17,11,108,5,0.2506467392789146,6
3368,39,51,63,29,0.2485762976887629,22
3369,40,25,47,14,0.24655985846699452,11
3370,39,10,93,5,0.24650819188032075,5
3371,13,56,53,26,0.23596481784004864,30
3372,11,65,39,33,0.23090569657274948,32
3373,65,10,101,5,0.22906131925901718,5
3374,47,12,53,6,0.22656162850800943,6
3375,88,15,79,8,0.22413158533616365,7
3376,87,50,96,24,0.22380305623995284,26
3377,106,69,28,34,0.21905675330440585,35
3378,7,99,107,54,0.21373648564267417,45
3379,53,21,44,9,0.2122113313421154,12
3380,48,26,11,13,0.21053633238551017,13
3381,28,11,66,5,0.2056598644516812,6
3382,46,23,17,12,0.20521498367655996,11
3383,33,13,74,6,0.20465467586240857,7
3384,8,46,20,23,0.2023315764151644,23
3385,63,48,40,23,0.20172959340563693,25
3386,76,11,47,3,0.1986777302440924,8
3387,107,61,74,29,0.19420996588142148,32
3388,112,18,72,9,0.1936517175084139,9
3389,19,21,112,11,0.1905110640381326,10
3390,35,12,70,7,0.18631436457958764,5
3391,44,15,65,6,0.18351226600640885,9
3392,50,25,114,12,0.18060110833646845,13
3393,70,23,41,13,0.17939581625615084,10
3394,71,33,8,17,0.17759312635004623,16
3395,11,47,106,26,0.17225906773687616,21
3396,51,50,9,24,0.1707745155048165,26
3397,12,10,29,5,0.16867451381405588,5
3398,106,28,100,13,0.1677556244233457,15
3399,7,51,4,26,0.16136746029798088,25
3400,18,24,104,14,0.15875087569414603,10
3401,62,12,106,6,0.1584669634691407,6
3402,7,16,83,7,0.15765677447455273,9
3403,19,23,88,12,0.1550442655002045,11
3404,70,56,8,28,0.15218257137377833,28
3405,51,17,85,8,0.1485089203425444,9
3406,37,41,114,19,0.14487606275647485,22
3407,100,51,39,26,0.14360825003579727,25
3408,68,19,57,10,0.13549914627164314,9
3409,73,10,25,5,0.1328731236438802,5
3410,33,16,114,9,0.13065946112886406,7
3411,87,62,51,31,0.1301702940341213,31
3412,69,25,7,13,0.12779683769016903,12
3413,28,22,98,9,0.12169006680659694,13
3414,107,21,79,11,0.1178028492260971,10
3415,18,23,12,12,0.11420711031997514,11
3416,80,23,84,12,0.11286096846693221,11
3417,68,10,79,4,0.11002938828097442,6
3418,103,22,29,12,0.10854405086209114,10
3419,64,24,100,11,0.10532763947275085,13
3420,2,18,84,9,0.10504403066305398,9
3421,100,19,17,8,0.10330347718863789,11
3422,27,19,23,10,0.0995832775496503,9
3423,13,24,45,12,0.09910833731150663,12
3424,86,30,53,13,0.09593092236920715,17
3425,74,39,25,20,0.09563368284676016,19
3426,87,14,92,7,0.09367358040314991,7
3427,114,29,36,13,0.09213128587786307,16
3428,114,48,104,25,0.08363522002228145,23
3429,84,37,88,17,0.08333477514829757,20
3430,62,10,95,5,0.08147821861479798,5
3431,30,48,100,25,0.0805276602237058,23
3432,97,36,74,17,0.07931920932357782,19
3433,87,43,104,23,0.07856624027495081,20
3434,68,31,77,15,0.07468526243037156,16
3435,87,32,62,16,0.06899373968097366,16
3436,62,19,37,8,0.06880627143278654,11
3437,106,21,40,10,0.06808253080226546,11
3438,51,39,30,20,0.06682446440230774,19
3439,86,80,54,41,0.0655329278743415,39
3440,107,71,114,36,0.06336114924955376,35
3441,103,17,41,9,0.062364299462224854,8
3442,13,29,34,15,0.05455287257368432,14
3443,8,70,106,37,0.05212763279076112,33
3444,73,16,106,8,0.04700386219362951,8
3445,83,17,51,10,0.04607341431682285,7
3446,31,11,97,5,0.04256244744109723,6
3447,55,23,3,12,0.03361106113229084,11
3448,84,19,17,10,0.032612383959908106,9
3449,13,57,9,27,0.01801614367993792,30
3450,60,15,80,7,0.014675025668747566,8
3451,109,17,83,7,0.00972932964701334,10
3452,85,18,16,8,0.00556795502767413,10
3453,94,23,86,12,3.56651914630205e-05,11
3454,86,23,94,11,-3.566519146163031e-05,12
3455,16,18,85,10,-0.005567955027674327,8
3456,106,47,76,26,-0.009505075346386196,21
3457,83,17,109,10,-0.009729329647013785,7
3458,80,15,60,8,-0.014675025668747439,7
3459,9,57,13,30,-0.01801614367993859,27
3460,17,19,84,9,-0.03261238395990876,10
3461,3,23,55,11,-0.033611061132289295,12
3462,97,11,31,6,-0.042562447441096586,5
3463,51,17,83,7,-0.04607341431682421,10
3464,106,16,73,8,-0.0470038621936304,8
3465,106,70,8,33,-0.05212763279076128,37
3466,34,29,13,14,-0.054552872573684956,15
3467,41,17,103,8,-0.06236429946222318,9
3468,114,71,107,35,-0.06336114924955315,36
3469,54,80,86,39,-0.0655329278743427,41
3470,30,39,51,19,-0.06682446440230849,20
3471,40,21,106,11,-0.0680825308022658,10
3472,37,19,62,11,-0.06880627143278734,8
3473,62,32,87,16,-0.068993739680973,16
3474,77,31,68,16,-0.07468526243037167,15
3475,104,43,87,20,-0.07856624027495072,23
3476,74,36,97,19,-0.07931920932357782,17
3477,100,48,30,23,-0.08052766022370664,25
3478,95,10,62,5,-0.08147821861479762,5
3479,88,37,84,20,-0.0833347751482989,17
3480,104,48,114,23,-0.08363522002228167,25
3481,36,29,114,16,-0.09213128587786189,13
3482,92,14,87,7,-0.09367358040315074,7
3483,25,39,74,19,-0.0956336828467596,20
3484,53,30,86,17,-0.09593092236920858,13
3485,11,80,16,36,-0.09636151621677108,44
3486,11,62,107,30,-0.09659036725643244,32
3487,45,24,13,12,-0.09910833731150781,12
3488,23,19,27,9,-0.09958327754964931,10
3489,17,19,100,11,-0.10330347718863957,8
3490,84,18,2,9,-0.10504403066305477,9
3491,100,24,64,13,-0.10532763947275099,11
3492,29,22,103,10,-0.10854405086209082,12
3493,79,10,68,6,-0.11002938828097442,4
3494,84,23,80,11,-0.11286096846693237,12
3495,12,23,18,11,-0.11420711031997492,12
3496,79,21,107,10,-0.11780284922609727,11
3497,98,22,28,13,-0.1216900668065983,9
3498,7,25,69,12,-0.1277968376901685,13
3499,51,62,87,31,-0.13017029403412197,31
3500,114,16,33,7,-0.13065946112886495,9
3501,25,10,73,5,-0.1328731236438802,5
3502,57,19,68,9,-0.13549914627164278,10
3503,39,51,100,25,-0.14360825003579586,26
3504,114,41,37,22,-0.14487606275647485,19
3505,85,17,51,9,-0.14850892034254606,8
3506,8,56,70,28,-0.15218257137377827,28
3507,88,23,19,11,-0.1550442655002052,12
3508,83,16,7,9,-0.1576567744745514,7
3509,106,12,62,6,-0.15846696346914188,6
3510,104,24,18,10,-0.15875087569414587,14
3511,4,51,7,25,-0.16136746029798163,26
3512,100,28,106,15,-0.16775562442334394,13
3513,29,10,12,5,-0.16867451381405657,5
3514,9,50,51,26,-0.1707745155048177,24
3515,106,47,11,21,-0.17225906773687602,26
3516,8,33,71,16,-0.17759312635004632,17
3517,41,23,70,10,-0.17939581625614923,13
3518,114,25,50,13,-0.18060110833646717,12
3519,65,15,44,9,-0.1835122660064091,6
3520,70,12,35,5,-0.18631436457958692,7
3521,112,21,19,10,-0.19051106403813386,11
3522,72,18,112,9,-0.1936517175084139,9
3523,47,11,76,8,-0.19867773024409274,3
3524,40,48,63,25,-0.20172959340563568,23
3525,20,46,8,23,-0.20233157641516486,23
3526,74,13,33,7,-0.20465467586240804,6
3527,17,23,46,11,-0.2052149836765593,12
3528,66,11,28,6,-0.20565986445168055,5
3529,44,21,53,12,-0.2122113313421161,9
3530,107,99,7,45,-0.2137364856426742,54
3531,28,69,106,35,-0.21905675330440377,34
3532,96,50,87,26,-0.22380305623995211,24
3533,79,15,88,7,-0.2241315853361646,8
3534,53,12,47,6,-0.22656162850800912,6
3535,101,10,65,5,-0.2290613192590168,5
3536,39,65,11,32,-0.23090569657275037,33
3537,53,56,13,30,-0.23596481784004786,26
3538,93,10,39,5,-0.24650819188031967,5
3539,47,25,40,11,-0.24655985846699366,14
3540,63,51,39,22,-0.24857629768876138,29
3541,108,11,17,6,-0.25064673927891384,5
3542,68,32,4,16,-0.2573095525279973,16
3543,88,36,71,20,-0.2575205357030929,16
3544,107,80,54,39,-0.25756345940778924,41
3545,76,22,37,10,-0.26060953944428406,12
3546,107,75,84,38,-0.2641091425459951,37
3547,38,11,36,7,-0.26679215079866964,4
3548,52,18,87,8,-0.26866049234300404,10
3549,39,77,7,37,-0.27491898597572295,40
3550,49,87,13,48,-0.27566807487151174,39
3551,5,18,53,10,-0.277821332967146,8
3552,70,20,7,12,-0.27895885562124184,8
3553,68,40,104,21,-0.2798877887850195,19
3554,67,12,96,5,-0.279965012591097,7
3555,25,12,67,6,-0.2816428039469064,6
3556,90,22,88,12,-0.28375513251826495,10
3557,60,63,68,30,-0.28538797843058206,33
3558,15,46,13,22,-0.2858651477398276,24
3559,33,18,87,9,-0.2899071897038148,9
3560,25,17,27,8,-0.29129494741175216,9
3561,19,16,98,9,-0.2931159253816844,7
3562,69,26,11,14,-0.29757549445255466,12
3563,41,52,16,28,-0.3012450538253157,24
3564,38,17,51,9,-0.3030848850194272,8
3565,107,35,1,17,-0.30511491832295834,18
3566,111,19,23,8,-0.30722018824927033,11
3567,28,12,64,6,-0.30789275575683855,6
3568,53,48,60,23,-0.3118269913878375,25
3569,69,22,114,12,-0.31706249889901467,10
3570,28,25,83,11,-0.3193130867023753,14
3571,2,34,86,16,-0.32232529406269944,18
3572,71,17,80,8,-0.3237123360021318,9
3573,57,23,55,13,-0.3255685631992851,10
3574,2,26,87,13,-0.32619162405938956,13
3575,46,13,3,6,-0.3275969114299653,7
3576,64,17,108,9,-0.3288515928978421,8
3577,106,20,83,9,-0.3316445649094112,11
3578,4,13,109,7,-0.3380907022892352,6
3579,69,12,17,6,-0.33992057730208786,6
3580,51,41,53,20,-0.3439811842946886,21
3581,15,45,19,23,-0.34636498036347363,22
3582,5,10,49,5,-0.3484948933204407,5
3583,75,13,34,7,-0.35287672494658556,6
3584,63,49,68,25,-0.3537099268739361,24
3585,41,32,57,16,-0.3569864565157146,16
3586,87,19,17,9,-0.3631074209821953,10
3587,13,18,92,11,-0.3652174588156323,7
3588,28,26,95,14,-0.36814720179538646,12
3589,41,19,94,9,-0.368634786473706,10
3590,75,21,40,11,-0.3686371386700461,10
3591,60,27,63,14,-0.37326617266532136,13
3592,84,18,14,10,-0.37783903496494253,8
3593,16,29,102,15,-0.3779583414469201,14
3594,97,22,70,10,-0.3783758219642562,12
3595,71,28,114,14,-0.3795577437704577,14
3596,36,30,69,15,-0.3859879811009911,15
3597,76,17,95,9,-0.3896119374242386,8
3598,77,26,65,14,-0.38966705354800596,12
3599,65,89,7,42,-0.3900922503565505,47
3600,44,13,8,7,-0.3904420875789997,6
3601,84,14,102,7,-0.39120187443648013,7
3602,65,16,61,7,-0.3950505274193441,9
3603,20,15,104,7,-0.39743988488786003,8
3604,30,16,35,8,-0.4016415319429745,8
3605,11,45,27,23,-0.4058256777858905,22
3606,103,36,16,19,-0.4066681393188054,17
3607,114,45,16,24,-0.4068130302568858,21
3608,79,18,50,9,-0.4091046493522828,9
3609,55,39,96,19,-0.40999901205957984,20
3610,86,33,31,16,-0.4107692180392426,17
3611,69,16,20,8,-0.41101517077835736,8
3612,84,34,54,17,-0.41443229680937554,17
3613,38,14,5,7,-0.4168378546295618,7
3614,69,18,112,8,-0.41980133837250894,10
3615,7,32,49,17,-0.4218800909491176,15
3616,78,23,29,12,-0.4291222097543134,11
3617,31,43,40,21,-0.4296271974626791,22
3618,3,65,86,33,-0.4315499585584662,32
3619,38,28,68,15,-0.43898098439256167,13
3620,11,15,90,8,-0.4409004522210813,7
3621,9,11,80,4,-0.4439834453330448,7
3622,107,39,97,19,-0.4513498337115769,20
3623,12,58,65,28,-0.462819528280173,30
3624,76,38,104,18,-0.4636043507636345,20
3625,77,21,29,10,-0.46866904560212064,11
3626,31,54,65,28,-0.4691388746969265,26
3627,39,51,25,25,-0.4759465051184236,26
3628,50,58,86,31,-0.4764833561290644,27
3629,20,23,30,12,-0.4766139020425556,11
3630,41,31,75,17,-0.47837138213253816,14
3631,74,28,95,15,-0.4784255086028221,13
3632,94,10,84,5,-0.4811703860633948,5
3633,13,46,109,24,-0.48203372286829943,22
3634,104,14,57,9,-0.4845128262229359,5
3635,97,12,62,6,-0.4900514031250112,6
3636,93,24,86,12,-0.4923054375379694,12
3637,18,22,74,10,-0.4929022250899522,12
3638,87,59,5,30,-0.49916697205470045,29
3639,31,35,88,17,-0.499980797609059,18
3640,54,20,23,10,-0.5000451529620575,10
3641,91,13,90,7,-0.5003235284827329,6
3642,68,51,111,25,-0.5032623987050046,26
3643,7,41,54,21,-0.507241629203189,20
3644,9,18,4,9,-0.5118055197130339,9
3645,51,20,112,10,-0.5141422831615127,10
3646,66,10,112,6,-0.5146742754382657,4
3647,78,27,84,14,-0.515972418387299,13
3648,106,22,30,11,-0.5189588569615399,11
3649,83,18,60,9,-0.5212906629660219,9
3650,28,19,73,9,-0.5214155246375576,10
3651,77,24,4,12,-0.5234491201479351,12
3652,6,20,107,10,-0.528810542873795,10
3653,13,78,86,38,-0.5329870597409339,40
3654,30,61,87,31,-0.5330009356036213,30
3655,17,18,11,9,-0.5333410210662319,9
3656,1,10,106,5,-0.5396528610114302,5
3657,8,36,50,17,-0.5398388863137724,19
3658,27,29,63,16,-0.5399070299800356,13
3659,7,77,60,39,-0.5423394255026428,38
3660,54,29,64,14,-0.5456745481805153,15
3661,16,27,98,14,-0.5462850233229247,13
3662,51,32,23,16,-0.5473097590485466,16
3663,7,17,92,10,-0.5480230211986107,7
3664,65,74,68,37,-0.5506001841763739,37
3665,27,39,12,21,-0.5523057634996391,18
3666,54,49,5,26,-0.5526115688513301,23
3667,86,53,95,29,-0.5540869121526232,24
3668,41,20,46,11,-0.5567343104251291,9
3669,2,10,83,5,-0.559439726515081,5
3670,43,16,37,9,-0.5623554718266468,7
3671,78,13,71,7,-0.5661963238744554,6
3672,71,15,69,7,-0.5724150990318926,8
3673,65,49,60,22,-0.5726413570677142,27
3674,15,24,104,12,-0.5737247395128372,12
3675,7,40,114,21,-0.5741553045041317,19
3676,87,32,46,18,-0.5771141288489547,14
3677,86,35,80,18,-0.5771607275339606,17
3678,84,18,90,9,-0.5795253040496205,9
3679,100,24,94,10,-0.5797620298141505,14
3680,68,16,81,8,-0.5833845458965539,8
3681,112,28,63,14,-0.5834223269951164,14
3682,20,24,55,12,-0.5874553964616281,12
3683,36,13,76,9,-0.5885035889042698,4
3684,78,25,65,14,-0.5972758077920014,11
3685,23,10,71,6,-0.6000287508458257,4
3686,12,10,111,4,-0.6003907747378741,6
3687,106,32,71,17,-0.6009609652453869,15
3688,34,15,63,8,-0.6010869874219955,7
3689,16,31,111,15,-0.6048643985902039,16
3690,70,16,91,9,-0.6063303701253777,7
3691,69,42,51,22,-0.6101979768400001,20
3692,8,15,19,8,-0.610737958071677,7
3693,39,68,87,35,-0.6125718981179344,33
3694,11,55,28,29,-0.616199549727456,26
3695,58,22,31,11,-0.6168553703735028,11
3696,38,12,40,7,-0.6179079194784384,5
3697,47,45,39,24,-0.6235695040258793,21
3698,71,33,36,16,-0.6241330409639598,17
3699,74,42,54,21,-0.6253470328077771,21
3700,37,40,65,19,-0.6273579146862459,21
3701,84,30,109,16,-0.6283430275726458,14
3702,29,20,38,10,-0.6286324723530289,10
3703,1,23,60,12,-0.6297573562891176,11
3704,47,30,87,15,-0.6310013424305154,15
3705,64,28,4,15,-0.6316212138641698,13
3706,20,34,13,18,-0.6324978295967559,16
3707,20,16,93,9,-0.6327174645108351,7
3708,48,11,43,5,-0.6335452834733647,6
3709,36,17,111,9,-0.6365354853619557,8
3710,41,25,25,11,-0.6394054706376676,14
3711,69,15,85,8,-0.6408165415497269,7
3712,50,21,34,10,-0.6437821636330864,11
3713,109,10,2,5,-0.6444253237530958,5
3714,84,28,65,14,-0.6478183306385067,14
3715,78,32,63,17,-0.6511427448806526,15
3716,77,19,109,9,-0.6551340345633953,10
3717,60,26,109,13,-0.6737568590431613,13
3718,38,10,50,6,-0.675293514097801,4
3719,79,13,29,8,-0.6757838864896706,5
3720,39,39,50,20,-0.6773303120820158,19
3721,3,16,79,7,-0.678818732592888,9
3722,23,14,109,7,-0.6795387556597896,7
3723,25,19,18,9,-0.6816652439852758,10
3724,76,30,8,16,-0.6822031764790518,14
3725,48,17,88,10,-0.689025055934672,7
3726,86,69,68,34,-0.6897584561737039,35
3727,93,17,11,7,-0.6934063282822591,10
3728,43,30,3,16,-0.6945065447681108,14
3729,39,11,61,5,-0.6964131355147433,6
3730,91,11,38,6,-0.7003822911270713,5
3731,65,23,47,12,-0.7020951602660523,11
3732,11,49,63,28,-0.7041449631736966,21
3733,87,25,103,14,-0.7049312985026178,11
3734,51,64,55,33,-0.7052787365416385,31
3735,29,23,94,12,-0.7057962050625216,11
3736,27,18,106,11,-0.7074485049679552,7
3737,3,13,97,7,-0.7099885191404633,6
3738,12,37,51,19,-0.710191678656004,18
3739,71,18,43,8,-0.71222852771467,10
3740,28,13,82,6,-0.7153587234866207,7
3741,40,18,61,9,-0.7154895706830816,9
3742,79,21,34,12,-0.7201940806784467,9
3743,17,24,8,12,-0.7243993806611906,12
3744,88,63,46,31,-0.7264738004913419,32
3745,4,10,57,6,-0.7276499847388465,4
3746,96,10,71,5,-0.7278695572627789,5
3747,99,13,27,6,-0.7284055341482082,7
3748,27,13,33,7,-0.7289108112107213,6
3749,16,80,11,45,-0.7311060980382811,35
3750,5,41,95,20,-0.7316066534315533,21
3751,112,22,9,12,-0.7326551262265775,10
3752,86,77,40,41,-0.7352757671814375,36
3753,63,40,5,18,-0.7358500176759462,22
3754,106,43,50,21,-0.738942307634008,22
3755,15,24,25,11,-0.7394428200536295,13
3756,108,12,7,7,-0.7404080910313952,5
3757,84,27,37,14,-0.7406944026942689,13
3758,64,22,38,11,-0.741675899909911,11
3759,74,13,36,8,-0.743717573303844,5
3760,78,32,11,15,-0.7439751541430462,17
3761,84,24,46,13,-0.7446057703540011,11
3762,19,59,16,32,-0.7448074366788329,27
3763,28,85,107,45,-0.7466282052500216,40
3764,65,64,39,31,-0.7504610739617337,33
3765,13,15,14,9,-0.751185424264851,6
3766,3,28,9,14,-0.7589069260840974,14
3767,86,69,109,35,-0.7613768961042885,34
3768,20,83,86,43,-0.7625493429797979,40
3769,65,19,34,9,-0.7628058558484428,10
3770,109,58,28,31,-0.7644849013466701,27
3771,50,15,58,7,-0.7660630045931228,8
3772,93,20,97,10,-0.7717644600090567,10
3773,84,19,10,10,-0.7730240789929577,9
3774,40,40,16,21,-0.774301700167752,19
3775,69,32,88,17,-0.7753807063240767,15
3776,99,22,87,12,-0.7762165713325071,10
3777,28,51,13,26,-0.7790491963091725,25
3778,109,20,48,11,-0.7860713609857799,9
3779,104,18,4,8,-0.7872554057904768,10
3780,38,15,80,7,-0.7882565864146641,8
3781,3,15,96,7,-0.7883607611625825,8
3782,33,14,75,8,-0.7900898585820659,6
3783,89,16,28,9,-0.7901986413516622,7
3784,88,22,2,11,-0.7956469041111237,11
3785,62,11,98,6,-0.7995773049352679,5
3786,78,18,41,10,-0.8039593627471286,8
3787,40,26,30,13,-0.8045580871786177,13
3788,40,14,56,7,-0.8062835825274064,7
3789,50,31,84,15,-0.8064114901977935,16
3790,79,16,7,8,-0.8085663274395147,8
3791,41,80,7,40,-0.8113607765595651,40
3792,20,27,74,13,-0.8203305748765273,14
3793,45,19,114,10,-0.8205689132017484,9
3794,54,67,50,34,-0.8208738895797711,33
3795,95,15,84,8,-0.8218033746912378,7
3796,65,107,13,56,-0.8251358063632326,51
3797,37,48,28,24,-0.8263140292594411,24
3798,106,12,29,6,-0.8264692442725535,6
3799,49,54,88,28,-0.8267825014615153,26
3800,46,16,2,8,-0.8285194662826783,8
3801,88,78,8,40,-0.8346650298713413,38
3802,98,14,60,7,-0.8439389777307166,7
3803,95,15,33,8,-0.8491128905949189,7
3804,102,13,39,7,-0.8492100400200481,6
3805,11,38,65,19,-0.8512591605271699,19
3806,38,12,41,7,-0.851438988412223,5
3807,86,29,19,14,-0.8547184874040825,15
3808,64,14,77,6,-0.8550421959375909,8
3809,109,42,87,23,-0.8557093365192054,19
3810,114,10,10,6,-0.8617397018011254,4
3811,37,67,8,34,-0.8700084298071528,33
3812,84,17,60,7,-0.8716143564890693,10
3813,1,15,27,9,-0.8721383199452194,6
3814,91,17,84,9,-0.8755346549877636,8
3815,13,40,17,20,-0.8771877390861273,20
3816,88,21,83,10,-0.8798897555023183,11
3817,3,13,93,8,-0.8808947328421428,5
3818,86,50,9,27,-0.8880878607383526,23
3819,51,63,27,33,-0.8881383616064759,30
3820,39,74,86,36,-0.8920235918545372,38
3821,30,46,27,24,-0.893262370981151,22
3822,70,24,39,13,-0.8958543413772146,11
3823,69,30,3,14,-0.8962278395321779,16
3824,55,55,87,28,-0.8964696013179043,27
3825,74,17,68,10,-0.9001065237726515,7
3826,55,17,78,8,-0.9002458878614066,9
3827,50,14,62,8,-0.9017457082495504,6
3828,111,12,60,5,-0.9019980300500793,7
3829,14,11,112,5,-0.9022319115654427,6
3830,49,19,109,10,-0.9031267273973523,9
3831,75,35,36,16,-0.9076169876586756,19
3832,1,14,39,9,-0.9120351629887077,5
3833,68,38,15,21,-0.9158662466441888,17
3834,114,27,75,14,-0.9181862737012573,13
3835,113,14,86,8,-0.9183338417210523,6
3836,107,43,78,23,-0.9215347139145762,20
3837,40,29,18,17,-0.9358054757186769,12
3838,39,51,8,25,-0.939563300762841,26
3839,53,23,63,12,-0.9461903574638926,11
3840,5,14,14,8,-0.9561035605846475,6
3841,103,11,106,5,-0.9583580547252434,6
3842,106,38,104,19,-0.9604760273979325,19
3843,107,62,11,33,-0.9614829755615019,29
3844,50,31,76,18,-0.9653541591978413,13
3845,57,15,64,8,-0.9686108755747862,7
3846,63,20,15,10,-0.9688742288483313,10
3847,87,52,63,28,-0.969466480560497,24
3848,9,12,78,6,-0.9745877106891214,6
3849,5,65,107,33,-0.9748363761521153,32
3850,102,15,68,8,-0.9774478191416376,7
3851,57,56,16,30,-0.9788591489024668,26
3852,107,32,69,17,-0.9867318989974738,15
3853,27,13,20,7,-0.9871413726704222,6
3854,88,33,43,18,-0.9947945347929833,15
3855,17,37,37,21,-0.9978108601802036,16
3856,93,11,114,5,-1.0049906589581687,6
3857,13,73,41,37,-1.0052100802031871,36
3858,75,43,13,23,-1.0053644322647692,20
3859,88,12,45,7,-1.005819520359159,5
3860,86,32,85,17,-1.0113399236982104,15
3861,28,52,87,26,-1.0126365910584707,26
3862,60,13,57,7,-1.0152034376280947,6
3863,107,92,8,45,-1.0168882870821123,47
3864,18,41,107,19,-1.0183255345448867,22
3865,44,20,63,11,-1.0233184771026504,9
3866,37,53,51,30,-1.024933980807299,23
3867,97,33,2,17,-1.0254110764857562,16
3868,64,16,46,8,-1.031017738027724,8
3869,3,14,45,7,-1.0349134798027073,7
3870,18,59,7,29,-1.0365595161190124,30
3871,33,16,104,9,-1.037548645615811,7
3872,51,35,18,17,-1.0414861976482428,18
3873,77,13,112,8,-1.044011084095807,5
3874,13,60,4,32,-1.0440840904331994,28
3875,27,65,13,33,-1.0485281337521837,32
3876,107,69,39,35,-1.0492738159328625,34
3877,45,18,71,8,-1.050024616634439,10
3878,88,72,87,35,-1.0530380450919397,37
3879,18,24,30,12,-1.0579199601112548,12
3880,8,17,80,8,-1.0587286140181777,9
3881,44,14,100,7,-1.059041314786415,7
3882,60,12,33,5,-1.0606676023612402,7
3883,71,14,58,7,-1.067952436399428,7
3884,37,20,67,11,-1.0707700527635244,9
3885,97,16,9,7,-1.0715415510849833,9
3886,70,41,107,20,-1.0723253683389227,21
3887,97,19,64,10,-1.0748997556854094,9
3888,15,14,17,8,-1.0815196129384665,6
3889,65,54,75,27,-1.0834874610355845,27
3890,65,29,50,15,-1.0876879077972634,14
3891,74,13,40,7,-1.0901529369074696,6
3892,51,83,68,45,-1.0958426568834054,38
3893,106,39,70,19,-1.1024614638047292,20
3894,46,35,107,17,-1.1031099530770958,18
3895,2,18,96,9,-1.1039761816908782,9
3896,45,19,40,10,-1.1043531225931214,9
3897,47,12,91,6,-1.104710696366028,6
3898,55,13,73,7,-1.1082443575059588,6
3899,6,16,51,9,-1.1096986250731458,7
3900,109,16,40,9,-1.112646763896172,7
3901,86,19,33,9,-1.1129844538573441,10
3902,7,19,29,12,-1.1170674633929274,7
3903,18,13,27,6,-1.1211992327384528,7
3904,19,28,69,15,-1.1227446471060287,13
3905,11,21,29,11,-1.1293738650195773,10
3906,31,26,3,12,-1.1304098830558946,14
3907,106,26,36,13,-1.1307287364062808,13
3908,45,20,64,11,-1.143150033869323,9
3909,33,10,17,5,-1.1464162819529045,5
3910,8,13,111,6,-1.1570953689507364,7
3911,23,16,104,7,-1.1585628201755829,9
3912,63,108,65,56,-1.1623875158855317,52
3913,74,14,12,7,-1.1676100167547812,7
3914,55,52,39,28,-1.1740266098053438,24
3915,77,12,33,6,-1.1756675735500604,6
3916,48,26,8,14,-1.1767574962584832,12
3917,96,31,76,17,-1.1853039288193825,14
3918,110,16,87,9,-1.1878037867151192,7
3919,37,36,88,19,-1.188834543043674,17
3920,41,12,48,6,-1.1910839111619829,6
3921,16,67,25,35,-1.193286529710067,32
3922,85,31,107,16,-1.1983111993424356,15
3923,97,33,25,17,-1.2112097532933461,16
3924,63,16,58,7,-1.211674081917942,9
3925,74,11,98,6,-1.2137114800422124,5
3926,60,63,107,32,-1.2194248904584684,31
3927,41,17,55,9,-1.2209745250839963,8
3928,65,92,86,45,-1.2239963595428656,47
3929,9,26,71,14,-1.2262156519313807,12
3930,107,88,51,50,-1.2335246266798194,38
3931,95,16,63,8,-1.233969730193377,8
3932,93,21,107,10,-1.2375139728583175,11
3933,31,25,71,13,-1.2380158081615502,12
3934,4,30,107,15,-1.2387516471106224,15
3935,55,16,108,9,-1.242512686909534,7
3936,62,11,17,6,-1.2486647888480198,5
3937,70,27,63,14,-1.2550372321498742,13
3938,100,40,8,21,-1.2550832379425962,19
3939,46,10,27,6,-1.2550991025341744,4
3940,16,15,73,7,-1.2607482082851342,8
3941,14,15,107,7,-1.262180496300674,8
3942,86,73,30,40,-1.269987944192303,33
3943,108,19,50,9,-1.270167576199734,10
3944,1,11,71,5,-1.2732152302328004,6
3945,80,12,17,7,-1.2769817296361932,5
3946,107,59,96,32,-1.2779661064945946,27
3947,35,22,88,11,-1.284113043358928,11
3948,74,53,16,28,-1.2870673809929654,25
3949,88,17,89,8,-1.2888997749635154,9
3950,99,19,51,9,-1.2892082407104553,10
3951,74,22,2,12,-1.2925512141562505,10
3952,48,15,57,8,-1.2933503211639656,7
3953,98,18,50,10,-1.2936360808559442,8
3954,8,22,7,12,-1.2952715014492404,10
3955,18,28,77,16,-1.2955025967533473,12
3956,58,10,27,5,-1.301397937970096,5
3957,13,44,5,23,-1.3023509853743016,21
3958,50,23,27,14,-1.3046741995517461,9
3959,64,11,84,7,-1.3059634387921004,4
3960,114,28,41,14,-1.307338108043571,14
3961,58,28,9,15,-1.3102681358219028,13
3962,9,52,68,27,-1.3104638696206783,25
3963,17,38,65,22,-1.3107276954105338,16
3964,65,32,112,16,-1.312297716343952,16
3965,40,11,94,6,-1.3131730085845184,5
3966,51,12,32,6,-1.314434714983353,6
3967,80,18,74,9,-1.3199661328668575,9
3968,96,57,8,30,-1.3267739850117202,27
3969,87,27,12,15,-1.3278353834684424,12
3970,51,32,50,16,-1.3326103812189873,16
3971,13,43,50,22,-1.3366507520453892,21
3972,81,13,108,7,-1.3379621241230497,6
3973,54,49,39,25,-1.3384616724370857,24
3974,23,10,6,5,-1.3385415186806267,5
3975,60,38,3,20,-1.3412010919461752,18
3976,84,25,34,13,-1.3462587503063752,12
3977,63,72,107,34,-1.3468604650887521,38
3978,86,53,57,27,-1.3474253453353349,26
3979,40,17,108,8,-1.3479697301696822,9
3980,88,37,97,19,-1.3490743629309028,18
3981,81,14,30,7,-1.3508923221630345,7
3982,87,17,111,9,-1.3561671479223416,8
3983,74,12,112,6,-1.3616749140437368,6
3984,30,26,25,12,-1.3633847180345777,14
3985,76,47,106,22,-1.3637390504385927,25
3986,48,10,75,5,-1.3711471542080287,5
3987,55,66,86,35,-1.3714897734674971,31
3988,41,51,39,25,-1.372500567882371,26
3989,62,15,55,8,-1.3800432063216195,7
3990,41,30,106,15,-1.3806292559177735,15
3991,7,31,95,17,-1.3809406634768695,14
3992,3,61,87,32,-1.3817700433345628,29
3993,29,11,36,5,-1.3837445576600587,6
3994,9,13,91,7,-1.3946381880594534,6
3995,44,12,75,7,-1.3998373775330364,5
3996,95,17,70,8,-1.4011695857654913,9
3997,64,36,87,18,-1.4019068150674143,18
3998,9,25,46,12,-1.4052752923291365,13
3999,71,20,12,10,-1.4059148964814152,10
4000,62,29,100,14,-1.4095954922785314,15
4001,72,11,66,6,-1.416761062195627,5
4002,90,35,16,17,-1.4190191744987375,18
4003,53,11,1,6,-1.4196819324858239,5
4004,55,23,71,11,-1.421958484011042,12
4005,45,35,36,16,-1.4232731245081227,19
4006,25,28,50,14,-1.4391705454909016,14
4007,97,21,20,10,-1.4395279608818727,11
4008,69,33,65,17,-1.4425642416495137,16
4009,62,29,39,16,-1.4474002147033358,13
4010,48,21,39,12,-1.4474709554841445,9
4011,63,55,106,28,-1.4485566818099482,27
4012,13,73,39,39,-1.450285772990475,34
4013,83,23,25,13,-1.459720188055496,10
4014,47,21,31,11,-1.4606130980712662,10
4015,51,64,40,33,-1.4624658901194143,31
4016,3,24,71,13,-1.4668209780059573,11
4017,69,13,6,6,-1.4672562795661197,7
4018,7,24,35,12,-1.4676220715119415,12
4019,32,17,11,8,-1.4729852723414758,9
4020,43,20,106,10,-1.474165054679951,10
4021,63,15,73,7,-1.4760785674332912,8
4022,79,17,103,9,-1.4762996181953623,8
4023,69,20,109,10,-1.4769023355605448,10
4024,84,10,68,6,-1.4788993773509191,4
4025,71,74,60,39,-1.4843115108657061,35
4026,62,17,76,9,-1.4886483429037691,8
4027,16,49,15,24,-1.493354088481601,25
4028,11,16,112,8,-1.4950492246382485,8
4029,25,47,107,24,-1.4967278623744356,23
4030,5,52,46,28,-1.4974094901037482,24
4031,63,34,9,18,-1.4983458266579128,16
4032,50,31,17,15,-1.49970720548843,16
4033,86,44,15,23,-1.4999058240445278,21
4034,16,28,33,13,-1.5061133339188544,15
4035,27,29,64,15,-1.5066564848276949,14
4036,8,37,30,20,-1.5081255824989241,17
4037,55,12,46,7,-1.514859018089955,5
4038,85,16,12,8,-1.5174687419154704,8
4039,62,26,27,13,-1.5182408665379916,13
4040,37,14,35,7,-1.523131742310598,7
4041,76,17,3,9,-1.5249357900982534,8
4042,27,72,68,38,-1.524949709281465,34
4043,84,20,114,11,-1.52828266290098,9
4044,81,15,64,8,-1.5315551836921653,7
4045,65,39,15,21,-1.531674161277603,18
4046,53,13,29,8,-1.5317670028644754,5
4047,11,21,94,10,-1.5369194320927224,11
4048,11,46,50,24,-1.543099478793574,22
4049,74,61,107,33,-1.5445233108407423,28
4050,102,25,57,13,-1.548376076980684,12
4051,74,41,87,22,-1.5487349955501406,19
4052,43,33,27,17,-1.5525087019998645,16
4053,11,20,80,10,-1.553265227546683,10
4054,55,44,75,25,-1.5547955200380577,19
4055,30,35,54,18,-1.5563350804518044,17
4056,83,23,104,13,-1.5563880557352991,10
4057,15,19,64,9,-1.5585187752284793,10
4058,13,119,16,65,-1.562085332083959,54
4059,106,26,109,13,-1.5621072878912867,13
4060,111,14,9,7,-1.5621342613374538,7
4061,12,16,50,6,-1.5648641628940974,10
4062,86,100,106,52,-1.5692663469089445,48
4063,78,27,30,14,-1.569607458561736,13
4064,41,43,63,23,-1.570459310802143,20
4065,100,17,85,9,-1.5724753567461303,8
4066,46,25,60,13,-1.5735893742532685,12
4067,88,34,96,17,-1.575548976259807,17
4068,17,26,68,14,-1.5761968862643292,12
4069,90,22,55,10,-1.578656952498874,12
4070,100,12,58,6,-1.5819008855655043,6
4071,61,20,88,12,-1.5819478875432604,8
4072,25,15,2,7,-1.5845186001024019,8
4073,62,23,49,13,-1.5851399264471626,10
4074,19,15,58,8,-1.5924855336204529,7
4075,75,11,14,6,-1.594721022285632,5
4076,60,33,18,17,-1.5967719343018119,16
4077,79,20,28,10,-1.6049020016645688,10
4078,69,29,30,15,-1.6139022710932374,14
4079,13,32,38,15,-1.6143148990855232,17
4080,18,19,81,10,-1.6163568658399634,9
4081,66,12,51,6,-1.6170702618301576,6
4082,87,17,44,9,-1.6239279411647838,8
4083,72,31,13,15,-1.6241775993144314,16
4084,86,28,35,16,-1.6302927109086072,12
4085,68,18,6,8,-1.6346986227731553,10
4086,49,10,102,6,-1.6394569107680623,4
4087,88,59,41,32,-1.639787437624219,27
4088,68,41,30,21,-1.639799876413629,20
4089,38,34,86,18,-1.6422594839902307,16
4090,66,14,86,7,-1.6453880931803606,7
4091,68,23,36,12,-1.6511686348202665,11
4092,74,47,37,24,-1.6628163329711265,23
4093,48,19,106,10,-1.6634533717988316,9
4094,17,16,85,9,-1.6640468368595824,7
4095,9,16,81,8,-1.6671416814909092,8
4096,33,19,54,11,-1.6683853925492647,8
4097,60,48,87,24,-1.6692465502528933,24
4098,112,17,17,9,-1.6709980493790124,8
4099,31,28,45,15,-1.6710870406691087,13
4100,7,45,63,27,-1.6735738766299244,18
4101,64,18,17,10,-1.674226151428344,8
4102,106,40,55,22,-1.6835382667235002,18
4103,51,29,47,14,-1.68572259250394,15
4104,28,59,88,32,-1.691739512223794,27
4105,5,64,28,33,-1.6933141899778517,31
4106,51,63,3,31,-1.6935910709708704,32
4107,23,15,36,6,-1.6972875274185715,9
4108,102,16,20,8,-1.6989391239814924,8
4109,57,15,85,8,-1.7034495534090752,7
4110,37,10,48,5,-1.703593750319215,5
4111,71,28,62,14,-1.7107847940783525,14
4112,107,31,98,16,-1.7124892646076513,15
4113,45,15,63,8,-1.7260545689947928,7
4114,107,35,17,18,-1.7269738989467145,17
4115,28,10,77,5,-1.7274479044716362,5
4116,68,13,32,8,-1.7311662598089228,5
4117,75,19,70,9,-1.7314858975507368,10
4118,96,38,106,21,-1.7318320126651903,17
4119,44,27,16,15,-1.7334648777380297,12
4120,106,19,48,10,-1.7335189393534853,9
4121,34,17,12,9,-1.7370731920288964,8
4122,88,37,36,21,-1.7392851936744331,16
4123,6,11,18,6,-1.7414584600944745,5
4124,36,33,60,17,-1.7416473627060742,16
4125,107,68,27,37,-1.744593702200835,31
4126,60,29,11,16,-1.7486537890116292,13
4127,43,21,104,12,-1.750605109142023,9
4128,70,26,84,14,-1.7530345342228948,12
4129,57,45,78,24,-1.7583662843402394,21
4130,110,11,88,5,-1.7642228121429868,6
4131,43,18,68,9,-1.7652060939878167,9
4132,46,59,11,31,-1.771019448583436,28
4133,69,21,50,10,-1.7758250016074644,11
4134,90,25,37,13,-1.7816453937181784,12
4135,8,20,29,12,-1.7818268121537415,8
4136,100,13,61,7,-1.7880372053867668,6
4137,46,27,97,14,-1.7888516310768021,13
4138,48,19,20,11,-1.7888857426975089,8
4139,16,77,54,40,-1.7894100662362953,37
4140,39,35,114,17,-1.7909993968165123,18
4141,104,55,88,30,-1.7934662263443766,25
4142,103,10,63,6,-1.799391808148131,4
4143,16,50,112,26,-1.7995643538534825,24
4144,41,32,18,16,-1.8004819942826362,16
4145,31,34,51,20,-1.8036645224364214,14
4146,86,16,89,7,-1.8045740019354706,9
4147,86,57,70,31,-1.8046372203949796,26
4148,25,22,36,11,-1.8071440138268584,11
4149,112,32,13,16,-1.8090394068654707,16
4150,111,18,40,9,-1.8104998545748818,9
4151,99,13,102,7,-1.8212893413036864,6
4152,114,13,44,7,-1.8263733365516708,6
4153,114,15,11,7,-1.8276036019184323,8
4154,13,29,74,15,-1.8278354237299068,14
4155,96,38,84,19,-1.835648682700679,19
4156,20,30,114,16,-1.839540566254475,14
4157,51,23,103,12,-1.8411846957244382,11
4158,76,27,30,15,-1.8425803619698329,12
4159,3,24,8,11,-1.848093580149501,13
4160,97,22,53,12,-1.8492466822191078,10
4161,54,42,11,22,-1.8528374886785282,20
4162,61,20,13,12,-1.8534850314433573,8
4163,114,21,43,10,-1.8643335671695762,11
4164,5,95,37,49,-1.865428870342572,46
4165,48,19,60,10,-1.868377497336699,9
4166,27,33,29,19,-1.8780724522867036,14
4167,8,41,2,21,-1.8848654476169693,20
4168,30,16,96,9,-1.8850748786904887,7
4169,64,23,25,12,-1.8857238852847689,11
4170,106,35,20,19,-1.890590591428699,16
4171,99,27,55,15,-1.895072402151854,12
4172,28,67,8,36,-1.9053784571291421,31
4173,88,21,12,11,-1.9079727374799846,10
4174,96,20,13,11,-1.9091929339453748,9
4175,1,38,68,20,-1.9099752765436673,18
4176,68,67,88,36,-1.914885527852775,31
4177,17,11,110,6,-1.9155371371930654,5
4178,106,32,97,16,-1.9159665785715099,16
4179,76,11,99,5,-1.9173589523208336,6
4180,64,43,53,23,-1.9214578200473016,20
4181,100,18,98,10,-1.9217645875630167,8
4182,88,56,55,32,-1.9221308051774746,24
4183,70,32,104,17,-1.9224071285610191,15
4184,79,10,9,6,-1.9224211679655938,4
4185,50,40,63,22,-1.9230864117365445,18
4186,18,21,114,11,-1.923577249757447,10
4187,28,89,16,48,-1.9239787295163941,41
4188,54,28,17,14,-1.9259736473512514,14
4189,40,19,70,11,-1.9276789997691202,8
4190,65,103,54,54,-1.9285945616026126,49
4191,97,14,23,7,-1.9330528734436563,7
4192,98,10,32,5,-1.9380052263831622,5
4193,7,49,71,24,-1.9387153694352766,25
4194,104,13,110,8,-1.9388474450810558,5
4195,31,14,23,8,-1.9392936999416424,6
4196,55,20,25,11,-1.9429576796619947,9
4197,94,15,33,8,-1.9451389474962029,7
4198,48,16,7,8,-1.9478692265013033,8
4199,64,34,36,17,-1.9485056781764598,17
4200,57,34,27,17,-1.953476656636175,17
4201,43,34,51,17,-1.9576260367562008,17
4202,35,11,50,6,-1.9581460146246743,5
4203,33,14,39,7,-1.9600955952261445,7
4204,84,42,87,23,-1.9615694257244276,19
4205,112,24,41,13,-1.964220147900722,11
4206,70,49,16,27,-1.9664047334731969,22
4207,16,36,72,20,-1.9684192720116818,16
4208,35,10,54,6,-1.9706076038783524,4
4209,78,17,28,8,-1.9711388035219528,9
4210,3,46,39,23,-1.973168826489563,23
4211,70,31,88,17,-1.9762934359596291,14
4212,53,28,95,17,-1.9769373995573178,11
4213,18,20,3,12,-1.9827434721081492,8
4214,25,38,28,22,-1.983389891159918,16
4215,4,15,30,8,-1.9875071363114745,7
4216,4,19,53,10,-1.987694792892672,9
4217,11,23,12,11,-1.987712815559192,12
4218,15,16,28,8,-1.9904779382853452,8
4219,88,15,85,8,-1.9929645574579284,7
4220,112,15,104,8,-1.9939359727925703,7
4221,22,11,34,6,-1.995632857420717,5
4222,74,26,114,13,-1.997597253168688,13
4223,27,11,66,6,-1.9992664520674241,5
4224,11,56,87,32,-2.000245875012727,24
4225,87,32,75,17,-2.0004298974911783,15
4226,46,26,68,14,-2.0015169846627177,12
4227,97,22,83,10,-2.007636873207568,12
4228,100,10,6,5,-2.007704936202784,5
4229,30,23,15,12,-2.0093044010429213,11
4230,86,47,23,25,-2.0116860012086675,22
4231,102,29,16,15,-2.0125036552898954,14
4232,12,21,88,11,-2.0143660264494705,10
4233,70,29,68,15,-2.015118158104638,14
4234,37,14,69,7,-2.015512849900142,7
4235,60,11,93,7,-2.018629631632218,4
4236,90,37,8,21,-2.01946478207178,16
4237,17,27,114,16,-2.021159075364869,11
4238,107,53,50,27,-2.025793662275194,26
4239,13,11,32,6,-2.026181507027533,5
4240,12,33,39,18,-2.029185849485713,15
4241,114,14,91,7,-2.031242634143396,7
4242,13,25,33,13,-2.031483396821485,12
4243,34,11,112,6,-2.0324399383154277,5
4244,104,41,8,22,-2.032634893277436,19
4245,17,21,104,11,-2.0345116655508884,10
4246,50,13,83,6,-2.034563553464953,7
4247,88,59,40,32,-2.0357313010299647,27
4248,100,21,37,12,-2.0359732342110695,9
4249,88,63,114,33,-2.0468316772780453,30
4250,88,21,93,12,-2.047097578055207,9
4251,104,43,39,23,-2.050102147252709,20
4252,34,32,17,16,-2.061414706570038,16
4253,63,10,82,5,-2.0779758612966877,5
4254,65,47,74,24,-2.0847963525870905,23
4255,51,14,44,9,-2.0848742289559725,5
4256,39,49,15,28,-2.085527392017013,21
4257,68,43,64,25,-2.0864244028015873,18
4258,11,18,40,9,-2.089442100461012,9
4259,8,74,54,42,-2.089621958137288,32
4260,91,12,17,7,-2.0932516032559643,5
4261,8,22,97,11,-2.094799206270941,11
4262,55,34,83,17,-2.0962093979720193,17
4263,79,18,84,9,-2.0988599029371886,9
4264,23,19,112,11,-2.1018527652621195,8
4265,107,32,108,17,-2.10558050439271,15
4266,94,28,68,15,-2.1065110625469554,13
4267,13,38,57,19,-2.1070868819342956,19
4268,25,11,69,6,-2.112059751085246,5
4269,72,17,7,9,-2.1143024060967655,8
4270,70,11,53,6,-2.117480208536356,5
4271,63,24,49,12,-2.1212323385530327,12
4272,9,62,7,31,-2.1219031094822904,31
4273,114,32,102,18,-2.1240842876015074,14
4274,61,12,2,7,-2.133108515807601,5
4275,74,30,11,16,-2.13476100803091,14
4276,30,20,7,9,-2.135688474905444,11
4277,39,39,71,21,-2.140211900940766,18
4278,69,11,55,6,-2.141856565606558,5
4279,49,11,89,6,-2.1552213251273216,5
4280,86,14,6,8,-2.158350497876565,6
4281,98,16,55,9,-2.1617935333932956,7
4282,53,13,23,7,-2.1639220781507644,6
4283,94,32,19,17,-2.165510462778429,15
4284,81,30,60,16,-2.1697382345262226,14
4285,68,46,41,24,-2.171804807510052,22
4286,93,16,84,8,-2.173203038685071,8
4287,3,17,58,10,-2.1750406456469484,7
4288,74,64,8,36,-2.1866220406514896,28
4289,54,10,31,5,-2.1866689261471493,5
4290,12,33,86,18,-2.1894855932114754,15
4291,47,13,19,7,-2.1915786077930717,6
4292,43,12,72,7,-2.1927570530466096,5
4293,40,33,41,17,-2.193580777269949,16
4294,106,35,68,19,-2.1936858069827965,16
4295,11,60,8,32,-2.1947518664362273,28
4296,40,75,7,42,-2.1957521283064807,33
4297,16,72,104,39,-2.198861242302897,33
4298,49,10,96,5,-2.201359601705883,5
4299,27,27,75,15,-2.203651126537084,12
4300,39,32,17,18,-2.206086386357857,14
4301,96,50,5,28,-2.21142719225076,22
4302,51,12,93,6,-2.216632142916852,6
4303,62,11,72,6,-2.217469660829094,5
4304,107,35,29,22,-2.217736121602627,13
4305,98,14,18,6,-2.2211477971408065,8
4306,99,13,98,6,-2.22125816779338,7
4307,12,11,112,5,-2.224733688615062,6
4308,39,43,75,21,-2.225217366532354,22
4309,25,16,90,9,-2.226157693683706,7
4310,13,107,68,57,-2.226955311742634,50
4311,74,27,20,15,-2.230377352624161,12
4312,65,18,46,11,-2.232998478058102,7
4313,20,14,18,8,-2.233452860395892,6
4314,114,26,4,13,-2.2345648368573685,13
4315,48,17,27,10,-2.2349641271706258,7
4316,107,61,68,31,-2.2392858218745864,30
4317,55,89,8,45,-2.2400324745199134,44
4318,49,21,64,12,-2.2416010602386143,9
4319,13,65,104,35,-2.2428038741485192,30
4320,27,10,70,5,-2.243263258457554,5
4321,4,38,88,20,-2.24592170041755,18
4322,69,36,87,21,-2.24685081086476,15
4323,83,11,63,7,-2.251852755522098,4
4324,25,30,95,16,-2.25397314365567,14
4325,41,13,74,6,-2.254565024803335,7
4326,107,89,65,47,-2.261779459812637,42
4327,106,62,87,32,-2.262204101784014,30
4328,88,45,106,26,-2.2639858690375605,19
4329,42,11,87,6,-2.267067713255768,5
4330,7,12,85,7,-2.267272935114745,5
4331,96,66,28,35,-2.2674069446039327,31
4332,8,84,86,42,-2.2684162276686486,42
4333,31,10,61,5,-2.2696136748473594,5
4334,68,108,7,58,-2.2702884441480373,50
4335,108,29,16,17,-2.27259194310602,12
4336,86,44,49,21,-2.272809252757547,23
4337,69,12,77,6,-2.2797993708458972,6
4338,40,47,9,26,-2.2806450266015688,21
4339,65,19,48,9,-2.2816603054261098,10
4340,81,10,38,5,-2.2819621266449897,5
4341,84,88,86,44,-2.284433513190378,44
4342,88,26,81,14,-2.2857834835265276,12
4343,4,13,106,6,-2.287883468044352,7
4344,112,38,86,21,-2.2924646864380605,17
4345,5,24,100,13,-2.2932427434044693,11
4346,7,20,80,11,-2.2986689861273333,9
4347,32,21,86,11,-2.2989864902239,10
4348,112,24,87,12,-2.29999509507633,12
4349,95,26,60,14,-2.3000350580848172,12
4350,3,16,103,7,-2.306139458514919,9
4351,37,23,57,12,-2.3105129908375908,11
4352,63,31,71,17,-2.3112629873314643,14
4353,91,32,88,17,-2.315767764685103,15
4354,102,21,104,10,-2.320627297470276,11
4355,88,21,77,11,-2.324899205812002,10
4356,42,10,72,6,-2.3285230567907305,4
4357,5,51,109,26,-2.3285813949081646,25
4358,53,28,25,14,-2.3301510854690832,14
4359,17,19,90,9,-2.330539928781356,10
4360,50,13,6,7,-2.341492332331065,6
4361,38,12,114,6,-2.3415263774379937,6
4362,43,50,16,28,-2.3507433165143348,22
4363,31,36,4,21,-2.3535355966794675,15
4364,33,12,99,7,-2.354570382478156,5
4365,109,14,96,8,-2.3566759619593642,6
4366,97,14,100,8,-2.3583259709010784,6
4367,88,44,64,25,-2.359083003612554,19
4368,5,23,99,12,-2.3616219022642833,11
4369,97,13,49,8,-2.3668261814242064,5
4370,50,24,40,14,-2.3671440474550494,10
4371,63,32,25,16,-2.368826537360261,16
4372,55,31,53,17,-2.372089532662412,14
4373,12,29,49,12,-2.375753597057763,17
4374,107,40,71,23,-2.3760609676092477,17
4375,79,11,78,6,-2.376529733586171,5
4376,112,14,8,8,-2.379829723910836,6
4377,18,35,88,18,-2.3825741558006106,17
4378,56,13,75,8,-2.3840139649043506,5
4379,104,25,96,14,-2.3866419839158355,11
4380,71,21,4,13,-2.3871750117365993,8
4381,95,40,104,22,-2.389034218387607,18
4382,48,13,23,7,-2.3894452247322278,6
4383,45,22,16,13,-2.3925466679441407,9
4384,51,37,20,18,-2.3967661114188865,19
4385,109,21,97,11,-2.398141101921527,10
4386,28,38,46,22,-2.3990178798165633,16
4387,98,15,114,8,-2.3992721750256893,7
4388,80,26,20,14,-2.4033351571638573,12
4389,69,18,9,10,-2.4050002453980612,8
4390,66,13,106,8,-2.407503356329986,5
4391,86,117,107,63,-2.409383648607944,54
4392,16,46,78,25,-2.4095230161360495,21
4393,93,33,8,17,-2.4111455321691304,16
4394,92,11,65,6,-2.411285975254871,5
4395,28,28,60,13,-2.412225021834092,15
4396,94,19,28,11,-2.414960475317553,8
4397,86,28,108,16,-2.416374005048123,12
4398,99,11,109,6,-2.419517402501058,5
4399,77,68,60,36,-2.4218218165078453,32
4400,4,23,55,12,-2.4222288362060125,11
4401,9,56,88,30,-2.4233671798250107,26
4402,65,86,87,46,-2.4263513590294448,40
4403,38,17,8,9,-2.4272670792995714,8
4404,75,20,91,7,-2.4323694332612673,13
4405,23,54,16,29,-2.4326142049861335,25
4406,51,19,14,12,-2.4338441230915153,7
4407,102,24,109,13,-2.4374588964673864,11
4408,47,15,64,9,-2.441201731533323,6
4409,27,30,8,16,-2.4425733286028306,14
4410,50,10,32,4,-2.4440541907162716,6
4411,61,15,63,9,-2.4454100802634517,6
4412,51,53,8,28,-2.455772911290401,25
4413,86,17,110,9,-2.4597124602837575,8
4414,25,32,102,17,-2.4608896969250464,15
4415,1,17,17,9,-2.4627610735098764,8
4416,69,17,74,8,-2.466497282082454,9
4417,81,17,4,10,-2.467812477706327,7
4418,103,17,30,10,-2.4703689712282206,7
4419,72,11,30,6,-2.4724333071348408,5
4420,20,20,17,11,-2.47595507024807,9
4421,11,37,76,21,-2.481209953490073,16
4422,77,23,19,12,-2.4816175382976233,11
4423,29,35,16,18,-2.483874524711147,17
4424,111,11,18,6,-2.489910872635885,5
4425,11,21,64,13,-2.490493863054093,8
4426,107,44,34,25,-2.494421871197337,19
4427,111,37,65,21,-2.4964278491140752,16
4428,20,17,57,9,-2.4989361317601504,8
4429,67,13,84,6,-2.5007098745341834,7
4430,109,18,37,10,-2.5010134043415313,8
4431,78,42,86,22,-2.507883302246767,20
4432,36,15,12,8,-2.5163199425137495,7
4433,39,35,57,18,-2.5204234652197326,17
4434,11,17,14,10,-2.5264878637219237,7
4435,4,18,39,10,-2.5267698999647226,8
4436,9,33,36,18,-2.527924078037467,15
4437,30,19,99,11,-2.5303882936847786,8
4438,107,15,44,8,-2.5305445670994087,7
4439,17,29,7,16,-2.5320894413613915,13
4440,95,20,20,11,-2.5325274069422727,9
4441,43,24,41,13,-2.5392354831563426,11
4442,65,35,97,19,-2.5397394280205696,16
4443,95,14,77,7,-2.5410335587352315,7
4444,20,40,88,20,-2.541950104212904,20
4445,38,22,60,11,-2.5449702313683376,11
4446,36,74,7,40,-2.54935875079736,34
4447,76,14,44,8,-2.550414193143335,6
4448,30,12,47,5,-2.551854085041667,7
4449,47,33,16,18,-2.552088838549869,15
4450,1,19,73,11,-2.5534291003907295,8
4451,11,21,7,12,-2.554018943860652,9
4452,43,10,90,5,-2.5580681557920104,5
4453,38,25,88,15,-2.560016870827125,10
4454,68,71,16,41,-2.5614728211913396,30
4455,7,34,43,20,-2.5615476994306405,14
4456,65,10,21,6,-2.570147671925826,4
4457,61,14,27,7,-2.57284080053487,7
4458,51,29,1,15,-2.5741193049184683,14
4459,109,14,78,7,-2.574648131751719,7
4460,47,10,62,6,-2.5775304802735826,4
4461,112,22,50,13,-2.578275791966446,9
4462,88,15,33,9,-2.581178022844095,6
4463,29,20,41,11,-2.5826644120051867,9
4464,48,42,16,22,-2.5852222637676325,20
4465,18,33,86,19,-2.5923706641316473,14
4466,109,10,1,5,-2.592960677140225,5
4467,27,44,41,25,-2.596716183086402,19
4468,80,32,65,17,-2.5986356922004106,15
4469,103,15,43,9,-2.5988649430322988,6
4470,91,23,36,13,-2.600483205457647,10
4471,19,39,43,21,-2.603005615202756,18
4472,1,29,40,16,-2.608102727316189,13
4473,107,33,94,20,-2.613370215138467,13
4474,64,28,75,15,-2.614396425436705,13
4475,89,10,39,6,-2.6189716831037586,4
4476,28,42,39,22,-2.623339407780362,20
4477,85,10,8,6,-2.6233679922969846,4
4478,8,33,23,18,-2.626483448480395,15
4479,86,36,91,19,-2.627461430980282,17
4480,54,13,110,7,-2.6358849029934492,6
4481,11,40,13,22,-2.637307973213511,18
4482,69,24,100,13,-2.641711217702834,11
4483,5,60,16,35,-2.643518445682432,25
4484,102,32,54,17,-2.645569582100471,15
4485,20,20,19,10,-2.646933293157401,10
4486,36,13,57,8,-2.653116090105381,5
4487,88,29,92,16,-2.65412565592523,13
4488,89,13,51,7,-2.656220632059645,6
4489,27,24,40,11,-2.6563176029466598,13
4490,20,33,11,19,-2.658025854837769,14
4491,91,13,74,7,-2.658254293210725,6
4492,1,29,41,17,-2.6671220598664935,12
4493,7,118,13,63,-2.6708973171944717,55
4494,44,17,25,9,-2.673535476281759,8
4495,12,10,48,6,-2.675775448389388,4
4496,94,18,78,10,-2.675832304313798,8
4497,88,66,60,37,-2.676500890728167,29
4498,5,25,39,13,-2.6791322172692884,12
4499,58,14,43,8,-2.6806335210316137,6
4500,107,21,93,12,-2.6848247910711387,9
4501,30,26,28,13,-2.6864332481864484,13
4502,71,40,65,23,-2.6867803351656674,17
4503,102,20,13,12,-2.6891186576501758,8
4504,31,22,87,11,-2.6915087275033085,11
4505,11,26,48,14,-2.6929391751506655,12
4506,30,17,9,10,-2.6960180413408095,7
4507,3,37,12,21,-2.6999409236974605,16
4508,68,27,47,15,-2.700809442975109,12
4509,76,30,70,15,-2.70093044855826,15
4510,79,11,39,7,-2.7039365709334438,4
4511,54,62,87,35,-2.7078927354800775,27
4512,33,14,90,8,-2.70862298496318,6
4513,60,39,43,21,-2.71188258861537,18
4514,70,16,49,8,-2.7131214221068403,8
4515,4,20,63,11,-2.7170319642618344,9
4516,33,13,49,8,-2.7186925494377556,5
4517,87,22,77,12,-2.718895137209104,10
4518,80,11,95,6,-2.7197438471090796,5
4519,54,19,41,10,-2.720244948724289,9
4520,51,17,58,9,-2.7220403540386453,8
4521,88,16,44,8,-2.7255415222047015,8
4522,27,18,81,10,-2.728809971625026,8
4523,98,22,51,12,-2.729369792679445,10
4524,112,35,107,18,-2.7341883012072423,17
4525,54,25,15,12,-2.7351472639255974,13
4526,106,50,65,27,-2.735321183024918,23
4527,63,21,47,10,-2.7370968886641953,11
4528,63,12,99,6,-2.7377253409939377,6
4529,104,22,97,11,-2.7396377781056187,11
4530,68,31,69,17,-2.743936079051887,14
4531,62,45,16,27,-2.7487915093897546,18
4532,65,36,43,18,-2.7525986025329345,18
4533,43,14,70,8,-2.753352748891417,6
4534,96,34,97,17,-2.7556888339056815,17
4535,107,77,88,43,-2.7611647728657993,34
4536,94,17,1,8,-2.7623810098011994,9
4537,77,17,5,9,-2.7658375671945885,8
4538,10,11,5,5,-2.7716738654503192,6
4539,19,43,49,23,-2.774345326212919,20
4540,103,11,77,6,-2.7849069943634928,5
4541,91,31,28,17,-2.78581966806185,14
4542,41,58,51,31,-2.788035903246996,27
4543,112,14,85,8,-2.788857070839803,6
4544,102,12,70,5,-2.7906887378625402,7
4545,36,13,100,7,-2.7923934619121096,6
4546,1,26,7,14,-2.793205495238504,12
4547,44,14,68,7,-2.795327721392829,7
4548,8,32,83,16,-2.795775595052066,16
4549,112,14,106,7,-2.805082024542768,7
4550,72,11,20,6,-2.8074079366688274,5
4551,41,15,99,8,-2.808167291861728,7
4552,76,26,46,14,-2.809518783996085,12
4553,36,32,1,16,-2.8095303452930684,16
4554,39,18,34,9,-2.816812397698095,9
4555,48,14,68,7,-2.820644331468806,7
4556,71,13,18,7,-2.821320109059578,6
4557,62,18,54,10,-2.824080555827827,8
4558,112,21,75,12,-2.824219405034075,9
4559,50,44,2,24,-2.824465738990298,20
4560,9,49,107,25,-2.8292011367922663,24
4561,86,61,114,32,-2.830798394303986,29
4562,81,23,53,13,-2.832269045840244,10
4563,49,41,30,23,-2.833183272591318,18
4564,35,11,39,6,-2.8361547619317586,5
4565,43,21,78,12,-2.8365700958138973,9
4566,17,28,28,15,-2.8369834071231876,13
4567,16,25,4,12,-2.841104684052144,13
4568,39,33,95,18,-2.8414955259540986,15
4569,102,25,8,13,-2.845551076408804,12
4570,44,13,28,6,-2.846139863099275,7
4571,33,13,97,7,-2.8486496222061595,6
4572,61,21,3,14,-2.8504924308729245,7
4573,96,16,73,9,-2.853430398009382,7
4574,43,11,74,5,-2.8537773738161762,6
4575,49,10,79,6,-2.8563921563379915,4
4576,3,21,109,11,-2.8572484191290473,10
4577,94,15,88,7,-2.8588031686479423,8
4578,28,25,69,13,-2.86191295640514,12
4579,88,14,72,8,-2.866088260356642,6
4580,63,23,46,11,-2.867241869896345,12
4581,17,10,88,4,-2.869337502995377,6
4582,1,14,112,9,-2.8723250567679255,5
4583,53,12,57,6,-2.8739584447786406,6
4584,30,21,75,11,-2.874328227945735,10
4585,77,14,106,7,-2.8755893681261506,7
4586,87,23,83,12,-2.880053494146307,11
4587,51,139,16,74,-2.8865327335551183,65
4588,43,27,11,14,-2.8898992854022114,13
4589,89,17,50,10,-2.89533112730357,7
4590,70,10,44,5,-2.8975248911261424,5
4591,9,27,50,15,-2.8991061521351393,12
4592,51,31,70,16,-2.904546585958991,15
4593,37,19,91,10,-2.9050960547005253,9
4594,54,36,80,18,-2.9116630961094714,18
4595,28,100,86,56,-2.9116733038896894,44
4596,108,12,25,7,-2.9132670669268257,5
4597,33,10,37,6,-2.9157377490462184,4
4598,106,19,102,9,-2.9207255392565092,10
4599,86,82,74,43,-2.9212877807151494,39
4600,109,32,104,17,-2.921401798219769,15
4601,62,14,1,7,-2.9215215839903856,7
4602,33,10,3,6,-2.927658221464783,4
4603,40,18,12,9,-2.930289703709333,9
4604,66,12,9,6,-2.9315079085260156,6
4605,78,25,88,14,-2.9333918667099623,11
4606,28,21,33,10,-2.934003356051787,11
4607,87,20,36,12,-2.9355732508976633,8
4608,49,27,68,15,-2.9363199373932996,12
4609,65,27,83,14,-2.938404758323201,13
4610,9,10,72,5,-2.9405168738711245,5
4611,46,18,71,9,-2.9448527741935417,9
4612,87,37,18,21,-2.947620136311878,16
4613,49,29,17,14,-2.949684397508393,15
4614,29,19,54,11,-2.949914447875301,8
4615,43,15,29,8,-2.953551510168091,7
4616,87,18,6,10,-2.9548534484805393,8
4617,86,51,60,28,-2.958155015888654,23
4618,46,23,114,13,-2.9631435316072414,10
4619,57,18,25,10,-2.964934950553877,8
4620,17,10,26,5,-2.965521786469379,5
4621,37,21,2,11,-2.96975801126945,10
4622,4,32,36,19,-2.9739066740354194,13
4623,106,36,84,18,-2.9754739608250116,18
4624,1,13,46,6,-2.9771068452784495,7
4625,48,15,80,9,-2.9854010336942434,6
4626,3,31,88,17,-2.98629427981839,14
4627,34,11,114,5,-2.988482941118179,6
4628,49,33,76,18,-2.991297986979845,15
4629,90,47,86,27,-2.9972067340822783,20
4630,12,22,23,12,-2.998239206737618,10
4631,65,27,62,14,-2.999159330673646,13
4632,69,11,4,6,-2.9994841766617175,5
4633,34,14,96,8,-3.001763014782562,6
4634,37,47,20,25,-3.0049852144749636,22
4635,39,43,9,22,-3.012148514540606,21
4636,48,20,30,12,-3.014647330297821,8
4637,30,10,98,5,-3.02034303732743,5
4638,88,29,47,15,-3.0208806441241425,14
4639,33,17,40,11,-3.0217035797006933,6
4640,98,13,39,8,-3.033232316977352,5
4641,65,39,25,23,-3.0368934823131157,16
4642,12,30,68,16,-3.041358769608484,14
4643,96,13,38,7,-3.0422152322461713,6
4644,107,37,15,23,-3.0494114346230554,14
4645,60,32,78,17,-3.052731445661802,15
4646,8,17,10,10,-3.0558998323304016,7
4647,57,11,6,6,-3.056750466696465,5
4648,86,42,71,22,-3.0606693617391714,20
4649,41,34,60,17,-3.06259969646343,17
4650,25,18,71,10,-3.0644100067848146,8
4651,25,30,75,17,-3.069551733540898,13
4652,95,12,57,8,-3.0723044699630697,4
4653,60,29,19,15,-3.0741844930514612,14
4654,37,59,107,32,-3.087858660035624,27
4655,96,22,51,12,-3.0911457625040346,10
4656,107,91,13,49,-3.092266884905595,42
4657,27,17,6,9,-3.0947871865212924,8
4658,109,10,85,7,-3.095406882310695,3
4659,91,10,64,6,-3.0993479020870796,4
4660,74,16,88,10,-3.1000151762465555,6
4661,68,14,99,8,-3.100103615084465,6
4662,27,13,74,6,-3.1002755903304386,7
4663,60,15,92,9,-3.101629065738581,6
4664,87,38,29,22,-3.101661587985348,16
4665,86,21,111,12,-3.1037611827633413,9
4666,30,23,20,12,-3.104651925893034,11
4667,4,24,50,12,-3.1105592371369597,12
4668,17,25,25,14,-3.1106502600539105,11
4669,80,11,36,6,-3.1158574211756616,5
4670,94,42,43,23,-3.121120942526353,19
4671,11,26,34,15,-3.1224893996672782,11
4672,61,15,51,10,-3.123205657151169,5
4673,87,124,86,64,-3.1289403554174773,60
4674,2,15,76,9,-3.135016863493125,6
4675,45,12,112,6,-3.1460936650177533,6
4676,23,23,75,11,-3.148733601092015,12
4677,19,39,54,23,-3.1558386236264377,16
4678,7,51,104,28,-3.158219418007504,23
4679,82,21,86,12,-3.1586560919846263,9
4680,72,25,86,14,-3.1653246669242354,11
4681,74,14,90,9,-3.168061351028922,5
4682,3,28,11,16,-3.170749513155222,12
4683,60,25,106,15,-3.171261503808182,10
4684,51,39,57,21,-3.1757178835501545,18
4685,30,12,74,6,-3.175828716417198,6
4686,69,16,103,8,-3.1785957104061207,8
4687,47,14,72,7,-3.1816598855809177,7
4688,11,29,30,16,-3.1818482711889744,13
4689,50,21,100,12,-3.182484639829971,9
4690,114,31,54,16,-3.1847921316014234,15
4691,50,54,37,28,-3.1883352760136074,26
4692,5,61,88,32,-3.1946532218196624,29
4693,39,41,36,23,-3.1998605067578225,18
4694,34,22,100,11,-3.200899472340228,11
4695,86,93,7,53,-3.2025353891099275,40
4696,17,28,106,17,-3.2039846830051117,11
4697,20,18,15,10,-3.2047440335755613,8
4698,51,51,106,28,-3.2074755817578335,23
4699,97,12,56,6,-3.2085312435870676,6
4700,31,47,60,23,-3.2094707274879264,24
4701,104,64,37,36,-3.2105942477112235,28
4702,97,19,50,11,-3.210625734622642,8
4703,74,16,17,9,-3.21177055102783,7
4704,28,39,55,23,-3.2184704312839756,16
4705,7,55,23,30,-3.222928305376168,25
4706,51,103,13,54,-3.227556289434052,49
4707,58,12,12,7,-3.234783078384574,5
4708,36,49,107,26,-3.234838704648262,23
4709,86,93,63,54,-3.236835270517722,39
4710,34,18,9,10,-3.2368917561941424,8
4711,60,25,99,14,-3.238194459102709,11
4712,81,12,23,7,-3.2407035870770007,5
4713,96,10,64,6,-3.247034103841878,4
4714,15,38,100,21,-3.2528324504039126,17
4715,25,47,114,27,-3.2540864225169766,20
4716,108,11,29,6,-3.254331422994319,5
4717,74,24,7,15,-3.257493143792889,9
4718,77,34,86,19,-3.259763892176762,15
4719,53,56,18,30,-3.2615252410170648,26
4720,54,56,28,31,-3.262278028179984,25
4721,65,57,8,31,-3.2717260560147303,26
4722,13,20,85,12,-3.272077258935019,8
4723,67,13,114,7,-3.274670651234843,6
4724,53,50,39,28,-3.277161726088196,22
4725,68,31,19,18,-3.2786498819088243,13
4726,78,31,68,17,-3.2853723279616904,14
4727,60,25,90,15,-3.2889183131065622,10
4728,35,15,55,8,-3.2899027901624813,7
4729,5,60,104,32,-3.3007473735225057,28
4730,61,13,47,7,-3.3043540506366424,6
4731,29,30,3,17,-3.304635369456712,13
4732,64,21,114,12,-3.304666725448282,9
4733,66,12,88,7,-3.305300021832229,5
4734,96,14,41,9,-3.308894289236027,5
4735,79,19,63,11,-3.3134147957453677,8
4736,75,31,60,17,-3.313915862803686,14
4737,84,16,97,10,-3.316428205809935,6
4738,97,14,98,7,-3.3185319117606182,7
4739,51,46,28,24,-3.330644392104213,22
4740,3,44,68,23,-3.331199454130328,21
4741,5,13,68,7,-3.3380294056441127,6
4742,98,20,54,11,-3.3414082574983,9
4743,91,15,40,8,-3.345577169162442,7
4744,60,61,51,37,-3.3463130273558974,24
4745,65,20,94,10,-3.3472699488499087,10
4746,20,10,83,5,-3.347889825164404,5
4747,107,15,14,9,-3.3479962116917545,6
4748,51,85,88,43,-3.3509269089088347,42
4749,106,17,14,10,-3.3600594128266095,7
4750,8,23,14,13,-3.3634201583462153,10
4751,97,25,54,13,-3.364815342765676,12
4752,20,17,40,10,-3.3649339637959637,7
4753,57,27,69,16,-3.367166221655228,11
4754,87,32,15,17,-3.370814069097881,15
4755,39,40,64,22,-3.3772164918090795,18
4756,98,15,73,8,-3.3800553651819163,7
4757,55,28,36,15,-3.383336577257353,13
4758,9,31,60,18,-3.3853349951371756,13
4759,104,10,73,6,-3.391491099464731,4
4760,5,50,55,28,-3.393419962444799,22
4761,28,13,4,7,-3.3940824912486858,6
4762,86,142,16,81,-3.3961177612926936,61
4763,84,29,55,16,-3.4012305577969593,13
4764,102,15,3,8,-3.413104863312669,7
4765,36,11,17,5,-3.417273645156755,6
4766,112,17,54,10,-3.4203709759608767,7
4767,37,12,4,7,-3.4218717037755084,5
4768,69,10,108,4,-3.4269138907252144,6
4769,11,49,55,29,-3.4281320850013386,20
4770,27,35,34,19,-3.429203163509601,16
4771,81,11,78,5,-3.4320246992935264,6
4772,90,38,107,20,-3.442650987354403,18
4773,55,28,76,17,-3.4438952481653042,11
4774,49,35,87,18,-3.44558072643024,17
4775,46,63,86,37,-3.447367416883429,26
4776,114,14,112,7,-3.4529529803290626,7
4777,23,21,37,11,-3.4530437057487418,10
4778,5,23,33,12,-3.454327509177194,11
4779,54,53,46,29,-3.462224315333584,24
4780,5,60,74,32,-3.4699961467083447,28
4781,11,44,51,25,-3.472776128070486,19
4782,54,57,96,29,-3.47661338595835,28
4783,18,16,55,8,-3.481046717374471,8
4784,78,42,13,23,-3.4834703080770653,19
4785,70,20,25,11,-3.484518115943737,9
4786,45,16,41,10,-3.4850666688674528,6
4787,51,30,36,16,-3.4874600225025065,14
4788,36,13,62,7,-3.489528327052378,6
4789,109,26,20,16,-3.492917739743867,10
4790,55,19,48,11,-3.494162257250903,8
4791,114,36,97,20,-3.494809729950691,16
4792,51,39,114,20,-3.4973322349486486,19
4793,47,12,58,7,-3.4979705643460655,5
4794,15,22,23,12,-3.5001626021093473,10
4795,13,63,100,34,-3.50051168227405,29
4796,108,13,37,7,-3.5019197237718496,6
4797,109,27,25,15,-3.504136926234725,12
4798,23,16,74,9,-3.5053157619270587,7
4799,3,21,23,12,-3.5128096943873843,9
4800,50,18,43,11,-3.5141816448286627,7
4801,100,14,53,8,-3.519519789056673,6
4802,103,13,76,8,-3.521454752878398,5
4803,34,25,109,14,-3.528628974498501,11
4804,25,17,93,9,-3.530039788975629,8
4805,62,10,6,6,-3.534555615892033,4
4806,7,15,44,8,-3.535266020755452,7
4807,36,65,40,37,-3.5400829247343655,28
4808,27,29,47,16,-3.5439664319349258,13
4809,19,31,13,18,-3.544087166327379,13
4810,70,11,33,6,-3.5452850377562317,5
4811,49,17,114,8,-3.5487282111911385,9
4812,74,25,75,15,-3.5502981320595746,10
4813,65,49,53,26,-3.552341058928982,23
4814,30,15,114,8,-3.554559185886989,7
4815,36,19,28,10,-3.554999615354126,9
4816,79,12,60,7,-3.5553709332305647,5
4817,16,35,34,20,-3.556384138241578,15
4818,64,41,107,22,-3.561300386963444,19
4819,108,13,79,8,-3.562523700236057,5
4820,7,28,6,13,-3.5631855242339143,15
4821,84,13,62,7,-3.5672380956620335,6
4822,43,19,25,12,-3.5730773529480744,7
4823,87,22,14,13,-3.5746572289058,9
4824,95,10,97,6,-3.58943247133478,4
4825,30,12,17,6,-3.5949084621895326,6
4826,16,57,75,31,-3.5952902080350193,26
4827,18,19,91,11,-3.6010074197876603,8
4828,39,17,69,9,-3.6024816939136084,8
4829,88,36,1,19,-3.612486249864136,17
4830,85,18,28,10,-3.6213061715807027,8
4831,28,26,80,14,-3.6230809501897747,12
4832,19,23,62,14,-3.6244910416057854,9
4833,18,19,43,9,-3.6267699505365183,10
4834,11,15,33,7,-3.6324699886469727,8
4835,28,52,20,29,-3.638022846799735,23
4836,68,36,54,21,-3.638947721326895,15
4837,107,57,41,34,-3.639009088239298,23
4838,9,22,49,11,-3.641292433645158,11
4839,49,19,50,10,-3.645049395982722,9
4840,70,10,14,5,-3.6470421341148493,5
4841,66,16,63,9,-3.650382654951078,7
4842,80,34,16,20,-3.650847383014163,14
4843,18,11,17,5,-3.6519056838531805,6
4844,20,11,62,6,-3.653244367006128,5
4845,9,15,109,7,-3.6538651478462696,8
4846,60,45,30,28,-3.65390835767515,17
4847,77,20,55,11,-3.6546881978963213,9
4848,32,21,107,11,-3.6546977761524695,10
4849,71,10,90,5,-3.656103603020123,5
4850,15,27,49,14,-3.659149591383062,13
4851,31,24,39,14,-3.6610558433956144,10
4852,65,80,51,45,-3.664771412812795,35
4853,38,38,107,22,-3.669594298718899,16
4854,84,21,38,11,-3.6699802067032485,10
4855,50,54,87,29,-3.673811024150394,25
4856,109,23,65,11,-3.6820630235649316,12
4857,88,55,27,29,-3.6892145620737335,26
4858,28,19,23,10,-3.6970356039584393,9
4859,35,10,112,5,-3.704644012481237,5
4860,15,46,57,25,-3.706639476988935,21
4861,14,16,65,8,-3.707339765184437,8
4862,11,18,77,10,-3.711392742612507,8
4863,64,21,1,11,-3.714096825641642,10
4864,5,21,15,13,-3.7147342263498238,8
4865,11,14,85,8,-3.719074703847315,6
4866,104,15,89,8,-3.71970917274833,7
4867,54,64,20,33,-3.7237387131550492,31
4868,60,14,89,7,-3.723763452657912,7
4869,27,24,76,14,-3.724092782904178,10
4870,20,47,87,25,-3.724230400091726,22
4871,40,13,15,7,-3.72557831166786,6
4872,12,14,54,7,-3.727845074231436,7
4873,40,59,60,33,-3.735016412978278,26
4874,25,65,86,35,-3.735239092039536,30
4875,4,13,1,8,-3.7360390878519714,5
4876,7,31,15,15,-3.741081293807926,16
4877,40,42,53,23,-3.7429391558119995,19
4878,109,28,76,17,-3.743667571855247,11
4879,76,21,41,10,-3.750106309053706,11
4880,81,23,107,13,-3.750967395824281,10
4881,17,14,102,8,-3.765627490194503,6
4882,19,39,39,24,-3.7723271053894094,15
4883,13,47,114,23,-3.7759149187311776,24
4884,92,13,104,6,-3.7768187223532292,7
4885,93,10,7,5,-3.7802315490169662,5
4886,19,39,78,23,-3.7879382183310812,16
4887,39,11,6,6,-3.7966207547038056,5
4888,16,80,60,44,-3.805678741226447,36
4889,102,16,62,9,-3.80648773210449,7
4890,78,22,72,11,-3.8085176531004055,11
4891,5,16,110,9,-3.8138584796050923,7
4892,91,28,5,17,-3.814625093066516,11
4893,79,31,16,18,-3.819316250104339,13
4894,60,19,62,10,-3.822113325977996,9
4895,3,11,4,6,-3.825046392091852,5
4896,13,26,91,14,-3.8317482607331113,12
4897,60,77,13,45,-3.8326689716078373,32
4898,55,44,7,26,-3.8332053851439998,18
4899,109,45,16,26,-3.833289533054693,19
4900,46,13,38,8,-3.8338597693432233,5
4901,12,11,47,6,-3.8390154161535603,5
4902,7,26,20,14,-3.839940256500115,12
4903,31,23,18,12,-3.8430258307678655,11
4904,15,20,72,10,-3.8434788823037858,10
4905,38,21,30,13,-3.8447589179027672,8
4906,47,12,109,7,-3.8566604611588287,5
4907,107,50,40,30,-3.857060552716013,20
4908,62,33,86,18,-3.857981546675883,15
4909,104,29,30,15,-3.861841224882902,14
4910,63,41,74,22,-3.8635092916190312,19
4911,27,52,39,31,-3.8705079550154746,21
4912,41,86,65,51,-3.8730812369047194,35
4913,78,18,15,9,-3.8743903606720744,9
4914,104,33,41,17,-3.881745214521683,16
4915,29,19,76,9,-3.891834089248112,10
4916,54,25,1,14,-3.8929886538978167,11
4917,57,23,28,13,-3.8971175709019774,10
4918,58,13,77,7,-3.8981506835692437,6
4919,84,51,51,29,-3.8997018485628714,22
4920,63,30,55,16,-3.900377194965694,14
4921,91,15,102,8,-3.901213400624812,7
4922,37,26,102,15,-3.901578428361024,11
4923,90,11,64,6,-3.902108781861291,5
4924,52,14,30,8,-3.910728614777823,6
4925,46,50,51,28,-3.912731533664656,22
4926,87,38,95,21,-3.915668057739164,17
4927,3,32,15,18,-3.92106671332567,14
4928,70,38,37,22,-3.9227382855891673,16
4929,2,28,5,16,-3.923277825320168,12
4930,20,15,85,8,-3.925425491644285,7
4931,15,30,60,16,-3.934539265699295,14
4932,97,10,80,6,-3.9365866928471034,4
4933,98,15,102,8,-3.939114797619031,7
4934,40,11,6,6,-3.9442678680230827,5
4935,43,19,35,10,-3.946831407739413,9
4936,65,61,28,35,-3.946950789839021,26
4937,104,11,67,6,-3.95056976239549,5
4938,49,26,78,14,-3.9527522510286137,12
4939,93,24,74,13,-3.960101768879081,11
4940,96,15,78,9,-3.9616133541960434,6
4941,14,12,96,7,-3.975747798085754,5
4942,97,18,60,9,-3.9792005525226375,9
4943,69,29,41,18,-3.9797729258891983,11
4944,6,18,88,10,-3.9856102257236907,8
4945,3,12,106,7,-3.9869286680549827,5
4946,68,13,89,7,-3.9920034832972595,6
4947,100,18,9,11,-3.995326860016922,7
4948,112,16,31,10,-4.001730552260451,6
4949,54,40,13,23,-4.002518666516474,17
4950,71,33,30,18,-4.006253796204616,15
4951,31,12,66,7,-4.0087548725586535,5
4952,110,20,8,12,-4.013172679497405,8
4953,35,21,16,13,-4.016361918873652,8
4954,96,21,39,13,-4.016816457185763,8
4955,47,31,7,18,-4.025431088719288,13
4956,114,42,60,20,-4.029174933224298,22
4957,47,13,71,7,-4.030916530509354,6
4958,10,10,104,5,-4.031221485043642,5
4959,114,41,63,26,-4.037972989054352,15
4960,43,10,1,5,-4.03897671575872,5
4961,51,25,71,14,-4.0432752193478,11
4962,69,12,84,7,-4.046782427990888,5
4963,40,10,32,5,-4.050021677419869,5
4964,50,11,94,7,-4.051144013437595,4
4965,20,10,14,6,-4.051966837258037,4
4966,11,20,79,12,-4.052675901080834,8
4967,39,11,56,5,-4.06142915092174,6
4968,95,10,43,6,-4.0633983206079485,4
4969,38,12,20,8,-4.067291998076463,4
4970,18,38,28,20,-4.067881996028204,18
4971,31,68,7,38,-4.069172309295859,30
4972,8,38,60,20,-4.0695105804007685,18
4973,46,21,95,12,-4.071848693893576,9
4974,5,117,86,66,-4.074944655375777,51
4975,98,17,78,9,-4.084899624702041,8
4976,19,11,36,6,-4.0885902184216905,5
4977,51,51,17,27,-4.088673144397257,24
4978,46,67,13,39,-4.091227749409544,28
4979,39,17,80,9,-4.091599339844536,8
4980,43,25,69,14,-4.093607533799894,11
4981,54,33,104,18,-4.094488077381487,15
4982,35,24,20,14,-4.098728722002913,10
4983,62,15,30,8,-4.099340749559773,7
4984,93,20,83,11,-4.100880722204593,9
4985,37,54,16,30,-4.101602264091046,24
4986,74,35,104,21,-4.104594141618062,14
4987,49,60,16,35,-4.104686156783942,25
4988,63,30,97,17,-4.107378727934806,13
4989,19,46,100,26,-4.112454947141802,20
4990,2,12,7,7,-4.115660194227726,5
4991,54,38,55,20,-4.117783078696892,18
4992,87,23,58,13,-4.119284370275493,10
4993,106,51,107,28,-4.131711792879518,23
4994,27,51,7,28,-4.136091254496651,23
4995,20,11,71,7,-4.136430557393971,4
4996,71,47,53,27,-4.141303557057988,20
4997,65,49,23,26,-4.142109485382541,23
4998,95,12,100,6,-4.142851413596655,6
4999,73,13,20,8,-4.146065391689571,5
5000,76,18,84,10,-4.146116027740745,8
5001,17,12,99,7,-4.14837583337694,5
5002,84,60,28,34,-4.150279635735799,26
5003,3,55,27,30,-4.15267067840578,25
5004,84,24,27,13,-4.1560592219163555,11
5005,5,40,83,21,-4.1637099044245005,19
5006,96,24,60,16,-4.164982345638211,8
5007,23,53,107,29,-4.172486813229873,24
5008,25,27,23,15,-4.182190113226027,12
5009,1,36,13,22,-4.187998461115464,14
5010,103,12,112,7,-4.192929666832579,5
5011,29,26,51,14,-4.200611882951567,12
5012,74,18,108,11,-4.201041319943182,7
5013,36,56,65,32,-4.205692860728475,24
5014,87,28,90,16,-4.209781806456323,12
5015,63,20,17,11,-4.21709530073227,9
5016,18,19,4,11,-4.220670692754493,8
5017,100,29,28,17,-4.221129674472951,12
5018,16,37,97,20,-4.222715093786658,17
5019,44,11,71,6,-4.223524348839462,5
5020,38,21,9,12,-4.224156596688182,9
5021,104,11,29,6,-4.232469176091455,5
5022,109,12,71,7,-4.235965151087514,5
5023,71,44,16,26,-4.241804878716307,18
5024,34,14,106,7,-4.243674039664674,7
5025,72,10,6,5,-4.248570153213719,5
5026,18,11,94,6,-4.250781715158487,5
5027,107,30,91,18,-4.264126621091654,12
5028,7,13,12,7,-4.26484586719297,6
5029,55,15,29,9,-4.266015075713762,6
5030,57,27,19,15,-4.280011891536447,12
5031,15,20,114,11,-4.2831762689104504,9
5032,98,11,85,7,-4.293458254788543,4
5033,35,12,13,7,-4.295164540193832,5
5034,54,28,25,16,-4.300413553073274,12
5035,84,18,75,10,-4.30081159040195,8
5036,55,45,37,24,-4.301001080588835,21
5037,53,27,106,14,-4.302319600135899,13
5038,78,29,100,17,-4.3065041234398125,12
5039,52,10,50,5,-4.308197298973348,5
5040,8,10,31,6,-4.309099443279481,4
5041,90,13,76,8,-4.309550016746243,5
5042,17,23,97,13,-4.313428551304956,10
5043,98,27,104,13,-4.313899934387767,14
5044,88,53,11,31,-4.315288914266512,22
5045,71,14,70,7,-4.315612188206777,7
5046,40,22,4,12,-4.316643149060896,10
5047,103,15,15,8,-4.31675719046778,7
5048,41,21,47,11,-4.32003722756243,10
5049,65,29,19,16,-4.323452850174733,13
5050,41,19,95,11,-4.332143979792176,8
5051,22,12,60,7,-4.334241842742782,5
5052,48,20,34,11,-4.343261719849951,9
5053,65,29,70,18,-4.3439841796636145,11
5054,6,16,65,9,-4.346168811124812,7
5055,48,30,28,17,-4.353346769104993,13
5056,39,24,76,15,-4.35477451293687,9
5057,83,11,19,6,-4.359398192701051,5
5058,71,31,64,19,-4.35947313780117,12
5059,23,20,95,11,-4.361896262769259,9
5060,9,15,74,9,-4.36741522698094,6
5061,23,23,40,13,-4.36842332680331,10
5062,58,13,55,7,-4.369004483506263,6
5063,9,24,55,14,-4.371040618945101,10
5064,8,24,49,14,-4.374514809997582,10
5065,25,33,87,18,-4.379098196808543,15
5066,54,10,99,6,-4.3797228746123675,4
5067,64,12,12,7,-4.3938981464127,5
5068,2,22,16,13,-4.395353237879596,9
5069,11,18,62,10,-4.400361109158304,8
5070,108,14,71,8,-4.402422140240547,6
5071,13,38,12,25,-4.404764592205936,13
5072,76,16,34,8,-4.406030161353481,8
5073,109,43,88,26,-4.409029007848903,17
5074,64,24,50,13,-4.415510499418938,11
5075,53,64,7,36,-4.416213736910661,28
5076,23,17,29,9,-4.418393467914156,8
5077,87,29,71,16,-4.418670539958073,13
5078,77,42,13,24,-4.419681112621034,18
5079,13,30,99,17,-4.420966828834257,13
5080,98,11,57,6,-4.422154501358107,5
5081,20,14,23,8,-4.42777867543601,6
5082,27,17,108,10,-4.43028987016657,7
5083,109,15,95,9,-4.444131433700797,6
5084,16,44,95,24,-4.453378575583385,20
5085,73,12,50,8,-4.454782630059153,4
5086,97,11,77,7,-4.454901155383999,4
5087,32,18,37,10,-4.466542082918519,8
5088,57,10,91,5,-4.468260927215542,5
5089,25,31,96,17,-4.472832877552798,14
5090,3,26,62,15,-4.473036771828815,11
5091,107,33,95,18,-4.475609109265347,15
5092,8,12,56,7,-4.475636615156397,5
5093,7,30,100,17,-4.479542671667202,13
5094,64,46,7,25,-4.4812400569888355,21
5095,40,50,65,28,-4.488092661947341,22
5096,107,110,87,63,-4.492032093319163,47
5097,37,15,93,9,-4.4934456656390305,6
5098,39,21,58,12,-4.494576390875354,9
5099,79,16,8,8,-4.494949825171059,8
5100,60,47,55,26,-4.496007919155315,21
5101,100,73,16,42,-4.496116763819157,31
5102,69,12,76,8,-4.499300236532236,4
5103,51,30,49,17,-4.504127532693048,13
5104,87,41,23,24,-4.512300706037801,17
5105,93,16,20,8,-4.515352163146577,8
5106,112,18,49,10,-4.517911222226065,8
5107,50,23,74,13,-4.520207268757788,10
5108,51,64,54,36,-4.5226396489169325,28
5109,60,17,61,9,-4.5273940858246595,8
5110,48,19,13,11,-4.529838045170984,8
5111,28,71,50,41,-4.530365152854882,30
5112,75,23,106,12,-4.532198108241345,11
5113,107,74,100,39,-4.534920545343513,35
5114,15,18,99,11,-4.551461310618722,7
5115,46,15,83,8,-4.551826612706302,7
5116,23,15,70,8,-4.554568026577778,7
5117,5,18,43,10,-4.5592775438308895,8
5118,104,16,99,8,-4.562749239239297,8
5119,95,14,99,8,-4.572737764013027,6
5120,60,56,39,31,-4.573736342935888,25
5121,58,23,7,12,-4.575034525669345,11
5122,65,16,99,9,-4.579704538683142,7
5123,71,25,28,15,-4.584215619303487,10
5124,54,26,78,15,-4.592600537057518,11
5125,96,32,50,18,-4.592653394244437,14
5126,102,14,19,9,-4.600303598104888,5
5127,18,15,38,8,-4.607415756411176,7
5128,86,72,37,40,-4.607837359690986,32
5129,68,20,85,13,-4.615895850726343,7
5130,40,10,72,6,-4.6161082317709115,4
5131,58,20,60,11,-4.62148171402165,9
5132,88,37,100,22,-4.625717286575203,15
5133,94,16,3,9,-4.629270425756286,7
5134,92,15,51,8,-4.63031933752528,7
5135,89,13,65,7,-4.632113459581728,6
5136,110,15,106,8,-4.633960085739299,7
5137,25,22,60,12,-4.636282806493915,10
5138,109,19,73,11,-4.637139105733963,8
5139,69,11,80,6,-4.638884395252677,5
5140,25,13,48,7,-4.641698897655362,6
5141,13,14,73,8,-4.6427133386229835,6
5142,96,39,63,24,-4.649023449526139,15
5143,1,16,15,10,-4.6493508409190305,6
5144,79,13,27,7,-4.65158326253367,6
5145,54,62,63,36,-4.6520172622159,26
5146,47,15,25,8,-4.655390231832644,7
5147,38,19,109,12,-4.668016203688245,7
5148,39,51,40,30,-4.685059105758994,21
5149,72,22,85,14,-4.685894776044266,8
5150,5,16,71,9,-4.686451238703376,7
5151,84,36,16,21,-4.697024903080797,15
5152,112,21,3,11,-4.705334593377522,10
5153,46,23,20,15,-4.708713070266484,8
5154,12,14,74,8,-4.7158981291394015,6
5155,75,14,15,9,-4.7291616067808215,5
5156,46,11,6,6,-4.730994669309113,5
5157,55,82,13,47,-4.733958835671246,35
5158,77,16,25,9,-4.745845616411638,7
5159,5,30,90,18,-4.752640516818982,12
5160,50,23,7,13,-4.754905099968965,10
5161,50,16,93,10,-4.755526241513055,6
5162,3,42,107,22,-4.760146320288785,20
5163,79,12,55,7,-4.763372141256467,5
5164,60,23,76,15,-4.763967746356448,8
5165,94,16,55,9,-4.767452995148862,7
5166,31,15,12,8,-4.770632464521183,7
5167,70,13,90,7,-4.771084444295363,6
5168,37,10,9,6,-4.7723167368365935,4
5169,23,14,33,8,-4.772846471482118,6
5170,108,17,30,10,-4.777036339137378,7
5171,5,12,9,7,-4.777710715122403,5
5172,104,57,86,32,-4.778923035703436,25
5173,55,25,100,13,-4.783496502583423,12
5174,81,25,15,14,-4.783657780343267,11
5175,87,22,72,12,-4.7870712017642,10
5176,5,33,76,19,-4.788314400539968,14
5177,76,24,97,13,-4.7891970450006545,11
5178,1,17,9,8,-4.79405950293998,9
5179,20,13,52,8,-4.795236183864801,5
5180,25,11,111,6,-4.797175922879397,5
5181,46,23,7,15,-4.797661017581172,8
5182,88,14,34,8,-4.799596567728285,6
5183,96,22,75,15,-4.80138149231193,7
5184,56,11,16,7,-4.802141402722699,4
5185,12,16,1,9,-4.804302234326598,7
5186,88,44,75,26,-4.804702938088101,18
5187,106,25,2,14,-4.808494527305082,11
5188,106,12,6,7,-4.810944704219048,5
5189,85,11,74,6,-4.812388004493803,5
5190,54,15,14,10,-4.820525855929131,5
5191,25,19,31,10,-4.823839301099763,9
5192,9,47,65,28,-4.82612869570304,19
5193,90,13,41,7,-4.828201040811693,6
5194,67,15,8,9,-4.8319098461555825,6
5195,64,20,83,11,-4.840996077098241,9
5196,83,17,39,10,-4.845386042652696,7
5197,32,12,97,7,-4.851459349576838,5
5198,79,11,100,7,-4.852268357181291,4
5199,114,11,77,6,-4.854209160918299,5
5200,107,38,58,23,-4.857008495705362,15
5201,112,31,100,17,-4.858414274039212,14
5202,3,24,81,14,-4.860040341211914,10
5203,107,12,52,8,-4.8612628499818085,4
5204,89,10,5,7,-4.862465640901751,3
5205,106,54,37,29,-4.865641247327304,25
5206,1,11,29,7,-4.8669345755887905,4
5207,107,39,19,24,-4.867116029370309,15
5208,79,20,13,12,-4.869950872786804,8
5209,57,26,88,14,-4.87081224887015,12
5210,84,17,100,11,-4.876415167032029,6
5211,88,44,23,27,-4.876485476342165,17
5212,95,11,69,7,-4.882909765417962,4
5213,101,10,39,6,-4.8897412781033625,4
5214,51,47,75,26,-4.890410363576285,21
5215,77,16,23,9,-4.892331871891682,7
5216,102,24,11,13,-4.893399343069611,11
5217,54,14,38,8,-4.897121063973307,6
5218,29,15,9,9,-4.900194767905049,6
5219,11,32,15,19,-4.9040772238924895,13
5220,28,12,38,6,-4.907164394244693,6
5221,87,35,76,21,-4.9222225313957875,14
5222,86,41,43,24,-4.92338257505701,17
5223,11,20,72,11,-4.923870308975731,9
5224,106,56,74,32,-4.924754963776778,24
5225,36,40,86,23,-4.927433251240003,17
5226,9,22,114,15,-4.931319071415344,7
5227,9,18,62,10,-4.931496627802285,8
5228,71,11,49,6,-4.9409457894604065,5
5229,28,27,93,17,-4.941127481170006,10
5230,78,15,40,10,-4.942465399220729,5
5231,81,23,39,14,-4.943832581007466,9
5232,106,29,80,17,-4.946009667025365,12
5233,18,14,76,8,-4.948055179076069,6
5234,68,19,56,10,-4.94813216675333,9
5235,100,12,20,7,-4.948684351907288,5
5236,41,33,64,20,-4.951397157092104,13
5237,64,10,85,6,-4.962701184974939,4
5238,107,44,76,28,-4.963511886446056,16
5239,90,23,96,14,-4.963939687748077,9
5240,114,21,27,12,-4.967571693509977,9
5241,23,11,98,6,-4.9699651611390046,5
5242,44,10,80,5,-4.973541413806909,5
5243,55,34,80,18,-4.987967529735274,16
5244,94,19,63,11,-4.988953899876624,8
5245,31,23,50,13,-4.991999785997781,10
5246,71,15,74,8,-4.993812181109021,7
5247,106,41,7,21,-5.003800212982272,20
5248,5,26,93,16,-5.004460526821323,10
5249,83,13,102,8,-5.00532757458448,5
5250,3,27,41,18,-5.0080500461002275,9
5251,17,17,72,10,-5.008619057376982,7
5252,94,17,112,11,-5.010192110959217,6
5253,88,100,7,57,-5.012449658177524,43
5254,64,49,13,26,-5.0266998971793155,23
5255,87,36,94,20,-5.028702412089721,16
5256,41,24,20,13,-5.0314400771852865,11
5257,84,18,43,10,-5.034570350714231,8
5258,52,12,65,8,-5.036995856643753,4
5259,38,31,39,18,-5.039769505176328,13
5260,85,15,63,8,-5.044437930195333,7
5261,77,27,39,15,-5.045469290606398,12
5262,51,48,104,30,-5.045842035260691,18
5263,75,20,95,12,-5.050260152484932,8
5264,10,16,7,9,-5.060407065651959,7
5265,61,10,41,6,-5.060781095904467,4
5266,109,27,41,17,-5.069522776777774,10
5267,28,16,47,9,-5.079195021327367,7
5268,64,23,3,13,-5.079848362911409,10
5269,20,10,32,7,-5.08216341529211,3
5270,87,70,8,40,-5.084902312273524,30
5271,65,23,90,12,-5.084911236528136,11
5272,104,25,53,14,-5.094260383198605,11
5273,108,13,28,7,-5.102919930198643,6
5274,70,23,55,13,-5.1032220329288345,10
5275,54,30,9,17,-5.1065751437855,13
5276,1,10,30,6,-5.107240382060612,4
5277,4,18,75,11,-5.1124286444655915,7
5278,33,14,64,9,-5.132334361355248,5
5279,58,30,40,16,-5.133397385337809,14
5280,3,21,36,13,-5.136055944816986,8
5281,8,17,72,9,-5.13781996064983,8
5282,65,110,16,63,-5.145171506502088,47
5283,86,55,27,32,-5.148010188474062,23
5284,97,13,11,7,-5.149154391162877,6
5285,50,51,16,30,-5.149610319436329,21
5286,9,24,106,14,-5.150083731218861,10
5287,28,16,35,8,-5.1531236605423,8
5288,5,12,67,7,-5.159840528973067,5
5289,93,13,98,7,-5.16002306712359,6
5290,56,11,91,6,-5.160182814393273,5
5291,96,20,114,12,-5.164351476040406,8
5292,96,29,65,16,-5.165027076154162,13
5293,80,10,27,6,-5.166088753800779,4
5294,97,17,75,10,-5.183439015487436,7
5295,43,14,23,8,-5.189120753246301,6
5296,71,10,6,6,-5.19369227829273,4
5297,113,13,40,8,-5.193726392686624,5
5298,80,18,104,10,-5.194103195079233,8
5299,39,25,46,12,-5.196853389468722,13
5300,8,26,64,16,-5.197739409340508,10
5301,53,36,16,22,-5.201094174764714,14
5302,7,106,16,60,-5.201721932894633,46
5303,43,21,63,12,-5.2076884486347055,9
5304,109,22,50,13,-5.207842202449344,9
5305,91,12,33,6,-5.213867650447791,6
5306,8,14,69,8,-5.216534828858884,6
5307,76,18,20,9,-5.218902337593748,9
5308,37,22,40,12,-5.218981261850287,10
5309,106,54,54,29,-5.222938310920249,25
5310,39,23,92,12,-5.223931097826438,11
5311,5,11,35,6,-5.226534281744142,5
5312,107,127,16,78,-5.230248987064314,49
5313,23,12,9,7,-5.231512665759891,5
5314,25,21,91,12,-5.23677892954369,9
5315,16,14,52,8,-5.238731564661997,6
5316,40,26,25,15,-5.242222631716463,11
5317,51,21,102,12,-5.246852253062097,9
5318,65,14,85,8,-5.254482148208554,6
5319,31,11,35,6,-5.255104723881262,5
5320,1,11,34,8,-5.259854618241473,3
5321,104,67,107,39,-5.260319067961476,28
5322,75,55,86,30,-5.26427494208678,25
5323,92,11,28,7,-5.266199037582341,4
5324,109,42,51,27,-5.2739700808297565,15
5325,87,15,45,9,-5.278722468966395,6
5326,62,23,13,13,-5.279557581763118,10
5327,88,11,56,6,-5.280224334897691,5
5328,109,13,62,6,-5.284405260681885,7
5329,28,19,14,12,-5.2887953454841945,7
5330,86,21,99,13,-5.291638236148403,8
5331,87,15,10,9,-5.299026363997258,6
5332,8,18,12,11,-5.299832726924704,7
5333,98,16,27,9,-5.307731237447107,7
5334,61,15,86,9,-5.3141256002493495,6
5335,19,19,38,13,-5.315551758814999,6
5336,102,14,97,9,-5.335160623731844,5
5337,12,21,16,12,-5.337506727804566,9
5338,62,19,7,11,-5.339510147514966,8
5339,63,47,37,28,-5.351566239537104,19
5340,30,26,50,15,-5.354360679381177,11
5341,65,15,81,9,-5.355649781765625,6
5342,97,35,7,19,-5.356987360153851,16
5343,43,17,34,10,-5.360976222344831,7
5344,50,24,90,14,-5.361711287754656,10
5345,18,25,15,15,-5.370261713586336,10
5346,103,16,65,10,-5.377768524309904,6
5347,86,40,64,23,-5.391204217901306,17
5348,33,20,8,12,-5.397787705463012,8
5349,58,11,4,7,-5.405037105567146,4
5350,19,32,11,20,-5.420057417715362,12
5351,76,27,98,16,-5.421334528995662,11
5352,25,38,104,21,-5.42238345531963,17
5353,63,33,104,19,-5.4225005902868935,14
5354,69,13,42,7,-5.432900919803644,6
5355,68,29,71,18,-5.435653336862234,11
5356,41,41,87,24,-5.437630720258515,17
5357,84,25,85,16,-5.43974367052044,9
5358,63,31,100,17,-5.452576532321479,14
5359,71,43,75,27,-5.454468163058883,16
5360,3,33,65,20,-5.4556526835599515,13
5361,76,14,71,7,-5.456476326439049,7
5362,51,31,5,20,-5.465657211287607,11
5363,74,13,31,8,-5.468299370651384,5
5364,25,22,100,12,-5.476003695191371,10
5365,55,27,111,16,-5.4926637972483014,11
5366,86,83,11,48,-5.496362752172005,35
5367,102,10,67,6,-5.497246561771841,4
5368,38,27,16,18,-5.501435833243271,9
5369,102,26,76,16,-5.502301667327311,10
5370,64,15,44,9,-5.503275136525506,6
5371,40,13,2,8,-5.504797437287729,5
5372,19,14,40,9,-5.507682773045995,5
5373,109,13,32,7,-5.508051897308618,6
5374,81,10,80,5,-5.509744831821596,5
5375,83,19,95,12,-5.510188596504647,7
5376,65,23,45,12,-5.510611418282089,11
5377,87,28,80,17,-5.518166010205806,11
5378,68,47,114,27,-5.519247268707076,20
5379,7,33,28,20,-5.522079859732704,13
5380,102,11,64,7,-5.525256448935202,4
5381,100,19,72,12,-5.52664341254475,7
5382,23,21,64,12,-5.5388775759536575,9
5383,2,22,20,13,-5.544865436021075,9
5384,75,42,18,24,-5.546579166688544,18
5385,84,18,25,11,-5.5466876181289715,7
5386,31,53,36,30,-5.548564460468652,23
5387,25,41,8,25,-5.550067480025435,16
5388,54,16,69,9,-5.552096999235808,7
5389,50,20,41,12,-5.5529268201135,8
5390,46,44,8,24,-5.553053726096312,20
5391,4,11,46,6,-5.55622187464566,5
5392,95,30,13,17,-5.556983808516705,13
5393,40,72,13,41,-5.55717975004481,31
5394,95,10,31,6,-5.5581891593402775,4
5395,20,63,107,36,-5.562332766197254,27
5396,88,98,86,57,-5.562390170991595,41
5397,51,69,100,37,-5.571831001302536,32
5398,33,12,30,8,-5.573632303680848,4
5399,38,23,7,13,-5.575438881033769,10
5400,44,22,20,13,-5.576158683247875,9
5401,86,38,69,22,-5.57780243243977,16
5402,88,14,14,8,-5.580858903619988,6
5403,53,13,89,7,-5.581720835788214,6
5404,58,23,16,14,-5.587223743497611,9
5405,34,14,102,9,-5.587343030075011,5
5406,96,38,20,23,-5.5910643603065,15
5407,64,17,80,9,-5.593698551425535,8
5408,10,11,23,6,-5.611414438981714,5
5409,60,13,72,8,-5.611432015329073,5
5410,90,14,30,8,-5.614315415339312,6
5411,19,51,30,30,-5.61733531084903,21
5412,91,26,68,14,-5.6194663727720915,12
5413,50,26,95,15,-5.619957219349124,11
5414,22,10,51,6,-5.620245273736576,4
5415,84,24,9,14,-5.622843694169617,10
5416,5,10,19,6,-5.6233787755961275,4
5417,17,21,5,14,-5.625033929201381,7
5418,73,28,86,15,-5.62531345595925,13
5419,20,16,78,9,-5.6294679305494935,7
5420,6,11,15,7,-5.630932126309074,4
5421,9,43,75,26,-5.632694127818325,17
5422,46,16,109,9,-5.636528034552768,7
5423,74,23,73,14,-5.649045009007229,9
5424,97,13,39,8,-5.649731064357227,5
5425,97,10,4,6,-5.649870700339136,4
5426,60,32,49,19,-5.652266603264942,13
5427,61,13,9,8,-5.652969843590385,5
5428,16,44,20,28,-5.653886889078911,16
5429,75,31,46,18,-5.654705399493304,13
5430,87,56,100,31,-5.658391007902432,25
5431,82,11,54,7,-5.66427830231393,4
5432,99,31,16,18,-5.66581833704302,13
5433,74,22,100,13,-5.666768329458079,9
5434,37,39,75,25,-5.670197882049106,14
5435,25,10,94,5,-5.671887186214519,5
5436,13,37,63,21,-5.677540897301028,16
5437,95,10,102,6,-5.68531996234082,4
5438,9,37,28,20,-5.685359581946876,17
5439,114,17,76,11,-5.686109810518627,6
5440,40,21,35,13,-5.689140213576859,8
5441,5,46,106,28,-5.689619439430468,18
5442,32,10,70,5,-5.692479372096212,5
5443,50,13,23,9,-5.694114757145069,4
5444,62,17,53,10,-5.701449545318568,7
5445,65,37,64,21,-5.704413748738565,16
5446,72,16,107,9,-5.708684864640733,7
5447,47,14,11,9,-5.7112915010697805,5
5448,12,16,69,8,-5.715951067980107,8
5449,102,25,100,16,-5.719538880425677,9
5450,17,13,98,7,-5.72342530511381,6
5451,51,26,25,15,-5.726135112848949,11
5452,9,14,45,9,-5.727853500458989,5
5453,25,48,13,26,-5.729332953997916,22
5454,47,31,107,18,-5.730039668040247,13
5455,27,46,100,26,-5.732603402856778,20
5456,30,24,29,15,-5.734998612686146,9
5457,106,42,25,26,-5.737688222420908,16
5458,77,12,36,7,-5.751140829309579,5
5459,19,13,104,8,-5.751508534333888,5
5460,47,13,23,8,-5.7551420632928085,5
5461,53,13,58,6,-5.756559382638664,7
5462,109,20,100,13,-5.759474346902357,7
5463,68,15,80,9,-5.759836210772863,6
5464,54,10,61,6,-5.763750710129652,4
5465,76,19,13,11,-5.766341264416831,8
5466,17,45,16,29,-5.775641546561411,16
5467,8,95,16,57,-5.7900228794749085,38
5468,19,13,48,7,-5.7924314405881985,6
5469,51,45,78,24,-5.800274453414971,21
5470,31,19,91,12,-5.801858258461768,7
5471,106,11,10,8,-5.803672894932928,3
5472,98,19,8,12,-5.806615359942182,7
5473,20,13,79,8,-5.810117746469,5
5474,85,13,19,8,-5.818975421540376,5
5475,5,16,40,9,-5.82052725169565,7
5476,69,40,13,24,-5.8433632929084185,16
5477,65,10,108,5,-5.847992745343311,5
5478,79,12,80,6,-5.851472407179256,6
5479,65,61,55,35,-5.858765777581568,26
5480,112,21,7,13,-5.863389950487481,8
5481,7,17,34,10,-5.863504951401834,7
5482,95,36,54,20,-5.865979569344108,16
5483,19,50,87,30,-5.875904223711482,20
5484,31,12,28,7,-5.87633787823225,5
5485,36,12,46,7,-5.88209418081934,5
5486,74,22,102,13,-5.882481039476403,9
5487,108,17,75,10,-5.88550634585497,7
5488,103,18,39,11,-5.887093677643695,7
5489,43,16,17,9,-5.888801333071093,7
5490,84,34,74,18,-5.89139952158172,16
5491,68,15,101,10,-5.891939886749793,5
5492,43,34,39,19,-5.8937669125434455,15
5493,91,16,51,10,-5.8958428007861405,6
5494,103,12,54,8,-5.896465334872947,4
5495,107,59,75,39,-5.896729059645905,20
5496,29,12,50,7,-5.9053142051653245,5
5497,57,27,84,14,-5.910397185802948,13
5498,65,82,104,47,-5.912154582043186,35
5499,7,23,78,12,-5.919551023484503,11
5500,93,14,75,8,-5.9232430439307135,6
5501,49,47,27,28,-5.9233145844446,19
5502,86,33,34,19,-5.924341860840785,14
5503,114,20,73,12,-5.924435121305104,8
5504,77,20,12,11,-5.936585739129091,9
5505,3,17,34,10,-5.941229806680978,7
5506,53,15,28,9,-5.945744364633271,6
5507,76,31,28,17,-5.950271226300689,14
5508,10,12,97,6,-5.950831581917707,6
5509,103,15,78,11,-5.952284860488893,4
5510,16,69,30,42,-5.956505821437064,27
5511,53,52,68,31,-5.964244334939566,21
5512,77,28,49,18,-5.96535125721377,10
5513,16,16,89,9,-5.966481911201795,7
5514,40,18,97,11,-5.966918416140385,7
5515,87,21,102,13,-5.971447061156248,8
5516,18,20,64,12,-5.974775055211904,8
5517,77,25,3,14,-5.98288839075645,11
5518,84,20,98,13,-5.9888897315784195,7
5519,77,19,78,11,-5.9894838962393475,8
5520,31,25,114,14,-5.9918765203954925,11
5521,54,21,94,12,-6.000772945562409,9
5522,98,11,112,7,-6.005421104961223,4
5523,19,34,29,21,-6.006279537520524,13
5524,37,60,87,36,-6.0118966801727876,24
5525,48,15,29,9,-6.020141509256062,6
5526,17,17,103,11,-6.022913063656272,6
5527,37,24,98,14,-6.023716027404387,10
5528,86,62,100,35,-6.024521465285828,27
5529,8,32,34,19,-6.025162795851977,13
5530,50,17,91,11,-6.027790824025908,6
5531,68,10,26,6,-6.030745942778486,4
5532,31,31,75,17,-6.03348213428737,14
5533,98,24,7,15,-6.033686003781978,9
5534,32,16,8,9,-6.041444852098721,7
5535,88,18,76,10,-6.043471817882156,8
5536,93,15,70,9,-6.04469500542117,6
5537,112,30,53,16,-6.0449768388221905,14
5538,18,24,63,15,-6.046455003215171,9
5539,14,14,39,8,-6.049336679853417,6
5540,103,20,13,13,-6.058512514971599,7
5541,41,27,23,16,-6.068042449918635,11
5542,88,64,65,40,-6.068722517026162,24
5543,16,23,6,12,-6.074728029131809,11
5544,102,13,23,7,-6.080684731147943,6
5545,107,23,111,12,-6.08814286411973,11
5546,108,14,96,8,-6.092516088942793,6
5547,46,24,57,14,-6.094749729993643,10
5548,47,11,54,6,-6.095812400128514,5
5549,69,16,62,9,-6.0981418118710495,7
5550,15,12,84,7,-6.09892148672844,5
5551,10,13,16,8,-6.102410867550437,5
5552,90,32,54,19,-6.104592167356709,13
5553,7,12,90,7,-6.108519045195329,5
5554,31,13,81,9,-6.1171597913254026,4
5555,88,35,25,23,-6.12387967695023,12
5556,97,20,41,12,-6.148946376824951,8
5557,47,27,75,18,-6.156969718274411,9
5558,81,11,50,6,-6.158903696641065,5
5559,36,47,13,29,-6.167141158071527,18
5560,3,25,78,14,-6.175218404211584,11
5561,93,10,80,5,-6.175234905241036,5
5562,81,17,114,9,-6.179669023614306,8
5563,94,16,114,9,-6.184621239792868,7
5564,71,12,91,7,-6.18747414228945,5
5565,97,26,87,17,-6.190868250218131,9
5566,65,54,27,33,-6.196724957991716,21
5567,48,18,50,11,-6.197823593871153,7
5568,2,28,63,16,-6.200018491851487,12
5569,20,49,65,31,-6.200424954113156,18
5570,37,21,41,13,-6.201755384784584,8
5571,70,28,74,15,-6.203999405338755,13
5572,12,14,63,7,-6.204748395941869,7
5573,84,15,35,9,-6.209299301194262,6
5574,65,23,18,13,-6.210994598557499,10
5575,70,24,114,15,-6.214622620602992,9
5576,49,25,54,14,-6.225454221982543,11
5577,91,42,16,27,-6.227187272730331,15
5578,50,41,104,25,-6.230364171354916,16
5579,3,39,7,24,-6.232217973074319,15
5580,46,14,19,8,-6.236350596990494,6
5581,5,48,114,28,-6.237633533478722,20
5582,55,65,107,38,-6.2629651896189,27
5583,107,58,30,35,-6.265220866431884,23
5584,95,12,15,7,-6.265255655621161,5
5585,5,45,20,28,-6.270373633442783,17
5586,4,21,86,13,-6.2794844995496994,8
5587,68,35,11,20,-6.280005613646358,15
5588,93,14,29,8,-6.281843189307091,6
5589,72,15,50,9,-6.282212191469299,6
5590,86,21,47,13,-6.282505529772493,8
5591,4,15,12,10,-6.285579029533407,5
5592,108,13,54,9,-6.288035508418626,4
5593,68,68,40,42,-6.288399173895767,26
5594,102,36,28,21,-6.294379170221602,15
5595,8,16,43,9,-6.2973312547824625,7
5596,94,20,76,13,-6.29880756689131,7
5597,19,21,76,13,-6.301901405511211,8
5598,98,18,70,12,-6.319051319272617,6
5599,51,37,77,21,-6.323702748298249,16
5600,96,11,15,7,-6.332542018308189,4
5601,109,22,43,14,-6.337734890860961,8
5602,17,10,12,6,-6.340271038954066,4
5603,96,17,85,12,-6.345069391274802,5
5604,65,58,30,35,-6.347486219256752,23
5605,39,35,84,20,-6.3525949898803695,15
5606,27,13,92,7,-6.356396578041118,6
5607,15,18,47,10,-6.359572158435768,8
5608,43,19,64,11,-6.3596171770522805,8
5609,56,21,7,12,-6.361794853449643,9
5610,50,12,57,8,-6.36698198689182,4
5611,102,15,33,9,-6.371524301983965,6
5612,57,35,87,21,-6.372641139100553,14
5613,27,16,28,11,-6.382931621067471,5
5614,51,29,108,17,-6.386940693154833,12
5615,96,13,33,6,-6.392035038140809,7
5616,37,20,80,12,-6.401050818487372,8
5617,54,18,91,10,-6.414686940093467,8
5618,23,10,61,6,-6.419517618014351,4
5619,80,23,96,14,-6.423400971659429,9
5620,100,21,75,11,-6.426877840881264,10
5621,107,16,89,10,-6.429821795264184,6
5622,94,18,69,11,-6.432434124144747,7
5623,23,47,13,26,-6.4340973489419495,21
5624,33,16,68,10,-6.451134609706938,6
5625,28,10,6,6,-6.452419128804086,4
5626,18,23,50,13,-6.452668500546503,10
5627,91,20,8,12,-6.453847873736644,8
5628,10,15,11,9,-6.454288934219365,6
5629,57,19,97,11,-6.465009515620628,8
5630,50,16,15,10,-6.46898110916802,6
5631,68,11,98,7,-6.4699276959750645,4
5632,9,20,70,13,-6.477071321597405,7
5633,87,105,16,63,-6.489290122956573,42
5634,55,29,74,17,-6.503619546467788,12
5635,77,24,41,15,-6.512816462619649,9
5636,79,15,76,10,-6.514592595269537,5
5637,66,20,60,13,-6.515171561917162,7
5638,109,16,94,9,-6.521911813319807,7
5639,49,69,39,43,-6.52686668255468,26
5640,38,12,102,9,-6.529266346603463,3
5641,80,13,91,8,-6.531108694088673,5
5642,29,23,98,14,-6.531113392896417,9
5643,34,14,94,8,-6.5316475345754,6
5644,8,27,78,17,-6.539735477431525,10
5645,70,58,54,35,-6.543056803225656,23
5646,112,16,58,9,-6.546457957272807,7
5647,23,32,106,17,-6.5490553960891695,15
5648,19,22,64,15,-6.56099923334209,7
5649,50,17,78,11,-6.562139985257883,6
5650,30,15,112,10,-6.562692428407148,5
5651,63,31,75,18,-6.570041946714375,13
5652,114,26,53,15,-6.571088082289226,11
5653,81,12,77,7,-6.5752456736487765,5
5654,101,11,27,7,-6.582303845846212,4
5655,67,16,34,8,-6.586851367561421,8
5656,79,20,30,13,-6.592079457136293,7
5657,63,31,64,18,-6.595351994440166,13
5658,102,28,65,18,-6.598986547888402,10
5659,49,18,72,11,-6.60594693675743,7
5660,35,25,11,15,-6.6098986532599575,10
5661,60,44,23,27,-6.6144486823140545,17
5662,77,12,102,7,-6.618078815941928,5
5663,30,14,23,8,-6.618468991829209,6
5664,68,21,20,12,-6.619136630374986,9
5665,38,17,12,10,-6.62024917402118,7
5666,46,38,74,24,-6.622188071735937,14
5667,5,48,25,29,-6.626414170343123,19
5668,13,43,47,26,-6.630254291387857,17
5669,37,22,39,13,-6.632156694863052,9
5670,65,30,4,18,-6.635600395573753,12
5671,17,38,86,21,-6.641619574926921,17
5672,5,26,32,16,-6.6474470604519045,10
5673,63,59,8,34,-6.653552632837189,25
5674,37,19,71,11,-6.65399605348867,8
5675,71,11,83,6,-6.6562053803338666,5
5676,80,13,19,8,-6.6570365011750905,5
5677,57,12,10,8,-6.658857003244836,4
5678,54,20,85,13,-6.664179187550933,7
5679,68,31,23,17,-6.676959480055365,14
5680,69,27,58,15,-6.683019197918342,12
5681,98,24,11,14,-6.689063597940291,10
5682,28,54,104,32,-6.697414309723438,22
5683,106,11,111,8,-6.697425895741327,3
5684,86,18,10,10,-6.698064905065152,8
5685,23,25,63,16,-6.701335055503609,9
5686,38,11,108,7,-6.702463242169256,4
5687,74,15,83,8,-6.703298030488857,7
5688,97,35,28,22,-6.716635909782018,13
5689,32,10,65,6,-6.718474357729474,4
5690,95,13,14,8,-6.731405281187272,5
5691,96,38,74,24,-6.731828732252354,14
5692,69,20,15,13,-6.736896270525392,7
5693,19,13,50,8,-6.738479266305749,5
5694,29,10,18,7,-6.739197778395282,3
5695,48,26,84,16,-6.740791105108492,10
5696,68,13,45,8,-6.747691137383073,5
5697,71,10,94,6,-6.748460655059317,4
5698,97,54,86,32,-6.749652418711037,22
5699,109,27,63,15,-6.749986635160669,12
5700,50,17,33,10,-6.750798742645295,7
5701,8,39,13,24,-6.751757053519926,15
5702,96,82,86,50,-6.757041595559337,32
5703,63,63,51,35,-6.773843003389744,28
5704,42,10,8,5,-6.78054178477664,5
5705,87,35,48,22,-6.790488925793804,13
5706,38,14,2,8,-6.792448237787324,6
5707,81,34,86,23,-6.793767976423694,11
5708,31,10,55,6,-6.798197972656263,4
5709,87,23,108,14,-6.799580586486786,9
5710,49,16,28,9,-6.8012848235530035,7
5711,50,17,3,10,-6.80135709994392,7
5712,13,50,71,29,-6.804323620324037,21
5713,103,25,86,16,-6.806637205037491,9
5714,9,32,8,17,-6.810878783728156,15
5715,51,101,39,61,-6.8132830847231824,40
5716,4,13,56,7,-6.816273515879698,6
5717,31,69,68,41,-6.8216343585610195,28
5718,65,14,79,8,-6.821859416038812,6
5719,106,25,95,16,-6.830338155584793,9
5720,51,28,62,17,-6.837263314130047,11
5721,77,24,107,14,-6.845732737502613,10
5722,51,99,7,62,-6.849475435937795,37
5723,37,25,30,16,-6.853302921187577,9
5724,13,46,81,29,-6.853380616803491,17
5725,60,18,108,11,-6.856532886501664,7
5726,86,47,41,30,-6.858675087687564,17
5727,4,43,60,24,-6.864343045215706,19
5728,98,12,3,6,-6.866274172778351,6
5729,87,58,68,35,-6.867242541807756,23
5730,77,27,30,17,-6.867946363500201,10
5731,69,19,29,11,-6.87026975866342,8
5732,38,12,34,8,-6.8714448233593854,4
5733,99,15,106,10,-6.882359612487446,5
5734,15,28,29,17,-6.882712695666244,11
5735,67,13,88,9,-6.891493842154355,4
5736,62,33,107,18,-6.9022637475512845,15
5737,68,21,58,13,-6.90465268486649,8
5738,29,17,28,10,-6.905526522456792,7
5739,77,33,27,20,-6.913052068345059,13
5740,37,36,13,22,-6.914764249585317,14
5741,57,15,30,9,-6.917301673221198,6
5742,29,33,39,18,-6.938842255810811,15
5743,12,36,100,21,-6.93903973077968,15
5744,88,12,99,7,-6.939131232028662,5
5745,50,33,60,18,-6.944865376684973,15
5746,88,20,58,12,-6.951724289335951,8
5747,51,25,4,16,-6.952578906103856,9
5748,55,30,109,16,-6.952801077513018,14
5749,63,20,90,12,-6.95733483322538,8
5750,104,18,32,12,-6.959225086389547,6
5751,39,15,111,9,-6.9608600117118025,6
5752,36,34,16,21,-6.96230955324868,13
5753,97,23,18,14,-6.965163575719862,9
5754,87,78,13,49,-6.974390710890814,29
5755,68,22,29,14,-6.975698761703106,8
5756,30,30,53,18,-6.98498975026545,12
5757,55,20,17,11,-6.987444025974705,9
5758,13,23,111,13,-6.988942249892523,10
5759,5,15,62,9,-6.9927087595973925,6
5760,87,21,4,14,-6.993636995986407,7
5761,54,14,79,9,-6.993661154009002,5
5762,57,33,8,21,-6.998719542214547,12
5763,54,26,93,17,-7.002072182522708,9
5764,69,13,40,9,-7.006717860168283,4
5765,53,47,107,29,-7.009171118597259,18
5766,38,25,63,17,-7.013791456544737,8
5767,57,23,3,14,-7.014479906982348,9
5768,43,15,12,10,-7.021564164922878,5
5769,53,27,87,15,-7.0226395127694765,12
5770,40,15,95,9,-7.026458120737084,6
5771,13,13,89,7,-7.027546797235387,6
5772,78,12,38,8,-7.0314833130695105,4
5773,48,15,76,10,-7.031929988428476,5
5774,27,19,37,12,-7.034792767414986,7
5775,60,18,94,11,-7.03515997246868,7
5776,114,11,72,6,-7.039741382461142,5
5777,97,25,55,16,-7.041738062020974,9
5778,51,112,86,65,-7.045124405985645,47
5779,73,16,65,10,-7.056062739811477,6
5780,36,18,99,12,-7.061516094995873,6
5781,63,27,98,16,-7.061533653908025,11
5782,12,11,52,6,-7.062340699088408,5
5783,53,10,85,7,-7.0781457464371815,3
5784,70,35,28,21,-7.078735797739843,14
5785,76,37,16,20,-7.082520344517178,17
5786,64,26,30,16,-7.0955835601535755,10
5787,17,14,38,8,-7.099034060595349,6
5788,45,10,1,6,-7.100044646871247,4
5789,54,32,100,20,-7.10626505268504,12
5790,7,33,45,20,-7.114147641228475,13
5791,83,30,86,20,-7.114862976089347,10
5792,76,27,65,18,-7.121500914302365,9
5793,107,12,67,8,-7.124134838046419,4
5794,38,11,62,7,-7.1316627039169695,4
5795,15,39,27,22,-7.136849333340001,17
5796,68,28,97,17,-7.141635420047943,11
5797,78,13,33,8,-7.142209395263034,5
5798,55,50,40,31,-7.142420946012767,19
5799,60,17,5,11,-7.144002600647478,6
5800,69,12,111,7,-7.144443379259754,5
5801,51,26,97,17,-7.145200913148901,9
5802,19,18,84,11,-7.145362039647058,7
5803,37,14,29,8,-7.14724630286853,6
5804,3,26,104,16,-7.15057472667724,10
5805,3,25,114,16,-7.152889180930064,9
5806,30,13,80,8,-7.153305949978541,5
5807,48,13,69,7,-7.158814996268265,6
5808,14,14,86,8,-7.166696838482464,6
5809,55,39,104,24,-7.167673821947763,15
5810,57,19,114,12,-7.16817977917647,7
5811,61,13,30,8,-7.1697153559652405,5
5812,86,41,98,24,-7.171894084868248,17
5813,112,16,36,10,-7.175574629533439,6
5814,43,41,107,25,-7.185388949196882,16
5815,43,15,112,9,-7.1893251112725896,6
5816,22,13,109,8,-7.19047287621624,5
5817,27,28,72,16,-7.198042760659786,12
5818,52,22,86,14,-7.203855363753252,8
5819,8,27,18,18,-7.207241863382852,9
5820,76,21,100,12,-7.225478225762562,9
5821,40,27,114,18,-7.240772461331045,9
5822,5,14,31,9,-7.246607645789562,5
5823,96,12,69,8,-7.2527556906488755,4
5824,91,29,87,18,-7.256753645120718,11
5825,79,30,86,19,-7.258463117259924,11
5826,81,19,75,12,-7.259552889264539,7
5827,10,14,63,9,-7.261720580359904,5
5828,48,14,100,8,-7.263809625362936,6
5829,98,17,20,11,-7.267496359610283,6
5830,70,16,110,10,-7.267896542251016,6
5831,96,10,62,7,-7.268496266352443,3
5832,57,13,106,7,-7.272492874678534,6
5833,68,20,55,13,-7.273979151335479,7
5834,29,16,97,10,-7.284915525257297,6
5835,40,31,43,18,-7.287691070183636,13
5836,40,33,54,20,-7.298767912387552,13
5837,65,28,49,17,-7.315577259794155,11
5838,93,20,16,11,-7.319623013756244,9
5839,5,42,70,25,-7.323141246130922,17
5840,88,30,62,18,-7.323841783087013,12
5841,2,16,75,9,-7.332326563651874,7
5842,34,24,78,14,-7.336336560215481,10
5843,104,41,40,26,-7.342291894534161,15
5844,114,18,23,12,-7.344942637597017,6
5845,79,24,48,15,-7.345817828277464,9
5846,12,17,19,9,-7.3489102504137485,8
5847,9,19,17,11,-7.358179157868899,8
5848,8,25,73,15,-7.3587900254771785,10
5849,33,16,25,11,-7.36592627296452,5
5850,55,72,16,46,-7.367072119933609,26
5851,80,14,31,10,-7.367135464628977,4
5852,3,48,16,30,-7.37165699622341,18
5853,114,24,100,15,-7.3724280838709575,9
5854,71,10,73,6,-7.373234065194552,4
5855,81,19,71,12,-7.374213709282582,7
5856,30,21,34,13,-7.377448858621609,8
5857,94,31,27,19,-7.381571713402097,12
5858,71,29,50,17,-7.386130219514863,12
5859,5,10,1,6,-7.391988711274882,4
5860,94,11,20,7,-7.40491165274963,4
5861,20,30,70,19,-7.408681007686701,11
5862,41,34,36,18,-7.412500474371831,16
5863,57,15,9,9,-7.427077607114285,6
5864,9,46,16,30,-7.4405406867592765,16
5865,19,23,41,15,-7.443816997766071,8
5866,71,12,11,7,-7.444969376445684,5
5867,110,21,37,12,-7.457046552670356,9
5868,70,12,100,7,-7.4587771296449565,5
5869,53,12,45,7,-7.463487107897495,5
5870,39,18,110,12,-7.464111416570426,6
5871,31,37,64,23,-7.4738922265185375,14
5872,63,15,108,9,-7.475559971035059,6
5873,36,14,70,8,-7.476080415111231,6
5874,109,21,7,13,-7.49374057253885,8
5875,61,16,107,9,-7.509321940652878,7
5876,69,18,104,12,-7.510735223332436,6
5877,47,11,85,8,-7.514718359567324,3
5878,87,52,7,33,-7.517208318589071,19
5879,81,16,19,10,-7.526775736263618,6
5880,55,11,6,8,-7.526848268362213,3
5881,7,16,33,9,-7.532188482638043,7
5882,77,15,17,9,-7.533332094576503,6
5883,55,22,34,13,-7.5346031268462745,9
5884,46,10,85,7,-7.538229298143678,3
5885,69,28,78,17,-7.539471489927139,11
5886,55,13,49,8,-7.5458342197342585,5
5887,49,42,107,26,-7.54869416702441,16
5888,104,21,9,13,-7.555832585448779,8
5889,46,47,16,30,-7.556284800209043,17
5890,40,38,87,22,-7.562449238427529,16
5891,45,19,60,11,-7.562934672858015,8
5892,49,23,75,14,-7.565086245339051,9
5893,5,14,34,10,-7.5706698448560905,4
5894,77,12,46,7,-7.574271980014295,5
5895,114,31,28,18,-7.584853881328922,13
5896,36,10,72,6,-7.585561627806541,4
5897,103,24,11,16,-7.585830317962974,8
5898,57,36,11,20,-7.587225628637274,16
5899,64,24,55,16,-7.5905103785531685,8
5900,9,38,87,22,-7.592453429043,16
5901,36,20,18,12,-7.59490287850123,8
5902,7,30,37,18,-7.598616530184265,12
5903,58,18,54,10,-7.606404400860017,8
5904,88,25,108,16,-7.612957755702023,9
5905,69,32,60,18,-7.613845124007753,14
5906,72,22,54,14,-7.618738189484295,8
5907,27,14,71,9,-7.62097447229337,5
5908,61,11,69,8,-7.633216471104327,3
5909,5,29,97,19,-7.639418302115126,10
5910,60,11,70,7,-7.646435749026202,4
5911,31,13,33,7,-7.647223417443056,6
5912,60,39,104,27,-7.655966632440946,12
5913,66,11,104,8,-7.6588091193640615,3
5914,35,27,107,18,-7.659745377736293,9
5915,112,29,27,18,-7.661494705671572,11
5916,69,44,16,28,-7.665479946548732,16
5917,96,24,37,14,-7.66584492569651,10
5918,62,22,28,13,-7.667182073614821,9
5919,38,29,37,18,-7.668156637885105,11
5920,19,27,103,16,-7.669020445123164,11
5921,104,10,72,6,-7.673968450836452,4
5922,55,35,50,20,-7.677574556383835,15
5923,103,26,27,16,-7.681780370581866,10
5924,100,24,23,15,-7.684305486695593,9
5925,11,32,5,20,-7.6874421575338765,12
5926,7,25,111,15,-7.6903234257719815,10
5927,1,28,86,17,-7.696680317913658,11
5928,68,61,75,39,-7.698232004910782,22
5929,94,28,30,17,-7.7213771310551085,11
5930,101,14,16,9,-7.729447625525013,5
5931,26,10,87,6,-7.730492735259905,4
5932,72,12,76,8,-7.731997605583364,4
5933,29,41,65,25,-7.736031171751763,16
5934,29,18,46,9,-7.738693511487547,9
5935,29,20,49,12,-7.741005146754658,8
5936,84,11,44,6,-7.741464370739851,5
5937,111,10,30,7,-7.744421754490768,3
5938,54,13,73,8,-7.746921178252214,5
5939,68,29,28,19,-7.7489930389673605,10
5940,25,49,37,29,-7.755599308877523,20
5941,73,11,53,7,-7.756297558195456,4
5942,114,14,92,10,-7.774797164908212,4
5943,111,10,47,6,-7.786638633209642,4
5944,78,11,108,7,-7.797957113003336,4
5945,110,12,114,8,-7.80031681097971,4
5946,46,46,25,27,-7.8204011950255445,19
5947,106,63,13,39,-7.824636159857551,24
5948,107,33,2,21,-7.828664599470125,12
5949,87,36,78,22,-7.836795174171343,14
5950,1,20,114,13,-7.837742070296789,7
5951,88,80,54,50,-7.854553313400373,30
5952,91,26,106,17,-7.859341034872017,9
5953,35,12,44,7,-7.859665557157517,5
5954,98,15,108,9,-7.863072789163925,6
5955,53,26,27,17,-7.864216242382975,9
5956,90,25,114,15,-7.8701656835045455,10
5957,100,35,104,22,-7.883509665470489,13
5958,27,75,16,47,-7.890270543396148,28
5959,51,16,111,10,-7.892613399402855,6
5960,29,16,17,9,-7.899676305324425,7
5961,90,14,53,9,-7.901032299292589,5
5962,31,11,78,6,-7.904414780494012,5
5963,38,13,71,9,-7.906029048659733,4
5964,82,10,88,6,-7.9125780836424955,4
5965,61,14,6,9,-7.915350050859162,5
5966,18,22,54,13,-7.917650548154778,9
5967,107,38,12,25,-7.919995318333913,13
5968,3,32,49,19,-7.921458159088598,13
5969,58,12,30,8,-7.929379399940004,4
5970,2,12,30,7,-7.930773013016298,5
5971,103,11,18,8,-7.9353135943847235,3
5972,87,17,73,12,-7.94220715025842,5
5973,64,34,16,22,-7.948318536704253,12
5974,109,53,54,34,-7.951130265295214,19
5975,63,17,111,10,-7.959677987637775,7
5976,39,21,23,13,-7.9630880242589255,8
5977,5,25,65,15,-7.967561696591303,10
5978,68,20,34,12,-7.978044783319167,8
5979,76,26,112,15,-7.97915167815144,11
5980,84,28,5,17,-7.986435375626319,11
5981,3,19,20,12,-7.98758608002235,7
5982,70,16,13,10,-7.990308468406848,6
5983,40,16,98,9,-7.9934169616460915,7
5984,6,22,44,15,-7.994067314889739,7
5985,96,19,102,12,-7.995631160966494,7
5986,39,94,16,58,-8.001675530050077,36
5987,88,42,39,26,-8.004378009209995,16
5988,81,18,41,12,-8.009042710590084,6
5989,98,31,91,19,-8.010154956050265,12
5990,88,47,63,31,-8.011636403272155,16
5991,9,11,35,6,-8.012816785902407,5
5992,52,12,63,7,-8.015196003418383,5
5993,50,41,75,27,-8.02466935745211,14
5994,66,13,87,8,-8.030847362070954,5
5995,84,36,20,25,-8.04861670328596,11
5996,11,36,100,23,-8.056267972110492,13
5997,15,10,35,5,-8.056529361763387,5
5998,15,15,12,9,-8.061809473862587,6
5999,46,13,53,8,-8.064750592390654,5
6000,68,38,76,27,-8.067259765332077,11
6001,70,18,50,10,-8.072010588554933,8
6002,19,23,28,15,-8.074139814737293,8
6003,48,35,86,22,-8.077263763613384,13
6004,97,16,110,10,-8.077466293642948,6
6005,74,12,89,7,-8.079770785030162,5
6006,5,61,8,37,-8.080732178020163,24
6007,4,17,43,10,-8.083539648296872,7
6008,8,44,109,26,-8.084532850874995,18
6009,78,45,27,30,-8.094234380040165,15
6010,46,42,37,28,-8.095895819595153,14
6011,49,11,95,8,-8.095998639719069,3
6012,29,27,100,16,-8.09653836783874,11
6013,29,28,84,17,-8.097345709310337,11
6014,55,31,30,20,-8.098468910297374,11
6015,48,15,74,8,-8.108554922899495,7
6016,74,16,34,11,-8.118744758398412,5
6017,111,11,81,8,-8.120062859865854,3
6018,110,11,20,7,-8.125291114928718,4
6019,87,27,34,17,-8.12723012634996,10
6020,41,33,11,22,-8.134701758810118,11
6021,107,14,56,8,-8.142413744294045,6
6022,112,10,4,6,-8.145974306589782,4
6023,51,49,76,32,-8.147426040460973,17
6024,8,31,68,19,-8.152272734975385,12
6025,112,16,18,11,-8.155957753880717,5
6026,20,17,33,11,-8.157924685534638,6
6027,9,20,76,13,-8.161384986883025,7
6028,81,15,47,10,-8.165398445346261,5
6029,88,122,16,78,-8.186735552225066,44
6030,39,25,74,15,-8.19553508787693,10
6031,93,24,87,15,-8.201353690040278,9
6032,51,42,64,26,-8.201880887276833,16
6033,63,75,16,47,-8.205892894816378,28
6034,15,12,34,8,-8.217126810746985,4
6035,40,14,112,8,-8.221202026655053,6
6036,57,18,76,12,-8.224487012675361,6
6037,71,10,99,6,-8.22496630028886,4
6038,106,21,69,13,-8.230262561693124,8
6039,15,29,8,17,-8.25475655550095,12
6040,109,11,81,7,-8.258298145902149,4
6041,94,12,103,7,-8.264881457481591,5
6042,14,12,37,7,-8.266467835075433,5
6043,91,18,41,12,-8.276671952774393,6
6044,106,31,90,21,-8.28384546124837,10
6045,56,17,86,11,-8.300855291965847,6
6046,109,23,74,15,-8.306575916019822,8
6047,81,15,104,8,-8.308547186806486,7
6048,48,13,90,8,-8.30973168111364,5
6049,43,18,57,13,-8.312131327998166,5
6050,108,16,19,10,-8.312758842928977,6
6051,9,15,25,10,-8.323455878342047,5
6052,89,12,48,9,-8.328549669565296,3
6053,96,25,48,16,-8.343995751105185,9
6054,31,32,41,20,-8.353957395244585,12
6055,5,22,7,14,-8.357081514884824,8
6056,3,28,19,17,-8.369074412898637,11
6057,25,45,7,29,-8.372806618348289,16
6058,68,25,62,15,-8.382615098007268,10
6059,62,10,43,6,-8.394379014204606,4
6060,19,17,63,11,-8.404706837961044,6
6061,67,14,109,7,-8.41022889195963,7
6062,102,21,50,12,-8.41869338516401,9
6063,102,12,41,8,-8.421036787338009,4
6064,90,19,73,12,-8.424101991862472,7
6065,103,14,88,9,-8.430464226549898,5
6066,114,20,55,13,-8.432483182241098,7
6067,70,24,96,13,-8.437417991026262,11
6068,95,11,29,7,-8.438441558722076,4
6069,96,14,95,9,-8.450373982592183,5
6070,106,16,12,11,-8.461406597257815,5
6071,107,39,48,24,-8.464254422847032,15
6072,20,37,63,22,-8.464473402081472,15
6073,112,26,39,16,-8.46467402651886,10
6074,79,13,112,8,-8.473860498540244,5
6075,85,14,55,9,-8.476039600481302,5
6076,77,14,74,9,-8.485489523270209,5
6077,40,28,64,18,-8.49607162432113,10
6078,34,18,29,11,-8.49996347208046,7
6079,45,10,91,6,-8.504304930616431,4
6080,40,23,62,12,-8.506273692628868,11
6081,6,21,13,13,-8.50747605743762,8
6082,69,22,81,13,-8.51799786685539,9
6083,61,20,53,14,-8.524850655507478,6
6084,63,11,110,7,-8.534985747455591,4
6085,35,12,94,7,-8.545638882275087,5
6086,63,11,93,7,-8.547776338932225,4
6087,67,15,16,10,-8.550473387804695,5
6088,2,11,94,7,-8.550586885180518,4
6089,36,11,78,7,-8.552435160203329,4
6090,66,15,65,10,-8.555650294431567,5
6091,80,12,41,8,-8.558761558111074,4
6092,93,10,49,6,-8.572163796775683,4
6093,55,23,95,15,-8.57500650986488,8
6094,77,18,53,11,-8.576780251337032,7
6095,68,13,108,8,-8.580585833252005,5
6096,93,44,65,26,-8.591281807406075,18
6097,43,54,13,31,-8.598118378940658,23
6098,14,22,16,14,-8.60697123103142,8
6099,65,24,1,14,-8.633116949744032,10
6100,35,17,27,11,-8.645931055549601,6
6101,58,12,70,8,-8.662523092509444,4
6102,54,11,53,7,-8.670288326383613,4
6103,31,12,19,8,-8.67684008479621,4
6104,31,31,9,20,-8.678153869820548,11
6105,68,67,39,41,-8.679610428054554,26
6106,20,41,39,24,-8.683414479878408,17
6107,76,49,86,30,-8.683760649202954,19
6108,19,20,34,13,-8.7005736514845,7
6109,86,15,45,9,-8.710518828201982,6
6110,45,10,58,6,-8.721721801464438,4
6111,87,59,27,37,-8.722585860088166,22
6112,8,20,62,14,-8.725180325771555,6
6113,17,22,4,15,-8.72773506800961,7
6114,106,14,38,7,-8.74501943352997,7
6115,19,15,17,10,-8.757673461754576,5
6116,64,17,70,12,-8.763483643924097,5
6117,1,27,16,19,-8.77734005429633,8
6118,18,23,106,15,-8.778191080978738,8
6119,37,16,94,10,-8.782776933637447,6
6120,39,51,30,31,-8.783045292899404,20
6121,99,14,77,10,-8.784719144285262,4
6122,107,11,26,7,-8.789963547813729,4
6123,28,17,41,11,-8.792780130820775,6
6124,42,10,106,7,-8.802546839644418,3
6125,63,24,57,14,-8.808573587871944,10
6126,47,18,36,12,-8.810892372607713,6
6127,87,41,43,26,-8.818073788670256,15
6128,77,22,63,15,-8.81999753264251,7
6129,36,19,63,12,-8.822881427312195,7
6130,50,17,85,11,-8.828432540960764,6
6131,12,10,20,6,-8.842914423325945,4
6132,87,15,32,10,-8.84415502943487,5
6133,51,16,35,10,-8.849945437990398,6
6134,66,22,107,14,-8.85129730206017,8
6135,12,15,6,8,-8.873687126500895,7
6136,53,11,49,7,-8.876928289416243,4
6137,13,23,90,15,-8.883764352926041,8
6138,109,18,75,12,-8.883837567249163,6
6139,97,12,69,8,-8.888377862411463,4
6140,104,12,48,8,-8.912185347145057,4
6141,60,22,17,14,-8.913811593594376,8
6142,25,19,110,13,-8.917701672558223,6
6143,88,10,26,6,-8.91952728239028,4
6144,13,27,58,19,-8.92184464761992,8
6145,91,10,11,7,-8.923724837318142,3
6146,84,22,13,15,-8.926224969766146,7
6147,12,14,98,9,-8.92802355273952,5
6148,31,12,73,8,-8.93891957013575,4
6149,74,26,51,18,-8.938947542412075,8
6150,109,20,53,13,-8.945178102898181,7
6151,103,23,107,15,-8.947816508283688,8
6152,104,15,78,10,-8.957766332972088,5
6153,18,30,68,19,-8.962998195734913,11
6154,32,11,28,7,-8.963821007682874,4
6155,81,14,11,9,-8.967824856070845,5
6156,114,20,47,12,-8.969382880850324,8
6157,36,18,97,11,-8.970668153566264,7
6158,43,17,49,11,-8.971053579217555,6
6159,112,20,88,13,-8.974262508725221,7
6160,52,15,28,9,-8.975367013246691,6
6161,81,10,48,7,-8.989696104511108,3
6162,80,15,78,10,-8.990142670025005,5
6163,72,10,38,6,-8.999506480702255,4
6164,88,30,30,18,-9.008031571554382,12
6165,36,15,5,9,-9.008614310253614,6
6166,12,18,28,12,-9.017903873482359,6
6167,33,16,63,10,-9.020049921268521,6
6168,45,16,35,9,-9.0400315918615,7
6169,103,14,49,8,-9.06187116984282,6
6170,86,29,44,19,-9.073857704921481,10
6171,107,39,80,26,-9.074881524481423,13
6172,40,16,57,10,-9.075047590769474,6
6173,55,11,89,7,-9.077967122900677,4
6174,8,34,95,21,-9.07920947405897,13
6175,75,12,94,8,-9.080901166069642,4
6176,31,15,109,10,-9.113887572404183,5
6177,17,11,92,7,-9.114563540800457,4
6178,102,17,30,10,-9.136610239450578,7
6179,106,25,39,15,-9.155969378752744,10
6180,5,43,50,26,-9.156049369840705,17
6181,63,21,62,13,-9.161474645821366,8
6182,72,14,63,10,-9.168022793278983,4
6183,40,15,92,10,-9.168940871834318,5
6184,29,22,112,14,-9.174610307731975,8
6185,91,13,15,7,-9.175439096539634,6
6186,38,14,53,9,-9.17946873124013,5
6187,91,14,23,8,-9.188824217195519,6
6188,63,16,81,10,-9.193429569946268,6
6189,114,21,95,13,-9.195016624238182,8
6190,76,36,63,24,-9.197425932191027,12
6191,40,17,73,11,-9.199997222971483,6
6192,90,11,93,7,-9.204947446014161,4
6193,12,27,78,19,-9.208018205719984,8
6194,69,16,70,11,-9.227346228401576,5
6195,49,21,34,13,-9.230991761756371,8
6196,3,17,54,10,-9.232444908063064,7
6197,20,23,91,14,-9.233435902067152,9
6198,62,12,18,8,-9.23480098215858,4
6199,53,15,78,9,-9.245467105519943,6
6200,51,22,34,14,-9.254702967852264,8
6201,29,14,70,8,-9.28377551108064,6
6202,18,17,100,10,-9.29762264727719,7
6203,38,10,45,7,-9.31109379184883,3
6204,86,26,29,17,-9.312176261822106,9
6205,84,10,77,7,-9.326879307665175,3
6206,2,29,28,19,-9.34282167881126,10
6207,87,20,1,12,-9.344990956449259,8
6208,28,12,26,8,-9.352858082446943,4
6209,23,19,55,11,-9.354242967773875,8
6210,84,21,104,13,-9.37162724208143,8
6211,4,16,27,10,-9.378715415982104,6
6212,16,25,81,16,-9.384174025613888,9
6213,12,31,60,17,-9.3846318247009,14
6214,36,11,109,8,-9.390936468630553,3
6215,38,16,27,11,-9.401601002215298,5
6216,57,17,103,11,-9.414120229975815,6
6217,2,15,13,9,-9.422510080465482,6
6218,63,11,32,7,-9.44232166344675,4
6219,89,19,41,13,-9.453124323035377,6
6220,3,56,13,37,-9.45340515599933,19
6221,15,13,48,8,-9.460060192318016,5
6222,96,47,16,33,-9.462953828826512,14
6223,60,29,100,19,-9.465662133176442,10
6224,15,23,43,15,-9.471477205647833,8
6225,57,16,23,10,-9.474501256774834,6
6226,98,22,13,15,-9.474726692398683,7
6227,77,15,72,9,-9.475978955314686,6
6228,85,11,3,6,-9.478406721140294,5
6229,3,10,37,6,-9.485691026106418,4
6230,88,40,15,28,-9.49255578246836,12
6231,84,11,18,7,-9.493458888054228,4
6232,99,22,37,15,-9.502759058160713,7
6233,51,35,15,22,-9.503627084553733,13
6234,2,13,114,8,-9.50915856241785,5
6235,80,14,90,10,-9.509239360264804,4
6236,69,13,33,8,-9.51115802646404,5
6237,36,17,8,11,-9.51236026695053,6
6238,64,14,62,8,-9.515284324050947,6
6239,9,27,18,18,-9.520249042639605,9
6240,25,32,20,21,-9.520523686179052,11
6241,31,22,1,13,-9.525804060927038,9
6242,51,15,48,8,-9.527077025607763,7
6243,75,11,20,7,-9.527707505687719,4
6244,108,13,106,9,-9.535201707134298,4
6245,107,25,33,15,-9.539564483245073,10
6246,34,13,18,9,-9.550016463821068,4
6247,13,23,26,16,-9.562123129591576,7
6248,31,28,27,16,-9.569633624787404,12
6249,48,12,17,7,-9.570482008629265,5
6250,7,20,73,12,-9.582485903794177,8
6251,112,27,64,19,-9.59501283307151,8
6252,53,13,8,9,-9.596286006275326,4
6253,84,18,83,11,-9.60947373437216,7
6254,8,14,99,8,-9.611065592860308,6
6255,109,17,70,11,-9.623350653501726,6
6256,12,18,103,10,-9.627784072806602,8
6257,53,23,41,15,-9.631953807885303,8
6258,114,10,22,5,-9.649313306364819,5
6259,75,11,85,8,-9.651599660168168,3
6260,13,10,101,7,-9.652646543094523,3
6261,71,12,100,8,-9.66068752031631,4
6262,60,47,64,32,-9.661747726131638,15
6263,114,34,8,23,-9.699231858321152,11
6264,84,30,8,20,-9.700360955856535,10
6265,11,18,75,11,-9.710887852205726,7
6266,8,15,52,10,-9.715026692600487,5
6267,37,12,78,8,-9.71930744346727,4
6268,31,19,43,9,-9.720852773553686,10
6269,3,20,72,12,-9.745718908399102,8
6270,18,49,16,33,-9.751591518104966,16
6271,53,14,15,9,-9.759389882181187,5
6272,51,30,95,21,-9.77001175442697,9
6273,83,24,37,15,-9.783726366978415,9
6274,93,10,62,6,-9.798162399200404,4
6275,62,16,114,10,-9.799890996069498,6
6276,55,20,27,14,-9.808864964478701,6
6277,17,24,40,16,-9.815776001763277,8
6278,57,13,54,10,-9.824315369895016,3
6279,69,17,47,11,-9.824856595944096,6
6280,47,17,9,11,-9.833363334347146,6
6281,98,10,53,6,-9.839111782848335,4
6282,3,10,74,7,-9.841517466916374,3
6283,13,21,44,14,-9.844973608163802,7
6284,41,23,8,16,-9.850013092502921,7
6285,33,26,51,19,-9.853114112635922,7
6286,12,20,104,13,-9.854826291134746,7
6287,29,34,60,21,-9.8571564032302,13
6288,57,14,38,8,-9.862555383696968,6
6289,27,12,22,8,-9.866452926590911,4
6290,1,17,75,12,-9.87310906944801,5
6291,71,15,17,9,-9.874078720771612,6
6292,54,17,2,12,-9.883928701627932,5
6293,29,14,20,9,-9.888770035938014,5
6294,16,20,110,13,-9.89345041941321,7
6295,51,18,79,10,-9.895968302837433,8
6296,83,14,11,10,-9.896151919094907,4
6297,54,47,37,31,-9.89694629679085,16
6298,43,32,100,20,-9.897954228241398,12
6299,68,21,103,13,-9.904114100948439,8
6300,75,35,28,23,-9.910859132469225,12
6301,60,34,54,23,-9.913747967452048,11
6302,70,18,30,11,-9.913973705469935,7
6303,57,11,1,7,-9.916035104284742,4
6304,84,50,63,31,-9.919938234846498,19
6305,2,10,95,7,-9.9203126299905,3
6306,29,15,75,9,-9.923300198268764,6
6307,90,14,46,9,-9.960134782518512,5
6308,94,32,13,21,-9.967124786712033,11
6309,85,10,87,7,-9.971655390565868,3
6310,88,18,73,12,-9.974203425238962,6
6311,12,21,53,13,-9.979940044053077,8
6312,109,14,93,9,-9.987067099161266,5
6313,65,25,95,16,-9.987438820754939,9
6314,84,27,30,19,-10.023299208241367,8
6315,91,19,30,13,-10.028289002870833,6
6316,107,13,110,9,-10.034721322746934,4
6317,46,14,78,8,-10.036009292919493,6
6318,38,10,44,7,-10.048373138060267,3
6319,83,23,13,15,-10.067954696106943,8
6320,19,41,27,28,-10.068063409604914,13
6321,69,37,49,22,-10.07650924818243,15
6322,49,16,40,10,-10.077718304922938,6
6323,106,12,79,8,-10.079963228120917,4
6324,17,17,23,11,-10.090670558592322,6
6325,76,32,23,20,-10.095144638641566,12
6326,3,15,17,9,-10.104489232217418,6
6327,70,30,87,18,-10.114463896406376,12
6328,36,36,53,25,-10.11473282468799,11
6329,114,12,78,7,-10.123963867745248,5
6330,109,10,92,7,-10.132066653367776,3
6331,31,37,53,23,-10.136338371296794,14
6332,57,21,79,13,-10.139577379833112,8
6333,23,11,96,7,-10.143008283174424,4
6334,68,16,92,11,-10.14730683848729,5
6335,13,43,30,28,-10.148212403247411,15
6336,81,32,51,20,-10.158277615855122,12
6337,49,27,98,18,-10.169586744689964,9
6338,102,23,107,14,-10.174413703745893,9
6339,9,12,6,7,-10.175309866966634,5
6340,60,46,27,32,-10.177471149675247,14
6341,37,41,97,27,-10.190687502541847,14
6342,33,13,71,9,-10.195530501937561,4
6343,2,15,98,9,-10.198603389321665,6
6344,104,19,90,12,-10.205908373136605,7
6345,39,24,91,16,-10.206322081312436,8
6346,28,14,10,10,-10.2079261309438,4
6347,31,17,30,10,-10.214096274935343,7
6348,91,35,63,24,-10.225389928816243,11
6349,37,13,34,9,-10.225834586393082,4
6350,23,21,49,14,-10.242959754676487,7
6351,106,16,67,10,-10.252161434234205,6
6352,39,43,18,29,-10.257246202371956,14
6353,84,16,103,9,-10.266610610260122,7
6354,68,22,72,15,-10.275897741373276,7
6355,112,24,60,16,-10.282975838759182,8
6356,107,23,45,15,-10.289536165233189,8
6357,31,29,107,16,-10.30345756995746,13
6358,88,43,53,29,-10.308417089519109,14
6359,15,13,108,9,-10.31501087444828,4
6360,65,10,35,7,-10.321578642281732,3
6361,1,13,37,8,-10.34216426905315,5
6362,102,16,40,10,-10.346146758066936,6
6363,27,15,17,9,-10.354549099588288,6
6364,7,10,94,7,-10.355621654064775,3
6365,88,39,50,25,-10.364860984100913,14
6366,69,24,63,16,-10.366973166191583,8
6367,55,16,15,12,-10.37053728825799,4
6368,93,16,106,10,-10.37915501513517,6
6369,92,14,16,11,-10.38158487536854,3
6370,35,26,76,17,-10.390096019432454,9
6371,103,14,72,9,-10.391960458595065,5
6372,39,16,44,10,-10.434810009571377,6
6373,9,17,43,10,-10.43571876790201,7
6374,94,10,77,7,-10.443428313097055,3
6375,108,17,48,12,-10.443613045373397,5
6376,31,10,6,6,-10.459894630543896,4
6377,49,14,94,10,-10.474432971630804,4
6378,48,37,63,25,-10.480037623792747,12
6379,48,10,62,6,-10.487894133335649,4
6380,9,27,64,19,-10.495957554452968,8
6381,3,14,47,9,-10.496343519851871,5
6382,27,29,54,19,-10.506022353115851,10
6383,102,16,63,10,-10.517349087153978,6
6384,37,14,89,8,-10.519274673853,6
6385,36,27,27,17,-10.523349599331356,10
6386,97,19,71,13,-10.523533962196899,6
6387,41,26,100,17,-10.528975782655806,9
6388,17,16,41,11,-10.533333329606139,5
6389,108,13,76,9,-10.539317855686345,4
6390,20,39,50,26,-10.540260354284218,13
6391,11,15,49,10,-10.54175783006079,5
6392,3,26,28,17,-10.54496551322771,9
6393,79,13,19,8,-10.549815768045496,5
6394,40,17,28,10,-10.551622113062638,7
6395,54,19,71,12,-10.56377327137223,7
6396,9,15,95,9,-10.569002592922953,6
6397,75,26,104,17,-10.574353916694225,9
6398,37,16,49,10,-10.578750157819186,6
6399,109,38,11,26,-10.59201718767136,12
6400,91,31,7,22,-10.60910028610159,9
6401,103,13,28,9,-10.6092467019397,4
6402,91,12,69,7,-10.612845012106748,5
6403,71,18,98,12,-10.627953776602759,6
6404,35,11,3,7,-10.637414854102069,4
6405,16,11,26,7,-10.641463660095837,4
6406,98,25,5,16,-10.662918685540621,9
6407,100,11,47,7,-10.66425762434052,4
6408,9,21,20,14,-10.676297323703047,7
6409,76,13,75,8,-10.684711333832395,5
6410,36,13,43,8,-10.713552025008546,5
6411,111,11,54,8,-10.714143810197228,3
6412,106,64,16,44,-10.722961682071126,20
6413,17,22,53,15,-10.723383781136489,7
6414,11,10,23,7,-10.736120462067522,3
6415,108,23,53,14,-10.749834986479383,9
6416,57,21,65,14,-10.760244548071404,7
6417,43,24,55,18,-10.765561111805061,6
6418,7,11,59,8,-10.771239818059199,3
6419,19,25,7,18,-10.775977198177875,7
6420,91,25,55,18,-10.791612827626562,7
6421,89,12,63,9,-10.816669680392751,3
6422,81,17,106,10,-10.816681182916206,7
6423,65,26,38,16,-10.83463870682702,10
6424,15,14,62,9,-10.843943580538047,5
6425,114,31,87,19,-10.855794018644563,12
6426,67,17,86,11,-10.856458271232285,6
6427,66,10,11,6,-10.898142591848792,4
6428,5,17,73,11,-10.90738305979487,6
6429,86,37,102,25,-10.919714046293317,12
6430,66,10,78,6,-10.927212098742269,4
6431,60,15,103,10,-10.955343329408253,5
6432,88,19,102,14,-10.972125082564368,5
6433,97,25,13,16,-10.985857531237674,9
6434,49,34,100,22,-10.99920449039483,12
6435,110,20,51,14,-11.000148170458745,6
6436,3,26,40,18,-11.007177692487943,8
6437,46,19,30,13,-11.008568666826074,6
6438,71,13,15,9,-11.00914391321026,4
6439,103,17,34,12,-11.01488088004568,5
6440,92,14,41,9,-11.016394202336143,5
6441,66,13,7,8,-11.034566799554375,5
6442,32,17,16,11,-11.045561391190384,6
6443,114,12,32,8,-11.045874107216177,4
6444,1,39,55,27,-11.047135752371082,12
6445,11,11,99,7,-11.04788337752713,4
6446,104,15,62,11,-11.098747349135209,4
6447,32,13,74,9,-11.101664191982367,4
6448,65,18,72,12,-11.109219542203151,6
6449,70,15,46,10,-11.123543654837002,5
6450,91,16,43,11,-11.128114127049445,5
6451,13,31,108,21,-11.148353863265475,10
6452,1,13,78,9,-11.156578268103178,4
6453,38,18,11,12,-11.20455542890719,6
6454,1,11,89,7,-11.20901106938993,4
6455,46,12,100,8,-11.210309669403358,4
6456,3,15,25,10,-11.21463496022273,5
6457,106,18,98,12,-11.217270403208776,6
6458,51,13,73,9,-11.219804453521853,4
6459,8,36,75,25,-11.220741251540183,11
6460,96,20,46,12,-11.223825219116964,8
6461,77,16,98,11,-11.231262510023575,5
6462,68,25,25,17,-11.235607083018872,8
6463,81,13,40,9,-11.249205674756395,4
6464,109,21,68,15,-11.251244714581787,6
6465,7,52,75,35,-11.2746633859962,17
6466,55,14,2,9,-11.276816159574057,5
6467,27,11,111,8,-11.279710088837586,3
6468,60,25,47,17,-11.28316200541763,8
6469,61,10,75,6,-11.283854363299366,4
6470,5,10,80,7,-11.295210617596885,3
6471,96,25,7,18,-11.300422106484014,7
6472,20,12,64,9,-11.331308462604776,3
6473,112,11,108,7,-11.335603356831987,4
6474,77,30,104,20,-11.335858846829382,10
6475,62,21,74,14,-11.355871307801838,7
6476,102,15,75,11,-11.3579023724584,4
6477,112,22,28,15,-11.372427658976596,7
6478,78,28,39,19,-11.374922957505097,9
6479,10,14,107,9,-11.38119632500004,5
6480,38,11,4,8,-11.395009854616482,3
6481,18,17,47,12,-11.411676107822032,5
6482,12,26,41,18,-11.41461712371932,8
6483,18,47,13,31,-11.43817217657445,16
6484,68,18,50,11,-11.447393428752164,7
6485,106,41,114,27,-11.462749893343954,14
6486,18,15,11,10,-11.496523839067972,5
6487,37,12,68,8,-11.496583691347078,4
6488,75,14,98,9,-11.497093707313171,5
6489,81,15,7,9,-11.525413070422037,6
6490,7,12,110,7,-11.526061320417652,5
6491,76,15,74,9,-11.544600382799558,6
6492,3,15,38,10,-11.55575224939262,5
6493,3,13,108,9,-11.562059375800661,4
6494,71,10,111,7,-11.563837134119527,3
6495,104,16,36,10,-11.564722196156035,6
6496,39,15,90,10,-11.577976501423594,5
6497,70,23,11,16,-11.609570033059052,7
6498,38,17,75,13,-11.628826987325242,4
6499,40,12,100,8,-11.638460148115906,4
6500,83,17,107,12,-11.644521740420235,5
6501,104,11,93,7,-11.670878710804795,4
6502,88,10,21,7,-11.67738292245627,3
6503,81,10,8,7,-11.678569579324556,3
6504,28,23,34,16,-11.682170467841411,7
6505,96,13,91,9,-11.692854193124042,4
6506,69,12,34,10,-11.742698738008174,2
6507,43,20,54,13,-11.759609270938485,7
6508,62,10,112,7,-11.78047192200998,3
6509,65,12,91,8,-11.784658313781671,4
6510,54,10,44,7,-11.791894285038754,3
6511,40,21,8,15,-11.791921402372775,6
6512,108,11,8,8,-11.805411430354427,3
6513,91,10,53,7,-11.811611902058761,3
6514,17,10,83,6,-11.812775268760374,4
6515,111,16,28,11,-11.820301223407922,5
6516,64,10,74,6,-11.828764368523549,4
6517,28,47,63,33,-11.828866423716303,14
6518,86,17,92,11,-11.83357437507567,6
6519,28,34,74,23,-11.834419909257845,11
6520,107,45,57,30,-11.845167977874887,15
6521,41,22,111,14,-11.859477089655313,8
6522,12,11,79,7,-11.866943529008417,4
6523,11,13,2,9,-11.88450219450607,4
6524,77,17,71,12,-11.915487518479782,5
6525,12,30,94,19,-11.933387464684667,11
6526,65,46,114,30,-11.938229846486397,16
6527,18,27,95,18,-11.951490678023534,9
6528,55,18,102,12,-11.983866194974432,6
6529,29,16,64,12,-12.010507228979478,4
6530,81,29,87,18,-12.01535695996611,11
6531,104,12,1,8,-12.020108292717424,4
6532,89,10,7,7,-12.029257289487045,3
6533,89,10,10,7,-12.051235053807009,3
6534,63,18,1,11,-12.054495717242014,7
6535,71,22,104,14,-12.060518806565574,8
6536,3,20,53,14,-12.068087567340713,6
6537,19,21,72,15,-12.088885005162664,6
6538,35,11,8,8,-12.093356369533684,3
6539,72,20,28,14,-12.11934808588004,6
6540,70,12,34,8,-12.123530804367727,4
6541,4,10,15,6,-12.1242208434208,4
6542,63,12,92,7,-12.136993324985582,5
6543,47,13,55,8,-12.137143102946048,5
6544,96,40,11,27,-12.14102850879166,13
6545,70,22,2,14,-12.153236389251056,8
6546,99,21,107,14,-12.174640608684573,7
6547,57,25,70,15,-12.177083859404236,10
6548,84,35,11,24,-12.189911906563859,11
6549,88,83,13,58,-12.195764790442619,25
6550,13,11,42,8,-12.203174115394757,3
6551,106,11,78,8,-12.21024325274275,3
6552,37,19,64,13,-12.216856507558585,6
6553,43,19,75,14,-12.224767647713705,5
6554,60,22,74,14,-12.230302476711504,8
6555,12,14,30,10,-12.247519333468231,4
6556,29,11,58,8,-12.250932195859464,3
6557,19,16,9,11,-12.252328421645837,5
6558,84,11,71,8,-12.255989147154674,3
6559,39,10,32,7,-12.25900875776762,3
6560,41,13,34,8,-12.262731570966233,5
6561,60,18,37,11,-12.263894360602317,7
6562,39,21,109,15,-12.264003725130951,6
6563,18,15,69,10,-12.281407888329312,5
6564,19,29,51,21,-12.290136577107422,8
6565,12,12,72,9,-12.291429668749544,3
6566,49,22,41,15,-12.296817896590069,7
6567,96,29,98,20,-12.301665445316491,9
6568,57,14,75,10,-12.306540056833528,4
6569,77,26,100,18,-12.30976335790178,8
6570,104,23,49,16,-12.322985298305156,7
6571,97,12,67,9,-12.35346782744064,3
6572,12,14,75,9,-12.356839423121746,5
6573,77,22,8,15,-12.389831393600819,7
6574,72,17,39,12,-12.40392712900527,5
6575,50,17,36,10,-12.423703215189779,7
6576,3,32,30,23,-12.42374491228286,9
6577,58,27,65,18,-12.431650709075084,9
6578,87,31,98,22,-12.43458344819276,9
6579,37,14,18,10,-12.438833593443572,4
6580,9,30,15,18,-12.451949073593187,12
6581,85,10,41,6,-12.470634664927642,4
6582,81,12,28,8,-12.485800898870087,4
6583,92,15,64,8,-12.492372460791037,7
6584,27,33,104,23,-12.514336487582195,10
6585,5,27,75,17,-12.535083552437035,10
6586,71,18,41,13,-12.557773267008848,5
6587,5,27,57,19,-12.572003913811173,8
6588,102,12,15,9,-12.597866884640942,3
6589,109,38,107,27,-12.59817428070907,11
6590,85,20,39,13,-12.618845399489867,7
6591,78,20,76,15,-12.633094549652572,5
6592,38,13,100,10,-12.638482369277126,3
6593,5,15,48,11,-12.675358072710548,4
6594,63,40,80,28,-12.682443988429267,12
6595,57,16,62,12,-12.692635812852643,4
6596,2,12,57,8,-12.707474284723991,4
6597,9,19,11,13,-12.708684805193936,6
6598,88,16,111,12,-12.710530076381987,4
6599,48,12,98,9,-12.72400980532305,3
6600,106,24,46,15,-12.725492516069489,9
6601,49,13,80,8,-12.731038457974943,5
6602,106,14,33,10,-12.736963404825662,4
6603,36,10,95,7,-12.746346244298937,3
6604,1,15,100,10,-12.750379039232412,5
6605,64,14,109,8,-12.756972146613661,6
6606,81,12,54,8,-12.757047966098474,4
6607,51,21,80,14,-12.779249811641693,7
6608,11,14,108,10,-12.798974196396992,4
6609,89,10,19,7,-12.79921548352811,3
6610,49,16,48,12,-12.810788363261887,4
6611,46,40,104,27,-12.826160652792538,13
6612,43,20,30,15,-12.838886769237316,5
6613,94,25,39,17,-12.842801062921897,8
6614,65,21,2,16,-12.8900275785182,5
6615,109,19,17,13,-12.911257852793488,6
6616,65,46,100,33,-12.913281442092941,13
6617,94,13,9,8,-12.936870793436032,5
6618,12,15,114,9,-12.949509468076533,6
6619,60,29,91,19,-12.952631394075716,10
6620,87,26,79,19,-12.964381621365796,7
6621,94,17,85,12,-12.991600312687373,5
6622,79,12,15,8,-13.059472232177564,4
6623,3,28,84,18,-13.065986590514674,10
6624,37,41,11,29,-13.080901694615491,12
6625,87,11,21,8,-13.114631052870209,3
6626,70,10,83,6,-13.118339150755117,4
6627,3,30,63,23,-13.136472607002512,7
6628,37,28,95,21,-13.149042342745602,7
6629,112,17,47,11,-13.19505835586536,6
6630,89,17,27,12,-13.200102555354917,5
6631,109,26,30,19,-13.209580961967477,7
6632,54,18,36,12,-13.217744798273172,6
6633,54,37,75,25,-13.241406019841683,12
6634,11,23,95,17,-13.263288005084238,6
6635,5,31,102,21,-13.269431869962297,10
6636,99,12,7,8,-13.274517260788413,4
6637,106,19,64,13,-13.295192075566398,6
6638,46,17,50,11,-13.310329365776978,6
6639,46,12,18,9,-13.322032493347338,3
6640,32,11,55,7,-13.36363963009391,4
6641,35,12,104,8,-13.369677424437175,4
6642,19,15,18,11,-13.380338986795524,4
6643,112,11,91,8,-13.423237527272477,3
6644,53,15,75,10,-13.423496737137004,5
6645,68,16,61,11,-13.424919545398375,5
6646,32,12,25,7,-13.427877456338663,5
6647,45,15,23,11,-13.436468047997268,4
6648,53,19,43,14,-13.438033142991657,5
6649,35,15,36,11,-13.440272285829963,4
6650,77,19,43,13,-13.44590515078262,6
6651,69,24,27,16,-13.483104419153626,8
6652,108,12,84,9,-13.488009207908556,3
6653,63,32,30,22,-13.49817196218878,10
6654,112,13,55,10,-13.498405767917479,3
6655,29,27,13,18,-13.513958263485302,9
6656,6,10,80,7,-13.522871173076245,3
6657,109,17,57,12,-13.555888364324371,5
6658,91,12,76,9,-13.56346091448288,3
6659,74,10,15,7,-13.56932630742914,3
6660,11,31,104,22,-13.57220534859567,9
6661,57,20,34,14,-13.584679931175108,6
6662,12,13,9,9,-13.614723999539923,4
6663,60,18,34,13,-13.64483641529246,5
6664,94,12,17,8,-13.646957443918598,4
6665,18,11,49,8,-13.655065375637419,3
6666,49,13,47,10,-13.686396277061279,3
6667,44,14,104,10,-13.703910249073422,4
6668,31,25,63,18,-13.714594813504094,7
6669,27,10,97,6,-13.735152835550487,4
6670,88,37,95,26,-13.752013257016609,11
6671,20,16,34,12,-13.76310700617088,4
6672,76,19,7,12,-13.791356001018313,7
6673,112,11,97,9,-13.794615799527321,2
6674,31,74,13,51,-13.800549608099518,23
6675,31,17,98,11,-13.805084918983175,6
6676,112,14,38,11,-13.819485047030144,3
6677,103,30,100,21,-13.847875266312384,9
6678,50,18,77,14,-13.854547351284703,4
6679,104,14,34,10,-13.864298464092721,4
6680,50,19,53,13,-13.883151416746287,6
6681,112,10,25,7,-13.919292260310078,3
6682,3,31,100,22,-13.921725717823314,9
6683,112,11,37,8,-13.937736127059297,3
6684,20,14,60,10,-13.93992645286088,4
6685,69,19,75,14,-13.94230448490658,5
6686,109,11,91,8,-13.94618860472034,3
6687,71,24,40,17,-13.948125771645659,7
6688,39,21,108,14,-13.94833446698378,7
6689,109,29,114,22,-13.961336538901845,7
6690,75,12,111,8,-13.972281809419961,4
6691,54,29,48,20,-14.01975726236914,9
6692,103,16,55,12,-14.032110996505946,4
6693,39,11,45,7,-14.033377854173942,4
6694,109,23,15,18,-14.044569549955568,5
6695,77,29,40,21,-14.048771071022598,8
6696,38,22,104,15,-14.071473191155556,7
6697,9,30,41,21,-14.113579732248974,9
6698,75,10,72,7,-14.207053385683185,3
6699,7,17,61,11,-14.217702740281519,6
6700,102,11,46,8,-14.307494713152051,3
6701,57,12,31,8,-14.310689026630849,4
6702,86,25,26,19,-14.32203675657022,6
6703,77,27,7,19,-14.33556677589385,8
6704,83,10,40,8,-14.347262135245904,2
6705,81,15,100,10,-14.382694095158195,5
6706,90,16,20,11,-14.40477443227545,5
6707,70,26,108,19,-14.427393649276276,7
6708,14,11,80,7,-14.435345395194508,4
6709,35,13,97,10,-14.4445517315995,3
6710,5,12,44,9,-14.447481002517355,3
6711,35,13,63,9,-14.450412261730216,4
6712,2,10,73,7,-14.457830254043136,3
6713,76,10,80,7,-14.461464881129865,3
6714,25,12,34,9,-14.468789684868275,3
6715,62,11,12,8,-14.509530975721363,3
6716,37,12,73,8,-14.533349572792924,4
6717,50,19,80,15,-14.554439051919099,4
6718,99,12,50,8,-14.581629542155014,4
6719,109,34,27,23,-14.672056456650022,11
6720,19,16,55,11,-14.68778354720053,5
6721,78,19,17,13,-14.709203332504178,6
6722,83,19,114,14,-14.71253096490687,5
6723,29,10,74,7,-14.72390247298373,3
6724,31,10,100,7,-14.730848989291465,3
6725,102,11,90,6,-14.739148726840858,5
6726,106,14,32,11,-14.741977351969277,3
6727,51,22,72,15,-14.75505634651796,7
6728,109,14,72,11,-14.772801167610014,3
6729,35,11,102,7,-14.787485364380144,4
6730,76,13,15,9,-14.81353391108204,4
6731,38,13,87,9,-14.859584047072818,4
6732,28,12,110,8,-14.8602682733133,4
6733,94,42,16,31,-14.871920571902171,11
6734,22,12,13,9,-14.994671319317485,3
6735,75,10,45,8,-15.003649946946844,2
6736,99,18,25,13,-15.014737107768294,5
6737,93,10,38,6,-15.046407356806796,4
6738,79,16,104,11,-15.05495488242158,5
6739,77,10,54,9,-15.067841236649627,1
6740,77,16,15,12,-15.07093803861921,4
6741,47,13,78,9,-15.091757543510102,4
6742,68,29,100,20,-15.127566113231643,9
6743,29,10,71,8,-15.14318831762859,2
6744,98,16,109,12,-15.216713921072746,4
6745,46,14,93,11,-15.251126640356869,3
6746,94,12,104,9,-15.27233865597327,3
6747,84,15,41,11,-15.33074063826509,4
6748,2,15,100,10,-15.363858490781986,5
6749,25,14,49,10,-15.43786379260084,4
6750,94,15,62,11,-15.456678982493086,4
6751,107,25,73,17,-15.460672720698524,8
6752,103,12,74,9,-15.463990000688312,3
6753,39,12,2,9,-15.473797666414958,3
6754,84,22,112,16,-15.486639525748986,6
6755,31,15,69,10,-15.502962092044207,5
6756,104,20,64,15,-15.515264160119221,5
6757,10,11,37,7,-15.516949569025604,4
6758,14,11,25,9,-15.536643242754739,2
6759,9,16,48,12,-15.537621007215709,4
6760,31,12,104,8,-15.561592201078605,4
6761,5,20,23,15,-15.563915929412014,5
6762,45,14,4,10,-15.600891470448104,4
6763,69,10,23,8,-15.603167423944376,2
6764,85,11,106,8,-15.605731963514037,3
6765,97,13,90,9,-15.62188808576594,4
6766,97,12,14,10,-15.664913845649806,2
6767,112,14,15,10,-15.700949053545525,4
6768,1,13,8,10,-15.702434313684371,3
6769,51,20,45,15,-15.703190735785386,5
6770,80,13,75,10,-15.71805205236554,3
6771,88,14,98,11,-15.721203352726127,3
6772,35,12,80,9,-15.72406211872363,3
6773,77,14,37,10,-15.73169378416834,4
6774,96,16,93,12,-15.73319462766121,4
6775,35,10,75,8,-15.755761764469415,2
6776,93,11,30,8,-15.77720736230077,3
6777,88,19,80,13,-15.78210749106585,6
6778,17,22,95,17,-15.802621580377178,5
6779,41,12,15,9,-15.83344464930069,3
6780,31,45,16,33,-15.837412153743443,12
6781,51,23,94,17,-15.876961640520744,6
6782,28,29,90,22,-15.880089586771652,7
6783,57,18,94,13,-15.891839037049907,5
6784,28,12,43,8,-15.894105628705272,4
6785,9,30,53,22,-15.894615033798411,8
6786,70,13,80,11,-15.90133341789594,2
6787,51,18,2,12,-15.90559711313002,6
6788,76,18,54,13,-15.916701819672275,5
6789,41,18,30,13,-15.955365157993048,5
6790,63,13,14,9,-15.961958621197994,4
6791,85,17,30,12,-15.962999516967606,5
6792,37,14,15,11,-16.033544043199246,3
6793,5,18,41,12,-16.050377082501456,6
6794,103,11,50,8,-16.107700105307455,3
6795,112,15,71,11,-16.11687592102847,4
6796,46,13,98,9,-16.12835125202737,4
6797,102,10,43,7,-16.154622115934174,3
6798,35,12,48,9,-16.1584671300222,3
6799,60,16,102,11,-16.199085660218575,5
6800,77,31,16,23,-16.21288067345658,8
6801,57,16,29,12,-16.251057006057927,4
6802,80,12,34,10,-16.269229317512288,2
6803,33,16,65,12,-16.286121361101078,4
6804,2,19,104,13,-16.35238800305578,6
6805,57,22,100,16,-16.352929528191847,6
6806,83,13,27,11,-16.36809252264109,2
6807,40,10,29,8,-16.37829418439082,2
6808,39,19,99,15,-16.42872930905631,4
6809,25,25,11,20,-16.429746187224737,5
6810,55,15,14,12,-16.464885141480416,3
6811,87,10,61,7,-16.482333693393567,3
6812,64,10,66,8,-16.526342406123632,2
6813,83,20,16,15,-16.531803021169054,5
6814,81,17,49,12,-16.548537671207548,5
6815,68,22,95,18,-16.550204863156033,4
6816,36,10,101,8,-16.627946704419497,2
6817,69,23,53,17,-16.67657945090473,6
6818,112,28,78,21,-16.679149831728488,7
6819,12,11,55,8,-16.70360942532312,3
6820,103,13,109,9,-16.7215146195565,4
6821,71,15,95,10,-16.72675418994599,5
6822,83,13,23,10,-16.744700089549813,3
6823,76,10,1,7,-16.815372977495876,3
6824,97,14,38,11,-16.838290194315167,3
6825,69,14,72,11,-16.843378758894527,3
6826,29,27,88,20,-16.852047860671814,7
6827,57,21,7,14,-16.86838035950274,7
6828,48,14,78,11,-16.88793509976696,3
6829,10,12,13,9,-16.89276746041982,3
6830,112,19,20,15,-16.964936240764274,4
6831,31,10,38,6,-16.97274158238424,4
6832,102,11,48,9,-16.98431234773642,2
6833,46,11,43,8,-16.991693442801246,3
6834,109,15,12,12,-17.036286111783696,3
6835,70,11,48,8,-17.04295857723929,3
6836,102,12,29,10,-17.056577765128154,2
6837,1,14,18,11,-17.058153705270225,3
6838,9,29,27,21,-17.072056537621457,8
6839,2,11,60,8,-17.11684300008854,3
6840,23,13,72,10,-17.14817782244225,3
6841,41,10,6,7,-17.168490702692317,3
6842,5,22,27,16,-17.186967099907662,6
6843,106,10,35,7,-17.319051156851785,3
6844,35,10,60,7,-17.41812694726481,3
6845,29,10,80,8,-17.457200220457587,2
6846,18,14,23,10,-17.468338798211544,4
6847,57,10,47,7,-17.502805405052264,3
6848,83,11,110,9,-17.575104905290946,2
6849,67,10,20,8,-17.6724550880506,2
6850,9,12,108,8,-17.689021813252335,4
6851,3,11,5,7,-17.694163901939547,4
6852,58,23,86,18,-17.708236566074184,5
6853,51,23,90,18,-17.7178788097309,5
6854,55,12,44,9,-17.771847163193563,3
6855,5,18,30,15,-17.81053305502534,3
6856,88,17,32,13,-17.824594134673823,4
6857,114,11,111,8,-17.846918134233796,3
6858,41,10,35,7,-17.84884882348167,3
6859,30,15,95,11,-17.91990160883281,4
6860,62,17,78,13,-18.093769732536938,4
6861,54,10,67,8,-18.121548101252507,2
6862,79,10,75,8,-18.185200748196127,2
6863,43,12,81,9,-18.327617727929386,3
6864,6,11,19,8,-18.335706204340305,3
6865,13,20,80,14,-18.335804849316276,6
6866,54,12,34,10,-18.362976743969615,2
6867,18,10,5,8,-18.464269170029826,2
6868,31,15,106,11,-18.52908676481624,4
6869,33,19,55,15,-18.562648470025508,4
6870,29,13,72,10,-18.568703052277584,3
6871,12,10,45,8,-18.65380711999512,2
6872,28,17,99,13,-18.754584808369174,4
6873,58,12,49,9,-18.76050052933211,3
6874,102,12,27,10,-18.772173343475483,2
6875,35,15,87,11,-18.824404565886294,4
6876,97,12,34,9,-18.831202908180156,3
6877,4,13,98,11,-18.936498509144613,2
6878,106,11,89,7,-18.95338953455919,4
6879,106,10,92,8,-19.041690772468705,2
6880,43,12,45,9,-19.04326521517843,3
6881,54,16,4,14,-19.244087603842104,2
6882,18,14,99,11,-19.290873438644514,3
6883,29,16,109,11,-19.29384395841607,5
6884,36,19,30,17,-19.30529767168729,2
6885,29,11,114,8,-19.428812885704772,3
6886,6,11,30,9,-19.605882514870544,2
6887,108,12,114,9,-19.622938702057745,3
6888,5,11,64,9,-19.698196874853632,2
6889,31,11,15,8,-19.738787942525683,3
6890,32,12,95,10,-19.760326388824467,2
6891,97,13,73,9,-19.966763707753135,4
6892,84,12,7,10,-20.160900959942534,2
6893,68,38,112,30,-20.161440612174857,8
6894,34,10,64,8,-20.224712091526342,2
6895,103,10,75,9,-20.241991505098973,1
6896,10,15,51,12,-20.332726180509006,3
6897,66,11,13,9,-20.385605001870267,2
6898,3,17,48,13,-20.442566414929487,4
6899,94,23,81,17,-20.51779847980575,6
6900,94,12,48,10,-20.576242864974443,2
6901,79,11,17,9,-20.72101316555543,2
6902,68,11,90,9,-20.787956198015944,2
6903,3,17,75,14,-20.897191698320935,3
6904,62,11,34,9,-20.901478916088543,2
6905,10,14,112,11,-21.02177070913973,3
6906,43,10,110,8,-21.055981543018305,2
6907,112,16,80,12,-21.10879540796462,4
6908,37,10,19,9,-21.121276459586678,1
6909,72,11,57,11,-21.2224791597557,0
6910,51,11,101,9,-21.22662017561448,2
6911,91,16,104,15,-21.31971827875211,1
6912,4,13,25,11,-21.42004260246313,2
6913,4,15,41,10,-21.480590173913868,5
6914,57,13,26,10,-21.519388702063118,3
6915,31,12,62,9,-21.790941067775986,3
6916,38,12,55,10,-22.071024000200875,2
6917,57,14,112,11,-22.163408269660163,3
6918,97,12,91,10,-22.175648770183788,2
6919,109,13,19,11,-22.638381086719185,2
6920,1,10,3,8,-22.67051623941871,2
6921,8,11,4,10,-23.17790508365148,1
6922,66,10,58,9,-23.43526848489906,1
6923,77,19,75,16,-23.528365703077355,3
6924,33,10,100,9,-24.40727081526952,1
6925,42,11,104,10,-24.554805995086454,1
6926,89,11,11,10,-25.076774065413545,1
6927,38,10,69,9,-27.695920761479563,1
6928,61,10,98,10,-28.323329566102483,0
6929,23,13,90,12,-28.362481429909796,1
6930,37,11,44,11,-29.883498899257123,0
6931,102,16,112,15,-31.192976791251173,1
