,againstHero,games,hero,losses,shift,wins
0,112,16,102,1,31.192976791251173,15
1,44,11,37,0,29.883498899257123,11
2,90,13,23,1,28.3624814299098,12
3,69,10,38,1,27.695920761479563,9
4,11,11,89,1,25.07677406541354,10
5,26,12,57,2,24.80508950345583,10
6,104,11,42,1,24.55480599508645,10
7,100,10,33,1,24.40727081526952,9
8,34,11,97,2,24.058676404388496,9
9,75,19,77,3,23.528365703077363,16
10,58,10,66,1,23.43526848489906,9
11,4,11,8,1,23.177905083651492,10
12,72,12,29,2,22.845970500293163,10
13,3,10,1,2,22.67051623941871,8
14,19,13,109,2,22.638381086719185,11
15,91,12,97,2,22.175648770183788,10
16,112,14,57,3,22.163408269660163,11
17,55,12,38,2,22.071024000200875,10
18,62,12,31,3,21.79094106777599,9
19,41,15,4,5,21.480590173913868,10
20,25,13,4,2,21.42004260246313,11
21,49,11,58,2,21.376962439830404,9
22,104,16,91,1,21.319718278752113,15
23,101,11,51,2,21.22662017561448,9
24,57,11,72,0,21.2224791597557,11
25,80,16,112,4,21.10879540796462,12
26,110,10,43,2,21.055981543018305,8
27,112,14,10,3,21.02177070913973,11
28,34,11,62,2,20.901478916088546,9
29,75,17,3,3,20.897191698320935,14
30,90,11,68,2,20.787956198015944,9
31,17,11,79,2,20.721013165555437,9
32,81,23,94,6,20.51779847980575,17
33,48,17,3,4,20.44256641492949,13
34,13,11,66,2,20.385605001870267,9
35,51,15,10,3,20.332726180509006,12
36,75,10,103,1,20.241991505098973,9
37,64,10,34,2,20.22471209152634,8
38,112,38,68,8,20.161440612174857,30
39,7,12,84,2,20.160900959942534,10
40,73,13,97,4,19.966763707753135,9
41,65,15,33,3,19.770112976636934,12
42,95,12,32,2,19.760326388824463,10
43,15,11,31,3,19.73878794252568,8
44,48,11,94,2,19.702972057039275,9
45,64,11,5,2,19.698196874853632,9
46,114,12,108,3,19.622938702057745,9
47,30,11,6,2,19.605882514870544,9
48,30,19,36,2,19.30529767168729,17
49,99,14,18,3,19.290873438644514,11
50,4,16,54,2,19.2440876038421,14
51,45,12,43,3,19.04326521517843,9
52,92,10,106,2,19.041690772468705,8
53,29,14,57,3,18.996915689300955,11
54,89,11,106,4,18.95338953455919,7
55,98,13,4,2,18.936498509144613,11
56,87,15,35,4,18.8244045658863,11
57,27,12,102,2,18.772173343475483,10
58,99,17,28,4,18.754584808369174,13
59,45,10,12,2,18.653807119995122,8
60,55,19,33,4,18.562648470025508,15
61,106,15,31,4,18.52908676481624,11
62,5,10,18,2,18.464269170029823,8
63,80,20,13,6,18.33580484931627,14
64,19,11,6,3,18.335706204340305,8
65,81,12,43,3,18.327617727929386,9
66,75,10,79,2,18.18520074819613,8
67,67,10,54,2,18.121548101252507,8
68,95,15,30,4,17.919901608832813,11
69,78,16,62,4,17.89987876325871,12
70,35,10,41,3,17.84884882348167,7
71,111,11,114,3,17.846918134233796,8
72,32,17,88,4,17.82459413467382,13
73,30,18,5,3,17.81053305502534,15
74,44,12,55,3,17.77184716319356,9
75,90,23,51,5,17.7178788097309,18
76,86,23,58,5,17.708236566074184,18
77,5,11,3,4,17.694163901939547,7
78,108,12,9,4,17.68902181325234,8
79,20,10,67,2,17.6724550880506,8
80,110,11,83,2,17.575104905290946,9
81,23,14,18,4,17.468338798211544,10
82,80,10,29,2,17.457200220457587,8
83,60,10,35,3,17.41812694726481,7
84,34,11,54,2,17.37969504408319,9
85,35,10,106,3,17.319051156851785,7
86,109,15,29,5,17.2607577250384,10
87,55,12,112,2,17.232830626787052,10
88,27,22,5,6,17.18696709990766,16
89,6,10,41,3,17.168490702692317,7
90,72,13,23,3,17.14817782244225,10
91,60,11,2,3,17.11684300008854,8
92,27,29,9,8,17.072056537621453,21
93,18,14,1,3,17.058153705270225,11
94,29,12,102,2,17.056577765128154,10
95,48,11,70,3,17.04295857723929,8
96,12,15,109,3,17.036286111783692,12
97,43,11,46,3,16.991693442801246,8
98,38,10,31,4,16.97274158238424,6
99,20,19,112,4,16.964936240764274,15
100,13,12,10,3,16.892767460419815,9
101,78,14,48,3,16.88793509976696,11
102,7,21,57,7,16.868380359502744,14
103,72,14,69,3,16.843378758894527,11
104,38,14,97,3,16.838290194315167,11
105,1,10,76,3,16.815372977495876,7
106,23,13,83,3,16.744700089549806,10
107,95,15,71,5,16.72675418994599,10
108,109,13,103,4,16.721514619556498,9
109,55,11,12,3,16.703609425323116,8
110,78,28,112,7,16.679149831728484,21
111,53,23,69,6,16.67657945090473,17
112,101,10,36,2,16.6279467044195,8
113,95,22,68,4,16.550204863156036,18
114,49,17,81,5,16.548537671207544,12
115,16,20,83,5,16.531803021169058,15
116,66,10,64,2,16.526342406123636,8
117,61,10,87,3,16.482333693393567,7
118,14,15,55,3,16.464885141480416,12
119,11,25,25,5,16.429746187224733,20
120,99,19,39,4,16.42872930905631,15
121,29,10,40,2,16.378294184390825,8
122,27,13,83,2,16.368092522641092,11
123,100,22,57,6,16.35292952819185,16
124,104,19,2,6,16.352388003055783,13
125,34,12,80,2,16.269229317512288,10
126,102,16,60,5,16.199085660218575,11
127,48,12,35,3,16.1584671300222,9
128,43,10,102,3,16.154622115934178,7
129,98,13,46,4,16.128351252027375,9
130,71,15,112,4,16.116875921028473,11
131,30,17,41,5,16.109597077758615,12
132,50,11,103,3,16.107700105307455,8
133,68,11,37,3,16.057273622388777,8
134,41,18,5,6,16.05037708250146,12
135,15,14,37,3,16.033544043199246,11
136,30,17,85,5,15.962999516967606,12
137,14,13,63,4,15.961958621197992,9
138,54,18,76,5,15.916701819672271,13
139,2,18,51,6,15.905597113130021,12
140,80,13,70,2,15.901333417895936,11
141,53,30,9,8,15.894615033798411,22
142,43,12,28,4,15.894105628705272,8
143,94,18,57,5,15.891839037049907,13
144,90,29,28,7,15.880089586771653,22
145,94,23,51,6,15.876961640520744,17
146,16,45,31,12,15.837412153743443,33
147,15,12,41,3,15.833444649300692,9
148,95,22,17,5,15.80262158037718,17
149,80,19,88,6,15.782107491065846,13
150,30,11,93,3,15.777207362300766,8
151,75,10,35,2,15.755761764469415,8
152,93,16,96,4,15.733194627661211,12
153,37,14,77,4,15.73169378416834,10
154,80,12,35,3,15.72406211872363,9
155,75,13,80,3,15.718052052365534,10
156,45,20,51,5,15.703190735785382,15
157,8,13,1,3,15.702434313684373,10
158,15,14,112,4,15.700949053545523,10
159,14,12,97,2,15.664913845649806,10
160,88,26,29,7,15.663393885093674,19
161,90,13,97,4,15.621888085765939,9
162,106,11,85,3,15.60573196351404,8
163,23,10,69,2,15.603167423944376,8
164,4,14,45,4,15.600891470448106,10
165,23,20,5,5,15.563915929412016,15
166,104,12,31,4,15.561592201078605,8
167,48,16,9,4,15.537621007215709,12
168,25,11,14,2,15.536643242754739,9
169,37,11,10,4,15.516949569025604,7
170,64,20,104,5,15.515264160119225,15
171,69,15,31,5,15.502962092044205,10
172,112,22,84,6,15.486639525748984,16
173,2,12,39,3,15.473797666414955,9
174,74,12,103,3,15.463990000688314,9
175,73,25,107,8,15.460672720698525,17
176,62,15,94,4,15.456678982493088,11
177,49,14,25,4,15.43786379260084,10
178,100,15,2,5,15.363858490781988,10
179,41,15,84,4,15.33074063826509,11
180,104,12,94,3,15.27233865597327,9
181,93,14,46,3,15.251126640356864,11
182,71,10,29,2,15.143188317628589,8
183,78,13,47,4,15.091757543510106,9
184,54,10,77,1,15.067841236649627,9
185,104,16,79,5,15.054954882421578,11
186,38,10,93,4,15.046407356806796,6
187,25,18,99,5,15.014737107768298,13
188,45,10,75,2,15.003649946946844,8
189,13,12,22,3,14.994671319317485,9
190,16,29,77,8,14.872386678350557,21
191,16,42,94,11,14.87192057190217,31
192,110,12,28,4,14.860268273313302,8
193,87,13,38,4,14.859584047072822,9
194,15,13,76,4,14.81353391108204,9
195,102,11,35,4,14.787485364380148,7
196,72,14,109,3,14.772801167610016,11
197,55,15,19,5,14.762490489035601,10
198,72,22,51,7,14.75505634651796,15
199,32,14,106,3,14.741977351969275,11
200,100,10,31,3,14.730848989291463,7
201,74,10,29,3,14.72390247298373,7
202,114,19,83,5,14.712530964906872,14
203,17,19,78,6,14.709203332504181,13
204,27,34,109,11,14.672056456650022,23
205,50,12,99,4,14.581629542155014,8
206,80,19,50,4,14.554439051919097,15
207,73,12,37,4,14.533349572792922,8
208,15,15,77,4,14.526389381898243,11
209,12,11,62,3,14.509530975721361,8
210,34,12,25,3,14.468789684868277,9
211,80,10,76,3,14.461464881129865,7
212,73,10,2,3,14.457830254043136,7
213,63,13,35,4,14.450412261730216,9
214,44,12,5,3,14.447481002517355,9
215,97,13,35,3,14.444551731599502,10
216,80,11,14,4,14.435345395194508,7
217,108,26,70,7,14.42739364927628,19
218,76,19,78,4,14.413574538633682,15
219,100,15,81,5,14.382694095158195,10
220,40,10,83,2,14.347262135245902,8
221,7,27,77,8,14.33556677589385,19
222,26,25,86,6,14.322036756570222,19
223,31,12,57,4,14.310689026630849,8
224,46,11,102,3,14.30749471315205,8
225,34,12,37,3,14.30057126443514,9
226,100,28,68,9,14.286728990485928,19
227,61,17,7,6,14.21770274028152,11
228,72,10,75,3,14.207053385683187,7
229,109,15,98,4,14.143515346576434,11
230,41,30,9,9,14.113579732248976,21
231,104,22,38,7,14.071473191155556,15
232,55,15,103,4,14.058125972172373,11
233,40,29,77,8,14.048771071022596,21
234,15,23,109,5,14.044569549955568,18
235,45,11,39,4,14.033377854173942,7
236,48,29,54,9,14.01975726236914,20
237,111,12,75,4,13.972281809419963,8
238,114,29,109,7,13.96133653890184,22
239,108,21,39,7,13.948334466983779,14
240,40,24,71,7,13.948125771645659,17
241,91,11,109,3,13.946188604720339,8
242,75,19,69,5,13.942304484906579,14
243,60,14,20,4,13.93992645286088,10
244,37,11,112,3,13.937736127059294,8
245,100,31,3,9,13.921725717823312,22
246,25,10,112,3,13.919292260310076,7
247,41,25,12,7,13.885526354207714,18
248,53,19,50,6,13.883151416746285,13
249,34,14,104,4,13.86429846409272,10
250,77,18,50,4,13.854547351284703,14
251,38,14,112,3,13.819485047030144,11
252,98,17,31,6,13.805084918983171,11
253,13,74,31,23,13.800549608099516,51
254,97,11,112,2,13.794615799527321,9
255,7,19,76,7,13.79135600101831,12
256,65,26,58,8,13.76646278961035,18
257,34,16,20,4,13.763107006170879,12
258,95,37,88,11,13.752013257016605,26
259,97,10,27,4,13.735152835550483,6
260,63,25,31,7,13.714594813504092,18
261,104,14,44,4,13.703910249073422,10
262,47,13,49,3,13.686396277061283,10
263,49,11,18,3,13.655065375637422,8
264,17,12,94,4,13.646957443918598,8
265,9,13,12,4,13.614723999539923,9
266,34,20,57,6,13.584679931175105,14
267,104,31,11,9,13.572205348595668,22
268,15,10,74,3,13.569326307429137,7
269,76,12,91,3,13.563460914482881,9
270,57,17,109,5,13.55588836432437,12
271,80,10,6,3,13.522871173076249,7
272,30,32,63,10,13.498171962188783,22
273,84,12,108,3,13.488009207908556,9
274,27,24,69,8,13.48310441915363,16
275,103,14,60,4,13.469649431194169,10
276,43,19,77,6,13.44590515078262,13
277,36,15,35,4,13.440272285829963,11
278,43,19,53,5,13.438033142991653,14
279,23,15,45,4,13.436468047997268,11
280,25,12,32,5,13.427877456338663,7
281,61,16,68,5,13.424919545398375,11
282,75,15,53,5,13.423496737137006,10
283,91,11,112,3,13.423237527272482,8
284,104,12,35,4,13.369677424437178,8
285,55,11,32,4,13.36363963009391,7
286,18,12,46,3,13.322032493347338,9
287,100,25,77,7,13.319896480018869,18
288,50,17,46,6,13.310329365776974,11
289,64,19,106,6,13.295192075566398,13
290,7,12,99,4,13.274517260788409,8
291,102,31,5,10,13.269431869962297,21
292,95,23,11,6,13.26328800508424,17
293,15,29,9,11,13.254539415012557,18
294,75,37,54,12,13.241406019841682,25
295,36,18,54,6,13.217744798273172,12
296,27,17,89,5,13.200102555354913,12
297,47,17,112,6,13.195058355865363,11
298,95,28,37,7,13.149042342745604,21
299,98,13,88,3,13.13778782250953,10
300,63,30,3,7,13.13647260700251,23
301,83,10,70,4,13.118339150755117,6
302,21,11,87,3,13.114631052870209,8
303,47,13,3,4,13.091382859027682,9
304,11,41,37,12,13.080901694615491,29
305,84,28,3,10,13.06598659051468,18
306,15,12,79,4,13.059472232177564,8
307,79,26,87,7,12.9643816213658,19
308,91,29,60,10,12.952631394075715,19
309,114,15,12,6,12.94950946807653,9
310,9,13,94,5,12.936870793436032,8
311,100,46,65,13,12.91328144209294,33
312,17,19,109,6,12.911257852793495,13
313,2,21,65,5,12.890027578518202,16
314,87,10,66,3,12.884783195379669,7
315,39,25,94,8,12.842801062921897,17
316,104,40,46,13,12.826160652792534,27
317,48,16,49,4,12.810788363261889,12
318,108,14,11,4,12.798974196396989,10
319,30,19,43,5,12.796623632801937,14
320,80,21,51,7,12.779249811641693,14
321,54,12,81,4,12.757047966098476,8
322,109,14,64,6,12.75697214661366,8
323,100,15,1,5,12.750379039232412,10
324,95,10,36,3,12.746346244298937,7
325,33,14,106,4,12.736963404825662,10
326,80,13,49,5,12.731038457974943,8
327,46,24,106,9,12.725492516069492,15
328,98,12,48,3,12.72400980532305,9
329,111,16,88,4,12.710530076381987,12
330,11,19,9,6,12.708684805193935,13
331,57,12,2,4,12.707474284723991,8
332,62,16,57,4,12.692635812852643,12
333,80,40,63,12,12.682443988429272,28
334,100,29,103,9,12.678593336678208,20
335,48,15,5,4,12.675358072710548,11
336,11,17,38,5,12.666110828343465,12
337,100,13,38,3,12.63848236927713,10
338,107,38,109,11,12.598174280709069,27
339,15,12,102,3,12.597866884640938,9
340,57,27,5,8,12.572003913811171,19
341,41,18,71,5,12.55777326700885,13
342,34,17,60,5,12.542344059494534,12
343,75,27,5,10,12.535083552437033,17
344,49,16,43,5,12.516560129525121,11
345,104,33,27,10,12.514336487582195,23
346,64,15,92,7,12.492372460791035,8
347,28,12,81,4,12.485800898870087,8
348,41,10,85,4,12.470634664927642,6
349,18,14,37,4,12.43883359344357,10
350,98,31,87,9,12.43458344819276,22
351,36,17,50,7,12.423703215189779,10
352,39,17,72,5,12.403927129005272,12
353,8,22,77,7,12.389831393600819,15
354,75,14,12,5,12.356839423121745,9
355,67,12,97,3,12.35346782744064,9
356,18,13,19,4,12.347892346341663,9
357,49,23,104,7,12.322985298305156,16
358,47,24,60,7,12.306617941323184,17
359,75,14,57,4,12.306540056833526,10
360,98,29,96,9,12.301665445316493,20
361,69,15,18,5,12.281407888329312,10
362,109,21,39,6,12.264003725130953,15
363,37,18,60,7,12.263894360602315,11
364,34,13,41,5,12.262731570966233,8
365,32,10,39,3,12.25900875776762,7
366,71,11,84,3,12.255989147154674,8
367,9,16,19,5,12.252328421645835,11
368,38,11,78,3,12.248719399574963,8
369,51,28,19,8,12.241859799093062,20
370,74,22,60,8,12.230302476711508,14
371,75,19,43,5,12.224767647713705,14
372,64,19,37,6,12.216856507558587,13
373,78,11,106,3,12.210243252742755,8
374,42,11,13,3,12.203174115394757,8
375,13,26,29,9,12.196916226476908,17
376,11,35,84,11,12.189911906563859,24
377,70,25,57,10,12.177083859404236,15
378,107,21,99,7,12.174640608684571,14
379,2,22,70,8,12.153236389251056,14
380,11,40,96,13,12.141028508791658,27
381,55,13,47,5,12.137143102946048,8
382,92,12,63,5,12.136993324985582,7
383,15,10,4,4,12.1242208434208,6
384,34,12,70,4,12.123530804367727,8
385,28,20,72,6,12.11934808588004,14
386,8,11,35,3,12.093356369533685,8
387,72,21,19,6,12.088885005162663,15
388,26,11,28,3,12.079045982156577,8
389,53,20,3,6,12.068087567340713,14
390,104,22,71,8,12.060518806565575,14
391,39,19,85,7,12.059881057913875,12
392,1,18,63,7,12.054495717242014,11
393,10,10,89,3,12.051235053807009,7
394,7,10,89,3,12.029257289487047,7
395,1,12,104,4,12.020108292717422,8
396,87,29,81,11,12.01535695996611,18
397,64,16,29,4,12.010507228979476,12
398,102,18,55,6,11.983866194974436,12
399,95,27,18,9,11.951490678023532,18
400,114,46,65,16,11.938229846486395,30
401,94,30,12,11,11.933387464684667,19
402,71,17,77,5,11.915487518479784,12
403,2,13,11,4,11.88450219450607,9
404,79,11,12,4,11.86694352900842,7
405,111,22,41,8,11.859477089655313,14
406,57,45,107,15,11.845167977874892,30
407,74,34,28,11,11.834419909257846,23
408,30,30,3,9,11.833742535667652,21
409,92,17,86,6,11.833574375075667,11
410,63,47,28,14,11.8288664237163,33
411,74,10,64,4,11.828764368523546,6
412,28,16,111,5,11.82030122340792,11
413,83,10,17,4,11.812775268760372,6
414,53,10,91,3,11.811611902058761,7
415,8,11,108,3,11.805411430354427,8
416,8,21,40,6,11.791921402372775,15
417,44,10,54,3,11.791894285038754,7
418,91,12,65,4,11.784658313781675,8
419,112,10,62,3,11.78047192200998,7
420,54,20,43,7,11.759609270938485,13
421,100,31,43,11,11.757793113852522,20
422,34,12,69,2,11.742698738008178,10
423,13,82,88,25,11.731891784753875,57
424,91,13,96,4,11.692854193124042,9
425,34,23,28,7,11.682170467841415,16
426,8,10,81,3,11.678569579324554,7
427,21,10,88,3,11.677382922456276,7
428,93,11,104,4,11.670878710804793,7
429,107,17,83,5,11.644521740420231,12
430,100,12,40,4,11.638460148115906,8
431,75,17,38,4,11.628826987325246,13
432,11,23,70,7,11.609570033059049,16
433,30,41,13,14,11.600993566247704,27
434,90,15,39,5,11.57797650142359,10
435,36,16,104,6,11.564722196156039,10
436,111,10,71,3,11.563837134119533,7
437,108,13,3,4,11.562059375800661,9
438,38,15,3,5,11.55575224939262,10
439,74,15,76,6,11.544600382799558,9
440,110,12,7,5,11.526061320417648,7
441,7,15,81,6,11.525413070422038,9
442,98,14,75,5,11.49709370731317,9
443,11,15,18,5,11.49652383906797,10
444,114,41,106,14,11.462749893343952,27
445,50,18,68,7,11.447393428752163,11
446,13,47,18,16,11.43817217657445,31
447,47,17,18,5,11.411676107822029,12
448,29,10,95,3,11.401888238693152,7
449,4,11,38,3,11.395009854616484,8
450,107,14,10,5,11.38119632500004,9
451,39,28,78,9,11.374922957505097,19
452,28,22,112,7,11.372427658976592,15
453,75,15,102,4,11.357902372458398,11
454,74,21,62,7,11.355871307801836,14
455,104,30,77,10,11.335858846829385,20
456,108,11,112,4,11.33560335683198,7
457,64,12,20,3,11.33130846260478,9
458,7,25,96,7,11.300422106484014,18
459,49,36,69,14,11.300366835956483,22
460,72,11,12,3,11.296180739596437,8
461,80,10,5,3,11.295210617596885,7
462,75,10,61,4,11.283854363299362,6
463,111,11,27,3,11.279710088837586,8
464,2,14,55,5,11.276816159574059,9
465,75,52,7,17,11.274663385996204,35
466,68,21,109,6,11.251244714581786,15
467,40,13,81,4,11.249205674756393,9
468,25,25,68,8,11.235607083018873,17
469,98,16,77,5,11.231262510023573,11
470,46,20,96,8,11.223825219116966,12
471,75,36,8,11,11.220741251540183,25
472,73,13,51,4,11.219804453521853,9
473,98,18,106,6,11.217270403208776,12
474,25,15,3,5,11.214634960222732,10
475,100,12,46,4,11.210309669403356,8
476,89,11,1,4,11.209011069389932,7
477,95,29,51,8,11.161050582896516,21
478,78,13,1,4,11.156578268103178,9
479,108,31,13,10,11.148353863265479,21
480,43,16,91,5,11.128114127049443,11
481,46,15,70,5,11.123543654837002,10
482,48,11,102,3,11.116814719382416,8
483,72,18,65,6,11.109219542203151,12
484,74,13,32,4,11.101664191982366,9
485,62,15,104,4,11.098747349135207,11
486,60,33,29,12,11.07047089279055,21
487,99,11,11,4,11.04788337752713,7
488,55,39,1,12,11.047135752371082,27
489,32,12,114,4,11.045874107216177,8
490,16,17,32,6,11.04556139119038,11
491,7,13,66,5,11.034566799554375,8
492,41,14,92,5,11.016394202336144,9
493,15,13,71,4,11.00914391321026,9
494,40,26,3,8,11.00717769248795,18
495,51,20,110,6,11.000148170458745,14
496,13,25,97,9,10.985857531237675,16
497,78,10,66,4,10.92721209874227,6
498,73,17,5,6,10.907383059794872,11
499,11,10,66,4,10.898142591848796,6
500,34,15,43,5,10.890919445406583,10
501,86,17,67,6,10.856458271232285,11
502,87,31,114,12,10.855794018644565,19
503,62,14,15,5,10.843943580538047,9
504,38,26,65,10,10.83463870682702,16
505,85,16,94,5,10.818759630623866,11
506,106,17,81,7,10.816681182916202,10
507,63,12,89,3,10.81666968039275,9
508,55,25,91,7,10.791612827626562,18
509,7,25,19,7,10.775977198177877,18
510,59,11,7,3,10.771239818059199,8
511,65,21,57,7,10.760244548071402,14
512,53,23,108,9,10.749834986479383,14
513,30,23,109,7,10.748881787794609,16
514,53,22,17,7,10.72338378113649,15
515,54,11,111,3,10.714143810197228,8
516,43,13,36,5,10.713552025008548,8
517,75,13,76,5,10.684711333832391,8
518,20,21,9,7,10.676297323703045,14
519,47,11,100,4,10.66425762434052,7
520,5,25,98,9,10.66291868554062,16
521,26,11,16,4,10.64146366009584,7
522,55,23,43,6,10.640503492252687,17
523,3,11,35,4,10.637414854102067,7
524,98,18,71,6,10.627953776602759,12
525,69,12,91,5,10.61284501210675,7
526,28,13,103,4,10.6092467019397,9
527,7,31,91,9,10.609100286101588,22
528,41,21,49,7,10.608235357108473,14
529,11,38,109,12,10.59201718767136,26
530,49,16,37,6,10.578750157819185,10
531,104,26,75,9,10.57435391669422,17
532,95,15,9,6,10.569002592922953,9
533,71,19,54,7,10.563773271372229,12
534,28,17,40,7,10.551622113062637,10
535,30,13,12,4,10.550544303199306,9
536,19,13,79,5,10.549815768045493,8
537,28,26,3,9,10.544965513227709,17
538,49,15,11,5,10.54175783006079,10
539,50,39,20,13,10.540260354284218,26
540,76,13,108,4,10.539317855686345,9
541,41,16,17,5,10.533333329606137,11
542,71,19,97,6,10.5235339621969,13
543,27,27,36,10,10.523349599331352,17
544,89,14,37,6,10.519274673853001,8
545,63,16,102,6,10.517349087153976,10
546,64,27,9,8,10.495957554452968,19
547,62,10,48,4,10.487894133335649,6
548,63,37,48,12,10.480037623792745,25
549,94,14,49,4,10.474432971630803,10
550,6,10,31,4,10.459894630543896,6
551,30,11,33,3,10.449500632702227,8
552,77,10,94,3,10.443428313097055,7
553,43,17,9,7,10.435718767902006,10
554,44,16,39,6,10.434810009571377,10
555,76,17,57,5,10.424696568875106,12
556,95,19,114,7,10.422604339796184,12
557,72,14,103,5,10.391960458595063,9
558,76,26,35,9,10.390096019432455,17
559,16,14,92,3,10.381584875368542,11
560,106,16,93,6,10.37915501513517,10
561,15,16,55,4,10.37053728825799,12
562,63,24,69,8,10.366973166191581,16
563,50,39,88,14,10.364860984100916,25
564,94,10,7,3,10.355621654064773,7
565,17,15,27,6,10.35454909958829,9
566,40,16,102,6,10.346146758066935,10
567,37,13,1,5,10.342164269053148,8
568,30,18,46,6,10.329090932236763,12
569,11,14,10,5,10.326527517070998,9
570,35,10,65,3,10.321578642281732,7
571,108,13,15,4,10.31501087444828,9
572,53,43,88,14,10.308417089519107,29
573,107,29,31,13,10.30345756995746,16
574,45,23,107,8,10.289536165233189,15
575,60,24,112,8,10.282975838759185,16
576,72,22,68,7,10.275897741373274,15
577,103,16,84,7,10.26661061026012,9
578,18,43,39,14,10.257246202371954,29
579,67,16,106,6,10.252161434234207,10
580,49,21,23,7,10.242959754676484,14
581,63,35,91,11,10.225389928816243,24
582,30,17,31,7,10.214096274935343,10
583,10,14,28,4,10.207926130943799,10
584,91,24,39,8,10.206322081312438,16
585,90,19,104,7,10.205908373136607,12
586,98,15,2,6,10.198603389321667,9
587,71,13,33,4,10.195530501937561,9
588,97,41,37,14,10.190687502541845,27
589,27,46,60,14,10.177471149675247,32
590,6,12,9,5,10.175309866966636,7
591,98,27,49,9,10.169586744689958,18
592,51,32,81,12,10.158277615855118,20
593,92,16,68,5,10.14730683848729,11
594,96,11,23,4,10.143008283174426,7
595,94,15,109,6,10.140509349254696,9
596,79,21,57,8,10.139577379833113,13
597,53,37,31,14,10.136338371296793,23
598,92,10,109,3,10.132066653367776,7
599,78,12,114,5,10.123963867745248,7
600,53,36,36,11,10.114732824687987,25
601,87,30,70,12,10.114463896406379,18
602,17,15,3,6,10.104489232217418,9
603,23,32,76,12,10.095144638641568,20
604,23,17,17,6,10.090670558592322,11
605,79,12,106,4,10.079963228120917,8
606,40,16,49,6,10.077718304922938,10
607,27,41,19,13,10.068063409604914,28
608,13,23,83,8,10.067954696106945,15
609,44,10,38,3,10.048373138060269,7
610,78,14,46,6,10.036009292919493,8
611,110,13,107,4,10.03472132274693,9
612,30,19,91,6,10.028289002870832,13
613,30,27,84,8,10.023299208241367,19
614,95,25,65,9,9.987438820754939,16
615,53,21,12,8,9.979940044053077,13
616,73,18,88,6,9.974203425238965,12
617,46,14,90,5,9.960134782518512,9
618,78,16,50,5,9.957089435942969,11
619,75,15,29,6,9.923300198268764,9
620,95,10,2,3,9.920312629990502,7
621,63,50,84,19,9.919938234846502,31
622,30,50,39,19,9.919924585068483,31
623,1,11,57,4,9.916035104284743,7
624,30,18,70,7,9.913973705469937,11
625,54,34,60,11,9.913747967452048,23
626,28,35,75,12,9.910859132469223,23
627,103,21,68,8,9.904114100948439,13
628,37,47,54,16,9.896946296790851,31
629,11,14,83,4,9.89615191909491,10
630,79,18,51,8,9.895968302837433,10
631,110,20,16,7,9.893450419413208,13
632,20,14,29,5,9.888770035938014,9
633,100,33,49,12,9.885330346900629,21
634,2,17,54,5,9.883928701627934,12
635,17,15,71,6,9.874078720771614,9
636,75,17,1,5,9.87310906944801,12
637,22,12,27,4,9.866452926590915,8
638,38,14,57,6,9.862555383696968,8
639,54,28,27,10,9.857125139228906,18
640,104,20,12,7,9.854826291134748,13
641,51,26,33,7,9.853114112635922,19
642,44,21,13,7,9.844973608163798,14
643,74,10,3,3,9.841517466916372,7
644,53,10,98,4,9.839111782848335,6
645,9,17,47,6,9.833363334347146,11
646,47,17,69,6,9.824856595944096,11
647,54,13,57,3,9.824315369895016,10
648,40,24,17,8,9.815776001763279,16
649,34,18,19,6,9.811807524582058,12
650,27,20,55,6,9.8088649644787,14
651,114,16,62,6,9.799890996069497,10
652,62,10,93,4,9.798162399200404,6
653,37,24,83,9,9.783726366978417,15
654,15,14,53,5,9.759389882181187,9
655,16,49,18,16,9.751591518104966,33
656,72,20,3,8,9.745718908399102,12
657,43,19,31,10,9.720852773553682,9
658,78,12,37,4,9.719307443467272,8
659,52,15,8,5,9.715026692600487,10
660,68,30,8,11,9.713048677811617,19
661,75,18,11,7,9.71088785220573,11
662,8,30,84,10,9.700360955856537,20
663,8,34,114,11,9.69923185832115,23
664,16,64,106,21,9.698477969183921,43
665,78,27,69,10,9.666260825143702,17
666,64,47,60,15,9.66174772613163,32
667,100,12,71,4,9.66068752031631,8
668,101,10,13,3,9.652646543094525,7
669,85,11,75,3,9.651599660168166,8
670,22,10,114,5,9.649313306364819,5
671,41,23,53,8,9.631953807885303,15
672,103,18,12,8,9.627784072806602,10
673,70,17,109,6,9.623350653501726,11
674,99,14,8,6,9.61106559286031,8
675,83,18,84,7,9.609473734372159,11
676,8,13,53,4,9.596286006275326,9
677,64,27,112,8,9.595012833071515,19
678,73,20,7,8,9.582485903794176,12
679,17,12,48,5,9.570482008629265,7
680,27,28,31,12,9.569633624787398,16
681,26,23,13,7,9.562123129591575,16
682,49,12,103,5,9.551109456592227,7
683,18,13,34,4,9.550016463821068,9
684,106,13,108,4,9.535201707134298,9
685,20,11,75,4,9.527707505687719,7
686,48,15,51,7,9.527077025607761,8
687,1,22,31,9,9.525804060927038,13
688,20,32,25,11,9.520523686179052,21
689,18,27,9,9,9.520249042639604,18
690,62,14,64,6,9.515284324050944,8
691,8,17,36,6,9.51236026695053,11
692,33,13,69,5,9.511158026464036,8
693,90,14,80,4,9.509239360264802,10
694,114,13,2,5,9.509158562417847,8
695,15,35,51,13,9.503627084553731,22
696,37,22,99,7,9.502759058160713,15
697,18,11,84,4,9.493458888054228,7
698,15,40,88,12,9.492555782468358,28
699,37,10,3,4,9.485691026106416,6
700,72,15,77,6,9.475978955314686,9
701,23,16,57,6,9.474501256774838,10
702,43,23,15,8,9.471477205647831,15
703,100,29,60,10,9.465662133176442,19
704,16,47,96,14,9.46295382882651,33
705,41,19,89,6,9.453124323035377,13
706,32,11,63,4,9.44232166344675,7
707,13,15,2,6,9.422510080465486,9
708,103,17,57,6,9.414120229975815,11
709,100,25,41,9,9.40329459195757,16
710,27,16,38,5,9.401601002215301,11
711,109,11,36,3,9.390936468630548,8
712,60,31,12,14,9.384631824700898,17
713,81,25,16,9,9.384174025613888,16
714,27,16,4,6,9.3787154159821,10
715,104,21,84,8,9.37162724208143,13
716,94,13,34,5,9.35579132587053,8
717,55,19,23,8,9.354242967773875,11
718,1,20,87,8,9.344990956449259,12
719,28,29,2,10,9.34282167881126,19
720,111,15,51,5,9.328246716797016,10
721,77,10,84,3,9.326879307665175,7
722,45,10,38,3,9.31109379184883,7
723,100,26,29,10,9.301757839272296,16
724,100,17,18,7,9.297622647277194,10
725,49,16,112,6,9.288177963157707,10
726,70,14,29,6,9.28377551108064,8
727,20,16,90,6,9.25670480461804,10
728,34,22,51,8,9.254702967852264,14
729,78,15,53,6,9.245467105519944,9
730,86,34,48,12,9.236642112579286,22
731,18,12,62,4,9.234800982158584,8
732,91,23,20,9,9.233435902067152,14
733,54,17,3,7,9.232444908063068,10
734,70,16,69,5,9.227346228401574,11
735,107,21,103,7,9.216518894849143,14
736,48,16,108,5,9.209950001192905,11
737,78,27,12,8,9.208018205719986,19
738,93,11,90,4,9.204947446014161,7
739,73,17,40,6,9.199997222971483,11
740,63,36,76,12,9.19742593219103,24
741,81,16,63,6,9.19342956994627,10
742,23,14,91,6,9.188824217195519,8
743,53,14,38,5,9.17946873124013,9
744,15,13,91,6,9.175439096539632,7
745,102,37,86,13,9.175322859485366,24
746,112,22,29,8,9.174610307731975,14
747,92,15,40,5,9.168940871834318,10
748,63,14,72,4,9.168022793278983,10
749,62,21,63,8,9.161474645821363,13
750,50,43,5,17,9.156049369840707,26
751,39,25,106,10,9.155969378752744,15
752,92,11,17,4,9.114563540800457,7
753,109,15,31,5,9.11388757240418,10
754,15,10,6,3,9.11193288321201,7
755,94,12,75,4,9.080901166069644,8
756,95,34,8,13,9.079209474058969,21
757,89,11,55,4,9.077967122900679,7
758,57,16,40,6,9.075047590769472,10
759,80,39,107,13,9.074881524481428,26
760,44,29,86,10,9.073857704921485,19
761,13,55,3,19,9.055927203589913,36
762,35,16,45,7,9.040031591861501,9
763,63,16,33,6,9.020049921268521,10
764,5,15,36,6,9.008614310253613,9
765,30,30,88,12,9.008031571554382,18
766,38,10,72,4,8.999506480702253,6
767,78,15,80,5,8.990142670025005,10
768,48,10,81,3,8.989696104511108,7
769,28,15,52,6,8.975367013246691,9
770,88,20,112,7,8.974262508725223,13
771,97,18,36,7,8.970668153566264,11
772,47,20,114,8,8.969382880850322,12
773,11,14,81,5,8.967824856070845,9
774,28,11,32,4,8.963821007682872,7
775,68,30,18,11,8.962998195734913,19
776,78,15,104,5,8.957766332972092,10
777,100,35,11,12,8.950423282440326,23
778,53,20,109,7,8.945178102898183,13
779,51,26,74,8,8.938947542412073,18
780,73,12,31,4,8.938919570135752,8
781,98,14,12,5,8.92802355273952,9
782,13,22,84,7,8.92622496976615,15
783,76,48,51,16,8.925061488027245,32
784,11,10,91,3,8.923724837318142,7
785,58,27,13,8,8.921844647619922,19
786,72,17,49,6,8.921503010914293,11
787,26,10,88,4,8.919527282390282,6
788,110,19,25,6,8.917701672558222,13
789,17,22,60,8,8.913811593594374,14
790,48,12,104,4,8.912185347145057,8
791,69,12,97,4,8.888377862411462,8
792,75,18,109,6,8.883837567249163,12
793,90,23,13,8,8.88376435292604,15
794,49,11,53,4,8.876928289416245,7
795,6,15,12,7,8.873687126500897,8
796,50,24,30,9,8.864762243264122,15
797,107,22,66,8,8.85129730206017,14
798,35,16,51,6,8.849945437990401,10
799,32,15,87,5,8.84415502943487,10
800,20,10,12,4,8.842914423325947,6
801,85,17,50,6,8.828432540960762,11
802,63,19,36,7,8.822881427312195,12
803,63,22,77,7,8.81999753264251,15
804,36,18,47,6,8.810892372607714,12
805,57,24,63,10,8.808573587871942,14
806,106,10,42,3,8.802546839644418,7
807,41,17,28,6,8.792780130820773,11
808,26,11,107,4,8.789963547813727,7
809,77,14,99,4,8.784719144285264,10
810,94,16,37,6,8.782776933637448,10
811,106,23,18,8,8.778191080978742,15
812,16,27,1,8,8.777340054296328,19
813,70,17,64,5,8.763483643924099,12
814,19,25,3,9,8.75255526100678,16
815,38,14,106,7,8.74501943352997,7
816,4,22,17,7,8.727735068009611,15
817,62,20,8,6,8.725180325771555,14
818,27,59,87,22,8.722585860088165,37
819,58,10,45,4,8.721721801464442,6
820,45,15,86,6,8.710518828201982,9
821,13,31,94,11,8.70746057207898,20
822,86,49,76,19,8.683760649202954,30
823,39,41,20,17,8.683414479878408,24
824,39,67,68,26,8.679610428054557,41
825,9,31,31,11,8.678153869820548,20
826,19,12,31,4,8.676840084796211,8
827,53,11,54,4,8.670288326383611,7
828,70,12,58,4,8.662523092509444,8
829,27,17,35,6,8.6459310555496,11
830,41,19,97,7,8.638943706099205,12
831,1,24,65,10,8.63311694974403,14
832,65,44,93,18,8.591281807406075,26
833,108,13,68,5,8.580585833252007,8
834,53,18,77,7,8.57678025133703,11
835,95,23,55,8,8.575006509864881,15
836,49,10,93,4,8.572163796775682,6
837,41,12,80,4,8.558761558111074,8
838,65,15,66,5,8.555650294431567,10
839,78,11,36,4,8.552435160203329,7
840,94,11,2,4,8.55058688518052,7
841,16,15,67,5,8.550473387804695,10
842,93,11,63,4,8.547776338932225,7
843,94,12,35,5,8.545638882275087,7
844,110,11,63,4,8.534985747455593,7
845,53,20,61,6,8.524850655507478,14
846,81,22,69,9,8.51799786685539,13
847,13,21,6,8,8.50747605743762,13
848,62,23,40,11,8.506273692628868,12
849,91,10,45,4,8.504304930616431,6
850,29,18,34,7,8.499963472080458,11
851,64,28,40,10,8.496071624321134,18
852,28,17,12,6,8.494896988707827,11
853,74,14,77,5,8.485489523270209,9
854,55,14,85,5,8.476039600481302,9
855,112,13,79,5,8.473860498540246,8
856,39,26,112,10,8.464674026518862,16
857,63,37,20,15,8.46447340208147,22
858,48,39,107,15,8.46425442284703,24
859,12,16,106,5,8.461406597257813,11
860,114,24,3,8,8.461132150785255,16
861,95,14,96,5,8.45037398259218,9
862,41,20,37,7,8.445393431529393,13
863,96,24,70,11,8.437417991026262,13
864,55,20,114,7,8.432483182241098,13
865,88,14,103,5,8.430464226549898,9
866,73,19,90,7,8.424101991862472,12
867,41,12,102,4,8.421036787338009,8
868,16,74,27,27,8.419832628912095,47
869,50,21,102,9,8.41869338516401,12
870,109,14,67,7,8.410228891959628,7
871,63,17,19,6,8.404706837961042,11
872,43,10,62,4,8.394379014204608,6
873,13,21,98,7,8.382728400092747,14
874,62,25,68,10,8.38261509800727,15
875,7,45,25,16,8.37280661834829,29
876,7,22,5,8,8.357081514884824,14
877,41,32,31,12,8.353957395244583,20
878,48,25,96,9,8.343995751105187,16
879,16,93,39,35,8.337598577571407,58
880,48,12,89,3,8.328549669565296,9
881,25,15,9,5,8.323455878342044,10
882,19,16,108,6,8.312758842928977,10
883,57,18,43,5,8.312131327998166,13
884,90,13,48,5,8.30973168111364,8
885,104,15,81,7,8.308547186806486,8
886,86,17,56,6,8.300855291965847,11
887,8,21,41,7,8.297019486473621,14
888,90,31,106,10,8.283845461248372,21
889,41,18,91,6,8.276671952774393,12
890,41,21,19,7,8.276612064828885,14
891,37,12,14,5,8.266467835075433,7
892,103,12,94,5,8.264881457481591,7
893,8,29,15,12,8.254756555500956,17
894,69,21,106,8,8.230262561693124,13
895,99,10,71,4,8.22496630028886,6
896,112,14,40,6,8.221202026655053,8
897,107,22,102,9,8.213723175398458,13
898,16,75,63,28,8.205892894816376,47
899,64,42,51,16,8.201880887276834,26
900,87,24,93,9,8.20135369004028,15
901,58,26,69,11,8.200000948757868,15
902,74,25,39,10,8.195535087876927,15
903,16,122,88,44,8.186735552225068,78
904,47,15,81,5,8.165398445346261,10
905,76,20,9,7,8.161384986883023,13
906,33,17,20,6,8.157924685534635,11
907,18,16,112,5,8.155957753880719,11
908,4,10,112,4,8.145974306589784,6
909,56,14,107,6,8.142413744294045,8
910,11,33,41,11,8.13470175881012,22
911,20,11,110,4,8.125291114928716,7
912,81,11,111,3,8.120062859865854,8
913,34,16,74,5,8.118744758398414,11
914,74,15,48,7,8.108554922899495,8
915,3,10,85,5,8.102330604310952,5
916,81,45,13,16,8.101358080411167,29
917,38,17,19,5,8.100688864380347,12
918,95,11,49,3,8.095998639719067,8
919,37,42,46,14,8.09589581959515,28
920,27,45,78,15,8.094234380040165,30
921,109,44,8,18,8.084532850874995,26
922,43,17,4,7,8.083539648296872,10
923,8,61,5,24,8.080732178020162,37
924,89,12,74,5,8.079770785030162,7
925,110,16,97,6,8.077466293642946,10
926,50,18,70,8,8.072010588554935,10
927,76,38,68,11,8.067259765332079,27
928,53,13,46,5,8.064750592390656,8
929,12,15,15,6,8.061809473862589,9
930,35,10,15,5,8.056529361763387,5
931,20,36,84,11,8.04861670328596,25
932,16,45,46,16,8.034750190065967,29
933,84,27,29,11,8.026114791649642,16
934,75,41,50,14,8.02466935745211,27
935,16,47,3,17,8.022951142726752,30
936,63,12,52,5,8.015196003418383,7
937,35,11,9,5,8.012816785902409,6
938,63,47,88,16,8.011636403272151,31
939,76,16,114,5,8.01045549406789,11
940,91,31,98,12,8.010154956050265,19
941,41,18,81,6,8.009042710590082,12
942,39,42,88,16,8.004378009209994,26
943,46,15,29,8,7.998285412892301,7
944,102,19,96,7,7.9956311609664965,12
945,44,22,6,7,7.994067314889742,15
946,13,16,70,6,7.990308468406848,10
947,20,19,3,7,7.987586080022351,12
948,5,28,84,11,7.986435375626319,17
949,112,26,76,11,7.979151678151438,15
950,34,20,68,8,7.978044783319167,12
951,65,25,5,10,7.967561696591304,15
952,23,21,39,8,7.9630880242589255,13
953,111,17,63,7,7.959677987637777,10
954,54,53,109,19,7.951130265295214,34
955,16,34,64,12,7.9483185367042495,22
956,73,17,87,5,7.942207150258419,12
957,33,24,107,10,7.9345080318988535,14
958,30,12,2,5,7.930773013016298,7
959,30,12,58,4,7.929379399940001,8
960,49,32,3,13,7.921458159088596,19
961,54,22,18,9,7.917650548154775,13
962,6,14,61,5,7.915350050859163,9
963,88,10,82,4,7.912578083642496,6
964,71,13,38,4,7.906029048659733,9
965,78,11,31,5,7.904414780494012,6
966,53,14,90,5,7.90103229929259,9
967,17,16,29,7,7.899676305324427,9
968,19,13,46,5,7.892870343532164,8
969,104,35,100,13,7.883509665470489,22
970,114,25,90,10,7.8701656835045455,15
971,27,26,53,9,7.864216242382974,17
972,108,15,98,6,7.863072789163925,9
973,44,12,35,5,7.859665557157517,7
974,106,26,91,9,7.859341034872018,17
975,114,20,1,7,7.837742070296788,13
976,13,53,43,23,7.8302961662590365,30
977,2,33,107,12,7.828664599470127,21
978,13,63,106,24,7.824636159857552,39
979,25,46,46,19,7.8204011950255445,27
980,34,10,22,4,7.8127158014108495,6
981,114,12,110,4,7.80031681097971,8
982,108,11,78,4,7.797957113003336,7
983,47,10,111,4,7.786638633209644,6
984,92,14,114,4,7.774797164908212,10
985,50,22,18,9,7.758401768064157,13
986,53,11,73,4,7.756297558195456,7
987,37,49,25,20,7.755599308877524,29
988,28,29,68,10,7.74899303896736,19
989,73,13,54,5,7.746921178252216,8
990,44,11,84,5,7.741464370739849,6
991,65,41,29,16,7.736031171751761,25
992,48,12,15,5,7.733213395656079,7
993,76,12,72,4,7.731997605583364,8
994,16,14,101,5,7.729447625525014,9
995,75,61,68,22,7.698232004910781,39
996,86,28,1,11,7.69668031791366,17
997,111,25,7,10,7.69032342577198,15
998,5,32,11,12,7.687442157533876,20
999,23,24,100,9,7.6843054866955915,15
1000,27,26,103,10,7.6817803705818655,16
1001,50,35,55,15,7.677574556383833,20
1002,72,10,104,4,7.673968450836452,6
1003,103,27,19,11,7.669020445123164,16
1004,37,29,38,11,7.668156637885108,18
1005,28,22,62,9,7.6671820736148195,13
1006,37,24,96,10,7.665844925696509,14
1007,16,44,69,16,7.665479946548734,28
1008,27,29,112,11,7.66149470567157,18
1009,107,27,35,9,7.659745377736294,18
1010,104,11,66,3,7.6588091193640615,8
1011,104,39,60,12,7.6559666324409426,27
1012,33,13,31,6,7.647223417443057,7
1013,70,11,60,4,7.6464357490262,7
1014,97,29,5,10,7.639418302115124,19
1015,69,11,61,3,7.633216471104325,8
1016,28,22,19,8,7.627099764741291,14
1017,71,14,27,5,7.62097447229337,9
1018,54,22,72,8,7.618738189484298,14
1019,60,32,69,14,7.613845124007755,18
1020,108,25,88,9,7.612957755702022,16
1021,54,18,58,8,7.606404400860017,10
1022,37,30,7,12,7.598616530184265,18
1023,54,79,88,30,7.59594185423803,49
1024,18,20,36,8,7.5949028785012285,12
1025,87,38,9,16,7.592453429043002,22
1026,55,24,64,8,7.5905103785531685,16
1027,11,24,103,8,7.585830317962976,16
1028,72,10,36,4,7.585561627806539,6
1029,28,31,114,13,7.584853881328923,18
1030,46,12,77,5,7.574271980014295,7
1031,34,14,5,4,7.5706698448560905,10
1032,12,35,107,12,7.568720059601813,23
1033,75,23,49,9,7.565086245339055,14
1034,60,19,45,8,7.562934672858015,11
1035,87,38,40,16,7.562449238427529,22
1036,9,21,104,8,7.555832585448778,13
1037,49,13,55,5,7.545834219734257,8
1038,85,10,46,3,7.538229298143679,7
1039,34,22,55,9,7.534603126846274,13
1040,17,15,77,6,7.533332094576503,9
1041,33,16,7,7,7.532188482638043,9
1042,6,11,55,3,7.526848268362216,8
1043,7,52,87,19,7.517208318589072,33
1044,85,11,47,3,7.514718359567323,8
1045,104,18,69,6,7.510735223332435,12
1046,7,21,109,8,7.493740572538848,13
1047,70,14,36,6,7.476080415111229,8
1048,108,15,63,6,7.475559971035058,9
1049,64,37,31,14,7.4738922265185375,23
1050,34,31,8,12,7.466974677979834,19
1051,110,18,39,6,7.464111416570426,12
1052,45,12,53,5,7.463487107897495,7
1053,100,12,70,5,7.458777129644957,7
1054,37,21,110,9,7.457046552670356,12
1055,78,35,87,14,7.4551028865479925,21
1056,11,12,71,5,7.444969376445684,7
1057,16,46,9,16,7.440540686759275,30
1058,9,15,57,6,7.427077607114284,9
1059,36,34,41,16,7.412500474371832,18
1060,70,30,20,11,7.408681007686702,19
1061,20,11,94,4,7.404911652749632,7
1062,1,10,5,4,7.391988711274886,6
1063,50,29,71,12,7.386130219514862,17
1064,27,31,94,12,7.381571713402093,19
1065,34,21,30,8,7.377448858621609,13
1066,71,19,81,7,7.374213709282583,12
1067,73,10,71,4,7.37323406519455,6
1068,100,24,114,9,7.3724280838709575,15
1069,31,14,80,4,7.367135464628976,10
1070,16,72,55,26,7.36707211993361,46
1071,25,16,33,5,7.36592627296452,11
1072,73,25,8,10,7.35879002547718,15
1073,17,19,9,8,7.3581791578689,11
1074,34,15,103,5,7.354456552823521,10
1075,19,17,12,8,7.3489102504137485,9
1076,48,24,79,9,7.345817828277461,15
1077,23,18,114,6,7.344942637597016,12
1078,40,41,104,15,7.342291894534163,26
1079,75,16,2,7,7.332326563651873,9
1080,43,39,87,15,7.327121204659327,24
1081,34,13,88,5,7.324661467404564,8
1082,62,30,88,12,7.323841783087014,18
1083,70,42,5,17,7.323141246130927,25
1084,16,20,93,9,7.319623013756245,11
1085,34,26,87,10,7.3175437680280275,16
1086,34,20,49,8,7.304688788559014,12
1087,54,33,40,13,7.298767912387551,20
1088,30,30,55,11,7.297909474841512,19
1089,43,31,40,13,7.2876910701836355,18
1090,97,16,29,6,7.284915525257299,10
1091,55,20,68,7,7.273979151335479,13
1092,106,13,57,6,7.272492874678534,7
1093,62,10,96,3,7.268496266352443,7
1094,110,16,70,6,7.267896542251015,10
1095,20,17,98,6,7.267496359610282,11
1096,100,14,48,6,7.263809625362937,8
1097,63,14,10,5,7.2617205803599045,9
1098,75,19,81,7,7.259552889264539,12
1099,86,30,79,11,7.258463117259926,19
1100,87,29,91,11,7.256753645120718,18
1101,69,12,96,4,7.252755690648875,8
1102,31,14,5,5,7.246607645789562,9
1103,114,27,40,9,7.240772461331043,18
1104,100,21,76,9,7.2254782257625605,12
1105,18,27,8,9,7.2072418633828494,18
1106,86,22,52,8,7.203855363753254,14
1107,72,28,27,12,7.198042760659784,16
1108,109,13,22,5,7.1904728762162415,8
1109,112,15,43,6,7.1893251112725896,9
1110,86,110,51,46,7.186264009009982,64
1111,36,16,112,6,7.175574629533441,10
1112,98,41,86,17,7.171894084868247,24
1113,30,13,61,5,7.1697153559652405,8
1114,114,19,57,7,7.16817977917647,12
1115,104,39,55,15,7.167673821947762,24
1116,8,19,33,7,7.156947433543343,12
1117,80,13,30,5,7.153305949978541,8
1118,29,14,37,6,7.147246302868531,8
1119,84,18,19,7,7.145362039647056,11
1120,97,26,51,9,7.145200913148902,17
1121,111,12,69,5,7.144443379259755,7
1122,5,17,60,6,7.144002600647477,11
1123,40,50,55,19,7.142420946012768,31
1124,33,13,78,5,7.142209395263033,8
1125,11,35,57,16,7.140027278328806,19
1126,40,67,68,25,7.137607275293423,42
1127,27,39,15,17,7.136849333339997,22
1128,62,11,38,4,7.131662703916968,7
1129,67,12,107,4,7.124134838046416,8
1130,65,27,76,9,7.121500914302366,18
1131,86,30,83,10,7.114862976089345,20
1132,45,33,7,13,7.114147641228475,20
1133,100,32,54,12,7.106265052685038,20
1134,1,10,45,4,7.100044646871245,6
1135,38,14,17,6,7.099034060595348,8
1136,30,26,64,10,7.0955835601535755,16
1137,16,37,76,17,7.08252034451718,20
1138,28,35,70,14,7.078735797739843,21
1139,85,10,53,3,7.0781457464371815,7
1140,52,11,12,5,7.062340699088407,6
1141,98,27,63,11,7.061533653908023,16
1142,99,18,36,6,7.061516094995872,12
1143,65,16,73,6,7.056062739811479,10
1144,17,14,19,5,7.043328257314956,9
1145,55,25,97,9,7.041738062020972,16
1146,72,11,114,5,7.039741382461145,6
1147,94,18,60,7,7.035159972468677,11
1148,37,19,27,7,7.034792767414984,12
1149,49,19,29,8,7.032846194426556,11
1150,76,15,48,5,7.031929988428476,10
1151,89,13,13,6,7.027546797235386,7
1152,95,15,40,6,7.026458120737083,9
1153,87,27,53,12,7.022639512769477,15
1154,12,15,43,5,7.021564164922878,10
1155,100,34,88,13,7.018805733136069,21
1156,3,23,57,9,7.014479906982347,14
1157,63,25,38,8,7.013791456544735,17
1158,107,47,53,18,7.009171118597258,29
1159,40,13,69,4,7.0067178601682825,9
1160,93,26,54,9,7.002072182522706,17
1161,8,33,57,12,6.998719542214547,21
1162,79,14,54,5,6.993661154009002,9
1163,4,21,87,7,6.993636995986407,14
1164,62,15,5,6,6.992708759597391,9
1165,111,23,13,10,6.988942249892523,13
1166,17,20,55,9,6.987444025974705,11
1167,104,25,3,10,6.987282972364142,15
1168,53,30,30,12,6.984989750265453,18
1169,29,22,68,8,6.975698761703106,14
1170,43,20,109,7,6.971508379947059,13
1171,18,23,97,9,6.965163575719862,14
1172,16,34,36,13,6.9623095532486845,21
1173,111,15,39,6,6.960860011711801,9
1174,32,18,104,6,6.95922508638955,12
1175,90,20,63,8,6.95733483322538,12
1176,4,25,51,9,6.952578906103857,16
1177,13,39,69,15,6.9462738533889254,24
1178,60,33,50,15,6.944865376684973,18
1179,99,12,88,5,6.93913123202866,7
1180,100,36,12,15,6.939039730779679,21
1181,39,33,29,15,6.938842255810812,18
1182,13,36,37,14,6.91476424958532,22
1183,27,33,77,13,6.913052068345057,20
1184,28,17,29,7,6.905526522456791,10
1185,58,21,68,8,6.90465268486649,13
1186,107,33,62,15,6.902263747551283,18
1187,88,13,67,4,6.891493842154356,9
1188,30,27,94,11,6.8894939969363636,16
1189,106,15,99,5,6.882359612487447,10
1190,34,12,38,4,6.8714448233593854,8
1191,29,19,69,8,6.87026975866342,11
1192,68,58,87,23,6.867242541807757,35
1193,3,12,98,6,6.866274172778351,6
1194,60,43,4,19,6.864343045215706,24
1195,41,47,86,17,6.858675087687563,30
1196,108,18,60,7,6.856532886501664,11
1197,30,25,37,9,6.853302921187576,16
1198,7,99,51,37,6.849475435937799,62
1199,62,28,51,11,6.837263314130049,17
1200,95,25,106,9,6.830338155584792,16
1201,49,26,77,9,6.827495313117423,17
1202,79,14,65,6,6.821859416038811,8
1203,68,69,31,28,6.821634358561019,41
1204,56,13,4,6,6.816273515879696,7
1205,39,101,51,40,6.813283084723181,61
1206,8,32,9,15,6.810878783728151,17
1207,86,25,103,9,6.80663720503749,16
1208,71,50,13,21,6.804323620324037,29
1209,3,17,50,7,6.801357099943921,10
1210,28,16,49,7,6.801284823553003,9
1211,108,23,87,9,6.799580586486788,14
1212,55,10,31,4,6.798197972656263,6
1213,86,34,81,11,6.793767976423695,23
1214,2,14,38,6,6.792448237787324,8
1215,109,28,55,13,6.787411237199466,15
1216,8,10,42,5,6.78054178477664,5
1217,51,63,63,28,6.773843003389743,35
1218,49,27,65,11,6.761581477384978,16
1219,86,82,96,32,6.757041595559335,50
1220,13,39,8,15,6.751757053519925,24
1221,33,17,50,7,6.750798742645294,10
1222,63,27,109,12,6.749986635160668,15
1223,86,54,97,22,6.749652418711037,32
1224,94,10,71,4,6.748460655059317,6
1225,45,13,68,5,6.747691137383071,8
1226,84,26,48,10,6.7407911051084906,16
1227,18,10,29,3,6.739197778395282,7
1228,15,20,69,7,6.736896270525392,13
1229,74,38,96,14,6.731828732252355,24
1230,14,13,95,5,6.731405281187272,8
1231,65,10,32,4,6.718474357729474,6
1232,28,35,97,13,6.716635909782017,22
1233,83,15,74,7,6.703298030488857,8
1234,108,11,38,4,6.702463242169258,7
1235,63,25,23,9,6.701335055503612,16
1236,10,18,86,8,6.698064905065153,10
1237,111,11,106,3,6.697425895741327,8
1238,104,54,28,22,6.6974143097234355,32
1239,11,24,98,10,6.689063597940294,14
1240,23,31,68,14,6.676959480055366,17
1241,85,20,54,7,6.664179187550933,13
1242,10,12,57,4,6.658857003244836,8
1243,19,13,80,5,6.6570365011750905,8
1244,83,11,71,5,6.656205380333864,6
1245,71,19,37,8,6.653996053488669,11
1246,8,59,63,25,6.653552632837189,34
1247,32,26,5,10,6.647447060451906,16
1248,86,38,17,17,6.641619574926921,21
1249,102,19,88,6,6.636908554010758,13
1250,4,30,65,12,6.6356003955737535,18
1251,39,22,37,9,6.632156694863052,13
1252,47,43,13,17,6.630254291387857,26
1253,25,48,5,19,6.626414170343125,29
1254,74,38,46,14,6.622188071735937,24
1255,19,36,107,13,6.620431832626573,23
1256,20,21,68,9,6.619136630374984,12
1257,23,14,30,6,6.618468991829208,8
1258,102,12,77,5,6.618078815941928,7
1259,11,25,35,10,6.6098986532599575,15
1260,65,28,102,10,6.598986547888404,18
1261,64,31,63,13,6.5953519944401675,18
1262,30,20,79,7,6.592079457136293,13
1263,34,16,67,8,6.58685136756142,8
1264,27,11,101,4,6.582303845846212,7
1265,77,12,81,5,6.5752456736487765,7
1266,72,21,87,9,6.574955845843893,12
1267,53,26,114,11,6.571088082289226,15
1268,75,31,63,13,6.570041946714378,18
1269,112,15,30,5,6.562692428407148,10
1270,64,22,19,7,6.56099923334209,15
1271,106,32,23,15,6.549055396089171,17
1272,58,16,112,7,6.546457957272807,9
1273,54,58,70,23,6.543056803225659,35
1274,78,27,8,10,6.539735477431524,17
1275,98,23,29,9,6.531113392896418,14
1276,91,13,80,5,6.531108694088673,8
1277,102,12,38,3,6.529266346603461,9
1278,39,69,49,26,6.526866682554677,43
1279,60,20,66,7,6.515171561917162,13
1280,76,15,79,5,6.514592595269538,10
1281,41,24,77,9,6.512816462619647,15
1282,3,20,112,9,6.50633594997227,11
1283,74,29,55,12,6.503619546467787,17
1284,90,11,102,6,6.502237322589002,5
1285,18,10,103,3,6.501498615339008,7
1286,70,20,9,7,6.477071321597407,13
1287,98,11,68,4,6.4699276959750645,7
1288,15,16,50,6,6.468981109168021,10
1289,97,19,57,8,6.465009515620626,11
1290,8,20,91,8,6.453847873736644,12
1291,6,10,28,4,6.452419128804086,6
1292,68,16,33,6,6.451134609706936,10
1293,13,77,87,29,6.437776756748543,48
1294,13,47,23,21,6.43409734894195,26
1295,69,18,94,7,6.432434124144747,11
1296,89,16,107,6,6.429821795264183,10
1297,40,16,33,5,6.427211772717694,11
1298,75,21,100,10,6.426877840881264,11
1299,96,23,80,9,6.423400971659428,14
1300,61,10,23,4,6.419517618014351,6
1301,91,18,54,8,6.414686940093468,10
1302,80,20,37,8,6.401050818487373,12
1303,100,18,109,6,6.399415941002621,12
1304,33,13,96,7,6.392035038140808,6
1305,108,29,51,12,6.386940693154832,17
1306,28,16,27,5,6.382931621067471,11
1307,87,35,57,14,6.372641139100552,21
1308,33,15,102,6,6.371524301983966,9
1309,57,12,50,4,6.36698198689182,8
1310,7,21,56,9,6.361794853449644,12
1311,64,19,43,8,6.3596171770522805,11
1312,47,18,15,8,6.359572158435766,10
1313,92,13,27,6,6.356396578041118,7
1314,84,35,39,15,6.3525949898803695,20
1315,85,17,96,5,6.345069391274802,12
1316,15,24,18,9,6.3402318230961585,15
1317,15,11,96,4,6.332542018308189,7
1318,107,40,49,16,6.324298903814961,24
1319,77,37,51,16,6.323702748298248,21
1320,70,18,98,6,6.319051319272616,12
1321,30,66,16,26,6.310791816237723,40
1322,76,21,19,8,6.301901405511211,13
1323,76,20,94,7,6.29880756689131,13
1324,28,36,102,15,6.294379170221602,21
1325,54,13,108,4,6.288035508418625,9
1326,12,15,4,5,6.285579029533408,10
1327,47,21,86,8,6.282505529772493,13
1328,50,15,72,6,6.282212191469298,9
1329,29,14,93,6,6.281843189307092,8
1330,11,35,68,15,6.280005613646359,20
1331,86,21,4,8,6.2794844995496994,13
1332,20,45,5,17,6.270373633442785,28
1333,16,94,8,37,6.26809845398659,57
1334,15,12,95,5,6.265255655621163,7
1335,16,104,87,42,6.246072070408228,62
1336,114,48,5,20,6.237633533478721,28
1337,34,31,86,13,6.237009896243484,18
1338,7,39,3,15,6.232217973074318,24
1339,104,41,50,16,6.230364171354915,25
1340,111,26,55,10,6.228608034123602,16
1341,16,42,91,15,6.227187272730326,27
1342,54,25,49,11,6.225454221982543,14
1343,114,24,70,9,6.2146226206029915,15
1344,35,15,84,6,6.209299301194261,9
1345,63,14,12,7,6.204748395941864,7
1346,74,28,70,13,6.203999405338755,15
1347,65,49,20,18,6.200424954113156,31
1348,63,28,2,12,6.200018491851485,16
1349,27,54,65,21,6.196724957991716,33
1350,87,26,97,9,6.1908682502181325,17
1351,87,48,19,19,6.187717869450032,29
1352,91,12,71,5,6.187474142289449,7
1353,114,16,94,7,6.184621239792869,9
1354,114,17,81,8,6.179669023614306,9
1355,80,10,93,5,6.175234905241036,5
1356,107,23,77,10,6.174961839792214,13
1357,43,14,8,6,6.169495664997545,8
1358,13,47,36,18,6.167141158071529,29
1359,16,20,12,8,6.1660254934200225,12
1360,50,11,81,5,6.158903696641065,6
1361,75,27,47,9,6.156969718274411,18
1362,107,40,43,16,6.1450899164659445,24
1363,25,35,88,12,6.123879676950231,23
1364,81,13,31,4,6.117159791325403,9
1365,90,12,7,5,6.108519045195328,7
1366,16,13,10,5,6.102410867550438,8
1367,62,16,69,7,6.098141811871047,9
1368,54,11,47,5,6.095812400128514,6
1369,57,24,46,10,6.094749729993643,14
1370,96,14,108,6,6.092516088942792,8
1371,111,23,107,11,6.08814286411973,12
1372,85,21,72,7,6.082147909318165,14
1373,23,13,102,6,6.080684731147943,7
1374,6,23,16,11,6.074728029131809,12
1375,65,64,88,24,6.068722517026158,40
1376,23,27,41,11,6.068042449918637,16
1377,30,57,65,23,6.05792299806429,34
1378,23,43,60,17,6.05331122826769,26
1379,39,14,14,6,6.04933667985342,8
1380,63,24,18,9,6.046455003215173,15
1381,53,30,112,14,6.044976838822192,16
1382,70,15,93,6,6.04469500542117,9
1383,76,18,88,8,6.043471817882154,10
1384,8,16,32,7,6.041444852098721,9
1385,7,24,98,9,6.0336860037819795,15
1386,75,31,31,14,6.033482134287373,17
1387,26,10,68,4,6.030745942778486,6
1388,91,17,50,6,6.027790824025911,11
1389,95,20,46,8,6.027785407812038,12
1390,100,62,86,27,6.024521465285827,35
1391,98,24,37,10,6.023716027404386,14
1392,103,17,17,6,6.022913063656272,11
1393,29,15,48,6,6.020141509256061,9
1394,29,27,15,11,6.019767915792352,16
1395,87,60,37,24,6.011896680172788,36
1396,94,21,54,9,6.000772945562409,12
1397,114,25,31,11,5.991876520395493,14
1398,78,19,77,8,5.989483896239347,11
1399,98,20,84,7,5.988889731578423,13
1400,29,22,86,9,5.985988397553441,13
1401,81,17,27,7,5.98096092269796,10
1402,64,20,18,8,5.974775055211904,12
1403,102,21,87,8,5.971447061156249,13
1404,97,18,40,7,5.966918416140386,11
1405,68,52,53,21,5.964244334939563,31
1406,97,12,10,6,5.950831581917705,6
1407,28,31,76,14,5.950271226300689,17
1408,28,15,53,6,5.9457443646332715,9
1409,49,12,33,4,5.9430630012189605,8
1410,74,10,43,5,5.941779824004124,5
1411,34,17,3,7,5.941229806680978,10
1412,73,20,114,8,5.924435121305103,12
1413,27,47,49,19,5.9233145844446,28
1414,75,14,93,6,5.923243043930715,8
1415,78,23,7,11,5.919551023484503,12
1416,104,82,65,35,5.912154582043187,47
1417,84,27,57,13,5.910397185802947,14
1418,50,12,29,5,5.9053142051653245,7
1419,75,59,107,20,5.896729059645907,39
1420,54,12,103,4,5.896465334872947,8
1421,51,16,91,6,5.895842800786141,10
1422,39,34,43,15,5.893766912543444,19
1423,101,15,68,5,5.8919398867497925,10
1424,74,34,84,16,5.891399521581718,18
1425,17,16,43,7,5.888801333071096,9
1426,39,18,103,7,5.887093677643695,11
1427,75,17,108,7,5.885506345854971,10
1428,46,12,36,5,5.882094180819339,7
1429,97,27,68,11,5.880460614845399,16
1430,28,12,31,5,5.87633787823225,7
1431,107,64,55,27,5.87153194979236,37
1432,62,17,9,7,5.86600144742425,10
1433,54,36,95,16,5.865979569344106,20
1434,34,17,7,7,5.863504951401833,10
1435,7,21,112,8,5.8633899504874805,13
1436,55,61,65,26,5.858765777581566,35
1437,80,12,79,6,5.851472407179256,6
1438,108,10,65,5,5.847992745343311,5
1439,100,68,51,31,5.844116232130886,37
1440,58,19,88,8,5.842538876771352,11
1441,40,16,5,7,5.820527251695649,9
1442,79,13,20,5,5.810117746469002,8
1443,8,19,98,7,5.806615359942183,12
1444,10,11,106,3,5.8036728949329275,8
1445,91,19,31,7,5.801858258461766,12
1446,78,45,51,21,5.800274453414972,24
1447,48,13,19,6,5.792431440588199,7
1448,58,36,107,14,5.7842068622531,22
1449,85,13,112,5,5.770596297207225,8
1450,72,19,15,9,5.769899156315001,10
1451,65,22,109,11,5.769211228591334,11
1452,13,19,76,8,5.766341264416831,11
1453,61,10,54,4,5.763750710129652,6
1454,80,15,68,6,5.759836210772863,9
1455,58,13,53,7,5.756559382638666,6
1456,23,13,47,5,5.755142063292807,8
1457,104,13,19,5,5.751508534333886,8
1458,36,12,77,5,5.751140829309578,7
1459,84,11,15,5,5.74240703223565,6
1460,40,50,39,20,5.739978674185262,30
1461,25,42,106,16,5.73768822242091,26
1462,29,24,30,9,5.734998612686146,15
1463,13,48,25,22,5.729332953997915,26
1464,45,14,9,5,5.727853500458987,9
1465,25,26,51,11,5.72613511284895,15
1466,98,13,17,6,5.723425305113809,7
1467,100,25,102,9,5.719538880425677,16
1468,69,16,12,8,5.715951067980107,8
1469,11,14,47,5,5.7112915010697805,9
1470,107,16,72,7,5.708684864640732,9
1471,64,37,65,16,5.704413748738564,21
1472,53,17,62,7,5.701449545318567,10
1473,23,13,50,4,5.694114757145069,9
1474,70,10,32,5,5.692479372096213,5
1475,106,46,5,18,5.689619439430471,28
1476,35,21,40,8,5.6891402135768585,13
1477,30,56,107,23,5.687658400093384,33
1478,28,37,9,17,5.685359581946875,20
1479,102,10,95,4,5.685319962340818,6
1480,63,37,13,16,5.677540897301027,21
1481,94,10,25,5,5.671887186214519,5
1482,29,32,19,12,5.671111826185552,20
1483,75,39,37,14,5.670197882049105,25
1484,16,31,99,13,5.665818337043021,18
1485,109,24,34,10,5.665532316173583,14
1486,54,11,82,4,5.664278302313932,7
1487,100,56,87,25,5.6583910079024315,31
1488,46,31,75,13,5.654705399493307,18
1489,20,44,16,16,5.653886889078911,28
1490,9,13,61,5,5.652969843590383,8
1491,49,32,60,13,5.652266603264943,19
1492,4,10,97,4,5.649870700339136,6
1493,39,13,97,5,5.649731064357227,8
1494,73,23,74,9,5.649045009007229,14
1495,109,16,46,7,5.636528034552769,9
1496,75,43,9,17,5.6326941278183265,26
1497,19,15,81,6,5.630310593885412,9
1498,78,16,20,7,5.6294679305494935,9
1499,86,28,73,13,5.62531345595925,15
1500,5,21,17,7,5.625033929201379,14
1501,19,10,5,4,5.623378775596127,6
1502,9,24,84,10,5.622843694169622,14
1503,51,10,22,4,5.620245273736575,6
1504,95,26,50,11,5.619957219349123,15
1505,68,26,91,12,5.61946637277209,14
1506,30,14,90,6,5.614315415339312,8
1507,72,13,60,5,5.611432015329071,8
1508,23,11,10,5,5.611414438981715,6
1509,30,25,77,10,5.596876821609194,15
1510,80,17,64,8,5.593698551425534,9
1511,20,38,96,15,5.591064360306499,23
1512,102,14,34,5,5.587343030075011,9
1513,16,23,58,9,5.587223743497611,14
1514,89,13,53,6,5.5817208357882135,7
1515,14,14,88,6,5.580858903619985,8
1516,69,38,86,16,5.577802432439769,22
1517,20,22,44,9,5.576158683247874,13
1518,7,23,38,10,5.57543888103377,13
1519,86,98,88,41,5.562390170991596,57
1520,107,63,20,27,5.562332766197254,36
1521,31,10,95,4,5.5581891593402775,6
1522,13,30,95,13,5.556983808516705,17
1523,46,11,4,5,5.55622187464566,6
1524,8,44,46,20,5.553053726096314,24
1525,69,16,54,7,5.552096999235811,9
1526,8,41,25,16,5.550067480025434,25
1527,36,53,31,23,5.548564460468652,30
1528,29,16,23,7,5.547160957253139,9
1529,25,18,84,7,5.5466876181289715,11
1530,18,42,75,18,5.546579166688546,24
1531,20,22,2,9,5.544865436021075,13
1532,40,23,27,12,5.543091094529359,11
1533,23,21,12,9,5.539017913653243,12
1534,64,21,23,9,5.538877575953661,12
1535,16,22,14,9,5.533520092369799,13
1536,15,12,40,5,5.5284615805276305,7
1537,72,19,100,7,5.526643412544751,12
1538,64,11,102,4,5.525256448935202,7
1539,100,24,55,11,5.522124052483792,13
1540,28,33,7,13,5.522079859732702,20
1541,114,47,68,20,5.519247268707076,27
1542,80,28,87,11,5.518166010205808,17
1543,107,66,104,27,5.510215850574596,39
1544,95,19,83,7,5.510188596504647,12
1545,80,10,81,5,5.509744831821596,5
1546,32,13,109,6,5.5080518973086185,7
1547,2,13,40,5,5.504797437287729,8
1548,44,15,64,6,5.503275136525506,9
1549,16,27,38,9,5.5014358332432725,18
1550,62,25,3,10,5.499799252341513,15
1551,67,10,102,4,5.49724656177184,6
1552,18,22,65,10,5.4808823809991205,12
1553,100,22,25,10,5.476003695191372,12
1554,31,13,74,5,5.468299370651384,8
1555,78,23,34,10,5.465824513333962,13
1556,5,31,51,11,5.465657211287606,20
1557,71,14,76,7,5.456476326439047,7
1558,65,33,3,13,5.455652683559951,20
1559,75,43,71,16,5.454468163058883,27
1560,100,31,63,14,5.452576532321479,17
1561,85,25,84,9,5.439743670520439,16
1562,87,41,41,17,5.4376307202585155,24
1563,71,29,68,11,5.435653336862236,18
1564,42,13,69,6,5.432900919803646,7
1565,104,33,63,14,5.422500590286895,19
1566,104,38,25,17,5.422383455319629,21
1567,98,27,76,11,5.421334528995661,16
1568,11,32,19,12,5.420057417715361,20
1569,16,124,107,47,5.410604174654474,77
1570,4,11,58,4,5.405037105567146,7
1571,78,14,103,4,5.40302761041599,10
1572,54,31,90,13,5.397442007333916,18
1573,64,40,86,17,5.391204217901304,23
1574,90,24,50,10,5.361711287754659,14
1575,7,35,97,16,5.356987360153851,19
1576,81,15,65,6,5.355649781765623,9
1577,37,47,63,19,5.351566239537104,28
1578,47,10,12,4,5.346203816219377,6
1579,15,14,103,6,5.340852738797559,8
1580,7,19,62,8,5.339510147514967,11
1581,11,52,88,21,5.336315191520826,31
1582,97,14,102,5,5.335160623731844,9
1583,13,39,77,16,5.309839375728809,23
1584,27,16,98,7,5.307731237447107,9
1585,12,18,8,7,5.299832726924706,11
1586,77,17,11,7,5.296719838615225,10
1587,87,10,42,4,5.296399197387675,6
1588,99,21,86,8,5.291638236148403,13
1589,14,19,28,7,5.288795345484194,12
1590,62,13,109,7,5.284405260681885,6
1591,56,11,88,5,5.280224334897691,6
1592,13,23,62,10,5.279557581763118,13
1593,28,11,92,4,5.26619903758234,7
1594,86,55,75,25,5.26427494208678,30
1595,34,11,1,3,5.259854618241473,8
1596,35,11,31,5,5.255104723881263,6
1597,85,14,65,6,5.254482148208556,8
1598,100,73,107,34,5.251248925768812,39
1599,102,21,51,9,5.246852253062099,12
1600,25,26,40,11,5.242222631716463,15
1601,98,15,40,7,5.239271076053035,8
1602,52,14,16,6,5.238731564661996,8
1603,91,21,25,9,5.236778929543691,12
1604,9,12,23,5,5.231512665759894,7
1605,35,11,5,5,5.226534281744142,6
1606,100,45,27,20,5.2259296818293555,25
1607,92,23,39,11,5.22393109782644,12
1608,54,54,106,25,5.222938310920249,29
1609,3,24,77,11,5.221969486388195,13
1610,76,23,27,9,5.219691338614379,14
1611,40,22,37,10,5.2189812618502875,12
1612,20,18,76,9,5.218902337593747,9
1613,69,14,8,6,5.216534828858885,8
1614,33,12,91,6,5.213867650447791,6
1615,50,22,109,9,5.207842202449344,13
1616,63,21,43,9,5.207688448634706,12
1617,16,106,7,46,5.201721932894633,60
1618,16,36,53,14,5.201094174764711,22
1619,30,13,57,6,5.198214808758373,7
1620,64,26,8,10,5.1977394093405085,16
1621,46,25,39,13,5.196853389468722,12
1622,104,18,80,8,5.194103195079234,10
1623,40,13,113,5,5.193726392686624,8
1624,6,10,71,4,5.193692278292729,6
1625,23,14,43,6,5.1891207532463,8
1626,75,17,97,7,5.183439015487436,10
1627,41,16,78,6,5.177820611113412,10
1628,27,10,80,4,5.166088753800779,6
1629,65,29,96,13,5.165027076154164,16
1630,114,20,96,8,5.164351476040407,12
1631,91,11,56,5,5.1601828143932735,6
1632,98,13,93,6,5.160023067123591,7
1633,67,12,5,5,5.159840528973067,7
1634,12,11,58,4,5.1569470777512985,7
1635,35,16,28,8,5.153123660542302,8
1636,106,24,9,10,5.150083731218861,14
1637,16,51,50,21,5.149610319436332,30
1638,11,13,97,6,5.149154391162879,7
1639,16,110,65,47,5.145171506502089,63
1640,72,17,8,8,5.13781996064983,9
1641,36,21,3,8,5.136055944816986,13
1642,19,26,57,11,5.1334362302359,15
1643,40,30,58,14,5.133397385337812,16
1644,64,14,33,5,5.132334361355246,9
1645,85,13,57,5,5.130764008093785,8
1646,75,18,4,7,5.112428644465592,11
1647,30,10,1,4,5.107240382060611,6
1648,9,30,54,13,5.106575143785501,17
1649,107,30,47,13,5.104713660133337,17
1650,55,23,70,10,5.1032220329288345,13
1651,28,13,108,6,5.102919930198642,7
1652,13,19,103,7,5.1013320107282825,12
1653,53,25,104,11,5.0942603831986055,14
1654,90,23,65,11,5.084911236528136,12
1655,8,70,87,30,5.084902312273525,40
1656,32,10,20,3,5.082163415292109,7
1657,3,23,64,10,5.079848362911411,13
1658,47,16,28,7,5.079195021327368,9
1659,90,13,33,5,5.072843762888294,8
1660,51,41,109,15,5.066683739905551,26
1661,41,10,61,4,5.060781095904467,6
1662,7,16,10,7,5.060407065651958,9
1663,95,20,75,8,5.050260152484931,12
1664,104,48,51,18,5.045842035260691,30
1665,63,15,85,7,5.044437930195333,8
1666,39,31,38,13,5.039769505176328,18
1667,65,12,52,4,5.0369958566437525,8
1668,43,18,84,8,5.034570350714234,10
1669,20,24,41,11,5.031440077185285,13
1670,94,36,87,16,5.028702412089722,20
1671,13,49,64,23,5.026699897179315,26
1672,7,100,88,43,5.012449658177523,57
1673,112,17,94,6,5.010192110959217,11
1674,72,17,17,7,5.00861905737698,10
1675,41,27,3,9,5.008050046100229,18
1676,102,13,83,5,5.0053275745844825,8
1677,93,26,5,10,5.004460526821323,16
1678,7,41,106,20,5.003800212982272,21
1679,74,15,71,7,4.993812181109021,8
1680,50,23,31,10,4.99199978599778,13
1681,63,19,94,8,4.988953899876626,11
1682,80,34,55,16,4.987967529735275,18
1683,16,53,37,23,4.974512627646201,30
1684,80,10,44,5,4.9735414138069105,5
1685,98,11,23,5,4.969965161139006,6
1686,27,21,114,9,4.967571693509977,12
1687,40,49,107,19,4.964616090179718,30
1688,96,23,90,9,4.963939687748078,14
1689,76,44,107,16,4.963511886446058,28
1690,85,10,64,4,4.962701184974938,6
1691,64,33,41,13,4.951397157092105,20
1692,20,12,100,5,4.9486843519072865,7
1693,56,19,68,9,4.94813216675333,10
1694,76,14,18,6,4.948055179076069,8
1695,48,35,87,14,4.946418242596833,21
1696,80,29,106,12,4.946009667025365,17
1697,39,23,81,9,4.943832581007466,14
1698,40,15,78,5,4.942465399220729,10
1699,93,27,28,10,4.941127481170006,17
1700,49,11,71,5,4.940945789460408,6
1701,100,23,69,10,4.932564056039485,13
1702,13,71,40,31,4.932202242966281,40
1703,114,22,9,7,4.931319071415342,15
1704,78,19,43,8,4.93069141454136,11
1705,86,40,36,17,4.927433251240005,23
1706,74,56,106,24,4.924754963776778,32
1707,72,20,11,9,4.923870308975731,11
1708,43,41,86,17,4.923382575057013,24
1709,38,12,28,6,4.907164394244691,6
1710,15,32,11,13,4.9040772238924895,19
1711,38,14,54,6,4.897121063973306,8
1712,11,24,102,11,4.8933993430696106,13
1713,23,16,77,7,4.892331871891681,9
1714,75,47,51,21,4.890410363576286,26
1715,39,10,101,4,4.889741278103363,6
1716,69,11,95,4,4.882909765417961,7
1717,23,44,88,17,4.876485476342163,27
1718,100,17,84,6,4.87641516703203,11
1719,88,26,57,12,4.870812248870149,14
1720,13,20,79,8,4.869950872786802,12
1721,29,11,1,4,4.86693457558879,7
1722,37,54,106,25,4.865641247327302,29
1723,5,10,89,3,4.86246564090175,7
1724,52,12,107,4,4.861262849981809,8
1725,81,24,3,10,4.860040341211912,14
1726,100,31,112,14,4.858414274039212,17
1727,77,11,114,5,4.854209160918298,6
1728,100,11,79,4,4.852268357181291,7
1729,97,12,32,5,4.851459349576839,7
1730,39,17,83,7,4.845386042652696,10
1731,16,71,100,30,4.845032066509387,41
1732,83,20,64,9,4.840996077098241,11
1733,11,26,43,12,4.837858920444737,14
1734,8,15,67,6,4.831909846155583,9
1735,41,13,90,6,4.828201040811693,7
1736,65,47,9,19,4.826128695703039,28
1737,31,19,25,9,4.823839301099763,10
1738,14,15,54,5,4.820525855929132,10
1739,74,11,85,5,4.812388004493803,6
1740,6,12,106,5,4.810944704219048,7
1741,2,25,106,11,4.808494527305082,14
1742,75,44,88,18,4.804702938088107,26
1743,1,16,12,7,4.804302234326601,9
1744,16,11,56,4,4.8021414027227,7
1745,75,22,96,7,4.801381492311931,15
1746,7,23,46,8,4.79766101758117,15
1747,111,11,25,5,4.797175922879397,6
1748,52,13,20,5,4.795236183864801,8
1749,9,17,1,9,4.794059502939978,8
1750,16,44,17,16,4.792262993794136,28
1751,97,24,76,11,4.789197045000655,13
1752,76,33,5,14,4.788314400539968,19
1753,15,25,81,11,4.783657780343267,14
1754,86,57,104,25,4.778923035703435,32
1755,9,12,5,5,4.777710715122403,7
1756,33,14,23,6,4.772846471482118,8
1757,9,10,37,4,4.7723167368365935,6
1758,90,13,70,6,4.771084444295362,7
1759,12,15,31,7,4.770632464521183,8
1760,55,16,94,7,4.767452995148861,9
1761,76,23,60,8,4.763967746356446,15
1762,55,12,79,5,4.763372141256469,7
1763,93,16,50,6,4.755526241513054,10
1764,7,23,50,10,4.754905099968965,13
1765,90,30,5,12,4.752640516818983,18
1766,16,59,49,24,4.751408831883825,35
1767,25,16,77,7,4.745845616411638,9
1768,6,11,46,5,4.730994669309113,6
1769,15,14,75,5,4.729161606780822,9
1770,19,13,8,5,4.728766252515099,8
1771,107,15,61,7,4.722903053660273,8
1772,20,23,46,8,4.708713070266485,15
1773,62,12,84,5,4.699556310812965,7
1774,16,36,84,15,4.697024903080797,21
1775,71,16,5,7,4.686451238703377,9
1776,109,19,38,7,4.6680162036882455,12
1777,27,54,86,23,4.66738888338914,31
1778,25,15,47,7,4.655390231832646,8
1779,63,62,54,26,4.652017262215903,36
1780,27,13,79,6,4.651583262533671,7
1781,16,44,109,18,4.650684464951719,26
1782,15,16,1,6,4.649350840919029,10
1783,63,39,96,15,4.649023449526137,24
1784,87,53,50,24,4.644204651506126,29
1785,73,14,13,6,4.642713338622983,8
1786,48,13,25,6,4.64169889765536,7
1787,80,11,69,5,4.638884395252678,6
1788,73,19,109,8,4.637139105733967,11
1789,60,22,25,10,4.636282806493916,12
1790,106,15,110,7,4.633960085739299,8
1791,65,13,89,6,4.632113459581728,7
1792,51,15,92,7,4.630319337525281,8
1793,3,16,94,7,4.629270425756285,9
1794,60,20,58,9,4.621481714021651,11
1795,13,80,55,34,4.619815115515482,46
1796,72,10,40,4,4.6161082317709115,6
1797,85,20,68,7,4.615895850726342,13
1798,37,72,86,32,4.607837359690983,40
1799,38,15,18,7,4.6074157564111795,8
1800,100,21,74,9,4.602031243810209,12
1801,77,13,95,6,4.60149322445291,7
1802,19,14,102,5,4.6003035981048885,9
1803,50,32,96,14,4.592653394244439,18
1804,78,26,54,11,4.592600537057518,15
1805,28,25,71,10,4.584215619303489,15
1806,99,16,65,7,4.579704538683142,9
1807,7,23,58,11,4.575034525669344,12
1808,39,56,60,25,4.573736342935889,31
1809,99,14,95,6,4.572737764013027,8
1810,50,12,19,5,4.570143678172117,7
1811,99,16,104,8,4.5627492392393,8
1812,74,23,109,9,4.562525277723523,14
1813,43,18,5,8,4.5592775438308895,10
1814,70,15,23,7,4.554568026577778,8
1815,40,13,19,5,4.553733685230351,8
1816,83,15,46,7,4.551826612706301,8
1817,99,18,15,7,4.551461310618723,11
1818,9,14,29,6,4.534452930887614,8
1819,106,23,75,11,4.532198108241345,12
1820,50,71,28,30,4.530365152854881,41
1821,13,19,48,8,4.529838045170983,11
1822,61,17,60,8,4.527394085824659,9
1823,74,23,50,10,4.520207268757788,13
1824,23,41,87,17,4.512300706037799,24
1825,49,30,51,13,4.504127532693048,17
1826,41,23,43,10,4.5016279133119586,13
1827,76,12,69,4,4.499300236532236,8
1828,55,47,60,21,4.496007919155317,26
1829,8,16,79,8,4.494949825171058,8
1830,58,21,39,9,4.494576390875354,12
1831,93,15,37,6,4.493445665639034,9
1832,11,82,86,36,4.492883739377422,46
1833,65,50,40,22,4.488092661947342,28
1834,7,46,64,21,4.481240056988839,25
1835,100,30,7,13,4.479542671667203,17
1836,56,12,8,5,4.475636615156396,7
1837,95,33,107,15,4.475609109265348,18
1838,40,15,109,6,4.473863564525377,9
1839,96,31,25,14,4.4728328775528,17
1840,91,10,57,5,4.468260927215541,5
1841,37,18,32,8,4.466542082918521,10
1842,3,14,102,6,4.459245823871048,8
1843,77,11,97,4,4.4549011553839994,7
1844,50,12,73,4,4.454782630059153,8
1845,95,44,16,20,4.453378575583387,24
1846,95,15,109,6,4.444131433700797,9
1847,108,17,27,7,4.430289870166569,10
1848,23,14,20,6,4.42777867543601,8
1849,57,11,98,5,4.422154501358108,6
1850,99,30,13,13,4.420966828834258,17
1851,71,29,87,13,4.418670539958073,16
1852,7,64,53,28,4.416213736910661,36
1853,50,24,64,11,4.4155104994189385,13
1854,114,46,13,23,4.412752578147673,23
1855,34,16,76,8,4.406030161353482,8
1856,12,38,13,13,4.404764592205934,25
1857,71,14,108,6,4.402422140240549,8
1858,62,18,11,8,4.400361109158305,10
1859,16,22,2,9,4.395353237879593,13
1860,12,12,64,5,4.3938981464127,7
1861,99,10,54,4,4.3797228746123675,6
1862,87,33,25,15,4.379098196808542,18
1863,87,109,107,47,4.378204402644428,62
1864,49,24,8,10,4.374514809997584,14
1865,54,63,51,28,4.373143801169512,35
1866,55,24,9,10,4.371040618945099,14
1867,55,13,58,6,4.369004483506264,7
1868,40,23,23,10,4.368423326803309,13
1869,74,15,9,6,4.367415226980942,9
1870,95,20,23,9,4.3618962627692595,11
1871,64,31,71,12,4.35947313780117,19
1872,19,11,83,5,4.3593981927010494,6
1873,76,24,39,9,4.354774512936871,15
1874,28,30,48,13,4.353346769104992,17
1875,65,16,6,7,4.346168811124812,9
1876,70,29,65,11,4.343984179663613,18
1877,34,20,48,9,4.343261719849951,11
1878,100,62,13,28,4.340799598798275,34
1879,78,24,3,11,4.334264436116631,13
1880,60,12,22,5,4.334241842742782,7
1881,95,19,41,8,4.332143979792177,11
1882,47,21,41,10,4.32003722756243,11
1883,4,22,40,10,4.316643149060896,12
1884,70,14,71,7,4.315612188206775,7
1885,104,27,98,14,4.313899934387766,13
1886,97,23,17,10,4.3134285513049555,13
1887,86,24,72,10,4.313346082418057,14
1888,51,11,66,5,4.311917297275017,6
1889,76,13,90,5,4.309550016746244,8
1890,31,10,8,4,4.309099443279478,6
1891,50,10,52,5,4.308197298973349,5
1892,100,29,78,12,4.306504123439813,17
1893,106,27,53,13,4.302319600135898,14
1894,37,45,55,21,4.301001080588836,24
1895,75,18,84,8,4.30081159040195,10
1896,25,28,54,12,4.300413553073274,16
1897,13,12,35,5,4.29516454019383,7
1898,85,11,98,4,4.293458254788545,7
1899,49,21,9,10,4.29185781077822,11
1900,51,49,46,21,4.286234042072618,28
1901,114,20,15,9,4.283176268910449,11
1902,86,61,46,24,4.2759623608500394,37
1903,29,15,55,6,4.26601507571376,9
1904,12,13,7,6,4.264845867192969,7
1905,91,30,107,12,4.264126621091653,18
1906,94,11,18,5,4.250781715158486,6
1907,6,10,72,5,4.248570153213718,5
1908,62,22,19,8,4.244721565594646,14
1909,106,14,34,7,4.243674039664675,7
1910,16,44,71,18,4.241804878716306,26
1911,71,12,109,5,4.235965151087515,7
1912,29,11,104,5,4.232469176091455,6
1913,9,21,38,9,4.224156596688182,12
1914,71,11,44,5,4.223524348839462,6
1915,28,29,100,12,4.221129674472951,17
1916,4,19,18,8,4.220670692754494,11
1917,17,20,63,9,4.217095300732271,11
1918,90,28,87,12,4.209781806456323,16
1919,65,56,36,24,4.205692860728479,32
1920,108,18,74,7,4.201041319943183,11
1921,30,48,19,21,4.195624778093544,27
1922,112,12,103,5,4.192929666832579,7
1923,87,34,49,16,4.192296058776267,18
1924,13,36,1,14,4.1879984611154635,22
1925,94,32,107,12,4.187445885164777,20
1926,23,27,25,12,4.182190113226028,15
1927,89,15,16,7,4.180346950354627,8
1928,107,53,23,24,4.172486813229872,29
1929,60,24,96,8,4.164982345638211,16
1930,83,40,5,19,4.163709904424501,21
1931,27,24,84,11,4.156059221916357,13
1932,27,55,3,25,4.152670678405782,30
1933,28,60,84,26,4.150279635735803,34
1934,99,12,17,5,4.14837583337694,7
1935,84,18,76,8,4.146116027740745,10
1936,20,13,73,5,4.146065391689569,8
1937,68,17,43,8,4.143806778934838,9
1938,100,12,95,6,4.142851413596655,6
1939,23,49,65,23,4.1421094853825435,26
1940,53,47,71,20,4.141303557057986,27
1941,71,11,20,4,4.13643055739397,7
1942,7,51,27,23,4.136091254496649,28
1943,45,22,65,11,4.1259231703887,11
1944,55,38,54,18,4.11778307869689,20
1945,7,12,2,5,4.115660194227726,7
1946,107,41,3,20,4.112474461307598,21
1947,97,30,63,13,4.107378727934806,17
1948,104,35,74,14,4.104594141618063,21
1949,93,14,109,6,4.103558953267082,8
1950,83,20,93,9,4.100880722204593,11
1951,30,15,62,7,4.099340749559774,8
1952,20,24,35,10,4.098728722002914,14
1953,104,33,54,15,4.09448807738149,18
1954,69,25,43,11,4.093607533799894,14
1955,80,17,39,8,4.091599339844535,9
1956,13,67,46,28,4.091227749409544,39
1957,17,51,51,24,4.088673144397257,27
1958,36,11,19,5,4.088590218421688,6
1959,78,17,98,8,4.084899624702042,9
1960,19,22,77,10,4.083441350216122,12
1961,48,10,43,4,4.078805310749648,6
1962,103,15,3,8,4.0762115621222215,7
1963,86,117,5,51,4.074944655375778,66
1964,60,38,8,18,4.06951058040077,20
1965,7,68,31,30,4.069172309295859,38
1966,28,38,18,18,4.067881996028203,20
1967,20,12,38,4,4.067291998076464,8
1968,43,10,95,4,4.063398320607949,6
1969,56,11,39,6,4.061429150921739,5
1970,79,20,11,8,4.052675901080834,12
1971,14,10,20,4,4.051966837258039,6
1972,94,11,50,4,4.051144013437595,7
1973,32,10,40,5,4.050021677419869,5
1974,84,12,69,5,4.04678242799089,7
1975,71,25,51,11,4.043275219347798,14
1976,1,10,43,5,4.038976715758721,5
1977,63,41,114,15,4.037972989054352,26
1978,104,10,10,5,4.031221485043642,5
1979,71,13,47,6,4.030916530509353,7
1980,7,31,47,13,4.025431088719289,18
1981,39,21,96,8,4.016816457185763,13
1982,16,21,35,8,4.016361918873651,13
1983,8,20,110,8,4.013172679497404,12
1984,66,12,31,5,4.008754872558654,7
1985,30,33,71,15,4.006253796204616,18
1986,13,40,54,17,4.002518666516472,23
1987,31,16,112,6,4.001730552260451,10
1988,57,44,15,20,3.9962627935517094,24
1989,9,18,100,7,3.99532686001692,11
1990,89,13,68,6,3.99200348329726,7
1991,30,17,102,8,3.9885406117931677,9
1992,106,12,3,5,3.9869286680549822,7
1993,88,18,6,8,3.98561022572369,10
1994,41,29,69,11,3.9797729258891983,18
1995,60,18,97,9,3.9792005525226366,9
1996,96,12,14,5,3.975747798085754,7
1997,100,37,15,16,3.9688324595887114,21
1998,87,23,112,11,3.964071093642114,12
1999,78,15,96,6,3.961613354196041,9
2000,74,24,93,11,3.9601017688790825,13
2001,78,26,49,12,3.9527522510286133,14
2002,67,11,104,5,3.9505697623954914,6
2003,28,61,65,26,3.946950789839023,35
2004,35,19,43,9,3.946831407739413,10
2005,6,11,40,5,3.9442678680230823,6
2006,102,15,98,7,3.939114797619031,8
2007,80,10,97,4,3.9365866928471034,6
2008,60,30,15,14,3.9345392656992946,16
2009,85,15,20,7,3.9254254916442872,8
2010,34,10,15,4,3.924422453398223,6
2011,5,28,2,12,3.923277825320168,16
2012,37,38,70,16,3.9227382855891664,22
2013,15,32,3,14,3.9210667133256685,18
2014,30,14,52,6,3.910728614777823,8
2015,64,11,90,5,3.90210878186129,6
2016,102,26,37,11,3.9015784283610255,15
2017,102,15,91,7,3.9012134006248127,8
2018,55,30,63,14,3.9003771949657002,16
2019,51,51,84,22,3.8997018485628683,29
2020,28,23,57,10,3.897117570901977,13
2021,1,25,54,11,3.892988653897817,14
2022,76,19,29,10,3.891834089248111,9
2023,12,16,38,7,3.8866326449918494,9
2024,41,33,104,16,3.881745214521683,17
2025,15,18,78,9,3.8743903606720744,9
2026,65,86,41,35,3.873081236904718,51
2027,39,52,27,21,3.8705079550154746,31
2028,74,41,63,19,3.86350929161903,22
2029,30,29,104,14,3.8618412248829026,15
2030,112,12,77,4,3.8608875347628993,8
2031,86,33,62,15,3.8579815466758847,18
2032,109,12,47,5,3.856660461158829,7
2033,30,21,38,8,3.844758917902768,13
2034,18,23,31,11,3.843025830767866,12
2035,20,26,7,12,3.839940256500117,14
2036,38,13,46,5,3.833859769343221,8
2037,7,44,55,18,3.8332053851440007,26
2038,13,77,60,32,3.8326689716078346,45
2039,91,26,13,12,3.831748260733109,14
2040,17,31,39,13,3.827602699322767,18
2041,4,11,3,5,3.825046392091852,6
2042,62,19,60,9,3.822113325977996,10
2043,16,31,79,13,3.819316250104341,18
2044,5,28,91,11,3.8146250930665166,17
2045,110,16,5,7,3.8138584796050923,9
2046,72,22,78,11,3.8085176531004064,11
2047,62,16,102,7,3.80648773210449,9
2048,47,11,30,6,3.805010691364058,5
2049,6,11,39,5,3.796620754703807,6
2050,11,27,3,11,3.7934397307353995,16
2051,65,15,103,6,3.7910147297492114,9
2052,7,10,93,5,3.7802315490169653,5
2053,104,13,92,7,3.7768187223532306,6
2054,39,39,19,15,3.772327105389409,24
2055,76,32,49,14,3.771534220140117,18
2056,102,14,17,6,3.7656274901945017,8
2057,50,17,48,7,3.7531631449398386,10
2058,41,21,76,11,3.7501063090537037,10
2059,76,28,109,11,3.7436675718552475,17
2060,53,42,40,19,3.7429391558119995,23
2061,15,31,7,16,3.741081293807926,15
2062,1,13,4,5,3.736039087851971,8
2063,86,65,25,30,3.735239092039536,35
2064,60,59,40,26,3.7350164129782777,33
2065,29,34,107,12,3.7321236169755396,22
2066,54,14,12,7,3.727845074231434,7
2067,88,42,109,17,3.7267794890601453,25
2068,87,47,20,22,3.7242304000917286,25
2069,89,14,60,7,3.7237634526579124,7
2070,20,64,54,31,3.7237387131550506,33
2071,89,15,104,7,3.7197091727483307,8
2072,12,19,77,9,3.719515550896187,10
2073,85,14,11,6,3.7190747038473155,8
2074,15,21,5,8,3.714734226349825,13
2075,1,21,64,10,3.714096825641643,11
2076,60,79,16,36,3.7079525590780484,43
2077,65,16,14,8,3.7073397651844364,8
2078,112,10,35,5,3.7046440124812348,5
2079,23,19,28,9,3.6970356039584393,10
2080,86,14,61,6,3.691831205405497,8
2081,87,35,69,14,3.67553372619528,21
2082,38,21,84,10,3.6699802067032476,11
2083,107,38,38,16,3.669594298718899,22
2084,51,80,65,35,3.664771412812795,45
2085,39,24,31,10,3.6610558433956157,14
2086,49,27,15,13,3.6591495913830623,14
2087,90,10,71,5,3.6561036030201253,5
2088,107,21,32,10,3.6546977761524686,11
2089,55,20,77,9,3.6546881978963213,11
2090,109,15,9,8,3.6538651478462696,7
2091,77,11,58,5,3.653719631575704,6
2092,62,11,20,5,3.653244367006128,6
2093,17,11,18,6,3.651905683853181,5
2094,16,34,80,14,3.650847383014163,20
2095,63,16,66,7,3.650382654951077,9
2096,60,18,48,8,3.648966344536587,10
2097,14,10,70,5,3.647042134114848,5
2098,41,57,107,23,3.6390090882392983,34
2099,54,36,68,15,3.638947721326894,21
2100,20,52,28,23,3.6380228467997373,29
2101,33,15,11,8,3.6324699886469727,7
2102,43,19,18,10,3.6267699505365183,9
2103,80,26,28,12,3.6230809501897743,14
2104,1,36,88,17,3.612486249864136,19
2105,57,38,51,17,3.6113741694576036,21
2106,69,17,39,8,3.6024816939136075,9
2107,91,19,18,8,3.601007419787661,11
2108,75,57,16,26,3.59529020803502,31
2109,17,12,30,6,3.5949084621895344,6
2110,97,10,95,4,3.58943247133478,6
2111,16,34,29,16,3.585198926230536,18
2112,14,22,87,9,3.574657228905801,13
2113,25,19,43,7,3.573077352948075,12
2114,6,28,7,15,3.5631855242339143,13
2115,79,13,108,5,3.562523700236059,8
2116,107,41,64,19,3.561300386963443,22
2117,34,35,16,15,3.5563841382415777,20
2118,60,12,79,5,3.555370933230565,7
2119,28,19,36,9,3.5549996153541237,10
2120,114,15,30,7,3.554559185886989,8
2121,53,49,65,23,3.552341058928982,26
2122,75,25,74,10,3.5502981320595755,15
2123,114,17,49,9,3.5487282111911393,8
2124,33,11,70,5,3.5452850377562317,6
2125,13,31,19,13,3.544087166327379,18
2126,47,29,27,13,3.5439664319349258,16
2127,40,65,36,28,3.5400829247343655,37
2128,44,15,7,7,3.5352660207554516,8
2129,6,10,62,4,3.534555615892033,6
2130,93,17,25,8,3.5300397889756283,9
2131,76,13,103,5,3.521454752878398,8
2132,53,14,100,6,3.5195197890566727,8
2133,100,19,50,8,3.5174830229699685,11
2134,23,21,3,9,3.512809694387383,12
2135,74,16,23,7,3.505315761927058,9
2136,13,90,107,41,3.504344737880481,49
2137,25,27,109,12,3.504136926234727,15
2138,37,13,108,6,3.501919723771849,7
2139,58,12,47,5,3.4979705643460672,7
2140,114,39,51,19,3.4973322349486486,20
2141,97,36,114,16,3.4948097299506915,20
2142,48,19,55,8,3.494162257250903,11
2143,20,26,109,10,3.492917739743869,16
2144,62,13,36,6,3.489528327052378,7
2145,36,30,51,14,3.4874600225025074,16
2146,41,16,45,6,3.485066668867455,10
2147,25,20,70,9,3.484518115943736,11
2148,13,42,78,19,3.483470308077065,23
2149,60,41,114,22,3.4828028477548303,19
2150,55,16,18,8,3.4810467173744706,8
2151,96,57,54,28,3.4766133859583515,29
2152,112,10,98,4,3.474493961605602,6
2153,51,44,11,19,3.4727761280704854,25
2154,15,22,30,10,3.472555589829476,12
2155,74,60,5,28,3.469996146708342,32
2156,69,12,48,6,3.4680662481377906,6
2157,46,53,54,24,3.462224315333584,29
2158,33,23,5,11,3.454327509177194,12
2159,37,21,23,10,3.453043705748743,11
2160,112,14,114,7,3.4529529803290635,7
2161,95,37,87,17,3.4486313771107997,20
2162,50,17,49,8,3.445365386788849,9
2163,76,28,55,11,3.4438952481653065,17
2164,78,11,81,6,3.4320246992935264,5
2165,34,35,27,16,3.4292031635096016,19
2166,55,49,11,20,3.4281320850013377,29
2167,108,10,69,6,3.4269138907252144,4
2168,4,12,37,5,3.421871703775507,7
2169,54,17,112,7,3.420370975960876,10
2170,17,11,36,6,3.4172736451567545,5
2171,34,20,79,8,3.408526065897861,12
2172,55,29,84,13,3.40123055779696,16
2173,4,13,28,6,3.3940824912486867,7
2174,55,50,5,22,3.393419962444802,28
2175,73,10,104,4,3.391491099464731,6
2176,39,26,77,12,3.3910289050314786,14
2177,13,102,51,48,3.3892674992786493,54
2178,60,31,9,13,3.3853349951371747,18
2179,36,28,55,13,3.383336577257353,15
2180,73,15,98,7,3.380055365181917,8
2181,64,40,39,18,3.377216491809078,22
2182,15,32,87,15,3.3708140690978814,17
2183,69,27,57,11,3.36716622165523,16
2184,40,17,20,7,3.3649339637959645,10
2185,54,25,97,12,3.3648153427656755,13
2186,14,23,8,10,3.3634201583462158,13
2187,41,26,109,10,3.362021638820746,16
2188,33,11,60,6,3.3611775749026793,5
2189,14,17,106,7,3.360059412826609,10
2190,83,10,20,5,3.3478898251644025,5
2191,94,20,65,10,3.3472699488499082,10
2192,51,61,60,24,3.3463130273558974,37
2193,40,15,91,7,3.345577169162442,8
2194,58,22,87,10,3.3430688761521683,12
2195,54,20,98,9,3.3414082574982986,11
2196,68,13,5,6,3.3380294056441144,7
2197,41,19,50,8,3.331657114556134,11
2198,68,44,3,21,3.331199454130326,23
2199,28,46,51,22,3.330644392104213,24
2200,98,14,97,7,3.3185319117606187,7
2201,97,16,84,6,3.316428205809935,10
2202,60,31,75,14,3.3139158628036856,17
2203,63,19,79,8,3.3134147957453677,11
2204,41,14,96,5,3.3088942892360285,9
2205,19,12,85,5,3.3060773006740143,7
2206,88,12,66,5,3.305300021832229,7
2207,114,21,64,9,3.3046667254482847,12
2208,47,13,61,6,3.3043540506366424,7
2209,104,60,5,28,3.3007473735225052,32
2210,55,15,35,7,3.289902790162483,8
2211,90,25,60,10,3.288918313106561,15
2212,68,31,78,14,3.285372327961691,17
2213,19,31,68,13,3.2786498819088243,18
2214,39,50,53,22,3.277161726088194,28
2215,114,13,67,6,3.2746706512348434,7
2216,85,20,13,8,3.2720772589350196,12
2217,8,57,65,26,3.2717260560147303,31
2218,97,36,16,17,3.2658181366665224,19
2219,28,56,54,25,3.2622780281799852,31
2220,18,56,53,26,3.2615252410170665,30
2221,86,34,77,15,3.2597638921767618,19
2222,7,24,74,9,3.257493143792888,15
2223,16,141,86,61,3.2553869093200642,80
2224,114,47,25,20,3.2540864225169766,27
2225,64,10,96,4,3.247034103841879,6
2226,23,12,81,5,3.240703587077002,7
2227,99,25,60,11,3.2381944591027096,14
2228,9,18,34,8,3.2368917561941424,10
2229,63,93,86,39,3.2368352705177204,54
2230,107,49,36,23,3.234838704648264,26
2231,23,55,7,25,3.2229283053761675,30
2232,55,39,28,16,3.2184704312839787,23
2233,17,16,74,7,3.211770551027832,9
2234,50,19,97,8,3.210625734622642,11
2235,37,64,104,28,3.210594247711222,36
2236,60,47,31,24,3.2094707274879264,23
2237,56,12,97,6,3.2085312435870676,6
2238,106,51,51,23,3.207475581757835,28
2239,16,49,43,21,3.2053630845690413,28
2240,15,18,20,8,3.2047440335755613,10
2241,106,28,17,11,3.2039846830051117,17
2242,7,93,86,40,3.2025353891099297,53
2243,51,25,29,12,3.2014733405608187,13
2244,36,41,39,18,3.1998605067578225,23
2245,88,61,5,29,3.1946532218196624,32
2246,49,17,109,8,3.18951026983136,9
2247,30,16,108,7,3.1892122508171337,9
2248,37,54,50,26,3.188335276013606,28
2249,54,31,114,15,3.1847921316014234,16
2250,30,29,11,13,3.1818482711889744,16
2251,103,16,69,8,3.1785957104061198,8
2252,74,12,30,6,3.175828716417199,6
2253,106,25,60,10,3.171261503808182,15
2254,90,14,74,5,3.1680613510289204,9
2255,86,21,82,9,3.1586560919846263,12
2256,104,51,7,23,3.158219418007504,28
2257,19,28,65,13,3.151219516035401,15
2258,75,23,23,12,3.1487336010920157,11
2259,112,12,45,6,3.1460936650177542,6
2260,76,15,2,6,3.1350168634931235,9
2261,33,24,13,11,3.126334459005488,13
2262,19,12,58,5,3.124268878014423,7
2263,51,15,61,5,3.1232056571511686,10
2264,34,26,11,11,3.1224893996672787,15
2265,16,138,51,64,3.122309264263027,74
2266,43,42,94,19,3.1211209425263533,23
2267,36,11,80,5,3.115857421175661,6
2268,25,25,17,11,3.1106502600539105,14
2269,50,24,4,12,3.110559237136959,12
2270,107,48,9,23,3.108544215551862,25
2271,111,21,86,9,3.103761182763341,12
2272,17,31,34,15,3.1027643782130476,16
2273,29,38,87,16,3.1016615879853475,22
2274,92,15,60,6,3.101629065738582,9
2275,74,13,27,7,3.1002755903304404,6
2276,99,14,68,6,3.1001036150844663,8
2277,88,16,74,6,3.100015176246556,10
2278,64,10,91,4,3.0993479020870796,6
2279,6,17,27,8,3.094787186521294,9
2280,51,22,96,10,3.0911457625040346,12
2281,107,59,37,27,3.0878586600356255,32
2282,77,11,33,5,3.0866280393594168,6
2283,45,14,87,6,3.0862202973256596,8
2284,76,35,87,15,3.0781518481988153,20
2285,19,29,60,14,3.0741844930514626,15
2286,75,30,25,13,3.069551733540898,17
2287,71,18,25,8,3.0644100067848146,10
2288,60,34,41,17,3.06259969646343,17
2289,71,42,86,20,3.060669361739169,22
2290,6,11,57,5,3.0567504666964656,6
2291,10,17,8,7,3.0558998323304003,10
2292,78,32,60,15,3.0527314456618035,17
2293,78,37,19,16,3.0511264570922734,21
2294,103,16,41,8,3.051077769785082,8
2295,88,84,51,42,3.050008369650854,42
2296,15,37,107,14,3.0494114346230567,23
2297,38,13,96,6,3.0422152322461717,7
2298,68,30,12,14,3.041358769608483,16
2299,25,39,65,16,3.0368934823131175,23
2300,39,13,98,5,3.03323231697735,8
2301,30,44,60,17,3.0222818482802416,27
2302,47,29,88,14,3.0208806441241434,15
2303,76,26,102,11,3.0198988245621554,15
2304,30,20,48,8,3.014647330297821,12
2305,9,43,39,21,3.012148514540607,22
2306,20,47,37,22,3.004985214474966,25
2307,96,14,34,6,3.0017630147825622,8
2308,4,11,69,5,2.999484176661719,6
2309,62,27,65,13,2.999159330673646,14
2310,87,40,109,17,2.9917649057861704,23
2311,114,11,34,6,2.9884829411181797,5
2312,88,31,3,14,2.986294279818389,17
2313,80,15,48,6,2.985401033694241,9
2314,46,13,1,7,2.97710684527845,6
2315,103,14,30,7,2.9768663186553685,7
2316,84,36,106,18,2.9754739608250116,18
2317,36,32,4,13,2.9739066740354185,19
2318,2,21,37,10,2.9697580112694486,11
2319,25,18,57,8,2.964934950553875,10
2320,114,23,46,10,2.9631435316072405,13
2321,29,15,43,7,2.9535515101680896,8
2322,18,37,87,16,2.947620136311876,21
2323,71,18,46,9,2.944852774193542,9
2324,72,10,9,5,2.940516873871124,5
2325,83,27,65,13,2.938404758323202,14
2326,68,27,49,12,2.936319937393299,15
2327,36,20,87,8,2.935573250897663,12
2328,33,21,28,11,2.9340033560517895,10
2329,9,12,66,6,2.9315079085260156,6
2330,1,14,62,7,2.9215215839903848,7
2331,104,32,109,15,2.9214017982197693,17
2332,74,82,86,39,2.921287780715151,43
2333,102,19,106,10,2.9207255392565097,9
2334,37,10,33,4,2.9157377490462175,6
2335,30,40,68,19,2.9141772915922917,21
2336,25,12,108,5,2.9132670669268244,7
2337,86,100,28,44,2.9116733038896876,56
2338,80,36,54,18,2.9116630961094696,18
2339,91,19,37,9,2.9050960547005245,10
2340,70,31,51,15,2.904546585958992,16
2341,50,27,9,12,2.8991061521351407,15
2342,44,10,70,5,2.8975248911261433,5
2343,50,17,89,7,2.8953311273035705,10
2344,87,69,88,34,2.889262156899852,35
2345,83,23,87,11,2.8800534941463094,12
2346,29,32,27,13,2.8799159327708,19
2347,106,14,77,7,2.8755893681261506,7
2348,75,21,30,10,2.8743282279457354,11
2349,57,12,53,6,2.8739584447786424,6
2350,54,38,19,16,2.8724319280079738,22
2351,112,14,1,5,2.872325056767924,9
2352,88,10,17,6,2.869337502995377,4
2353,46,23,63,12,2.867241869896345,11
2354,72,14,88,6,2.8660882603566415,8
2355,69,25,28,12,2.86191295640514,13
2356,79,10,49,4,2.8563921563379937,6
2357,73,16,96,7,2.8534303980093814,9
2358,3,21,61,7,2.8504924308729236,14
2359,97,13,33,6,2.8486496222061595,7
2360,28,13,44,7,2.8461398630992765,6
2361,8,25,102,12,2.8455510764088037,13
2362,27,54,88,26,2.8444665864539513,28
2363,95,33,39,15,2.841495525954098,18
2364,4,25,16,13,2.8411046840521443,12
2365,107,51,106,24,2.8408623146416327,27
2366,28,28,17,13,2.836983407123188,15
2367,39,11,35,5,2.836154761931759,6
2368,53,23,81,10,2.832269045840245,13
2369,2,44,50,20,2.824465738990298,24
2370,75,21,112,9,2.824219405034075,12
2371,54,18,62,8,2.824080555827827,10
2372,18,13,71,6,2.821320109059578,7
2373,68,14,48,7,2.8206443314688054,7
2374,34,18,39,9,2.816812397698094,9
2375,98,30,107,14,2.813395324711819,16
2376,87,85,65,39,2.8117833931971243,46
2377,1,32,36,16,2.8095303452930684,16
2378,99,15,41,7,2.8081672918617278,8
2379,20,11,72,5,2.807407936668827,6
2380,106,14,112,7,2.805082024542767,7
2381,83,32,8,16,2.795775595052067,16
2382,68,14,44,7,2.7953277213928303,7
2383,7,26,1,12,2.7932054952385035,14
2384,100,13,36,6,2.7923934619121087,7
2385,70,12,102,7,2.7906887378625402,5
2386,28,31,91,14,2.785819668061851,17
2387,77,11,103,5,2.7849069943634923,6
2388,28,17,85,8,2.7808523631648967,9
2389,5,11,10,6,2.7716738654503197,5
2390,5,17,77,8,2.765837567194589,9
2391,1,17,94,9,2.762381009801199,8
2392,97,34,96,17,2.7556888339056806,17
2393,70,14,43,6,2.753352748891417,8
2394,43,36,65,18,2.7525986025329345,18
2395,16,45,62,18,2.7487915093897555,27
2396,69,31,68,14,2.743936079051885,17
2397,97,22,104,11,2.7396377781056174,11
2398,99,12,63,6,2.7377253409939364,6
2399,47,21,63,11,2.7370968886641944,10
2400,65,50,106,23,2.735321183024918,27
2401,15,25,54,13,2.735147263925595,12
2402,51,22,98,10,2.7293697926794462,12
2403,44,16,88,8,2.7255415222047024,8
2404,58,17,51,8,2.722040354038644,9
2405,41,19,54,9,2.720244948724289,10
2406,95,11,80,5,2.7197438471090796,6
2407,63,20,4,9,2.717031964261833,11
2408,49,16,70,8,2.713121422106841,8
2409,43,39,60,18,2.711882588615369,21
2410,87,62,54,27,2.7078927354800784,35
2411,39,11,79,4,2.7039365709334446,7
2412,70,30,76,15,2.700930448558258,15
2413,47,27,68,12,2.7008094429751086,15
2414,9,17,30,7,2.6960180413408095,10
2415,87,22,31,11,2.6915087275033076,11
2416,13,20,102,8,2.6891186576501753,12
2417,65,40,71,17,2.686780335165667,23
2418,28,26,30,13,2.6864332481864475,13
2419,86,122,87,60,2.6826709053740343,62
2420,43,14,58,6,2.6806335210316137,8
2421,39,25,5,12,2.679132217269287,13
2422,60,66,88,29,2.676500890728166,37
2423,78,18,94,8,2.675832304313798,10
2424,48,10,12,4,2.6757754483893885,6
2425,25,17,44,8,2.673535476281759,9
2426,13,118,7,55,2.670897317194474,63
2427,41,29,1,12,2.6671220598664953,17
2428,74,13,91,6,2.658254293210725,7
2429,11,33,20,14,2.6580258548377698,19
2430,51,13,89,6,2.656220632059645,7
2431,92,29,88,13,2.6541256559252315,16
2432,57,13,36,5,2.6531160901053807,8
2433,19,20,20,10,2.6469332931574003,10
2434,54,32,102,15,2.64556958210047,17
2435,16,60,5,25,2.6435184456824317,35
2436,33,14,95,6,2.641545389608455,8
2437,13,40,11,18,2.637307973213511,22
2438,110,13,54,6,2.63588490299345,7
2439,3,15,79,6,2.6331342611336166,9
2440,91,36,86,17,2.627461430980282,19
2441,23,33,8,15,2.626483448480395,18
2442,8,10,85,4,2.6233679922969846,6
2443,39,42,28,20,2.6233394077803616,22
2444,39,10,89,4,2.6189716831037586,6
2445,75,28,64,13,2.6143964254367047,15
2446,40,29,1,13,2.608102727316189,16
2447,36,23,91,10,2.600483205457648,13
2448,65,32,80,15,2.598635692200407,17
2449,41,44,27,19,2.596716183086402,25
2450,1,10,109,5,2.5929606771402254,5
2451,86,33,18,14,2.5923706641316473,19
2452,51,57,41,27,2.5870386725384322,30
2453,16,42,48,20,2.585222263767632,22
2454,41,20,29,9,2.5826644120051876,11
2455,62,10,47,4,2.5775304802735826,6
2456,78,14,109,7,2.5746481317517187,7
2457,1,29,51,14,2.5741193049184687,15
2458,21,10,65,4,2.5701476719258265,6
2459,43,34,7,14,2.561547699430643,20
2460,16,71,68,30,2.561472821191339,41
2461,88,25,38,10,2.560016870827125,15
2462,86,14,14,7,2.5565201304900333,7
2463,7,21,11,9,2.554018943860651,12
2464,65,88,107,41,2.5538656841537626,47
2465,73,19,1,8,2.55342910039073,11
2466,16,33,47,15,2.5520888385498686,18
2467,44,14,76,6,2.5504141931433355,8
2468,7,74,36,34,2.5493587507973596,40
2469,60,22,38,11,2.544970231368338,11
2470,103,22,51,10,2.5449606528714366,12
2471,97,35,65,16,2.5397394280205696,19
2472,20,20,95,9,2.532527406942274,11
2473,7,29,17,13,2.532089441361392,16
2474,44,15,107,7,2.530544567099409,8
2475,99,19,30,8,2.530388293684779,11
2476,51,32,43,16,2.529488938008269,16
2477,36,33,9,15,2.5279240780374668,18
2478,39,18,4,8,2.5267698999647226,10
2479,14,17,11,7,2.5264878637219237,10
2480,57,35,39,17,2.520423465219732,18
2481,12,15,36,7,2.516319942513749,8
2482,60,50,86,23,2.5146802850614463,27
2483,86,42,78,20,2.5078833022467655,22
2484,50,52,107,25,2.5022496828069003,27
2485,37,18,109,8,2.501013404341532,10
2486,84,13,67,7,2.500709874534183,6
2487,57,17,20,8,2.498936131760151,9
2488,65,37,111,16,2.496427849114077,21
2489,34,44,107,19,2.4944218711973374,25
2490,112,17,69,9,2.4934455672651223,8
2491,64,21,11,8,2.490493863054093,13
2492,18,11,111,5,2.4899108726358863,6
2493,27,32,43,15,2.4768448216893395,17
2494,17,20,20,9,2.47595507024807,11
2495,30,11,72,5,2.4724333071348408,6
2496,4,17,81,7,2.4678124777063273,10
2497,74,17,69,9,2.4664972820824542,8
2498,17,17,1,8,2.462761073509877,9
2499,102,32,25,15,2.4608896969250456,17
2500,110,17,86,8,2.45971246028376,9
2501,8,53,51,25,2.4557729112904,28
2502,86,46,90,20,2.453097160300083,26
2503,63,15,61,6,2.4454100802634517,9
2504,32,10,50,6,2.444054190716271,4
2505,8,30,27,14,2.442573328602831,16
2506,64,15,47,6,2.4412017315333236,9
2507,109,24,102,11,2.437458896467388,13
2508,14,19,51,7,2.4338441230915158,12
2509,16,54,23,25,2.4326142049861326,29
2510,91,20,75,13,2.432369433261267,7
2511,8,17,38,8,2.427267079299572,9
2512,88,56,9,26,2.4233671798250107,30
2513,87,17,33,8,2.4230636639179637,9
2514,55,23,4,11,2.4222288362060125,12
2515,109,11,99,5,2.4195174025010595,6
2516,108,28,86,12,2.416374005048123,16
2517,28,19,94,8,2.414960475317553,11
2518,60,28,28,15,2.4122250218340917,13
2519,65,11,92,5,2.4112859752548714,6
2520,8,33,93,16,2.4111455321691304,17
2521,78,46,16,21,2.4095230161360504,25
2522,106,13,66,5,2.4075033563299866,8
2523,9,18,69,8,2.405000245398061,10
2524,20,26,80,12,2.4033351571638564,14
2525,114,15,98,7,2.3992721750256902,8
2526,46,38,28,16,2.3990178798165633,22
2527,97,21,109,10,2.398141101921526,11
2528,20,37,51,19,2.3967661114188874,18
2529,16,22,45,9,2.3925466679441416,13
2530,114,60,86,29,2.3916604434970483,31
2531,111,12,8,6,2.390343846489095,6
2532,23,13,48,6,2.3894452247322273,7
2533,104,40,95,18,2.3890342183876085,22
2534,4,21,71,8,2.3871750117365993,13
2535,96,25,104,11,2.3866419839158346,14
2536,75,13,56,5,2.3840139649043497,8
2537,88,35,18,17,2.3825741558006097,18
2538,8,14,112,6,2.3798297239108352,8
2539,78,11,79,5,2.3765297335861715,6
2540,71,40,107,17,2.3760609676092463,23
2541,49,29,12,17,2.3757535970577623,12
2542,53,31,55,14,2.3720895326624127,17
2543,25,32,63,16,2.3688265373602615,16
2544,40,24,50,10,2.3671440474550507,14
2545,49,13,97,5,2.366826181424206,8
2546,99,23,5,11,2.3616219022642833,12
2547,64,44,88,19,2.3590830036125556,25
2548,100,14,97,6,2.3583259709010775,8
2549,96,14,109,6,2.3566759619593642,8
2550,99,12,33,5,2.354570382478157,7
2551,4,36,31,15,2.3535355966794667,21
2552,88,76,107,34,2.3516736374048417,42
2553,49,38,19,18,2.3437680904079357,20
2554,114,12,38,6,2.341526377437994,6
2555,6,13,50,6,2.3414923323310646,7
2556,15,38,65,17,2.3398517824354403,21
2557,100,44,19,20,2.3351106998342677,24
2558,90,19,17,10,2.330539928781357,9
2559,25,28,53,14,2.3301510854690854,14
2560,109,51,5,25,2.3285813949081655,26
2561,72,10,42,4,2.3285230567907305,6
2562,77,21,88,10,2.324899205812,11
2563,54,18,29,8,2.3209749235438757,10
2564,104,21,102,11,2.320627297470276,10
2565,88,32,91,15,2.315767764685104,17
2566,71,31,63,14,2.311262987331465,17
2567,57,23,37,11,2.3105129908375908,12
2568,60,26,95,12,2.300035058084817,14
2569,86,21,32,10,2.2989864902239003,11
2570,80,20,7,9,2.298668986127333,11
2571,3,28,29,13,2.2964696243286857,15
2572,100,24,5,11,2.2932427434044684,13
2573,86,38,112,17,2.2924646864380605,21
2574,106,13,4,7,2.287883468044352,6
2575,81,26,88,12,2.2857834835265285,14
2576,86,88,84,44,2.2844335131903772,44
2577,38,10,81,5,2.2819621266449914,5
2578,48,19,65,10,2.2816603054261093,9
2579,9,47,40,21,2.2806450266015683,26
2580,77,12,69,6,2.2797993708458963,6
2581,16,29,108,12,2.2725919431060206,17
2582,7,108,68,50,2.2702884441480373,58
2583,61,10,31,5,2.2696136748473603,5
2584,86,84,8,42,2.2684162276686486,42
2585,28,66,96,31,2.267406944603933,35
2586,85,12,7,5,2.2672729351147445,7
2587,10,14,87,6,2.2663103024468136,8
2588,106,45,88,19,2.2639858690375614,26
2589,87,62,106,30,2.2622041017840115,32
2590,74,13,41,7,2.254565024803335,6
2591,95,30,25,14,2.25397314365567,16
2592,48,16,88,9,2.2527265796758793,7
2593,63,11,83,4,2.2518527555221,7
2594,88,38,4,18,2.2459217004175493,20
2595,70,10,27,5,2.243263258457552,5
2596,104,65,13,30,2.2428038741485183,35
2597,64,21,49,9,2.2416010602386143,12
2598,8,89,55,44,2.240032474519914,45
2599,54,102,65,48,2.239671261645841,54
2600,27,17,48,7,2.2349641271706275,10
2601,4,26,114,13,2.234564836857367,13
2602,18,14,20,6,2.2334528603958916,8
2603,46,18,65,7,2.232998478058102,11
2604,77,21,87,10,2.23200611064642,11
2605,11,41,54,19,2.2307575825855546,22
2606,23,21,15,10,2.2295883568640162,11
2607,68,107,13,50,2.226955311742634,57
2608,107,116,86,54,2.226666242986667,62
2609,90,16,25,7,2.2261576936837058,9
2610,75,43,39,22,2.2252173665323527,21
2611,112,11,12,6,2.2247336886150633,5
2612,98,13,99,7,2.2212581677933785,6
2613,18,14,98,8,2.221147797140808,6
2614,11,25,69,11,2.219760563258797,14
2615,72,11,62,5,2.217469660829094,6
2616,93,12,51,6,2.2166321429168523,6
2617,5,50,96,22,2.2114271922507607,28
2618,75,27,27,12,2.203651126537084,15
2619,96,10,49,5,2.2013596017058843,5
2620,7,75,40,33,2.1957521283064803,42
2621,8,60,11,28,2.1947518664362273,32
2622,68,35,106,16,2.1936858069827965,19
2623,41,33,40,16,2.1935807772699496,17
2624,72,12,43,5,2.1927570530466096,7
2625,19,13,47,6,2.1915786077930712,7
2626,86,33,12,15,2.1894855932114767,18
2627,31,10,54,5,2.186668926147148,5
2628,8,64,74,28,2.186622040651489,36
2629,58,17,3,7,2.1750406456469484,10
2630,84,16,93,8,2.173203038685072,8
2631,41,46,68,22,2.171804807510051,24
2632,60,30,81,14,2.1697382345262226,16
2633,77,27,18,11,2.1684272627383563,16
2634,19,32,94,15,2.165510462778429,17
2635,23,13,53,6,2.1639220781507627,7
2636,55,16,98,7,2.1617935333932947,9
2637,6,14,86,6,2.158350497876564,8
2638,89,11,49,5,2.155221325127322,6
2639,55,11,69,5,2.141856565606557,6
2640,71,39,39,18,2.140211900940766,21
2641,102,22,74,10,2.1384304011801047,12
2642,7,20,30,11,2.1356884749054443,9
2643,11,30,74,14,2.1347610080309107,16
2644,2,12,61,5,2.1331085158076015,7
2645,102,32,114,14,2.124084287601509,18
2646,7,62,9,31,2.12190310948229,31
2647,49,24,63,12,2.1212323385530327,12
2648,53,11,70,5,2.117480208536356,6
2649,7,17,72,8,2.1143024060967655,9
2650,74,12,33,6,2.113811361820999,6
2651,69,11,25,5,2.1120597510852464,6
2652,94,22,29,10,2.109797021304512,12
2653,57,38,13,19,2.1070868819342965,19
2654,68,28,94,13,2.1065110625469545,15
2655,108,32,107,15,2.1055805043927105,17
2656,86,33,38,15,2.105415418702344,18
2657,112,19,23,8,2.1018527652621173,11
2658,84,18,79,9,2.0988599029371873,9
2659,83,34,55,17,2.0962093979720215,17
2660,97,22,8,11,2.094799206270941,11
2661,17,12,91,5,2.0932516032559634,7
2662,60,67,77,32,2.0911684789459244,35
2663,40,18,11,9,2.089442100461012,9
2664,64,43,68,18,2.086424402801588,25
2665,15,49,39,21,2.085527392017013,28
2666,44,14,51,5,2.084874228955972,9
2667,74,47,65,23,2.0847963525870914,24
2668,82,10,63,5,2.077975861296688,5
2669,104,71,16,33,2.0698039945571574,38
2670,39,43,104,20,2.0501021472527095,23
2671,93,21,88,9,2.047097578055209,12
2672,114,63,88,30,2.046831677278045,33
2673,37,21,100,9,2.035973234211067,12
2674,40,59,88,27,2.0357313010299647,32
2675,83,13,50,7,2.034563553464953,6
2676,104,21,17,10,2.0345116655508866,11
2677,8,41,104,19,2.032634893277435,22
2678,112,11,34,5,2.0324399383154272,6
2679,91,14,114,7,2.0312426341433967,7
2680,32,11,13,5,2.026181507027534,6
2681,18,32,60,15,2.0244266182620256,17
2682,114,27,17,11,2.0211590753648707,16
2683,8,37,90,16,2.0194647820717804,21
2684,93,11,60,4,2.018629631632218,7
2685,69,14,37,7,2.015512849900141,7
2686,68,29,70,14,2.0151181581046385,15
2687,6,10,100,5,2.0077049362027837,5
2688,83,22,97,12,2.007636873207567,10
2689,8,39,100,18,2.005886580660696,21
2690,68,26,46,12,2.0015169846627185,14
2691,75,32,87,15,2.0004298974911783,17
2692,87,56,11,24,2.000245875012726,32
2693,66,11,27,5,1.9992664520674261,6
2694,114,26,74,13,1.9975972531686872,13
2695,104,15,112,7,1.99393597279257,8
2696,85,15,88,7,1.992964557457929,8
2697,12,23,11,12,1.9877128155591925,11
2698,53,19,4,9,1.987694792892671,10
2699,30,15,4,7,1.9875071363114756,8
2700,28,38,25,16,1.9833898911599184,22
2701,3,20,18,8,1.9827434721081498,12
2702,77,19,29,8,1.981161054072831,11
2703,95,28,53,11,1.9769373995573185,17
2704,88,31,70,14,1.9762934359596283,17
2705,39,46,3,23,1.973168826489564,23
2706,28,17,78,9,1.9711388035219528,8
2707,54,10,35,4,1.9706076038783524,6
2708,16,49,70,22,1.9664047334731982,27
2709,41,24,112,11,1.9642201479007217,13
2710,87,42,84,19,1.9615694257244276,23
2711,39,14,33,7,1.9600955952261434,7
2712,50,11,35,5,1.9581460146246747,6
2713,27,34,57,17,1.9534766566361748,17
2714,36,34,64,17,1.9485056781764598,17
2715,7,16,48,8,1.9478692265013036,8
2716,33,15,94,7,1.9451389474962026,8
2717,25,20,55,9,1.9429576796619945,11
2718,23,14,31,6,1.9392936999416424,8
2719,110,13,104,5,1.9388474450810558,8
2720,71,49,7,25,1.9387153694352777,24
2721,32,10,98,5,1.9380052263831626,5
2722,23,14,97,7,1.9330528734436567,7
2723,70,19,40,8,1.9276789997691202,11
2724,17,28,54,14,1.9259736473512523,14
2725,16,89,28,41,1.923978729516393,48
2726,114,21,18,10,1.923577249757446,11
2727,63,40,50,18,1.9230864117365438,22
2728,9,10,79,4,1.9224211679655938,6
2729,104,32,70,15,1.9224071285610203,17
2730,55,56,88,24,1.9221308051774735,32
2731,98,18,100,8,1.9217645875630163,10
2732,53,43,64,20,1.921457820047301,23
2733,99,11,76,6,1.9173589523208343,5
2734,97,32,106,16,1.9159665785715099,16
2735,110,11,17,5,1.9155371371930665,6
2736,88,67,68,31,1.9148855278527728,36
2737,68,38,1,18,1.9099752765436664,20
2738,13,20,96,9,1.909192933945374,11
2739,8,67,28,31,1.9053784571291423,36
2740,55,27,99,12,1.8950724021518552,15
2741,20,35,106,16,1.890590591428699,19
2742,25,23,64,11,1.8857238852847684,12
2743,17,28,49,15,1.8850836144226455,13
2744,96,16,30,7,1.885074878690488,9
2745,2,41,8,20,1.8848654476169697,21
2746,37,95,5,46,1.8654288703425719,49
2747,43,21,114,11,1.8643335671695769,10
2748,107,34,112,17,1.8511201240689454,17
2749,53,22,97,10,1.849246682219108,12
2750,8,24,3,13,1.8480935801495006,11
2751,16,118,13,53,1.845505830968455,65
2752,30,27,76,12,1.8425803619698342,15
2753,114,30,20,14,1.8395405662544742,16
2754,84,38,96,19,1.8356486827006797,19
2755,74,29,13,14,1.8278354237299064,15
2756,11,15,114,8,1.8276036019184323,7
2757,44,13,114,6,1.8263733365516701,7
2758,102,13,99,6,1.8212893413036875,7
2759,40,18,111,9,1.8104998545748818,9
2760,12,34,3,15,1.8101764659777833,19
2761,13,32,112,16,1.80903940686547,16
2762,36,22,25,11,1.8071440138268557,11
2763,70,57,86,26,1.8046372203949772,31
2764,51,34,31,14,1.8036645224364214,20
2765,18,32,41,16,1.8004819942826358,16
2766,63,10,103,4,1.799391808148132,6
2767,88,55,104,25,1.7934662263443764,30
2768,114,35,39,18,1.7909993968165117,17
2769,54,77,16,37,1.7894100662362948,40
2770,20,19,48,8,1.7888857426975076,11
2771,97,27,46,13,1.7888516310768017,14
2772,61,13,100,6,1.7880372053867657,7
2773,29,20,8,8,1.7818268121537417,12
2774,37,25,90,12,1.7816453937181782,13
2775,50,21,69,11,1.7758250016074648,10
2776,88,11,110,6,1.7642228121429866,5
2777,78,45,57,21,1.7583662843402377,24
2778,87,60,3,28,1.7580666314066156,32
2779,84,26,70,12,1.7530345342228948,14
2780,104,21,43,9,1.750605109142023,12
2781,11,29,60,13,1.7486537890116287,16
2782,27,68,107,31,1.7445937022008349,37
2783,60,33,36,16,1.7416473627060747,17
2784,18,11,6,5,1.7414584600944751,6
2785,36,37,88,16,1.7392851936744347,21
2786,54,73,8,32,1.7343257229328217,41
2787,16,27,44,12,1.7334648777380295,15
2788,106,38,96,17,1.7318320126651918,21
2789,70,19,75,10,1.7314858975507377,9
2790,32,13,68,5,1.731166259808923,8
2791,77,10,28,5,1.727447904471638,5
2792,17,35,107,17,1.7269738989467152,18
2793,63,15,45,7,1.7260545689947924,8
2794,50,20,34,9,1.7118812894704334,11
2795,62,28,71,14,1.710784794078352,14
2796,48,10,37,5,1.7035937503192145,5
2797,20,16,102,8,1.6989391239814933,8
2798,36,15,23,9,1.6972875274185721,6
2799,43,31,88,14,1.695452378897053,17
2800,28,64,5,31,1.6933141899778523,33
2801,88,59,28,27,1.6917395122237935,32
2802,58,13,50,7,1.6904606159972528,6
2803,47,29,51,15,1.6857225925039412,14
2804,55,40,106,18,1.6835382667235006,22
2805,3,37,60,17,1.6810408129313321,20
2806,17,18,64,8,1.6742261514283443,10
2807,63,45,7,18,1.6735738766299244,27
2808,45,28,31,13,1.6710870406691087,15
2809,87,48,60,24,1.6692465502528926,24
2810,54,19,33,8,1.668385392549265,11
2811,81,16,9,8,1.667141681490912,8
2812,85,16,17,7,1.6640468368595829,9
2813,46,25,76,12,1.6630163205732915,13
2814,11,57,46,27,1.662890115891342,30
2815,37,47,74,23,1.6628163329711263,24
2816,36,23,68,11,1.6511686348202657,12
2817,86,14,66,7,1.6453880931803613,7
2818,41,59,88,27,1.6397874376242199,32
2819,102,10,49,4,1.6394569107680623,6
2820,72,13,47,7,1.6387746545153188,6
2821,6,18,68,10,1.6346986227731553,8
2822,35,28,86,12,1.6302927109086067,16
2823,13,31,72,16,1.6241775993144327,15
2824,44,17,87,8,1.6239279411647842,9
2825,81,19,18,9,1.6163568658399623,10
2826,38,32,13,17,1.614314899085523,15
2827,30,29,69,14,1.613902271093239,15
2828,28,20,79,10,1.604902001664568,10
2829,14,11,75,5,1.5947210222856318,6
2830,16,53,57,24,1.5848148637973312,29
2831,2,15,25,8,1.5845186001024008,7
2832,58,12,100,6,1.5819008855655043,6
2833,107,22,81,10,1.581698926790109,12
2834,55,22,90,12,1.578656952498874,10
2835,96,34,88,17,1.5755489762598085,17
2836,60,25,46,12,1.5735893742532674,13
2837,63,43,41,20,1.5704593108021436,23
2838,30,27,78,13,1.569607458561735,14
2839,50,16,12,10,1.5648641628940967,6
2840,9,14,111,7,1.5621342613374551,7
2841,109,26,106,13,1.562107287891286,13
2842,64,19,15,10,1.5585187752284797,9
2843,104,23,83,10,1.5563880557352996,13
2844,54,35,30,17,1.556335080451803,18
2845,75,44,55,19,1.5547955200380577,25
2846,80,20,11,10,1.553265227546683,10
2847,87,41,74,19,1.54873499555014,22
2848,57,25,102,12,1.5483760769806836,13
2849,49,43,86,23,1.5469593224920277,20
2850,27,12,33,6,1.5458672151936605,6
2851,94,21,11,11,1.5369194320927215,10
2852,29,13,53,5,1.5317670028644748,8
2853,64,15,81,7,1.5315551836921653,8
2854,114,20,84,9,1.5282826629009798,11
2855,68,72,27,34,1.524949709281463,38
2856,77,30,68,15,1.52485587267376,15
2857,35,14,37,7,1.523131742310598,7
2858,27,26,62,13,1.5182408665379923,13
2859,12,16,85,8,1.5174687419154698,8
2860,46,12,55,5,1.5148590180899557,7
2861,100,21,34,11,1.5118468019701654,10
2862,30,37,8,17,1.5081255824989244,20
2863,64,29,27,14,1.5066564848276938,15
2864,33,28,16,15,1.5061133339188528,13
2865,3,62,51,32,1.5008766308008912,30
2866,17,31,50,16,1.4997072054884293,15
2867,9,34,63,16,1.4983458266579124,18
2868,46,52,5,24,1.4974094901037487,28
2869,107,47,25,23,1.4967278623744356,24
2870,112,16,11,8,1.4950492246382476,8
2871,76,17,62,8,1.4886483429037691,9
2872,60,74,71,35,1.4843115108657077,39
2873,68,10,84,4,1.478899377350919,6
2874,109,20,69,10,1.4769023355605444,10
2875,103,17,79,8,1.4762996181953612,9
2876,73,15,63,8,1.4760785674332926,7
2877,68,60,107,30,1.4755919303132567,30
2878,106,20,43,10,1.4741650546799518,10
2879,11,17,32,9,1.4729852723414754,8
2880,35,24,7,12,1.4676220715119421,12
2881,6,13,69,7,1.4672562795661186,6
2882,71,24,3,11,1.4668209780059585,13
2883,40,64,51,31,1.4624658901194145,33
2884,31,21,47,10,1.4606130980712668,11
2885,25,23,83,10,1.4597201880554966,13
2886,39,73,13,34,1.450285772990473,39
2887,106,55,63,27,1.4485566818099482,28
2888,39,21,48,9,1.4474709554841443,12
2889,39,29,62,13,1.4474002147033354,16
2890,65,33,69,16,1.4425642416495132,17
2891,20,21,97,11,1.439527960881874,10
2892,50,28,25,14,1.4391705454909012,14
2893,86,62,3,29,1.4383345750457774,33
2894,109,20,3,10,1.434376213159629,10
2895,107,62,60,30,1.4269631150411846,32
2896,36,35,45,19,1.423273124508123,16
2897,71,23,55,12,1.4219584840110406,11
2898,1,11,53,5,1.4196819324858228,6
2899,16,35,90,18,1.4190191744987382,17
2900,66,11,72,5,1.416761062195627,6
2901,6,17,87,8,1.4122521547017308,9
2902,29,22,78,10,1.4120834575153542,12
2903,12,16,40,8,1.4120822666164417,8
2904,109,18,77,9,1.410617297318329,9
2905,100,29,62,15,1.4095954922785312,14
2906,12,20,71,10,1.4059148964814159,10
2907,46,25,9,13,1.4052752923291358,12
2908,87,36,64,18,1.4019068150674154,18
2909,70,17,95,9,1.4011695857654913,8
2910,75,12,44,5,1.399837377533035,7
2911,91,13,9,6,1.3946381880594532,7
2912,36,11,29,6,1.3837445576600587,5
2913,95,31,7,14,1.3809406634768675,17
2914,106,30,41,15,1.3806292559177733,15
2915,55,15,62,7,1.3800432063216206,8
2916,39,51,41,26,1.3725005678823716,25
2917,86,66,55,31,1.371489773467497,35
2918,75,10,48,5,1.3711471542080278,5
2919,39,32,12,15,1.3663739107373383,17
2920,25,26,30,14,1.363384718034577,12
2921,112,12,74,6,1.3616749140437374,6
2922,72,35,16,16,1.3606835972281959,19
2923,111,17,87,8,1.3561671479223418,9
2924,30,14,81,7,1.3508923221630351,7
2925,97,37,88,18,1.349074362930903,19
2926,108,17,40,9,1.3479697301696818,8
2927,107,72,63,38,1.346860465088752,34
2928,34,25,84,12,1.346258750306376,13
2929,6,10,23,5,1.3385415186806262,5
2930,39,49,54,24,1.3384616724370861,25
2931,108,13,81,6,1.3379621241230502,7
2932,50,32,51,16,1.3326103812189878,16
2933,12,27,87,12,1.3278353834684422,15
2934,8,57,96,27,1.3267739850117202,30
2935,74,18,80,9,1.3199661328668575,9
2936,32,12,51,6,1.314434714983352,6
2937,100,16,85,8,1.3140606350637047,8
2938,94,11,40,5,1.313173008584519,6
2939,68,52,9,25,1.3104638696206772,27
2940,9,28,58,13,1.310268135821902,15
2941,41,28,114,14,1.30733810804357,14
2942,84,11,64,4,1.3059634387921,7
2943,27,23,50,9,1.3046741995517444,14
2944,5,44,13,21,1.302350985374302,23
2945,34,16,12,8,1.301741835874951,8
2946,7,22,8,10,1.29527150144924,12
2947,50,18,98,8,1.2936360808559426,10
2948,57,15,48,7,1.2933503211639665,8
2949,2,22,74,10,1.2925512141562505,12
2950,51,19,99,10,1.289208240710456,9
2951,89,17,88,9,1.2888997749635156,8
2952,16,53,74,25,1.2870673809929651,28
2953,88,22,35,11,1.2841130433589263,11
2954,96,59,107,27,1.2779661064945949,32
2955,17,12,80,5,1.2769817296361932,7
2956,107,38,90,19,1.2750427230775991,19
2957,71,11,1,6,1.2732152302328,5
2958,50,19,108,10,1.2701675761997318,9
2959,73,15,16,8,1.2607482082851333,7
2960,27,10,46,4,1.255099102534174,6
2961,63,27,70,13,1.2550372321498742,14
2962,17,11,62,5,1.2486647888480191,6
2963,108,16,55,7,1.2425126869095338,9
2964,107,30,4,15,1.2387516471106226,15
2965,71,25,31,12,1.2380158081615504,13
2966,63,16,95,8,1.233969730193377,8
2967,51,88,107,38,1.2335246266798188,50
2968,51,16,38,7,1.2327496347880265,9
2969,86,73,39,37,1.2318995282107095,36
2970,71,26,9,12,1.2262156519313812,14
2971,86,92,65,47,1.2239963595428645,45
2972,98,11,74,5,1.2137114800422117,6
2973,58,16,63,9,1.211674081917942,7
2974,25,33,97,16,1.211209753293348,17
2975,112,49,16,24,1.197214799064422,25
2976,25,67,16,32,1.1932865297100665,35
2977,48,12,41,6,1.1910839111619824,6
2978,88,36,37,17,1.188834543043674,19
2979,87,16,110,7,1.187803786715121,9
2980,76,31,96,14,1.1853039288193825,17
2981,8,26,48,12,1.176757496258483,14
2982,39,52,55,24,1.1740266098053433,28
2983,65,108,63,52,1.162387515885531,56
2984,104,16,23,9,1.1585628201755833,7
2985,87,54,55,26,1.1527665327316694,28
2986,64,20,45,9,1.1431500338693237,11
2987,50,21,112,9,1.1411219571120224,12
2988,36,26,106,13,1.1307287364062801,13
2989,3,26,31,14,1.130409883055894,12
2990,29,21,11,10,1.1293738650195786,11
2991,23,45,86,22,1.127225198734144,23
2992,27,13,18,7,1.1211992327384535,6
2993,29,19,7,7,1.1170674633929263,12
2994,33,19,86,10,1.112984453857345,9
2995,16,44,114,20,1.1112389462801522,24
2996,51,16,6,7,1.1096986250731455,9
2997,73,13,55,6,1.1082443575059586,7
2998,91,12,47,6,1.1047106963660296,6
2999,40,19,45,9,1.1043531225931202,10
3000,96,18,2,9,1.1039761816908797,9
3001,107,35,46,18,1.1031099530770954,17
3002,70,39,106,20,1.1024614638047308,19
3003,68,83,51,38,1.0958426568834045,45
3004,40,13,74,6,1.0901529369074687,7
3005,50,29,65,14,1.0876879077972634,15
3006,75,54,65,27,1.0834874610355825,27
3007,17,14,15,6,1.0815196129384674,8
3008,64,19,97,9,1.0748997556854092,10
3009,107,41,70,21,1.0723253683389224,20
3010,9,16,97,9,1.0715415510849842,7
3011,67,20,37,9,1.0707700527635258,11
3012,58,14,71,7,1.0679524363994282,7
3013,100,14,44,7,1.0590413147864144,7
3014,80,17,8,9,1.0587286140181775,8
3015,71,18,45,10,1.0500246166344394,8
3016,13,65,27,32,1.048528133752184,33
3017,4,60,13,28,1.0440840904331967,32
3018,18,35,51,18,1.0414861976482428,17
3019,104,16,33,7,1.0375486456158112,9
3020,90,21,88,11,1.0373159148886417,10
3021,7,59,18,30,1.0365595161190129,29
3022,45,14,3,7,1.0349134798027078,7
3023,46,16,64,8,1.031017738027725,8
3024,2,33,97,16,1.0254110764857562,17
3025,51,53,37,23,1.0249339808072997,30
3026,63,20,44,9,1.0233184771026502,11
3027,61,13,27,6,1.0219872336964406,7
3028,107,41,18,22,1.0183255345448823,19
3029,8,92,107,47,1.0168882870821125,45
3030,57,13,60,6,1.0152034376280954,7
3031,87,52,28,26,1.0126365910584707,26
3032,85,32,86,15,1.0113399236982092,17
3033,45,12,88,5,1.0058195203591582,7
3034,13,43,75,20,1.005364432264769,23
3035,41,73,13,36,1.0052100802031876,37
3036,114,11,93,6,1.004990658958168,5
3037,37,37,17,16,0.9978108601802018,21
3038,20,13,27,6,0.9871413726704231,7
3039,69,32,107,15,0.9867318989974736,17
3040,88,24,78,11,0.9845371119711142,13
3041,68,15,102,7,0.9774478191416366,8
3042,107,65,5,32,0.9748363761521144,33
3043,78,12,9,6,0.9745877106891208,6
3044,63,52,87,24,0.9694664805604959,28
3045,15,20,63,10,0.9688742288483304,10
3046,64,15,57,7,0.9686108755747862,8
3047,76,31,50,13,0.9653541591978417,18
3048,104,38,106,19,0.9604760273979323,19
3049,106,11,103,6,0.9583580547252424,5
3050,14,14,5,6,0.9561035605846475,8
3051,63,23,53,11,0.9461903574638922,12
3052,8,51,39,26,0.9395633007628413,25
3053,18,29,40,12,0.9358054757186772,17
3054,28,15,15,8,0.9292417398610766,7
3055,78,43,107,20,0.9215347139145763,23
3056,86,14,113,6,0.9183338417210537,8
3057,75,27,114,13,0.9181862737012574,14
3058,106,100,86,49,0.9173221659807225,51
3059,15,38,68,17,0.9158662466441888,21
3060,39,14,1,5,0.9120351629887077,9
3061,43,17,50,7,0.911659904777202,10
3062,76,16,95,8,0.9107888940485349,8
3063,36,35,75,19,0.9076169876586753,16
3064,19,43,15,21,0.9042377374703098,22
3065,112,11,14,6,0.9022319115654415,5
3066,60,12,111,7,0.9019980300500788,5
3067,62,14,50,6,0.9017457082495502,8
3068,30,39,49,18,0.9014628194587319,21
3069,78,17,55,9,0.9002458878614071,8
3070,68,17,74,7,0.9001065237726507,10
3071,3,30,69,16,0.8962278395321787,14
3072,39,24,70,11,0.8958543413772138,13
3073,27,63,51,30,0.8881383616064773,33
3074,9,50,86,23,0.8880878607383526,27
3075,93,13,3,5,0.8808947328421439,8
3076,83,21,88,11,0.8798897555023182,10
3077,84,17,91,8,0.8755346549877653,9
3078,27,15,1,6,0.8721383199452174,9
3079,60,17,84,10,0.871614356489069,7
3080,8,67,37,33,0.8700084298071539,34
3081,86,77,13,39,0.8633594484787409,38
3082,10,10,114,4,0.8617397018011257,6
3083,77,14,64,8,0.8550421959375887,6
3084,19,29,86,15,0.8547184874040823,14
3085,41,12,38,5,0.8514389884122232,7
3086,65,38,11,19,0.8512591605271688,19
3087,39,13,102,6,0.8492100400200487,7
3088,60,14,98,7,0.8439389777307171,7
3089,15,48,16,25,0.8419967502435246,23
3090,8,78,88,38,0.8346650298713422,40
3091,103,20,29,11,0.8306165364205729,9
3092,2,16,46,8,0.8285194662826778,8
3093,88,54,49,26,0.8267825014615151,28
3094,29,12,106,6,0.8264692442725535,6
3095,28,48,37,24,0.8263140292594408,24
3096,13,107,65,51,0.8251358063632331,56
3097,84,15,95,7,0.8218033746912388,8
3098,50,67,54,33,0.8208738895797709,34
3099,114,19,45,9,0.8205689132017492,10
3100,7,80,41,40,0.8113607765595663,40
3101,7,16,79,8,0.808566327439515,8
3102,84,31,50,16,0.8064114901977948,15
3103,56,14,40,7,0.8062835825274064,7
3104,30,26,40,13,0.8045580871786187,13
3105,98,11,62,5,0.7995773049352667,6
3106,2,22,88,11,0.7956469041111237,11
3107,28,16,89,7,0.7901986413516635,9
3108,75,14,33,6,0.7900898585820654,8
3109,96,15,3,8,0.788360761162582,7
3110,80,15,38,8,0.7882565864146641,7
3111,4,18,104,10,0.7872554057904764,8
3112,48,20,109,9,0.7860713609857797,11
3113,13,51,28,25,0.7790491963091711,26
3114,87,22,99,10,0.7762165713325069,12
3115,88,32,69,15,0.7753807063240761,17
3116,10,19,84,9,0.7730240789929571,10
3117,97,20,93,10,0.7717644600090583,10
3118,28,58,109,27,0.76448490134667,31
3119,33,14,88,6,0.7636730867570104,8
3120,34,19,65,10,0.7628058558484428,9
3121,86,83,20,40,0.7625493429797969,43
3122,109,69,86,34,0.7613768961042882,35
3123,9,28,3,14,0.7589069260840979,14
3124,87,60,30,29,0.7576103627807733,31
3125,14,15,13,6,0.7511854242648525,9
3126,39,64,65,33,0.7504610739617342,31
3127,107,85,28,40,0.7466282052500216,45
3128,16,59,19,27,0.744807436678833,32
3129,46,24,84,11,0.744605770354001,13
3130,11,32,78,17,0.7439751541430462,15
3131,36,13,74,5,0.7437175733038444,8
3132,38,22,64,11,0.741675899909912,11
3133,37,27,84,13,0.7406944026942688,14
3134,7,12,108,5,0.7404080910313953,7
3135,25,24,15,13,0.7394428200536315,11
3136,50,43,106,22,0.7389423076340088,21
3137,76,37,11,17,0.7368187666821265,20
3138,5,40,63,22,0.7358500176759455,18
3139,40,77,86,36,0.7352757671814381,41
3140,9,22,112,10,0.732655126226577,12
3141,95,41,5,21,0.731606653431554,20
3142,27,13,99,7,0.7284055341482095,6
3143,71,10,96,5,0.7278695572627789,5
3144,57,10,4,4,0.7276499847388471,6
3145,46,63,88,32,0.7264738004913415,31
3146,8,24,17,12,0.7243993806611897,12
3147,100,46,30,21,0.7199540567543316,25
3148,61,18,40,9,0.7154895706830828,9
3149,82,13,28,7,0.7153587234866209,6
3150,43,18,71,10,0.7122285277146704,8
3151,51,37,12,18,0.710191678656004,19
3152,97,13,3,6,0.7099885191404639,7
3153,106,18,27,7,0.7074485049679566,11
3154,55,64,51,31,0.7052787365416379,33
3155,103,25,87,11,0.7049312985026179,14
3156,63,49,11,21,0.7041449631736957,28
3157,47,23,65,11,0.7020951602660517,12
3158,18,23,104,13,0.701208945227421,10
3159,38,11,91,5,0.7003822911270713,6
3160,57,11,95,4,0.6989616542578664,7
3161,61,11,39,6,0.6964131355147419,5
3162,3,30,43,14,0.6945065447681112,16
3163,49,22,62,10,0.6937360485134608,12
3164,11,17,93,10,0.6934063282822602,7
3165,68,69,86,35,0.6897584561737047,34
3166,8,30,76,14,0.6822031764790529,16
3167,18,19,25,10,0.6816652439852776,9
3168,109,14,23,7,0.6795387556597896,7
3169,50,39,39,19,0.6773303120820146,20
3170,29,13,79,5,0.67578388648967,8
3171,50,10,38,4,0.6752935140978018,6
3172,109,26,60,13,0.673756859043161,13
3173,63,32,78,15,0.651142744880651,17
3174,65,28,84,14,0.6478183306385065,14
3175,2,10,109,5,0.6444253237530958,5
3176,61,19,13,11,0.643994979824989,8
3177,85,15,69,7,0.6408165415497267,8
3178,25,25,41,14,0.6394054706376684,11
3179,111,17,36,8,0.6365354853619557,9
3180,13,34,20,16,0.632497829596757,18
3181,4,28,64,13,0.6316212138641686,15
3182,87,30,47,15,0.6310013424305165,15
3183,60,23,1,11,0.6297573562891167,12
3184,109,30,84,14,0.6283430275726475,16
3185,65,40,37,21,0.6273579146862459,19
3186,103,14,43,8,0.6267197914442149,6
3187,36,33,71,17,0.6241330409639582,16
3188,40,12,38,5,0.6179079194784384,7
3189,31,22,58,11,0.6168553703735019,11
3190,28,55,11,26,0.6161995497274562,29
3191,30,23,18,12,0.6155308894854562,11
3192,87,68,39,33,0.6125718981179333,35
3193,51,42,69,20,0.6101979768400004,22
3194,91,16,70,7,0.6063303701253773,9
3195,111,31,16,16,0.604864398590204,15
3196,63,15,34,7,0.6010869874219945,8
3197,71,32,106,15,0.6009609652453856,17
3198,111,10,12,6,0.6003907747378726,4
3199,71,10,23,4,0.6000287508458257,6
3200,65,25,78,11,0.5972758077920006,14
3201,94,14,88,6,0.594908220356331,8
3202,50,42,13,21,0.5885113336676775,21
3203,76,13,36,4,0.5885035889042722,9
3204,55,24,20,12,0.5874553964616283,12
3205,63,28,112,14,0.5834223269951169,14
3206,81,16,68,8,0.5833845458965541,8
3207,94,24,100,14,0.5797620298141511,10
3208,90,18,84,9,0.5795253040496203,9
3209,80,35,86,17,0.5771607275339617,18
3210,46,32,87,14,0.5771141288489539,18
3211,114,40,7,19,0.5741553045041318,21
3212,104,24,15,12,0.5737247395128393,12
3213,60,49,65,27,0.5726413570677132,22
3214,69,15,71,8,0.5724150990318919,7
3215,71,13,78,6,0.5661963238744551,7
3216,37,16,43,7,0.562355471826647,9
3217,29,10,108,5,0.5615423900676226,5
3218,83,10,2,5,0.5594397265150824,5
3219,46,20,41,9,0.5567343104251282,11
3220,30,71,86,33,0.553348313863988,38
3221,5,49,54,23,0.5526115688513309,26
3222,12,39,27,18,0.5523057634996393,21
3223,68,74,65,37,0.5506001841763745,37
3224,92,17,7,7,0.5480230211986101,10
3225,98,27,16,13,0.5462850233229243,14
3226,64,29,54,15,0.5456745481805155,14
3227,60,77,7,38,0.5423394255026432,39
3228,63,29,27,13,0.5399070299800365,16
3229,50,36,8,19,0.5398388863137726,17
3230,106,10,1,5,0.539652861011431,5
3231,65,37,17,16,0.5366069246519296,21
3232,11,18,17,9,0.5333410210662327,9
3233,107,20,6,10,0.5288105428737948,10
3234,4,24,77,12,0.5234491201479377,12
3235,73,19,28,10,0.5214155246375574,9
3236,60,18,83,9,0.5212906629660227,9
3237,30,22,106,11,0.5189588569615401,11
3238,50,45,11,22,0.5161227733066865,23
3239,84,27,78,13,0.5159724183872996,14
3240,112,10,66,4,0.5146742754382652,6
3241,112,20,51,10,0.5141422831615118,10
3242,4,18,9,9,0.5118055197130339,9
3243,54,41,7,20,0.5072416292031896,21
3244,111,51,68,26,0.5032623987050037,25
3245,90,13,91,6,0.5003235284827323,7
3246,23,20,54,10,0.5000451529620598,10
3247,88,35,31,18,0.4999807976090588,17
3248,5,59,87,29,0.4991669720547012,30
3249,74,22,18,12,0.49290222508995235,10
3250,86,24,93,12,0.49230543753796824,12
3251,62,12,97,6,0.4900514031250112,6
3252,57,14,104,5,0.4845128262229356,9
3253,88,40,20,21,0.48272225314993983,19
3254,109,46,13,22,0.4820337228682999,24
3255,84,10,94,5,0.4811703860633969,5
3256,95,28,74,13,0.47842550860281996,15
3257,75,31,41,14,0.47837138213253816,17
3258,86,58,50,27,0.4764833561290648,31
3259,25,51,39,26,0.4759465051184244,25
3260,40,39,16,20,0.4700829739213681,19
3261,65,54,31,26,0.46913887469692744,28
3262,107,30,85,15,0.46361597633939294,15
3263,104,38,76,20,0.4636043507636342,18
3264,65,58,12,30,0.462819528280172,28
3265,97,39,107,20,0.4513498337115768,19
3266,80,11,9,7,0.4439834453330457,4
3267,90,15,11,7,0.4409004522210816,8
3268,68,28,38,13,0.4389809843925625,15
3269,40,43,31,22,0.429627197462679,21
3270,49,32,7,15,0.42188009094911627,17
3271,5,14,38,7,0.4168378546295618,7
3272,54,34,84,17,0.4144322968093763,17
3273,20,16,69,8,0.4110151707783569,8
3274,31,33,86,17,0.4107692180392416,16
3275,96,39,55,20,0.409999012059578,19
3276,50,18,79,9,0.4091046493522828,9
3277,43,37,19,18,0.4078151950565515,19
3278,16,36,103,17,0.4066681393188066,19
3279,27,45,11,22,0.4058256777858905,23
3280,35,16,30,8,0.4016415319429745,8
3281,104,15,20,8,0.39743988488785953,7
3282,61,16,65,9,0.395050527419345,7
3283,55,16,41,8,0.3929137359889599,8
3284,102,14,84,7,0.3912018744364814,7
3285,8,13,44,6,0.3904420875790005,7
3286,7,89,65,47,0.39009225035654854,42
3287,65,26,77,12,0.3896670535480057,14
3288,69,30,36,15,0.38598798110099336,15
3289,114,28,71,14,0.3795577437704574,14
3290,70,22,97,12,0.3783758219642565,10
3291,14,18,84,8,0.37783903496494214,10
3292,63,27,60,13,0.3732661726653222,14
3293,40,21,75,10,0.36863713867004627,11
3294,94,19,41,10,0.36863478647370623,9
3295,95,26,28,12,0.36814720179538635,14
3296,92,18,13,7,0.36521745881563183,11
3297,17,19,87,10,0.3631074209821953,9
3298,17,25,68,13,0.36066654828941963,12
3299,39,68,107,34,0.357926087997255,34
3300,57,32,41,16,0.35698645651571526,16
3301,87,61,51,30,0.3555795179834239,31
3302,68,49,63,24,0.3537099268739354,25
3303,57,51,86,26,0.35295749250567027,25
3304,34,13,75,6,0.35287672494658584,7
3305,49,10,5,5,0.3484948933204418,5
3306,53,41,51,21,0.3439811842946898,20
3307,17,12,69,6,0.33992057730208697,6
3308,109,13,4,6,0.3380907022892352,7
3309,83,20,106,11,0.33164456490941063,9
3310,108,17,64,8,0.3288515928978434,9
3311,3,13,46,7,0.32759691142996444,6
3312,87,26,2,13,0.3261916240593897,13
3313,80,17,71,9,0.3237123360021306,8
3314,86,34,2,18,0.32232529406269955,16
3315,83,25,28,14,0.3193130867023741,11
3316,114,22,69,10,0.31706249889901594,12
3317,60,48,53,25,0.3118269913878374,23
3318,64,12,28,6,0.30789275575683855,6
3319,23,19,111,11,0.30722018824927017,8
3320,1,35,107,18,0.30511491832295773,17
3321,16,52,41,24,0.30124505382531497,28
3322,3,16,76,8,0.29549269941760636,8
3323,98,16,19,7,0.29311592538168374,9
3324,27,17,25,9,0.2912949474117505,8
3325,13,46,15,24,0.2858651477398279,22
3326,68,63,60,33,0.28538797843058167,30
3327,67,12,25,6,0.2816428039469064,6
3328,96,12,67,7,0.27996501259109813,5
3329,104,40,68,19,0.2798877887850182,21
3330,7,20,70,8,0.27895885562124206,12
3331,53,18,5,8,0.2778213329671456,10
3332,7,77,39,40,0.2749189859757216,37
3333,112,16,17,8,0.27197121777913047,8
3334,87,18,52,10,0.2686604923430049,8
3335,36,11,38,4,0.26679215079866997,7
3336,37,22,76,12,0.2606095394442829,10
3337,30,45,27,23,0.2594124593655337,22
3338,86,15,89,6,0.25902148619611914,9
3339,54,80,107,41,0.25756345940778985,39
3340,71,36,88,16,0.25752053570309325,20
3341,4,32,68,16,0.25730955252799864,16
3342,17,11,108,5,0.2506467392789146,6
3343,39,51,63,29,0.2485762976887629,22
3344,57,22,55,12,0.24797671552008474,10
3345,40,25,47,14,0.24655985846699452,11
3346,39,10,93,5,0.24650819188032075,5
3347,86,79,54,40,0.23904456444882094,39
3348,15,42,86,21,0.23805195344324354,21
3349,13,56,53,26,0.23596481784004864,30
3350,11,65,39,33,0.23090569657274948,32
3351,65,10,101,5,0.22906131925901718,5
3352,47,12,53,6,0.22656162850800943,6
3353,88,15,79,8,0.22413158533616365,7
3354,87,50,96,24,0.22380305623995284,26
3355,106,69,28,34,0.21905675330440585,35
3356,7,99,107,54,0.21373648564267417,45
3357,53,21,44,9,0.2122113313421154,12
3358,48,26,11,13,0.21053633238551017,13
3359,28,11,66,5,0.2056598644516812,6
3360,46,23,17,12,0.20521498367655996,11
3361,8,46,20,23,0.2023315764151644,23
3362,63,48,40,23,0.20172959340563693,25
3363,76,11,47,3,0.1986777302440924,8
3364,107,61,74,29,0.19420996588142148,32
3365,112,18,72,9,0.1936517175084139,9
3366,12,21,18,10,0.19282803775168336,11
3367,19,21,112,11,0.1905110640381326,10
3368,88,19,61,8,0.1901426643579958,11
3369,35,12,70,7,0.18631436457958764,5
3370,44,15,65,6,0.18351226600640885,9
3371,50,25,114,12,0.18060110833646845,13
3372,70,23,41,13,0.17939581625615084,10
3373,71,33,8,17,0.17759312635004623,16
3374,11,47,106,26,0.17225906773687616,21
3375,51,50,9,24,0.1707745155048165,26
3376,12,10,29,5,0.16867451381405588,5
3377,106,28,100,13,0.1677556244233457,15
3378,7,51,4,26,0.16136746029798088,25
3379,62,12,106,6,0.1584669634691407,6
3380,7,16,83,7,0.15765677447455273,9
3381,112,31,65,16,0.15691587782419453,15
3382,19,23,88,12,0.1550442655002045,11
3383,70,56,8,28,0.15218257137377833,28
3384,51,17,85,8,0.1485089203425444,9
3385,37,41,114,19,0.14487606275647485,22
3386,100,51,39,26,0.14360825003579727,25
3387,68,19,57,10,0.13549914627164314,9
3388,73,10,25,5,0.1328731236438802,5
3389,33,16,114,9,0.13065946112886406,7
3390,84,74,107,37,0.13045885016786862,37
3391,69,25,7,13,0.12779683769016903,12
3392,28,22,98,9,0.12169006680659694,13
3393,107,21,79,11,0.1178028492260971,10
3394,80,23,84,12,0.11286096846693221,11
3395,23,31,51,16,0.11082387229984789,15
3396,68,10,79,4,0.11002938828097442,6
3397,39,44,47,21,0.1095786316302477,23
3398,64,24,100,11,0.10532763947275085,13
3399,2,18,84,9,0.10504403066305398,9
3400,100,19,17,8,0.10330347718863789,11
3401,27,19,23,10,0.0995832775496503,9
3402,13,24,45,12,0.09910833731150663,12
3403,86,30,53,13,0.09593092236920715,17
3404,74,39,25,20,0.09563368284676016,19
3405,87,14,92,7,0.09367358040314991,7
3406,114,29,36,13,0.09213128587786307,16
3407,95,52,86,24,0.08956033992826938,28
3408,49,86,13,47,0.08949691881843984,39
3409,114,48,104,25,0.08363522002228145,23
3410,84,37,88,17,0.08333477514829757,20
3411,97,36,74,17,0.07931920932357782,19
3412,87,43,104,23,0.07856624027495081,20
3413,87,32,62,16,0.06899373968097366,16
3414,62,19,37,8,0.06880627143278654,11
3415,106,21,40,10,0.06808253080226546,11
3416,51,39,30,20,0.06682446440230774,19
3417,107,71,114,36,0.06336114924955376,35
3418,17,39,13,20,0.05971803178296817,19
3419,29,19,38,9,0.056275627076261485,10
3420,13,29,34,15,0.05455287257368432,14
3421,8,70,106,37,0.05212763279076112,33
3422,19,27,69,14,0.04895022981261082,13
3423,73,16,106,8,0.04700386219362951,8
3424,83,17,51,10,0.04607341431682285,7
3425,74,41,54,20,0.04296760366186976,21
3426,31,11,97,5,0.04256244744109723,6
3427,16,28,102,14,0.03953820636299188,14
3428,55,23,3,12,0.03361106113229084,11
3429,84,19,17,10,0.032612383959908106,9
3430,13,57,9,27,0.01801614367993792,30
3431,60,15,80,7,0.014675025668747566,8
3432,109,17,83,7,0.00972932964701334,10
3433,85,18,16,8,0.00556795502767413,10
3434,94,23,86,12,3.56651914630205e-05,11
3435,86,23,94,11,-3.566519146163031e-05,12
3436,16,18,85,10,-0.005567955027674327,8
3437,106,47,76,26,-0.009505075346386196,21
3438,83,17,109,10,-0.009729329647013785,7
3439,80,15,60,8,-0.014675025668747439,7
3440,9,57,13,30,-0.01801614367993859,27
3441,17,19,84,9,-0.03261238395990876,10
3442,3,23,55,11,-0.033611061132289295,12
3443,97,11,31,6,-0.042562447441096586,5
3444,54,41,74,21,-0.04296760366187002,20
3445,51,17,83,7,-0.04607341431682421,10
3446,106,16,73,8,-0.0470038621936304,8
3447,69,27,19,13,-0.04895022981261305,14
3448,106,70,8,33,-0.05212763279076128,37
3449,34,29,13,14,-0.054552872573684956,15
3450,38,19,29,10,-0.05627562707626055,9
3451,13,39,17,19,-0.059718031782969076,20
3452,114,71,107,35,-0.06336114924955315,36
3453,30,39,51,19,-0.06682446440230849,20
3454,40,21,106,11,-0.0680825308022658,10
3455,37,19,62,11,-0.06880627143278734,8
3456,62,32,87,16,-0.068993739680973,16
3457,104,43,87,20,-0.07856624027495072,23
3458,74,36,97,19,-0.07931920932357782,17
3459,88,37,84,20,-0.0833347751482989,17
3460,104,48,114,23,-0.08363522002228167,25
3461,13,86,49,39,-0.0894969188184395,47
3462,86,52,95,28,-0.08956033992827091,24
3463,36,29,114,16,-0.09213128587786189,13
3464,92,14,87,7,-0.09367358040315074,7
3465,25,39,74,19,-0.0956336828467596,20
3466,53,30,86,17,-0.09593092236920858,13
3467,11,80,16,36,-0.09636151621677108,44
3468,11,62,107,30,-0.09659036725643244,32
3469,45,24,13,12,-0.09910833731150781,12
3470,23,19,27,9,-0.09958327754964931,10
3471,17,19,100,11,-0.10330347718863957,8
3472,84,18,2,9,-0.10504403066305477,9
3473,100,24,64,13,-0.10532763947275099,11
3474,47,44,39,23,-0.1095786316302473,21
3475,79,10,68,6,-0.11002938828097442,4
3476,51,31,23,15,-0.11082387229984611,16
3477,84,23,80,11,-0.11286096846693237,12
3478,79,21,107,10,-0.11780284922609727,11
3479,98,22,28,13,-0.1216900668065983,9
3480,7,25,69,12,-0.1277968376901685,13
3481,107,74,84,37,-0.13045885016787037,37
3482,114,16,33,7,-0.13065946112886495,9
3483,25,10,73,5,-0.1328731236438802,5
3484,57,19,68,9,-0.13549914627164278,10
3485,39,51,100,25,-0.14360825003579586,26
3486,114,41,37,22,-0.14487606275647485,19
3487,85,17,51,9,-0.14850892034254606,8
3488,8,56,70,28,-0.15218257137377827,28
3489,88,23,19,11,-0.1550442655002052,12
3490,65,31,112,15,-0.15691587782419436,16
3491,83,16,7,9,-0.1576567744745514,7
3492,106,12,62,6,-0.15846696346914188,6
3493,4,51,7,25,-0.16136746029798163,26
3494,100,28,106,15,-0.16775562442334394,13
3495,29,10,12,5,-0.16867451381405657,5
3496,9,50,51,26,-0.1707745155048177,24
3497,106,47,11,21,-0.17225906773687602,26
3498,8,33,71,16,-0.17759312635004632,17
3499,41,23,70,10,-0.17939581625614923,13
3500,114,25,50,13,-0.18060110833646717,12
3501,65,15,44,9,-0.1835122660064091,6
3502,70,12,35,5,-0.18631436457958692,7
3503,61,19,88,11,-0.19014266435799543,8
3504,112,21,19,10,-0.19051106403813386,11
3505,18,21,12,11,-0.19282803775168167,10
3506,72,18,112,9,-0.1936517175084139,9
3507,47,11,76,8,-0.19867773024409274,3
3508,40,48,63,25,-0.20172959340563568,23
3509,20,46,8,23,-0.20233157641516486,23
3510,17,23,46,11,-0.2052149836765593,12
3511,66,11,28,6,-0.20565986445168055,5
3512,44,21,53,12,-0.2122113313421161,9
3513,107,99,7,45,-0.2137364856426742,54
3514,28,69,106,35,-0.21905675330440377,34
3515,96,50,87,26,-0.22380305623995211,24
3516,79,15,88,7,-0.2241315853361646,8
3517,53,12,47,6,-0.22656162850800912,6
3518,101,10,65,5,-0.2290613192590168,5
3519,39,65,11,32,-0.23090569657275037,33
3520,53,56,13,30,-0.23596481784004786,26
3521,86,42,15,21,-0.23805195344324304,21
3522,54,79,86,39,-0.2390445644488226,40
3523,93,10,39,5,-0.24650819188031967,5
3524,47,25,40,11,-0.24655985846699366,14
3525,55,22,57,10,-0.24797671552008407,12
3526,63,51,39,22,-0.24857629768876138,29
3527,108,11,17,6,-0.25064673927891384,5
3528,68,32,4,16,-0.2573095525279973,16
3529,88,36,71,20,-0.2575205357030929,16
3530,107,80,54,39,-0.25756345940778924,41
3531,89,15,86,9,-0.2590214861961202,6
3532,27,45,30,22,-0.2594124593655354,23
3533,76,22,37,10,-0.26060953944428406,12
3534,38,11,36,7,-0.26679215079866964,4
3535,52,18,87,8,-0.26866049234300404,10
3536,17,16,112,8,-0.27197121777913247,8
3537,39,77,7,37,-0.27491898597572295,40
3538,5,18,53,10,-0.277821332967146,8
3539,70,20,7,12,-0.27895885562124184,8
3540,68,40,104,21,-0.2798877887850195,19
3541,67,12,96,5,-0.279965012591097,7
3542,25,12,67,6,-0.2816428039469064,6
3543,60,63,68,30,-0.28538797843058206,33
3544,15,46,13,22,-0.2858651477398276,24
3545,25,17,27,8,-0.29129494741175216,9
3546,19,16,98,9,-0.2931159253816844,7
3547,76,16,3,8,-0.2954926994176059,8
3548,41,52,16,28,-0.3012450538253157,24
3549,107,35,1,17,-0.30511491832295834,18
3550,111,19,23,8,-0.30722018824927033,11
3551,28,12,64,6,-0.30789275575683855,6
3552,53,48,60,23,-0.3118269913878375,25
3553,69,22,114,12,-0.31706249889901467,10
3554,28,25,83,11,-0.3193130867023753,14
3555,2,34,86,16,-0.32232529406269944,18
3556,71,17,80,8,-0.3237123360021318,9
3557,2,26,87,13,-0.32619162405938956,13
3558,46,13,3,6,-0.3275969114299653,7
3559,64,17,108,9,-0.3288515928978421,8
3560,106,20,83,9,-0.3316445649094112,11
3561,4,13,109,7,-0.3380907022892352,6
3562,69,12,17,6,-0.33992057730208786,6
3563,51,41,53,20,-0.3439811842946886,21
3564,5,10,49,5,-0.3484948933204407,5
3565,75,13,34,7,-0.35287672494658556,6
3566,86,51,57,25,-0.352957492505668,26
3567,63,49,68,25,-0.3537099268739361,24
3568,51,61,87,31,-0.3555795179834246,30
3569,41,32,57,16,-0.3569864565157146,16
3570,107,68,39,34,-0.35792608799725323,34
3571,68,25,17,12,-0.36066654828942024,13
3572,87,19,17,9,-0.3631074209821953,10
3573,13,18,92,11,-0.3652174588156323,7
3574,28,26,95,14,-0.36814720179538646,12
3575,41,19,94,9,-0.368634786473706,10
3576,75,21,40,11,-0.3686371386700461,10
3577,60,27,63,14,-0.37326617266532136,13
3578,84,18,14,10,-0.37783903496494253,8
3579,97,22,70,10,-0.3783758219642562,12
3580,71,28,114,14,-0.3795577437704577,14
3581,36,30,69,15,-0.3859879811009911,15
3582,77,26,65,14,-0.38966705354800596,12
3583,65,89,7,42,-0.3900922503565505,47
3584,44,13,8,7,-0.3904420875789997,6
3585,84,14,102,7,-0.39120187443648013,7
3586,41,16,55,8,-0.39291373598895946,8
3587,65,16,61,7,-0.3950505274193441,9
3588,20,15,104,7,-0.39743988488786003,8
3589,30,16,35,8,-0.4016415319429745,8
3590,11,45,27,23,-0.4058256777858905,22
3591,103,36,16,19,-0.4066681393188054,17
3592,19,37,43,19,-0.407815195056551,18
3593,79,18,50,9,-0.4091046493522828,9
3594,55,39,96,19,-0.40999901205957984,20
3595,86,33,31,16,-0.4107692180392426,17
3596,69,16,20,8,-0.41101517077835736,8
3597,84,34,54,17,-0.41443229680937554,17
3598,38,14,5,7,-0.4168378546295618,7
3599,7,32,49,17,-0.4218800909491176,15
3600,31,43,40,21,-0.4296271974626791,22
3601,38,28,68,15,-0.43898098439256167,13
3602,11,15,90,8,-0.4409004522210813,7
3603,9,11,80,4,-0.4439834453330448,7
3604,107,39,97,19,-0.4513498337115769,20
3605,12,58,65,28,-0.462819528280173,30
3606,76,38,104,18,-0.4636043507636345,20
3607,85,30,107,15,-0.4636159763393936,15
3608,31,54,65,28,-0.4691388746969265,26
3609,16,39,40,19,-0.4700829739213682,20
3610,39,51,25,25,-0.4759465051184236,26
3611,50,58,86,31,-0.4764833561290644,27
3612,20,23,30,12,-0.4766139020425556,11
3613,41,31,75,17,-0.47837138213253816,14
3614,74,28,95,15,-0.4784255086028221,13
3615,94,10,84,5,-0.4811703860633948,5
3616,13,46,109,24,-0.48203372286829943,22
3617,104,14,57,9,-0.4845128262229359,5
3618,97,12,62,6,-0.4900514031250112,6
3619,93,24,86,12,-0.4923054375379694,12
3620,18,22,74,10,-0.4929022250899522,12
3621,87,59,5,30,-0.49916697205470045,29
3622,31,35,88,17,-0.499980797609059,18
3623,54,20,23,10,-0.5000451529620575,10
3624,91,13,90,7,-0.5003235284827329,6
3625,68,51,111,25,-0.5032623987050046,26
3626,7,41,54,21,-0.507241629203189,20
3627,9,18,4,9,-0.5118055197130339,9
3628,51,20,112,10,-0.5141422831615127,10
3629,66,10,112,6,-0.5146742754382657,4
3630,78,27,84,14,-0.515972418387299,13
3631,11,45,50,23,-0.5161227733066868,22
3632,106,22,30,11,-0.5189588569615399,11
3633,83,18,60,9,-0.5212906629660219,9
3634,28,19,73,9,-0.5214155246375576,10
3635,77,24,4,12,-0.5234491201479351,12
3636,6,20,107,10,-0.528810542873795,10
3637,17,18,11,9,-0.5333410210662319,9
3638,17,37,65,21,-0.5366069246519297,16
3639,1,10,106,5,-0.5396528610114302,5
3640,8,36,50,17,-0.5398388863137724,19
3641,27,29,63,16,-0.5399070299800356,13
3642,7,77,60,39,-0.5423394255026428,38
3643,54,29,64,14,-0.5456745481805153,15
3644,16,27,98,14,-0.5462850233229247,13
3645,7,17,92,10,-0.5480230211986107,7
3646,65,74,68,37,-0.5506001841763739,37
3647,27,39,12,21,-0.5523057634996391,18
3648,54,49,5,26,-0.5526115688513301,23
3649,86,71,30,38,-0.5533483138639873,33
3650,41,20,46,11,-0.5567343104251291,9
3651,2,10,83,5,-0.559439726515081,5
3652,108,10,29,5,-0.5615423900676234,5
3653,43,16,37,9,-0.5623554718266468,7
3654,78,13,71,7,-0.5661963238744554,6
3655,71,15,69,7,-0.5724150990318926,8
3656,65,49,60,22,-0.5726413570677142,27
3657,15,24,104,12,-0.5737247395128372,12
3658,7,40,114,21,-0.5741553045041317,19
3659,87,32,46,18,-0.5771141288489547,14
3660,86,35,80,18,-0.5771607275339606,17
3661,84,18,90,9,-0.5795253040496205,9
3662,100,24,94,10,-0.5797620298141505,14
3663,68,16,81,8,-0.5833845458965539,8
3664,112,28,63,14,-0.5834223269951164,14
3665,20,24,55,12,-0.5874553964616281,12
3666,36,13,76,9,-0.5885035889042698,4
3667,13,42,50,21,-0.5885113336676766,21
3668,88,14,94,8,-0.594908220356331,6
3669,78,25,65,14,-0.5972758077920014,11
3670,23,10,71,6,-0.6000287508458257,4
3671,12,10,111,4,-0.6003907747378741,6
3672,106,32,71,17,-0.6009609652453869,15
3673,34,15,63,8,-0.6010869874219955,7
3674,16,31,111,15,-0.6048643985902039,16
3675,70,16,91,9,-0.6063303701253777,7
3676,69,42,51,22,-0.6101979768400001,20
3677,39,68,87,35,-0.6125718981179344,33
3678,18,23,30,11,-0.615530889485455,12
3679,11,55,28,29,-0.616199549727456,26
3680,58,22,31,11,-0.6168553703735028,11
3681,38,12,40,7,-0.6179079194784384,5
3682,71,33,36,16,-0.6241330409639598,17
3683,43,14,103,6,-0.6267197914442149,8
3684,37,40,65,19,-0.6273579146862459,21
3685,84,30,109,16,-0.6283430275726458,14
3686,1,23,60,12,-0.6297573562891176,11
3687,47,30,87,15,-0.6310013424305154,15
3688,64,28,4,15,-0.6316212138641698,13
3689,20,34,13,18,-0.6324978295967559,16
3690,20,16,93,9,-0.6327174645108351,7
3691,36,17,111,9,-0.6365354853619557,8
3692,41,25,25,11,-0.6394054706376676,14
3693,69,15,85,8,-0.6408165415497269,7
3694,13,19,61,8,-0.6439949798249884,11
3695,109,10,2,5,-0.6444253237530958,5
3696,84,28,65,14,-0.6478183306385067,14
3697,78,32,63,17,-0.6511427448806526,15
3698,60,26,109,13,-0.6737568590431613,13
3699,38,10,50,6,-0.675293514097801,4
3700,79,13,29,8,-0.6757838864896706,5
3701,39,39,50,20,-0.6773303120820158,19
3702,23,14,109,7,-0.6795387556597896,7
3703,25,19,18,9,-0.6816652439852758,10
3704,76,30,8,16,-0.6822031764790518,14
3705,86,69,68,34,-0.6897584561737039,35
3706,93,17,11,7,-0.6934063282822591,10
3707,62,22,49,12,-0.693736048513461,10
3708,43,30,3,16,-0.6945065447681108,14
3709,39,11,61,5,-0.6964131355147433,6
3710,95,11,57,7,-0.6989616542578677,4
3711,91,11,38,6,-0.7003822911270713,5
3712,104,23,18,10,-0.7012089452274208,13
3713,65,23,47,12,-0.7020951602660523,11
3714,11,49,63,28,-0.7041449631736966,21
3715,87,25,103,14,-0.7049312985026178,11
3716,51,64,55,33,-0.7052787365416385,31
3717,27,18,106,11,-0.7074485049679552,7
3718,3,13,97,7,-0.7099885191404633,6
3719,12,37,51,19,-0.710191678656004,18
3720,71,18,43,8,-0.71222852771467,10
3721,28,13,82,6,-0.7153587234866207,7
3722,40,18,61,9,-0.7154895706830816,9
3723,30,46,100,25,-0.7199540567543335,21
3724,17,24,8,12,-0.7243993806611906,12
3725,88,63,46,31,-0.7264738004913419,32
3726,4,10,57,6,-0.7276499847388465,4
3727,96,10,71,5,-0.7278695572627789,5
3728,99,13,27,6,-0.7284055341482082,7
3729,16,80,11,45,-0.7311060980382811,35
3730,5,41,95,20,-0.7316066534315533,21
3731,112,22,9,12,-0.7326551262265775,10
3732,86,77,40,41,-0.7352757671814375,36
3733,63,40,5,18,-0.7358500176759462,22
3734,106,43,50,21,-0.738942307634008,22
3735,15,24,25,11,-0.7394428200536295,13
3736,108,12,7,7,-0.7404080910313952,5
3737,84,27,37,14,-0.7406944026942689,13
3738,64,22,38,11,-0.741675899909911,11
3739,74,13,36,8,-0.743717573303844,5
3740,78,32,11,15,-0.7439751541430462,17
3741,84,24,46,13,-0.7446057703540011,11
3742,19,59,16,32,-0.7448074366788329,27
3743,28,85,107,45,-0.7466282052500216,40
3744,65,64,39,31,-0.7504610739617337,33
3745,13,15,14,9,-0.751185424264851,6
3746,30,60,87,31,-0.7576103627807728,29
3747,3,28,9,14,-0.7589069260840974,14
3748,86,69,109,35,-0.7613768961042885,34
3749,20,83,86,43,-0.7625493429797979,40
3750,65,19,34,9,-0.7628058558484428,10
3751,88,14,33,8,-0.763673086757011,6
3752,109,58,28,31,-0.7644849013466701,27
3753,93,20,97,10,-0.7717644600090567,10
3754,84,19,10,10,-0.7730240789929577,9
3755,69,32,88,17,-0.7753807063240767,15
3756,99,22,87,12,-0.7762165713325071,10
3757,28,51,13,26,-0.7790491963091725,25
3758,109,20,48,11,-0.7860713609857799,9
3759,104,18,4,8,-0.7872554057904768,10
3760,38,15,80,7,-0.7882565864146641,8
3761,3,15,96,7,-0.7883607611625825,8
3762,33,14,75,8,-0.7900898585820659,6
3763,89,16,28,9,-0.7901986413516622,7
3764,88,22,2,11,-0.7956469041111237,11
3765,62,11,98,6,-0.7995773049352679,5
3766,40,26,30,13,-0.8045580871786177,13
3767,40,14,56,7,-0.8062835825274064,7
3768,50,31,84,15,-0.8064114901977935,16
3769,79,16,7,8,-0.8085663274395147,8
3770,41,80,7,40,-0.8113607765595651,40
3771,20,27,74,13,-0.8203305748765273,14
3772,45,19,114,10,-0.8205689132017484,9
3773,54,67,50,34,-0.8208738895797711,33
3774,95,15,84,8,-0.8218033746912378,7
3775,65,107,13,56,-0.8251358063632326,51
3776,37,48,28,24,-0.8263140292594411,24
3777,106,12,29,6,-0.8264692442725535,6
3778,49,54,88,28,-0.8267825014615153,26
3779,46,16,2,8,-0.8285194662826783,8
3780,29,20,103,9,-0.8306165364205732,11
3781,88,78,8,40,-0.8346650298713413,38
3782,16,48,15,23,-0.8419967502435238,25
3783,98,14,60,7,-0.8439389777307166,7
3784,102,13,39,7,-0.8492100400200481,6
3785,11,38,65,19,-0.8512591605271699,19
3786,38,12,41,7,-0.851438988412223,5
3787,86,29,19,14,-0.8547184874040825,15
3788,64,14,77,6,-0.8550421959375909,8
3789,114,10,10,6,-0.8617397018011254,4
3790,13,77,86,38,-0.8633594484787404,39
3791,37,67,8,34,-0.8700084298071528,33
3792,84,17,60,7,-0.8716143564890693,10
3793,1,15,27,9,-0.8721383199452194,6
3794,91,17,84,9,-0.8755346549877636,8
3795,88,21,83,10,-0.8798897555023183,11
3796,3,13,93,8,-0.8808947328421428,5
3797,86,50,9,27,-0.8880878607383526,23
3798,51,63,27,33,-0.8881383616064759,30
3799,70,24,39,13,-0.8958543413772146,11
3800,69,30,3,14,-0.8962278395321779,16
3801,74,17,68,10,-0.9001065237726515,7
3802,55,17,78,8,-0.9002458878614066,9
3803,49,39,30,21,-0.9014628194587326,18
3804,50,14,62,8,-0.9017457082495504,6
3805,111,12,60,5,-0.9019980300500793,7
3806,14,11,112,5,-0.9022319115654427,6
3807,15,43,19,22,-0.904237737470311,21
3808,75,35,36,16,-0.9076169876586756,19
3809,95,16,76,8,-0.9107888940485349,8
3810,50,17,43,10,-0.911659904777202,7
3811,1,14,39,9,-0.9120351629887077,5
3812,68,38,15,21,-0.9158662466441888,17
3813,114,27,75,14,-0.9181862737012573,13
3814,113,14,86,8,-0.9183338417210523,6
3815,107,43,78,23,-0.9215347139145762,20
3816,15,15,28,7,-0.9292417398610756,8
3817,40,29,18,17,-0.9358054757186769,12
3818,39,51,8,25,-0.939563300762841,26
3819,53,23,63,12,-0.9461903574638926,11
3820,5,14,14,8,-0.9561035605846475,6
3821,103,11,106,5,-0.9583580547252434,6
3822,106,38,104,19,-0.9604760273979325,19
3823,107,62,11,33,-0.9614829755615019,29
3824,50,31,76,18,-0.9653541591978413,13
3825,57,15,64,8,-0.9686108755747862,7
3826,63,20,15,10,-0.9688742288483313,10
3827,87,52,63,28,-0.969466480560497,24
3828,9,12,78,6,-0.9745877106891214,6
3829,5,65,107,33,-0.9748363761521153,32
3830,102,15,68,8,-0.9774478191416376,7
3831,78,24,88,13,-0.9845371119711127,11
3832,107,32,69,17,-0.9867318989974738,15
3833,27,13,20,7,-0.9871413726704222,6
3834,17,37,37,21,-0.9978108601802036,16
3835,93,11,114,5,-1.0049906589581687,6
3836,13,73,41,37,-1.0052100802031871,36
3837,75,43,13,23,-1.0053644322647692,20
3838,88,12,45,7,-1.005819520359159,5
3839,86,32,85,17,-1.0113399236982104,15
3840,28,52,87,26,-1.0126365910584707,26
3841,60,13,57,7,-1.0152034376280947,6
3842,107,92,8,45,-1.0168882870821123,47
3843,18,41,107,19,-1.0183255345448867,22
3844,27,13,61,7,-1.0219872336964406,6
3845,44,20,63,11,-1.0233184771026504,9
3846,37,53,51,30,-1.024933980807299,23
3847,97,33,2,17,-1.0254110764857562,16
3848,64,16,46,8,-1.031017738027724,8
3849,3,14,45,7,-1.0349134798027073,7
3850,18,59,7,29,-1.0365595161190124,30
3851,88,21,90,10,-1.0373159148886413,11
3852,33,16,104,9,-1.037548645615811,7
3853,51,35,18,17,-1.0414861976482428,18
3854,13,60,4,32,-1.0440840904331994,28
3855,27,65,13,33,-1.0485281337521837,32
3856,45,18,71,8,-1.050024616634439,10
3857,8,17,80,8,-1.0587286140181777,9
3858,44,14,100,7,-1.059041314786415,7
3859,71,14,58,7,-1.067952436399428,7
3860,37,20,67,11,-1.0707700527635244,9
3861,97,16,9,7,-1.0715415510849833,9
3862,70,41,107,20,-1.0723253683389227,21
3863,97,19,64,10,-1.0748997556854094,9
3864,15,14,17,8,-1.0815196129384665,6
3865,65,54,75,27,-1.0834874610355845,27
3866,65,29,50,15,-1.0876879077972634,14
3867,74,13,40,7,-1.0901529369074696,6
3868,51,83,68,45,-1.0958426568834054,38
3869,106,39,70,19,-1.1024614638047292,20
3870,46,35,107,17,-1.1031099530770958,18
3871,2,18,96,9,-1.1039761816908782,9
3872,45,19,40,10,-1.1043531225931214,9
3873,47,12,91,6,-1.104710696366028,6
3874,55,13,73,7,-1.1082443575059588,6
3875,6,16,51,9,-1.1096986250731458,7
3876,114,44,16,24,-1.1112389462801515,20
3877,86,19,33,9,-1.1129844538573441,10
3878,7,19,29,12,-1.1170674633929274,7
3879,18,13,27,6,-1.1211992327384528,7
3880,86,45,23,23,-1.127225198734144,22
3881,11,21,29,11,-1.1293738650195773,10
3882,31,26,3,12,-1.1304098830558946,14
3883,106,26,36,13,-1.1307287364062808,13
3884,112,21,50,12,-1.1411219571120237,9
3885,45,20,64,11,-1.143150033869323,9
3886,55,54,87,28,-1.152766532731669,26
3887,23,16,104,7,-1.1585628201755829,9
3888,63,108,65,56,-1.1623875158855317,52
3889,74,14,12,7,-1.1676100167547812,7
3890,55,52,39,28,-1.1740266098053438,24
3891,48,26,8,14,-1.1767574962584832,12
3892,96,31,76,17,-1.1853039288193825,14
3893,110,16,87,9,-1.1878037867151192,7
3894,37,36,88,19,-1.188834543043674,17
3895,41,12,48,6,-1.1910839111619829,6
3896,16,67,25,35,-1.193286529710067,32
3897,16,49,112,25,-1.1972147990644224,24
3898,97,33,25,17,-1.2112097532933461,16
3899,63,16,58,7,-1.211674081917942,9
3900,74,11,98,6,-1.2137114800422124,5
3901,65,92,86,45,-1.2239963595428656,47
3902,9,26,71,14,-1.2262156519313807,12
3903,39,73,86,36,-1.2318995282107095,37
3904,38,16,51,9,-1.2327496347880251,7
3905,107,88,51,50,-1.2335246266798194,38
3906,95,16,63,8,-1.233969730193377,8
3907,93,21,107,10,-1.2375139728583175,11
3908,31,25,71,13,-1.2380158081615502,12
3909,4,30,107,15,-1.2387516471106224,15
3910,55,16,108,9,-1.242512686909534,7
3911,62,11,17,6,-1.2486647888480198,5
3912,70,27,63,14,-1.2550372321498742,13
3913,46,10,27,6,-1.2550991025341744,4
3914,16,15,73,7,-1.2607482082851342,8
3915,14,15,107,7,-1.262180496300674,8
3916,108,19,50,9,-1.270167576199734,10
3917,1,11,71,5,-1.2732152302328004,6
3918,80,12,17,7,-1.2769817296361932,5
3919,107,59,96,32,-1.2779661064945946,27
3920,35,22,88,11,-1.284113043358928,11
3921,74,53,16,28,-1.2870673809929654,25
3922,88,17,89,8,-1.2888997749635154,9
3923,99,19,51,9,-1.2892082407104553,10
3924,74,22,2,12,-1.2925512141562505,10
3925,48,15,57,8,-1.2933503211639656,7
3926,98,18,50,10,-1.2936360808559442,8
3927,8,22,7,12,-1.2952715014492404,10
3928,12,16,34,8,-1.301741835874951,8
3929,13,44,5,23,-1.3023509853743016,21
3930,50,23,27,14,-1.3046741995517461,9
3931,64,11,84,7,-1.3059634387921004,4
3932,114,28,41,14,-1.307338108043571,14
3933,58,28,9,15,-1.3102681358219028,13
3934,9,52,68,27,-1.3104638696206783,25
3935,40,11,94,6,-1.3131730085845184,5
3936,85,16,100,8,-1.3140606350637054,8
3937,51,12,32,6,-1.314434714983353,6
3938,80,18,74,9,-1.3199661328668575,9
3939,96,57,8,30,-1.3267739850117202,27
3940,87,27,12,15,-1.3278353834684424,12
3941,51,32,50,16,-1.3326103812189873,16
3942,81,13,108,7,-1.3379621241230497,6
3943,54,49,39,25,-1.3384616724370857,24
3944,23,10,6,5,-1.3385415186806267,5
3945,84,25,34,13,-1.3462587503063752,12
3946,63,72,107,34,-1.3468604650887521,38
3947,40,17,108,8,-1.3479697301696822,9
3948,88,37,97,19,-1.3490743629309028,18
3949,81,14,30,7,-1.3508923221630345,7
3950,87,17,111,9,-1.3561671479223416,8
3951,16,35,72,19,-1.3606835972281952,16
3952,74,12,112,6,-1.3616749140437368,6
3953,30,26,25,12,-1.3633847180345777,14
3954,76,47,106,22,-1.3637390504385927,25
3955,12,32,39,17,-1.366373910737338,15
3956,48,10,75,5,-1.3711471542080287,5
3957,55,66,86,35,-1.3714897734674971,31
3958,41,51,39,25,-1.372500567882371,26
3959,62,15,55,8,-1.3800432063216195,7
3960,41,30,106,15,-1.3806292559177735,15
3961,7,31,95,17,-1.3809406634768695,14
3962,29,11,36,5,-1.3837445576600587,6
3963,9,13,91,7,-1.3946381880594534,6
3964,44,12,75,7,-1.3998373775330364,5
3965,95,17,70,8,-1.4011695857654913,9
3966,64,36,87,18,-1.4019068150674143,18
3967,9,25,46,12,-1.4052752923291365,13
3968,71,20,12,10,-1.4059148964814152,10
3969,62,29,100,14,-1.4095954922785314,15
3970,77,18,109,9,-1.4106172973183295,9
3971,40,16,12,8,-1.412082266616442,8
3972,78,22,29,12,-1.4120834575153558,10
3973,87,17,6,9,-1.4122521547017293,8
3974,72,11,66,6,-1.416761062195627,5
3975,90,35,16,17,-1.4190191744987375,18
3976,53,11,1,6,-1.4196819324858239,5
3977,55,23,71,11,-1.421958484011042,12
3978,45,35,36,16,-1.4232731245081227,19
3979,60,62,107,32,-1.4269631150411863,30
3980,3,20,109,10,-1.4343762131596285,10
3981,3,62,86,33,-1.438334575045779,29
3982,25,28,50,14,-1.4391705454909016,14
3983,97,21,20,10,-1.4395279608818727,11
3984,69,33,65,17,-1.4425642416495137,16
3985,62,29,39,16,-1.4474002147033358,13
3986,48,21,39,12,-1.4474709554841445,9
3987,63,55,106,28,-1.4485566818099482,27
3988,13,73,39,39,-1.450285772990475,34
3989,83,23,25,13,-1.459720188055496,10
3990,47,21,31,11,-1.4606130980712662,10
3991,51,64,40,33,-1.4624658901194143,31
3992,3,24,71,13,-1.4668209780059573,11
3993,69,13,6,6,-1.4672562795661197,7
3994,7,24,35,12,-1.4676220715119415,12
3995,32,17,11,8,-1.4729852723414758,9
3996,43,20,106,10,-1.474165054679951,10
3997,107,60,68,30,-1.4755919303132576,30
3998,63,15,73,7,-1.4760785674332912,8
3999,79,17,103,9,-1.4762996181953623,8
4000,69,20,109,10,-1.4769023355605448,10
4001,84,10,68,6,-1.4788993773509191,4
4002,71,74,60,39,-1.4843115108657061,35
4003,62,17,76,9,-1.4886483429037691,8
4004,11,16,112,8,-1.4950492246382485,8
4005,25,47,107,24,-1.4967278623744356,23
4006,5,52,46,28,-1.4974094901037482,24
4007,63,34,9,18,-1.4983458266579128,16
4008,50,31,17,15,-1.49970720548843,16
4009,51,62,3,30,-1.5008766308008914,32
4010,16,28,33,13,-1.5061133339188544,15
4011,27,29,64,15,-1.5066564848276949,14
4012,8,37,30,20,-1.5081255824989241,17
4013,34,21,100,10,-1.5118468019701639,11
4014,55,12,46,7,-1.514859018089955,5
4015,85,16,12,8,-1.5174687419154704,8
4016,62,26,27,13,-1.5182408665379916,13
4017,37,14,35,7,-1.523131742310598,7
4018,68,30,77,15,-1.52485587267376,15
4019,27,72,68,38,-1.524949709281465,34
4020,84,20,114,11,-1.52828266290098,9
4021,81,15,64,8,-1.5315551836921653,7
4022,53,13,29,8,-1.5317670028644754,5
4023,11,21,94,10,-1.5369194320927224,11
4024,74,61,107,33,-1.5445233108407423,28
4025,33,12,27,6,-1.5458672151936614,6
4026,86,43,49,20,-1.5469593224920284,23
4027,102,25,57,13,-1.548376076980684,12
4028,74,41,87,22,-1.5487349955501406,19
4029,11,20,80,10,-1.553265227546683,10
4030,55,44,75,25,-1.5547955200380577,19
4031,30,35,54,18,-1.5563350804518044,17
4032,83,23,104,13,-1.5563880557352991,10
4033,15,19,64,9,-1.5585187752284793,10
4034,106,26,109,13,-1.5621072878912867,13
4035,111,14,9,7,-1.5621342613374538,7
4036,12,16,50,6,-1.5648641628940974,10
4037,86,100,106,52,-1.5692663469089445,48
4038,78,27,30,14,-1.569607458561736,13
4039,41,43,63,23,-1.570459310802143,20
4040,46,25,60,13,-1.5735893742532685,12
4041,88,34,96,17,-1.575548976259807,17
4042,90,22,55,10,-1.578656952498874,12
4043,81,22,107,12,-1.5816989267901087,10
4044,100,12,58,6,-1.5819008855655043,6
4045,25,15,2,7,-1.5845186001024019,8
4046,57,53,16,29,-1.5848148637973283,24
4047,75,11,14,6,-1.594721022285632,5
4048,79,20,28,10,-1.6049020016645688,10
4049,69,29,30,15,-1.6139022710932374,14
4050,13,32,38,15,-1.6143148990855232,17
4051,18,19,81,10,-1.6163568658399634,9
4052,87,17,44,9,-1.6239279411647838,8
4053,72,31,13,15,-1.6241775993144314,16
4054,86,28,35,16,-1.6302927109086072,12
4055,68,18,6,8,-1.6346986227731553,10
4056,47,13,72,6,-1.638774654515319,7
4057,49,10,102,6,-1.6394569107680623,4
4058,88,59,41,32,-1.639787437624219,27
4059,66,14,86,7,-1.6453880931803606,7
4060,68,23,36,12,-1.6511686348202665,11
4061,74,47,37,24,-1.6628163329711265,23
4062,46,57,11,30,-1.6628901158913412,27
4063,76,25,46,13,-1.663016320573292,12
4064,48,19,106,10,-1.6634533717988316,9
4065,17,16,85,9,-1.6640468368595824,7
4066,9,16,81,8,-1.6671416814909092,8
4067,33,19,54,11,-1.6683853925492647,8
4068,60,48,87,24,-1.6692465502528933,24
4069,31,28,45,15,-1.6710870406691087,13
4070,7,45,63,27,-1.6735738766299244,18
4071,64,18,17,10,-1.674226151428344,8
4072,60,37,3,20,-1.6810408129313321,17
4073,106,40,55,22,-1.6835382667235002,18
4074,51,29,47,14,-1.68572259250394,15
4075,50,13,58,6,-1.6904606159972515,7
4076,28,59,88,32,-1.691739512223794,27
4077,5,64,28,33,-1.6933141899778517,31
4078,88,31,43,17,-1.695452378897054,14
4079,23,15,36,6,-1.6972875274185715,9
4080,102,16,20,8,-1.6989391239814924,8
4081,37,10,48,5,-1.703593750319215,5
4082,71,28,62,14,-1.7107847940783525,14
4083,34,20,50,11,-1.7118812894704334,9
4084,45,15,63,8,-1.7260545689947928,7
4085,107,35,17,18,-1.7269738989467145,17
4086,28,10,77,5,-1.7274479044716362,5
4087,68,13,32,8,-1.7311662598089228,5
4088,75,19,70,9,-1.7314858975507368,10
4089,96,38,106,21,-1.7318320126651903,17
4090,44,27,16,15,-1.7334648777380297,12
4091,106,19,48,10,-1.7335189393534853,9
4092,8,73,54,41,-1.7343257229328222,32
4093,88,37,36,21,-1.7392851936744331,16
4094,6,11,18,6,-1.7414584600944745,5
4095,36,33,60,17,-1.7416473627060742,16
4096,107,68,27,37,-1.744593702200835,31
4097,60,29,11,16,-1.7486537890116292,13
4098,43,21,104,12,-1.750605109142023,9
4099,70,26,84,14,-1.7530345342228948,12
4100,3,60,87,32,-1.7580666314066156,28
4101,57,45,78,24,-1.7583662843402394,21
4102,110,11,88,5,-1.7642228121429868,6
4103,69,21,50,10,-1.7758250016074644,11
4104,90,25,37,13,-1.7816453937181784,12
4105,8,20,29,12,-1.7818268121537415,8
4106,100,13,61,7,-1.7880372053867668,6
4107,46,27,97,14,-1.7888516310768021,13
4108,48,19,20,11,-1.7888857426975089,8
4109,16,77,54,40,-1.7894100662362953,37
4110,39,35,114,17,-1.7909993968165123,18
4111,104,55,88,30,-1.7934662263443766,25
4112,103,10,63,6,-1.799391808148131,4
4113,41,32,18,16,-1.8004819942826362,16
4114,31,34,51,20,-1.8036645224364214,14
4115,86,57,70,31,-1.8046372203949796,26
4116,25,22,36,11,-1.8071440138268584,11
4117,112,32,13,16,-1.8090394068654707,16
4118,3,34,12,19,-1.8101764659777844,15
4119,111,18,40,9,-1.8104998545748818,9
4120,99,13,102,7,-1.8212893413036864,6
4121,114,13,44,7,-1.8263733365516708,6
4122,114,15,11,7,-1.8276036019184323,8
4123,13,29,74,15,-1.8278354237299068,14
4124,96,38,84,19,-1.835648682700679,19
4125,20,30,114,16,-1.839540566254475,14
4126,76,27,30,15,-1.8425803619698329,12
4127,13,118,16,65,-1.8455058309684538,53
4128,3,24,8,11,-1.848093580149501,13
4129,97,22,53,12,-1.8492466822191078,10
4130,112,34,107,17,-1.851120124068946,17
4131,114,21,43,10,-1.8643335671695762,11
4132,5,95,37,49,-1.865428870342572,46
4133,8,41,2,21,-1.8848654476169693,20
4134,30,16,96,9,-1.8850748786904887,7
4135,49,28,17,13,-1.8850836144226466,15
4136,64,23,25,12,-1.8857238852847689,11
4137,106,35,20,19,-1.890590591428699,16
4138,99,27,55,15,-1.895072402151854,12
4139,28,67,8,36,-1.9053784571291421,31
4140,88,21,12,11,-1.9079727374799846,10
4141,96,20,13,11,-1.9091929339453748,9
4142,1,38,68,20,-1.9099752765436673,18
4143,68,67,88,36,-1.914885527852775,31
4144,17,11,110,6,-1.9155371371930654,5
4145,106,32,97,16,-1.9159665785715099,16
4146,76,11,99,5,-1.9173589523208336,6
4147,64,43,53,23,-1.9214578200473016,20
4148,100,18,98,10,-1.9217645875630167,8
4149,88,56,55,32,-1.9221308051774746,24
4150,70,32,104,17,-1.9224071285610191,15
4151,79,10,9,6,-1.9224211679655938,4
4152,50,40,63,22,-1.9230864117365445,18
4153,18,21,114,11,-1.923577249757447,10
4154,28,89,16,48,-1.9239787295163941,41
4155,54,28,17,14,-1.9259736473512514,14
4156,40,19,70,11,-1.9276789997691202,8
4157,97,14,23,7,-1.9330528734436563,7
4158,98,10,32,5,-1.9380052263831622,5
4159,7,49,71,24,-1.9387153694352766,25
4160,104,13,110,8,-1.9388474450810558,5
4161,31,14,23,8,-1.9392936999416424,6
4162,55,20,25,11,-1.9429576796619947,9
4163,94,15,33,8,-1.9451389474962029,7
4164,48,16,7,8,-1.9478692265013033,8
4165,64,34,36,17,-1.9485056781764598,17
4166,57,34,27,17,-1.953476656636175,17
4167,35,11,50,6,-1.9581460146246743,5
4168,33,14,39,7,-1.9600955952261445,7
4169,84,42,87,23,-1.9615694257244276,19
4170,112,24,41,13,-1.964220147900722,11
4171,70,49,16,27,-1.9664047334731969,22
4172,35,10,54,6,-1.9706076038783524,4
4173,78,17,28,8,-1.9711388035219528,9
4174,3,46,39,23,-1.973168826489563,23
4175,70,31,88,17,-1.9762934359596291,14
4176,53,28,95,17,-1.9769373995573178,11
4177,29,19,77,11,-1.981161054072831,8
4178,18,20,3,12,-1.9827434721081492,8
4179,25,38,28,22,-1.983389891159918,16
4180,4,15,30,8,-1.9875071363114745,7
4181,4,19,53,10,-1.987694792892672,9
4182,11,23,12,11,-1.987712815559192,12
4183,88,15,85,8,-1.9929645574579284,7
4184,112,15,104,8,-1.9939359727925703,7
4185,74,26,114,13,-1.997597253168688,13
4186,27,11,66,6,-1.9992664520674241,5
4187,11,56,87,32,-2.000245875012727,24
4188,87,32,75,17,-2.0004298974911783,15
4189,46,26,68,14,-2.0015169846627177,12
4190,100,39,8,21,-2.0058865806606954,18
4191,97,22,83,10,-2.007636873207568,12
4192,100,10,6,5,-2.007704936202784,5
4193,12,21,88,11,-2.0143660264494705,10
4194,70,29,68,15,-2.015118158104638,14
4195,37,14,69,7,-2.015512849900142,7
4196,60,11,93,7,-2.018629631632218,4
4197,90,37,8,21,-2.01946478207178,16
4198,17,27,114,16,-2.021159075364869,11
4199,60,32,18,17,-2.0244266182620265,15
4200,13,11,32,6,-2.026181507027533,5
4201,114,14,91,7,-2.031242634143396,7
4202,34,11,112,6,-2.0324399383154277,5
4203,104,41,8,22,-2.032634893277436,19
4204,17,21,104,11,-2.0345116655508884,10
4205,50,13,83,6,-2.034563553464953,7
4206,88,59,40,32,-2.0357313010299647,27
4207,100,21,37,12,-2.0359732342110695,9
4208,88,63,114,33,-2.0468316772780453,30
4209,88,21,93,12,-2.047097578055207,9
4210,104,43,39,23,-2.050102147252709,20
4211,16,71,104,38,-2.0698039945571574,33
4212,63,10,82,5,-2.0779758612966877,5
4213,65,47,74,24,-2.0847963525870905,23
4214,51,14,44,9,-2.0848742289559725,5
4215,39,49,15,28,-2.085527392017013,21
4216,68,43,64,25,-2.0864244028015873,18
4217,11,18,40,9,-2.089442100461012,9
4218,77,67,60,35,-2.0911684789459244,32
4219,91,12,17,7,-2.0932516032559643,5
4220,8,22,97,11,-2.094799206270941,11
4221,55,34,83,17,-2.0962093979720193,17
4222,79,18,84,9,-2.0988599029371886,9
4223,23,19,112,11,-2.1018527652621195,8
4224,38,33,86,18,-2.1054154187023446,15
4225,107,32,108,17,-2.10558050439271,15
4226,94,28,68,15,-2.1065110625469554,13
4227,13,38,57,19,-2.1070868819342956,19
4228,29,22,94,12,-2.1097970213045127,10
4229,25,11,69,6,-2.112059751085246,5
4230,33,12,74,6,-2.113811361821,6
4231,72,17,7,9,-2.1143024060967655,8
4232,70,11,53,6,-2.117480208536356,5
4233,63,24,49,12,-2.1212323385530327,12
4234,9,62,7,31,-2.1219031094822904,31
4235,114,32,102,18,-2.1240842876015074,14
4236,61,12,2,7,-2.133108515807601,5
4237,74,30,11,16,-2.13476100803091,14
4238,30,20,7,9,-2.135688474905444,11
4239,39,39,71,21,-2.140211900940766,18
4240,69,11,55,6,-2.141856565606558,5
4241,49,11,89,6,-2.1552213251273216,5
4242,86,14,6,8,-2.158350497876565,6
4243,98,16,55,9,-2.1617935333932956,7
4244,53,13,23,7,-2.1639220781507644,6
4245,94,32,19,17,-2.165510462778429,15
4246,18,27,77,16,-2.168427262738356,11
4247,81,30,60,16,-2.1697382345262226,14
4248,68,46,41,24,-2.171804807510052,22
4249,93,16,84,8,-2.173203038685071,8
4250,3,17,58,10,-2.1750406456469484,7
4251,74,64,8,36,-2.1866220406514896,28
4252,54,10,31,5,-2.1866689261471493,5
4253,12,33,86,18,-2.1894855932114754,15
4254,47,13,19,7,-2.1915786077930717,6
4255,43,12,72,7,-2.1927570530466096,5
4256,40,33,41,17,-2.193580777269949,16
4257,106,35,68,19,-2.1936858069827965,16
4258,11,60,8,32,-2.1947518664362273,28
4259,40,75,7,42,-2.1957521283064807,33
4260,49,10,96,5,-2.201359601705883,5
4261,27,27,75,15,-2.203651126537084,12
4262,96,50,5,28,-2.21142719225076,22
4263,51,12,93,6,-2.216632142916852,6
4264,62,11,72,6,-2.217469660829094,5
4265,69,25,11,14,-2.219760563258797,11
4266,98,14,18,6,-2.2211477971408065,8
4267,99,13,98,6,-2.22125816779338,7
4268,12,11,112,5,-2.224733688615062,6
4269,39,43,75,21,-2.225217366532354,22
4270,25,16,90,9,-2.226157693683706,7
4271,86,116,107,62,-2.2266662429866666,54
4272,13,107,68,57,-2.226955311742634,50
4273,15,21,23,11,-2.2295883568640167,10
4274,74,27,20,15,-2.230377352624161,12
4275,54,41,11,22,-2.230757582585554,19
4276,87,21,77,11,-2.2320061106464215,10
4277,65,18,46,11,-2.232998478058102,7
4278,20,14,18,8,-2.233452860395892,6
4279,114,26,4,13,-2.2345648368573685,13
4280,48,17,27,10,-2.2349641271706258,7
4281,65,102,54,54,-2.239671261645842,48
4282,55,89,8,45,-2.2400324745199134,44
4283,49,21,64,12,-2.2416010602386143,9
4284,13,65,104,35,-2.2428038741485192,30
4285,27,10,70,5,-2.243263258457554,5
4286,4,38,88,20,-2.24592170041755,18
4287,83,11,63,7,-2.251852755522098,4
4288,88,16,48,7,-2.252726579675878,9
4289,25,30,95,16,-2.25397314365567,14
4290,41,13,74,6,-2.254565024803335,7
4291,106,62,87,32,-2.262204101784014,30
4292,88,45,106,26,-2.2639858690375605,19
4293,87,14,10,8,-2.2663103024468128,6
4294,7,12,85,7,-2.267272935114745,5
4295,96,66,28,35,-2.2674069446039327,31
4296,8,84,86,42,-2.2684162276686486,42
4297,31,10,61,5,-2.2696136748473594,5
4298,68,108,7,58,-2.2702884441480373,50
4299,108,29,16,17,-2.27259194310602,12
4300,69,12,77,6,-2.2797993708458972,6
4301,40,47,9,26,-2.2806450266015688,21
4302,65,19,48,9,-2.2816603054261098,10
4303,81,10,38,5,-2.2819621266449897,5
4304,84,88,86,44,-2.284433513190378,44
4305,88,26,81,14,-2.2857834835265276,12
4306,4,13,106,6,-2.287883468044352,7
4307,112,38,86,21,-2.2924646864380605,17
4308,5,24,100,13,-2.2932427434044693,11
4309,29,28,3,15,-2.2964696243286857,13
4310,7,20,80,11,-2.2986689861273333,9
4311,32,21,86,11,-2.2989864902239,10
4312,95,26,60,14,-2.3000350580848172,12
4313,37,23,57,12,-2.3105129908375908,11
4314,63,31,71,17,-2.3112629873314643,14
4315,91,32,88,17,-2.315767764685103,15
4316,102,21,104,10,-2.320627297470276,11
4317,29,18,54,10,-2.3209749235438757,8
4318,88,21,77,11,-2.324899205812002,10
4319,42,10,72,6,-2.3285230567907305,4
4320,5,51,109,26,-2.3285813949081646,25
4321,53,28,25,14,-2.3301510854690832,14
4322,17,19,90,9,-2.330539928781356,10
4323,19,44,100,24,-2.335110699834269,20
4324,65,38,15,21,-2.339851782435442,17
4325,50,13,6,7,-2.341492332331065,6
4326,38,12,114,6,-2.3415263774379937,6
4327,19,38,49,20,-2.343768090407938,18
4328,31,36,4,21,-2.3535355966794675,15
4329,33,12,99,7,-2.354570382478156,5
4330,109,14,96,8,-2.3566759619593642,6
4331,97,14,100,8,-2.3583259709010784,6
4332,88,44,64,25,-2.359083003612554,19
4333,5,23,99,12,-2.3616219022642833,11
4334,97,13,49,8,-2.3668261814242064,5
4335,50,24,40,14,-2.3671440474550494,10
4336,63,32,25,16,-2.368826537360261,16
4337,55,31,53,17,-2.372089532662412,14
4338,12,29,49,12,-2.375753597057763,17
4339,107,40,71,23,-2.3760609676092477,17
4340,79,11,78,6,-2.376529733586171,5
4341,112,14,8,8,-2.379829723910836,6
4342,18,35,88,18,-2.3825741558006106,17
4343,56,13,75,8,-2.3840139649043506,5
4344,104,25,96,14,-2.3866419839158355,11
4345,71,21,4,13,-2.3871750117365993,8
4346,95,40,104,22,-2.389034218387607,18
4347,48,13,23,7,-2.3894452247322278,6
4348,8,12,111,6,-2.390343846489093,6
4349,86,60,114,31,-2.391660443497049,29
4350,45,22,16,13,-2.3925466679441407,9
4351,51,37,20,18,-2.3967661114188865,19
4352,109,21,97,11,-2.398141101921527,10
4353,28,38,46,22,-2.3990178798165633,16
4354,98,15,114,8,-2.3992721750256893,7
4355,80,26,20,14,-2.4033351571638573,12
4356,69,18,9,10,-2.4050002453980612,8
4357,66,13,106,8,-2.407503356329986,5
4358,16,46,78,25,-2.4095230161360495,21
4359,93,33,8,17,-2.4111455321691304,16
4360,92,11,65,6,-2.411285975254871,5
4361,28,28,60,13,-2.412225021834092,15
4362,94,19,28,11,-2.414960475317553,8
4363,86,28,108,16,-2.416374005048123,12
4364,99,11,109,6,-2.419517402501058,5
4365,4,23,55,12,-2.4222288362060125,11
4366,33,17,87,9,-2.4230636639179637,8
4367,9,56,88,30,-2.4233671798250107,26
4368,38,17,8,9,-2.4272670792995714,8
4369,75,20,91,7,-2.4323694332612673,13
4370,23,54,16,29,-2.4326142049861335,25
4371,51,19,14,12,-2.4338441230915153,7
4372,102,24,109,13,-2.4374588964673864,11
4373,47,15,64,9,-2.441201731533323,6
4374,27,30,8,16,-2.4425733286028306,14
4375,50,10,32,4,-2.4440541907162716,6
4376,61,15,63,9,-2.4454100802634517,6
4377,90,46,86,26,-2.4530971603000826,20
4378,51,53,8,28,-2.455772911290401,25
4379,86,17,110,9,-2.4597124602837575,8
4380,25,32,102,17,-2.4608896969250464,15
4381,1,17,17,9,-2.4627610735098764,8
4382,69,17,74,8,-2.466497282082454,9
4383,81,17,4,10,-2.467812477706327,7
4384,72,11,30,6,-2.4724333071348408,5
4385,20,20,17,11,-2.47595507024807,9
4386,43,32,27,17,-2.4768448216893386,15
4387,11,37,76,21,-2.481209953490073,16
4388,111,11,18,6,-2.489910872635885,5
4389,11,21,64,13,-2.490493863054093,8
4390,69,17,112,8,-2.4934455672651232,9
4391,107,44,34,25,-2.494421871197337,19
4392,111,37,65,21,-2.4964278491140752,16
4393,20,17,57,9,-2.4989361317601504,8
4394,67,13,84,6,-2.5007098745341834,7
4395,109,18,37,10,-2.5010134043415313,8
4396,107,52,50,27,-2.5022496828069007,25
4397,78,42,86,22,-2.507883302246767,20
4398,86,50,60,27,-2.514680285061447,23
4399,36,15,12,8,-2.5163199425137495,7
4400,39,35,57,18,-2.5204234652197326,17
4401,102,28,16,15,-2.521941049128146,13
4402,11,17,14,10,-2.5264878637219237,7
4403,4,18,39,10,-2.5267698999647226,8
4404,9,33,36,18,-2.527924078037467,15
4405,43,32,51,16,-2.529488938008268,16
4406,30,19,99,11,-2.5303882936847786,8
4407,107,15,44,8,-2.5305445670994087,7
4408,17,29,7,16,-2.5320894413613915,13
4409,95,20,20,11,-2.5325274069422727,9
4410,65,35,97,19,-2.5397394280205696,16
4411,20,40,88,20,-2.541950104212904,20
4412,51,22,103,12,-2.544960652871437,10
4413,38,22,60,11,-2.5449702313683376,11
4414,36,74,7,40,-2.54935875079736,34
4415,76,14,44,8,-2.550414193143335,6
4416,47,33,16,18,-2.552088838549869,15
4417,1,19,73,11,-2.5534291003907295,8
4418,107,88,65,47,-2.553865684153762,41
4419,11,21,7,12,-2.554018943860652,9
4420,38,25,88,15,-2.560016870827125,10
4421,68,71,16,41,-2.5614728211913396,30
4422,7,34,43,20,-2.5615476994306405,14
4423,65,10,21,6,-2.570147671925826,4
4424,51,29,1,15,-2.5741193049184683,14
4425,109,14,78,7,-2.574648131751719,7
4426,47,10,62,6,-2.5775304802735826,4
4427,29,20,41,11,-2.5826644120051867,9
4428,48,42,16,22,-2.5852222637676325,20
4429,41,57,51,30,-2.587038672538432,27
4430,18,33,86,19,-2.5923706641316473,14
4431,109,10,1,5,-2.592960677140225,5
4432,27,44,41,25,-2.596716183086402,19
4433,80,32,65,17,-2.5986356922004106,15
4434,91,23,36,13,-2.600483205457647,10
4435,1,29,40,16,-2.608102727316189,13
4436,64,28,75,15,-2.614396425436705,13
4437,89,10,39,6,-2.6189716831037586,4
4438,28,42,39,22,-2.623339407780362,20
4439,85,10,8,6,-2.6233679922969846,4
4440,8,33,23,18,-2.626483448480395,15
4441,86,36,91,19,-2.627461430980282,17
4442,79,15,3,9,-2.6331342611336157,6
4443,54,13,110,7,-2.6358849029934492,6
4444,11,40,13,22,-2.637307973213511,18
4445,95,14,33,8,-2.6415453896084555,6
4446,5,60,16,35,-2.643518445682432,25
4447,102,32,54,17,-2.645569582100471,15
4448,20,20,19,10,-2.646933293157401,10
4449,36,13,57,8,-2.653116090105381,5
4450,88,29,92,16,-2.65412565592523,13
4451,89,13,51,7,-2.656220632059645,6
4452,20,33,11,19,-2.658025854837769,14
4453,91,13,74,7,-2.658254293210725,6
4454,1,29,41,17,-2.6671220598664935,12
4455,7,118,13,63,-2.6708973171944717,55
4456,44,17,25,9,-2.673535476281759,8
4457,12,10,48,6,-2.675775448389388,4
4458,94,18,78,10,-2.675832304313798,8
4459,88,66,60,37,-2.676500890728167,29
4460,5,25,39,13,-2.6791322172692884,12
4461,58,14,43,8,-2.6806335210316137,6
4462,107,21,93,12,-2.6848247910711387,9
4463,30,26,28,13,-2.6864332481864484,13
4464,71,40,65,23,-2.6867803351656674,17
4465,102,20,13,12,-2.6891186576501758,8
4466,31,22,87,11,-2.6915087275033085,11
4467,11,26,48,14,-2.6929391751506655,12
4468,30,17,9,10,-2.6960180413408095,7
4469,68,27,47,15,-2.700809442975109,12
4470,76,30,70,15,-2.70093044855826,15
4471,79,11,39,7,-2.7039365709334438,4
4472,54,62,87,35,-2.7078927354800775,27
4473,60,39,43,21,-2.71188258861537,18
4474,70,16,49,8,-2.7131214221068403,8
4475,4,20,63,11,-2.7170319642618344,9
4476,80,11,95,6,-2.7197438471090796,5
4477,54,19,41,10,-2.720244948724289,9
4478,51,17,58,9,-2.7220403540386453,8
4479,88,16,44,8,-2.7255415222047015,8
4480,98,22,51,12,-2.729369792679445,10
4481,54,25,15,12,-2.7351472639255974,13
4482,106,50,65,27,-2.735321183024918,23
4483,63,21,47,10,-2.7370968886641953,11
4484,63,12,99,6,-2.7377253409939377,6
4485,104,22,97,11,-2.7396377781056187,11
4486,68,31,69,17,-2.743936079051887,14
4487,62,45,16,27,-2.7487915093897546,18
4488,65,36,43,18,-2.7525986025329345,18
4489,43,14,70,8,-2.753352748891417,6
4490,96,34,97,17,-2.7556888339056815,17
4491,94,17,1,8,-2.7623810098011994,9
4492,77,17,5,9,-2.7658375671945885,8
4493,10,11,5,5,-2.7716738654503192,6
4494,85,17,28,9,-2.7808523631648976,8
4495,103,11,77,6,-2.7849069943634928,5
4496,91,31,28,17,-2.78581966806185,14
4497,102,12,70,5,-2.7906887378625402,7
4498,36,13,100,7,-2.7923934619121096,6
4499,1,26,7,14,-2.793205495238504,12
4500,44,14,68,7,-2.795327721392829,7
4501,8,32,83,16,-2.795775595052066,16
4502,112,14,106,7,-2.805082024542768,7
4503,72,11,20,6,-2.8074079366688274,5
4504,41,15,99,8,-2.808167291861728,7
4505,36,32,1,16,-2.8095303452930684,16
4506,65,85,87,46,-2.811783393197125,39
4507,107,30,98,16,-2.813395324711819,14
4508,39,18,34,9,-2.816812397698095,9
4509,48,14,68,7,-2.820644331468806,7
4510,71,13,18,7,-2.821320109059578,6
4511,62,18,54,10,-2.824080555827827,8
4512,112,21,75,12,-2.824219405034075,9
4513,50,44,2,24,-2.824465738990298,20
4514,81,23,53,13,-2.832269045840244,10
4515,35,11,39,6,-2.8361547619317586,5
4516,17,28,28,15,-2.8369834071231876,13
4517,16,25,4,12,-2.841104684052144,13
4518,39,33,95,18,-2.8414955259540986,15
4519,88,54,27,28,-2.8444665864539522,26
4520,102,25,8,13,-2.845551076408804,12
4521,44,13,28,6,-2.846139863099275,7
4522,33,13,97,7,-2.8486496222061595,6
4523,61,21,3,14,-2.8504924308729245,7
4524,96,16,73,9,-2.853430398009382,7
4525,49,10,79,6,-2.8563921563379915,4
4526,28,25,69,13,-2.86191295640514,12
4527,88,14,72,8,-2.866088260356642,6
4528,63,23,46,11,-2.867241869896345,12
4529,17,10,88,4,-2.869337502995377,6
4530,1,14,112,9,-2.8723250567679255,5
4531,19,38,54,22,-2.872431928007974,16
4532,53,12,57,6,-2.8739584447786406,6
4533,30,21,75,11,-2.874328227945735,10
4534,77,14,106,7,-2.8755893681261506,7
4535,27,32,29,19,-2.8799159327708006,13
4536,87,23,83,12,-2.880053494146307,11
4537,88,69,87,35,-2.889262156899855,34
4538,89,17,50,10,-2.89533112730357,7
4539,70,10,44,5,-2.8975248911261424,5
4540,9,27,50,15,-2.8991061521351393,12
4541,51,31,70,16,-2.904546585958991,15
4542,37,19,91,10,-2.9050960547005253,9
4543,54,36,80,18,-2.9116630961094714,18
4544,28,100,86,56,-2.9116733038896894,44
4545,108,12,25,7,-2.9132670669268257,5
4546,68,40,30,21,-2.914177291592292,19
4547,33,10,37,6,-2.9157377490462184,4
4548,106,19,102,9,-2.9207255392565092,10
4549,86,82,74,43,-2.9212877807151494,39
4550,109,32,104,17,-2.921401798219769,15
4551,62,14,1,7,-2.9215215839903856,7
4552,66,12,9,6,-2.9315079085260156,6
4553,28,21,33,10,-2.934003356051787,11
4554,87,20,36,12,-2.9355732508976633,8
4555,49,27,68,15,-2.9363199373932996,12
4556,65,27,83,14,-2.938404758323201,13
4557,9,10,72,5,-2.9405168738711245,5
4558,46,18,71,9,-2.9448527741935417,9
4559,87,37,18,21,-2.947620136311878,16
4560,43,15,29,8,-2.953551510168091,7
4561,46,23,114,13,-2.9631435316072414,10
4562,57,18,25,10,-2.964934950553877,8
4563,37,21,2,11,-2.96975801126945,10
4564,4,32,36,19,-2.9739066740354194,13
4565,106,36,84,18,-2.9754739608250116,18
4566,30,14,103,7,-2.976866318655369,7
4567,1,13,46,6,-2.9771068452784495,7
4568,48,15,80,9,-2.9854010336942434,6
4569,3,31,88,17,-2.98629427981839,14
4570,34,11,114,5,-2.988482941118179,6
4571,109,40,87,23,-2.99176490578617,17
4572,65,27,62,14,-2.999159330673646,13
4573,69,11,4,6,-2.9994841766617175,5
4574,34,14,96,8,-3.001763014782562,6
4575,37,47,20,25,-3.0049852144749636,22
4576,39,43,9,22,-3.012148514540606,21
4577,48,20,30,12,-3.014647330297821,8
4578,88,29,47,15,-3.0208806441241425,14
4579,60,44,30,27,-3.022281848280242,17
4580,98,13,39,8,-3.033232316977352,5
4581,65,39,25,23,-3.0368934823131157,16
4582,12,30,68,16,-3.041358769608484,14
4583,96,13,38,7,-3.0422152322461713,6
4584,107,37,15,23,-3.0494114346230554,14
4585,51,84,88,42,-3.0500083696508544,42
4586,41,16,103,8,-3.051077769785081,8
4587,19,37,78,21,-3.0511264570922707,16
4588,60,32,78,17,-3.052731445661802,15
4589,8,17,10,10,-3.0558998323304016,7
4590,57,11,6,6,-3.056750466696465,5
4591,86,42,71,22,-3.0606693617391714,20
4592,41,34,60,17,-3.06259969646343,17
4593,25,18,71,10,-3.0644100067848146,8
4594,25,30,75,17,-3.069551733540898,13
4595,60,29,19,15,-3.0741844930514612,14
4596,87,14,45,8,-3.086220297325659,6
4597,33,11,77,6,-3.0866280393594177,5
4598,37,59,107,32,-3.087858660035624,27
4599,96,22,51,12,-3.0911457625040346,10
4600,27,17,6,9,-3.0947871865212924,8
4601,91,10,64,6,-3.0993479020870796,4
4602,74,16,88,10,-3.1000151762465555,6
4603,68,14,99,8,-3.100103615084465,6
4604,27,13,74,6,-3.1002755903304386,7
4605,60,15,92,9,-3.101629065738581,6
4606,87,38,29,22,-3.101661587985348,16
4607,34,31,17,16,-3.1027643782130485,15
4608,86,21,111,12,-3.1037611827633413,9
4609,30,23,20,12,-3.104651925893034,11
4610,9,48,107,25,-3.1085442155518606,23
4611,4,24,50,12,-3.1105592371369597,12
4612,17,25,25,14,-3.1106502600539105,11
4613,80,11,36,6,-3.1158574211756616,5
4614,94,42,43,23,-3.121120942526353,19
4615,51,138,16,74,-3.122309264263026,64
4616,11,26,34,15,-3.1224893996672782,11
4617,61,15,51,10,-3.123205657151169,5
4618,58,12,19,7,-3.124268878014424,5
4619,13,24,33,13,-3.1263344590054882,11
4620,2,15,76,9,-3.135016863493125,6
4621,45,12,112,6,-3.1460936650177533,6
4622,23,23,75,11,-3.148733601092015,12
4623,65,28,19,15,-3.1512195160354017,13
4624,7,51,104,28,-3.158219418007504,23
4625,82,21,86,12,-3.1586560919846263,9
4626,74,14,90,9,-3.168061351028922,5
4627,60,25,106,15,-3.171261503808182,10
4628,30,12,74,6,-3.175828716417198,6
4629,69,16,103,8,-3.1785957104061207,8
4630,11,29,30,16,-3.1818482711889744,13
4631,114,31,54,16,-3.1847921316014234,15
4632,50,54,37,28,-3.1883352760136074,26
4633,108,16,30,9,-3.189212250817133,7
4634,109,17,49,9,-3.1895102698313593,8
4635,5,61,88,32,-3.1946532218196624,29
4636,39,41,36,23,-3.1998605067578225,18
4637,29,25,51,13,-3.20147334056082,12
4638,86,93,7,53,-3.2025353891099275,40
4639,17,28,106,17,-3.2039846830051117,11
4640,20,18,15,10,-3.2047440335755613,8
4641,43,49,16,28,-3.2053630845690404,21
4642,51,51,106,28,-3.2074755817578335,23
4643,97,12,56,6,-3.2085312435870676,6
4644,31,47,60,23,-3.2094707274879264,24
4645,104,64,37,36,-3.2105942477112235,28
4646,97,19,50,11,-3.210625734622642,8
4647,74,16,17,9,-3.21177055102783,7
4648,28,39,55,23,-3.2184704312839756,16
4649,87,122,86,63,-3.2205248546398186,59
4650,7,55,23,30,-3.222928305376168,25
4651,36,49,107,26,-3.234838704648262,23
4652,86,93,63,54,-3.236835270517722,39
4653,34,18,9,10,-3.2368917561941424,8
4654,60,25,99,14,-3.238194459102709,11
4655,81,12,23,7,-3.2407035870770007,5
4656,96,10,64,6,-3.247034103841878,4
4657,25,47,114,27,-3.2540864225169766,20
4658,86,141,16,80,-3.255386909320064,61
4659,74,24,7,15,-3.257493143792889,9
4660,77,34,86,19,-3.259763892176762,15
4661,53,56,18,30,-3.2615252410170648,26
4662,54,56,28,31,-3.262278028179984,25
4663,16,36,97,19,-3.2658181366665215,17
4664,65,57,8,31,-3.2717260560147303,26
4665,13,20,85,12,-3.272077258935019,8
4666,67,13,114,7,-3.274670651234843,6
4667,53,50,39,28,-3.277161726088196,22
4668,68,31,19,18,-3.2786498819088243,13
4669,78,31,68,17,-3.2853723279616904,14
4670,60,25,90,15,-3.2889183131065622,10
4671,35,15,55,8,-3.2899027901624813,7
4672,5,60,104,32,-3.3007473735225057,28
4673,61,13,47,7,-3.3043540506366424,6
4674,64,21,114,12,-3.304666725448282,9
4675,66,12,88,7,-3.305300021832229,5
4676,85,12,19,7,-3.3060773006740143,5
4677,96,14,41,9,-3.308894289236027,5
4678,79,19,63,11,-3.3134147957453677,8
4679,75,31,60,17,-3.313915862803686,14
4680,84,16,97,10,-3.316428205809935,6
4681,97,14,98,7,-3.3185319117606182,7
4682,51,46,28,24,-3.330644392104213,22
4683,3,44,68,23,-3.331199454130328,21
4684,50,19,41,11,-3.331657114556132,8
4685,5,13,68,7,-3.3380294056441127,6
4686,98,20,54,11,-3.3414082574983,9
4687,87,22,58,12,-3.3430688761521696,10
4688,91,15,40,8,-3.345577169162442,7
4689,60,61,51,37,-3.3463130273558974,24
4690,65,20,94,10,-3.3472699488499087,10
4691,20,10,83,5,-3.347889825164404,5
4692,107,15,14,9,-3.3479962116917545,6
4693,106,17,14,10,-3.3600594128266095,7
4694,60,11,33,5,-3.3611775749026793,6
4695,109,26,41,16,-3.362021638820747,10
4696,8,23,14,13,-3.3634201583462153,10
4697,97,25,54,13,-3.364815342765676,12
4698,20,17,40,10,-3.3649339637959637,7
4699,57,27,69,16,-3.367166221655228,11
4700,87,32,15,17,-3.370814069097881,15
4701,39,40,64,22,-3.3772164918090795,18
4702,98,15,73,8,-3.3800553651819163,7
4703,55,28,36,15,-3.383336577257353,13
4704,9,31,60,18,-3.3853349951371756,13
4705,51,102,13,54,-3.389267499278646,48
4706,77,26,39,14,-3.391028905031478,12
4707,104,10,73,6,-3.391491099464731,4
4708,5,50,55,28,-3.393419962444799,22
4709,28,13,4,7,-3.3940824912486858,6
4710,84,29,55,16,-3.4012305577969593,13
4711,79,20,34,12,-3.408526065897862,8
4712,36,11,17,5,-3.417273645156755,6
4713,112,17,54,10,-3.4203709759608767,7
4714,37,12,4,7,-3.4218717037755084,5
4715,69,10,108,4,-3.4269138907252144,6
4716,11,49,55,29,-3.4281320850013386,20
4717,27,35,34,19,-3.429203163509601,16
4718,81,11,78,5,-3.4320246992935264,6
4719,90,38,107,20,-3.442650987354403,18
4720,55,28,76,17,-3.4438952481653042,11
4721,49,17,50,9,-3.4453653867888487,8
4722,87,37,95,20,-3.4486313771107993,17
4723,114,14,112,7,-3.4529529803290626,7
4724,23,21,37,11,-3.4530437057487418,10
4725,5,23,33,12,-3.454327509177194,11
4726,54,53,46,29,-3.462224315333584,24
4727,107,76,88,43,-3.4647697731145515,33
4728,48,12,69,6,-3.4680662481377893,6
4729,5,60,74,32,-3.4699961467083447,28
4730,30,22,15,12,-3.472555589829476,10
4731,11,44,51,25,-3.472776128070486,19
4732,98,10,112,6,-3.474493961605603,4
4733,54,57,96,29,-3.47661338595835,28
4734,18,16,55,8,-3.481046717374471,8
4735,114,41,60,19,-3.4828028477548303,22
4736,78,42,13,23,-3.4834703080770653,19
4737,70,20,25,11,-3.484518115943737,9
4738,45,16,41,10,-3.4850666688674528,6
4739,51,30,36,16,-3.4874600225025065,14
4740,36,13,62,7,-3.489528327052378,6
4741,109,26,20,16,-3.492917739743867,10
4742,55,19,48,11,-3.494162257250903,8
4743,114,36,97,20,-3.494809729950691,16
4744,51,39,114,20,-3.4973322349486486,19
4745,47,12,58,7,-3.4979705643460655,5
4746,108,13,37,7,-3.5019197237718496,6
4747,109,27,25,15,-3.504136926234725,12
4748,107,90,13,49,-3.504344737880479,41
4749,23,16,74,9,-3.5053157619270587,7
4750,3,21,23,12,-3.5128096943873843,9
4751,50,19,100,11,-3.517483022969968,8
4752,100,14,53,8,-3.519519789056673,6
4753,103,13,76,8,-3.521454752878398,5
4754,25,17,93,9,-3.530039788975629,8
4755,62,10,6,6,-3.534555615892033,4
4756,7,15,44,8,-3.535266020755452,7
4757,36,65,40,37,-3.5400829247343655,28
4758,27,29,47,16,-3.5439664319349258,13
4759,19,31,13,18,-3.544087166327379,13
4760,70,11,33,6,-3.5452850377562317,5
4761,49,17,114,8,-3.5487282111911385,9
4762,74,25,75,15,-3.5502981320595746,10
4763,65,49,53,26,-3.552341058928982,23
4764,30,15,114,8,-3.554559185886989,7
4765,36,19,28,10,-3.554999615354126,9
4766,79,12,60,7,-3.5553709332305647,5
4767,16,35,34,20,-3.556384138241578,15
4768,64,41,107,22,-3.561300386963444,19
4769,108,13,79,8,-3.562523700236057,5
4770,7,28,6,13,-3.5631855242339143,15
4771,43,19,25,12,-3.5730773529480744,7
4772,87,22,14,13,-3.5746572289058,9
4773,29,34,16,18,-3.5851989262305364,16
4774,95,10,97,6,-3.58943247133478,4
4775,30,12,17,6,-3.5949084621895326,6
4776,16,57,75,31,-3.5952902080350193,26
4777,18,19,91,11,-3.6010074197876603,8
4778,39,17,69,9,-3.6024816939136084,8
4779,51,38,57,21,-3.6113741694576027,17
4780,88,36,1,19,-3.612486249864136,17
4781,28,26,80,14,-3.6230809501897747,12
4782,18,19,43,9,-3.6267699505365183,10
4783,11,15,33,7,-3.6324699886469727,8
4784,28,52,20,29,-3.638022846799735,23
4785,68,36,54,21,-3.638947721326895,15
4786,107,57,41,34,-3.639009088239298,23
4787,70,10,14,5,-3.6470421341148493,5
4788,48,18,60,10,-3.6489663445365874,8
4789,66,16,63,9,-3.650382654951078,7
4790,80,34,16,20,-3.650847383014163,14
4791,18,11,17,5,-3.6519056838531805,6
4792,20,11,62,6,-3.653244367006128,5
4793,58,11,77,6,-3.653719631575704,5
4794,9,15,109,7,-3.6538651478462696,8
4795,77,20,55,11,-3.6546881978963213,9
4796,32,21,107,11,-3.6546977761524695,10
4797,71,10,90,5,-3.656103603020123,5
4798,15,27,49,14,-3.659149591383062,13
4799,31,24,39,14,-3.6610558433956144,10
4800,65,80,51,45,-3.664771412812795,35
4801,38,38,107,22,-3.669594298718899,16
4802,84,21,38,11,-3.6699802067032485,10
4803,69,35,87,21,-3.6755337261952814,14
4804,61,14,86,8,-3.691831205405496,6
4805,28,19,23,10,-3.6970356039584393,9
4806,35,10,112,5,-3.704644012481237,5
4807,14,16,65,8,-3.707339765184437,8
4808,16,79,60,43,-3.7079525590780498,36
4809,64,21,1,11,-3.714096825641642,10
4810,5,21,15,13,-3.7147342263498238,8
4811,11,14,85,8,-3.719074703847315,6
4812,77,19,12,10,-3.719515550896186,9
4813,104,15,89,8,-3.71970917274833,7
4814,54,64,20,33,-3.7237387131550492,31
4815,60,14,89,7,-3.723763452657912,7
4816,20,47,87,25,-3.724230400091726,22
4817,12,14,54,7,-3.727845074231436,7
4818,107,34,29,22,-3.7321236169755405,12
4819,40,59,60,33,-3.735016412978278,26
4820,25,65,86,35,-3.735239092039536,30
4821,4,13,1,8,-3.7360390878519714,5
4822,7,31,15,15,-3.741081293807926,16
4823,40,42,53,23,-3.7429391558119995,19
4824,109,28,76,17,-3.743667571855247,11
4825,76,21,41,10,-3.750106309053706,11
4826,48,17,50,10,-3.7531631449398377,7
4827,17,14,102,8,-3.765627490194503,6
4828,49,32,76,18,-3.771534220140117,14
4829,19,39,39,24,-3.7723271053894094,15
4830,92,13,104,6,-3.7768187223532292,7
4831,93,10,7,5,-3.7802315490169662,5
4832,103,15,65,9,-3.7910147297492114,6
4833,3,27,11,16,-3.7934397307353986,11
4834,39,11,6,6,-3.7966207547038056,5
4835,30,11,47,5,-3.805010691364058,6
4836,102,16,62,9,-3.80648773210449,7
4837,78,22,72,11,-3.8085176531004055,11
4838,5,16,110,9,-3.8138584796050923,7
4839,91,28,5,17,-3.814625093066516,11
4840,79,31,16,18,-3.819316250104339,13
4841,60,19,62,10,-3.822113325977996,9
4842,3,11,4,6,-3.825046392091852,5
4843,39,31,17,18,-3.8276026993227674,13
4844,13,26,91,14,-3.8317482607331113,12
4845,60,77,13,45,-3.8326689716078373,32
4846,55,44,7,26,-3.8332053851439998,18
4847,46,13,38,8,-3.8338597693432233,5
4848,7,26,20,14,-3.839940256500115,12
4849,31,23,18,12,-3.8430258307678655,11
4850,38,21,30,13,-3.8447589179027672,8
4851,47,12,109,7,-3.8566604611588287,5
4852,62,33,86,18,-3.857981546675883,15
4853,77,12,112,8,-3.8608875347629006,4
4854,104,29,30,15,-3.861841224882902,14
4855,63,41,74,22,-3.8635092916190312,19
4856,27,52,39,31,-3.8705079550154746,21
4857,41,86,65,51,-3.8730812369047194,35
4858,78,18,15,9,-3.8743903606720744,9
4859,104,33,41,17,-3.881745214521683,16
4860,38,16,12,9,-3.8866326449918507,7
4861,29,19,76,9,-3.891834089248112,10
4862,54,25,1,14,-3.8929886538978167,11
4863,57,23,28,13,-3.8971175709019774,10
4864,84,51,51,29,-3.8997018485628714,22
4865,63,30,55,16,-3.900377194965694,14
4866,91,15,102,8,-3.901213400624812,7
4867,37,26,102,15,-3.901578428361024,11
4868,90,11,64,6,-3.902108781861291,5
4869,52,14,30,8,-3.910728614777823,6
4870,3,32,15,18,-3.92106671332567,14
4871,70,38,37,22,-3.9227382855891673,16
4872,2,28,5,16,-3.923277825320168,12
4873,15,10,34,6,-3.9244224533982246,4
4874,20,15,85,8,-3.925425491644285,7
4875,15,30,60,16,-3.934539265699295,14
4876,97,10,80,6,-3.9365866928471034,4
4877,98,15,102,8,-3.939114797619031,7
4878,40,11,6,6,-3.9442678680230827,5
4879,43,19,35,10,-3.946831407739413,9
4880,65,61,28,35,-3.946950789839021,26
4881,104,11,67,6,-3.95056976239549,5
4882,49,26,78,14,-3.9527522510286137,12
4883,93,24,74,13,-3.960101768879081,11
4884,96,15,78,9,-3.9616133541960434,6
4885,112,23,87,12,-3.964071093642113,11
4886,15,37,100,21,-3.968832459588713,16
4887,14,12,96,7,-3.975747798085754,5
4888,97,18,60,9,-3.9792005525226375,9
4889,69,29,41,18,-3.9797729258891983,11
4890,6,18,88,10,-3.9856102257236907,8
4891,3,12,106,7,-3.9869286680549827,5
4892,68,13,89,7,-3.9920034832972595,6
4893,100,18,9,11,-3.995326860016922,7
4894,15,44,57,24,-3.996262793551712,20
4895,112,16,31,10,-4.001730552260451,6
4896,54,40,13,23,-4.002518666516474,17
4897,71,33,30,18,-4.006253796204616,15
4898,31,12,66,7,-4.0087548725586535,5
4899,110,20,8,12,-4.013172679497405,8
4900,35,21,16,13,-4.016361918873652,8
4901,96,21,39,13,-4.016816457185763,8
4902,47,31,7,18,-4.025431088719288,13
4903,47,13,71,7,-4.030916530509354,6
4904,10,10,104,5,-4.031221485043642,5
4905,114,41,63,26,-4.037972989054352,15
4906,43,10,1,5,-4.03897671575872,5
4907,51,25,71,14,-4.0432752193478,11
4908,69,12,84,7,-4.046782427990888,5
4909,40,10,32,5,-4.050021677419869,5
4910,50,11,94,7,-4.051144013437595,4
4911,20,10,14,6,-4.051966837258037,4
4912,11,20,79,12,-4.052675901080834,8
4913,39,11,56,5,-4.06142915092174,6
4914,95,10,43,6,-4.0633983206079485,4
4915,38,12,20,8,-4.067291998076463,4
4916,18,38,28,20,-4.067881996028204,18
4917,31,68,7,38,-4.069172309295859,30
4918,8,38,60,20,-4.0695105804007685,18
4919,5,117,86,66,-4.074944655375777,51
4920,3,15,103,7,-4.076211562122219,8
4921,43,10,48,6,-4.078805310749649,4
4922,77,22,19,12,-4.083441350216121,10
4923,98,17,78,9,-4.084899624702041,8
4924,19,11,36,6,-4.0885902184216905,5
4925,51,51,17,27,-4.088673144397257,24
4926,46,67,13,39,-4.091227749409544,28
4927,39,17,80,9,-4.091599339844536,8
4928,43,25,69,14,-4.093607533799894,11
4929,54,33,104,18,-4.094488077381487,15
4930,35,24,20,14,-4.098728722002913,10
4931,62,15,30,8,-4.099340749559773,7
4932,93,20,83,11,-4.100880722204593,9
4933,74,35,104,21,-4.104594141618062,14
4934,63,30,97,17,-4.107378727934806,13
4935,3,41,107,21,-4.112474461307598,20
4936,2,12,7,7,-4.115660194227726,5
4937,54,38,55,20,-4.117783078696892,18
4938,65,22,45,11,-4.125923170388699,11
4939,106,51,107,28,-4.131711792879518,23
4940,27,51,7,28,-4.136091254496651,23
4941,20,11,71,7,-4.136430557393971,4
4942,71,47,53,27,-4.141303557057988,20
4943,65,49,23,26,-4.142109485382541,23
4944,95,12,100,6,-4.142851413596655,6
4945,43,17,68,9,-4.143806778934838,8
4946,73,13,20,8,-4.146065391689571,5
4947,76,18,84,10,-4.146116027740745,8
4948,17,12,99,7,-4.14837583337694,5
4949,84,60,28,34,-4.150279635735799,26
4950,3,55,27,30,-4.15267067840578,25
4951,84,24,27,13,-4.1560592219163555,11
4952,5,40,83,21,-4.1637099044245005,19
4953,96,24,60,16,-4.164982345638211,8
4954,23,53,107,29,-4.172486813229873,24
4955,16,15,89,8,-4.180346950354626,7
4956,25,27,23,15,-4.182190113226027,12
4957,107,32,94,20,-4.187445885164777,12
4958,1,36,13,22,-4.187998461115464,14
4959,49,34,87,18,-4.192296058776266,16
4960,103,12,112,7,-4.192929666832579,5
4961,19,48,30,27,-4.195624778093546,21
4962,74,18,108,11,-4.201041319943182,7
4963,36,56,65,32,-4.205692860728475,24
4964,87,28,90,16,-4.209781806456323,12
4965,63,20,17,11,-4.21709530073227,9
4966,18,19,4,11,-4.220670692754493,8
4967,100,29,28,17,-4.221129674472951,12
4968,44,11,71,6,-4.223524348839462,5
4969,38,21,9,12,-4.224156596688182,9
4970,104,11,29,6,-4.232469176091455,5
4971,109,12,71,7,-4.235965151087514,5
4972,71,44,16,26,-4.241804878716307,18
4973,34,14,106,7,-4.243674039664674,7
4974,19,22,62,14,-4.244721565594646,8
4975,72,10,6,5,-4.248570153213719,5
4976,18,11,94,6,-4.250781715158487,5
4977,107,30,91,18,-4.264126621091654,12
4978,7,13,12,7,-4.26484586719297,6
4979,55,15,29,9,-4.266015075713762,6
4980,46,61,86,37,-4.2759623608500394,24
4981,15,20,114,11,-4.2831762689104504,9
4982,46,49,51,28,-4.286234042072618,21
4983,9,21,49,11,-4.291857810778219,10
4984,98,11,85,7,-4.293458254788543,4
4985,35,12,13,7,-4.295164540193832,5
4986,54,28,25,16,-4.300413553073274,12
4987,84,18,75,10,-4.30081159040195,8
4988,55,45,37,24,-4.301001080588835,21
4989,53,27,106,14,-4.302319600135899,13
4990,78,29,100,17,-4.3065041234398125,12
4991,52,10,50,5,-4.308197298973348,5
4992,8,10,31,6,-4.309099443279481,4
4993,90,13,76,8,-4.309550016746243,5
4994,66,11,51,6,-4.311917297275017,5
4995,72,24,86,14,-4.313346082418059,10
4996,17,23,97,13,-4.313428551304956,10
4997,98,27,104,13,-4.313899934387767,14
4998,71,14,70,7,-4.315612188206777,7
4999,40,22,4,12,-4.316643149060896,10
5000,41,21,47,11,-4.32003722756243,10
5001,41,19,95,11,-4.332143979792176,8
5002,22,12,60,7,-4.334241842742782,5
5003,3,24,78,13,-4.334264436116631,11
5004,13,62,100,34,-4.340799598798272,28
5005,48,20,34,11,-4.343261719849951,9
5006,65,29,70,18,-4.3439841796636145,11
5007,6,16,65,9,-4.346168811124812,7
5008,48,30,28,17,-4.353346769104993,13
5009,39,24,76,15,-4.35477451293687,9
5010,83,11,19,6,-4.359398192701051,5
5011,71,31,64,19,-4.35947313780117,12
5012,23,20,95,11,-4.361896262769259,9
5013,9,15,74,9,-4.36741522698094,6
5014,23,23,40,13,-4.36842332680331,10
5015,58,13,55,7,-4.369004483506263,6
5016,9,24,55,14,-4.371040618945101,10
5017,51,63,54,35,-4.373143801169512,28
5018,8,24,49,14,-4.374514809997582,10
5019,25,33,87,18,-4.379098196808543,15
5020,54,10,99,6,-4.3797228746123675,4
5021,64,12,12,7,-4.3938981464127,5
5022,2,22,16,13,-4.395353237879596,9
5023,11,18,62,10,-4.400361109158304,8
5024,108,14,71,8,-4.402422140240547,6
5025,13,38,12,25,-4.404764592205936,13
5026,76,16,34,8,-4.406030161353481,8
5027,13,46,114,23,-4.412752578147675,23
5028,64,24,50,13,-4.415510499418938,11
5029,53,64,7,36,-4.416213736910661,28
5030,87,29,71,16,-4.418670539958073,13
5031,13,30,99,17,-4.420966828834257,13
5032,98,11,57,6,-4.422154501358107,5
5033,20,14,23,8,-4.42777867543601,6
5034,27,17,108,10,-4.43028987016657,7
5035,109,15,95,9,-4.444131433700797,6
5036,16,44,95,24,-4.453378575583385,20
5037,73,12,50,8,-4.454782630059153,4
5038,97,11,77,7,-4.454901155383999,4
5039,102,14,3,8,-4.459245823871048,6
5040,32,18,37,10,-4.466542082918519,8
5041,57,10,91,5,-4.468260927215542,5
5042,25,31,96,17,-4.472832877552798,14
5043,109,15,40,9,-4.473863564525377,6
5044,107,33,95,18,-4.475609109265347,15
5045,8,12,56,7,-4.475636615156397,5
5046,7,30,100,17,-4.479542671667202,13
5047,64,46,7,25,-4.4812400569888355,21
5048,40,50,65,28,-4.488092661947341,22
5049,37,15,93,9,-4.4934456656390305,6
5050,39,21,58,12,-4.494576390875354,9
5051,79,16,8,8,-4.494949825171059,8
5052,60,47,55,26,-4.496007919155315,21
5053,69,12,76,8,-4.499300236532236,4
5054,43,23,41,13,-4.501627913311958,10
5055,51,30,49,17,-4.504127532693048,13
5056,87,41,23,24,-4.512300706037801,17
5057,93,16,20,8,-4.515352163146577,8
5058,50,23,74,13,-4.520207268757788,10
5059,60,17,61,9,-4.5273940858246595,8
5060,48,19,13,11,-4.529838045170984,8
5061,28,71,50,41,-4.530365152854882,30
5062,75,23,106,12,-4.532198108241345,11
5063,29,14,9,8,-4.534452930887615,6
5064,15,18,99,11,-4.551461310618722,7
5065,46,15,83,8,-4.551826612706302,7
5066,19,13,40,8,-4.553733685230351,5
5067,23,15,70,8,-4.554568026577778,7
5068,5,18,43,10,-4.5592775438308895,8
5069,104,16,99,8,-4.562749239239297,8
5070,19,12,50,7,-4.570143678172118,5
5071,95,14,99,8,-4.572737764013027,6
5072,60,56,39,31,-4.573736342935888,25
5073,58,23,7,12,-4.575034525669345,11
5074,65,16,99,9,-4.579704538683142,7
5075,71,25,28,15,-4.584215619303487,10
5076,54,26,78,15,-4.592600537057518,11
5077,96,32,50,18,-4.592653394244437,14
5078,102,14,19,9,-4.600303598104888,5
5079,95,13,77,7,-4.601493224452909,6
5080,74,21,100,12,-4.60203124381021,9
5081,18,15,38,8,-4.607415756411176,7
5082,86,72,37,40,-4.607837359690986,32
5083,68,20,85,13,-4.615895850726343,7
5084,40,10,72,6,-4.6161082317709115,4
5085,55,80,13,46,-4.619815115515482,34
5086,58,20,60,11,-4.62148171402165,9
5087,94,16,3,9,-4.629270425756286,7
5088,92,15,51,8,-4.63031933752528,7
5089,89,13,65,7,-4.632113459581728,6
5090,110,15,106,8,-4.633960085739299,7
5091,25,22,60,12,-4.636282806493915,10
5092,109,19,73,11,-4.637139105733963,8
5093,69,11,80,6,-4.638884395252677,5
5094,25,13,48,7,-4.641698897655362,6
5095,13,14,73,8,-4.6427133386229835,6
5096,50,53,87,29,-4.6442046515061275,24
5097,96,39,63,24,-4.649023449526139,15
5098,1,16,15,10,-4.6493508409190305,6
5099,109,44,16,26,-4.650684464951717,18
5100,79,13,27,7,-4.65158326253367,6
5101,54,62,63,36,-4.6520172622159,26
5102,47,15,25,8,-4.655390231832644,7
5103,86,54,27,31,-4.667388883389138,23
5104,38,19,109,12,-4.668016203688245,7
5105,5,16,71,9,-4.686451238703376,7
5106,84,36,16,21,-4.697024903080797,15
5107,84,12,62,7,-4.699556310812963,5
5108,46,23,20,15,-4.708713070266484,8
5109,12,14,74,8,-4.7158981291394015,6
5110,61,15,107,8,-4.722903053660275,7
5111,8,13,19,8,-4.728766252515099,5
5112,75,14,15,9,-4.7291616067808215,5
5113,46,11,6,6,-4.730994669309113,5
5114,77,16,25,9,-4.745845616411638,7
5115,49,59,16,35,-4.751408831883824,24
5116,5,30,90,18,-4.752640516818982,12
5117,50,23,7,13,-4.754905099968965,10
5118,50,16,93,10,-4.755526241513055,6
5119,79,12,55,7,-4.763372141256467,5
5120,60,23,76,15,-4.763967746356448,8
5121,94,16,55,9,-4.767452995148862,7
5122,31,15,12,8,-4.770632464521183,7
5123,70,13,90,7,-4.771084444295363,6
5124,37,10,9,6,-4.7723167368365935,4
5125,23,14,33,8,-4.772846471482118,6
5126,5,12,9,7,-4.777710715122403,5
5127,104,57,86,32,-4.778923035703436,25
5128,81,25,15,14,-4.783657780343267,11
5129,5,33,76,19,-4.788314400539968,14
5130,76,24,97,13,-4.7891970450006545,11
5131,17,44,16,28,-4.792262993794134,16
5132,1,17,9,8,-4.79405950293998,9
5133,20,13,52,8,-4.795236183864801,5
5134,25,11,111,6,-4.797175922879397,5
5135,46,23,7,15,-4.797661017581172,8
5136,96,22,75,15,-4.80138149231193,7
5137,56,11,16,7,-4.802141402722699,4
5138,12,16,1,9,-4.804302234326598,7
5139,88,44,75,26,-4.804702938088101,18
5140,106,25,2,14,-4.808494527305082,11
5141,106,12,6,7,-4.810944704219048,5
5142,85,11,74,6,-4.812388004493803,5
5143,54,15,14,10,-4.820525855929131,5
5144,25,19,31,10,-4.823839301099763,9
5145,9,47,65,28,-4.82612869570304,19
5146,90,13,41,7,-4.828201040811693,6
5147,67,15,8,9,-4.8319098461555825,6
5148,43,26,11,14,-4.837858920444739,12
5149,64,20,83,11,-4.840996077098241,9
5150,100,71,16,41,-4.845032066509386,30
5151,83,17,39,10,-4.845386042652696,7
5152,32,12,97,7,-4.851459349576838,5
5153,79,11,100,7,-4.852268357181291,4
5154,114,11,77,6,-4.854209160918299,5
5155,112,31,100,17,-4.858414274039212,14
5156,3,24,81,14,-4.860040341211914,10
5157,107,12,52,8,-4.8612628499818085,4
5158,89,10,5,7,-4.862465640901751,3
5159,106,54,37,29,-4.865641247327304,25
5160,1,11,29,7,-4.8669345755887905,4
5161,79,20,13,12,-4.869950872786804,8
5162,57,26,88,14,-4.87081224887015,12
5163,84,17,100,11,-4.876415167032029,6
5164,88,44,23,27,-4.876485476342165,17
5165,95,11,69,7,-4.882909765417962,4
5166,101,10,39,6,-4.8897412781033625,4
5167,51,47,75,26,-4.890410363576285,21
5168,77,16,23,9,-4.892331871891682,7
5169,102,24,11,13,-4.893399343069611,11
5170,54,14,38,8,-4.897121063973307,6
5171,11,32,15,19,-4.9040772238924895,13
5172,28,12,38,6,-4.907164394244693,6
5173,87,35,76,21,-4.9222225313957875,14
5174,86,41,43,24,-4.92338257505701,17
5175,11,20,72,11,-4.923870308975731,9
5176,106,56,74,32,-4.924754963776778,24
5177,36,40,86,23,-4.927433251240003,17
5178,43,19,78,11,-4.930691414541358,8
5179,9,22,114,15,-4.931319071415344,7
5180,40,71,13,40,-4.932202242966283,31
5181,69,23,100,13,-4.932564056039485,10
5182,71,11,49,6,-4.9409457894604065,5
5183,28,27,93,17,-4.941127481170006,10
5184,78,15,40,10,-4.942465399220729,5
5185,81,23,39,14,-4.943832581007466,9
5186,106,29,80,17,-4.946009667025365,12
5187,18,14,76,8,-4.948055179076069,6
5188,68,19,56,10,-4.94813216675333,9
5189,100,12,20,7,-4.948684351907288,5
5190,41,33,64,20,-4.951397157092104,13
5191,64,10,85,6,-4.962701184974939,4
5192,107,44,76,28,-4.963511886446056,16
5193,90,23,96,14,-4.963939687748077,9
5194,107,49,40,30,-4.964616090179718,19
5195,114,21,27,12,-4.967571693509977,9
5196,23,11,98,6,-4.9699651611390046,5
5197,44,10,80,5,-4.973541413806909,5
5198,37,53,16,30,-4.974512627646202,23
5199,107,109,87,63,-4.975819901828633,46
5200,55,34,80,18,-4.987967529735274,16
5201,94,19,63,11,-4.988953899876624,8
5202,31,23,50,13,-4.991999785997781,10
5203,71,15,74,8,-4.993812181109021,7
5204,106,41,7,21,-5.003800212982272,20
5205,5,26,93,16,-5.004460526821323,10
5206,83,13,102,8,-5.00532757458448,5
5207,3,27,41,18,-5.0080500461002275,9
5208,17,17,72,10,-5.008619057376982,7
5209,94,17,112,11,-5.010192110959217,6
5210,88,100,7,57,-5.012449658177524,43
5211,64,49,13,26,-5.0266998971793155,23
5212,87,36,94,20,-5.028702412089721,16
5213,41,24,20,13,-5.0314400771852865,11
5214,84,18,43,10,-5.034570350714231,8
5215,52,12,65,8,-5.036995856643753,4
5216,38,31,39,18,-5.039769505176328,13
5217,85,15,63,8,-5.044437930195333,7
5218,51,48,104,30,-5.045842035260691,18
5219,75,20,95,12,-5.050260152484932,8
5220,10,16,7,9,-5.060407065651959,7
5221,61,10,41,6,-5.060781095904467,4
5222,109,41,51,26,-5.066683739905549,15
5223,33,13,90,8,-5.072843762888294,5
5224,28,16,47,9,-5.079195021327367,7
5225,64,23,3,13,-5.079848362911409,10
5226,20,10,32,7,-5.08216341529211,3
5227,87,70,8,40,-5.084902312273524,30
5228,65,23,90,12,-5.084911236528136,11
5229,104,25,53,14,-5.094260383198605,11
5230,103,19,13,12,-5.101332010728284,7
5231,108,13,28,7,-5.102919930198643,6
5232,70,23,55,13,-5.1032220329288345,10
5233,47,30,107,17,-5.104713660133338,13
5234,54,30,9,17,-5.1065751437855,13
5235,1,10,30,6,-5.107240382060612,4
5236,4,18,75,11,-5.1124286444655915,7
5237,57,13,85,8,-5.130764008093785,5
5238,33,14,64,9,-5.132334361355248,5
5239,58,30,40,16,-5.133397385337809,14
5240,57,26,19,15,-5.133436230235902,11
5241,3,21,36,13,-5.136055944816986,8
5242,8,17,72,9,-5.13781996064983,8
5243,65,110,16,63,-5.145171506502088,47
5244,97,13,11,7,-5.149154391162877,6
5245,50,51,16,30,-5.149610319436329,21
5246,9,24,106,14,-5.150083731218861,10
5247,28,16,35,8,-5.1531236605423,8
5248,58,11,12,7,-5.156947077751297,4
5249,5,12,67,7,-5.159840528973067,5
5250,93,13,98,7,-5.16002306712359,6
5251,56,11,91,6,-5.160182814393273,5
5252,96,20,114,12,-5.164351476040406,8
5253,96,29,65,16,-5.165027076154162,13
5254,80,10,27,6,-5.166088753800779,4
5255,78,16,41,10,-5.177820611113413,6
5256,97,17,75,10,-5.183439015487436,7
5257,43,14,23,8,-5.189120753246301,6
5258,71,10,6,6,-5.19369227829273,4
5259,113,13,40,8,-5.193726392686624,5
5260,80,18,104,10,-5.194103195079233,8
5261,39,25,46,12,-5.196853389468722,13
5262,8,26,64,16,-5.197739409340508,10
5263,57,13,30,7,-5.1982148087583715,6
5264,53,36,16,22,-5.201094174764714,14
5265,7,106,16,60,-5.201721932894633,46
5266,43,21,63,12,-5.2076884486347055,9
5267,109,22,50,13,-5.207842202449344,9
5268,91,12,33,6,-5.213867650447791,6
5269,8,14,69,8,-5.216534828858884,6
5270,76,18,20,9,-5.218902337593748,9
5271,37,22,40,12,-5.218981261850287,10
5272,27,23,76,14,-5.219691338614381,9
5273,77,24,3,13,-5.221969486388194,11
5274,106,54,54,29,-5.222938310920249,25
5275,39,23,92,12,-5.223931097826438,11
5276,27,45,100,25,-5.225929681829357,20
5277,5,11,35,6,-5.226534281744142,5
5278,23,12,9,7,-5.231512665759891,5
5279,25,21,91,12,-5.23677892954369,9
5280,16,14,52,8,-5.238731564661997,6
5281,40,15,98,8,-5.239271076053038,7
5282,40,26,25,15,-5.242222631716463,11
5283,51,21,102,12,-5.246852253062097,9
5284,107,73,100,39,-5.251248925768814,34
5285,65,14,85,8,-5.254482148208554,6
5286,31,11,35,6,-5.255104723881262,5
5287,1,11,34,8,-5.259854618241473,3
5288,75,55,86,30,-5.26427494208678,25
5289,92,11,28,7,-5.266199037582341,4
5290,62,23,13,13,-5.279557581763118,10
5291,86,82,11,47,-5.279987079766375,35
5292,88,11,56,6,-5.280224334897691,5
5293,109,13,62,6,-5.284405260681885,7
5294,28,19,14,12,-5.2887953454841945,7
5295,86,21,99,13,-5.291638236148403,8
5296,42,10,87,6,-5.296399197387675,4
5297,11,17,77,10,-5.296719838615225,7
5298,8,18,12,11,-5.299832726924704,7
5299,98,16,27,9,-5.307731237447107,7
5300,77,39,13,23,-5.309839375728811,16
5301,102,14,97,9,-5.335160623731844,5
5302,88,52,11,31,-5.336315191520829,21
5303,62,19,7,11,-5.339510147514966,8
5304,103,14,15,8,-5.340852738797559,6
5305,12,10,47,6,-5.346203816219379,4
5306,63,47,37,28,-5.351566239537104,19
5307,65,15,81,9,-5.355649781765625,6
5308,97,35,7,19,-5.356987360153851,16
5309,50,24,90,14,-5.361711287754656,10
5310,86,40,64,23,-5.391204217901306,17
5311,90,31,54,18,-5.397442007333916,13
5312,103,14,78,10,-5.403027610415989,4
5313,58,11,4,7,-5.405037105567146,4
5314,107,124,16,77,-5.410604174654476,47
5315,19,32,11,20,-5.420057417715362,12
5316,76,27,98,16,-5.421334528995662,11
5317,25,38,104,21,-5.42238345531963,17
5318,63,33,104,19,-5.4225005902868935,14
5319,69,13,42,7,-5.432900919803644,6
5320,68,29,71,18,-5.435653336862234,11
5321,41,41,87,24,-5.437630720258515,17
5322,84,25,85,16,-5.43974367052044,9
5323,63,31,100,17,-5.452576532321479,14
5324,71,43,75,27,-5.454468163058883,16
5325,3,33,65,20,-5.4556526835599515,13
5326,76,14,71,7,-5.456476326439049,7
5327,51,31,5,20,-5.465657211287607,11
5328,34,23,78,13,-5.465824513333961,10
5329,74,13,31,8,-5.468299370651384,5
5330,25,22,100,12,-5.476003695191371,10
5331,65,22,18,12,-5.480882380999119,10
5332,102,10,67,6,-5.497246561771841,4
5333,3,25,62,15,-5.499799252341511,10
5334,38,27,16,18,-5.501435833243271,9
5335,102,26,76,16,-5.502301667327311,10
5336,64,15,44,9,-5.503275136525506,6
5337,40,13,2,8,-5.504797437287729,5
5338,109,13,32,7,-5.508051897308618,6
5339,81,10,80,5,-5.509744831821596,5
5340,83,19,95,12,-5.510188596504647,7
5341,104,66,107,39,-5.510215850574599,27
5342,87,28,80,17,-5.518166010205806,11
5343,68,47,114,27,-5.519247268707076,20
5344,7,33,28,20,-5.522079859732704,13
5345,55,24,100,13,-5.522124052483792,11
5346,102,11,64,7,-5.525256448935202,4
5347,100,19,72,12,-5.52664341254475,7
5348,40,12,15,7,-5.5284615805276305,5
5349,23,21,64,12,-5.5388775759536575,9
5350,12,21,23,12,-5.539017913653241,9
5351,27,23,40,11,-5.543091094529357,12
5352,2,22,20,13,-5.544865436021075,9
5353,75,42,18,24,-5.546579166688544,18
5354,84,18,25,11,-5.5466876181289715,7
5355,23,16,29,9,-5.547160957253139,7
5356,31,53,36,30,-5.548564460468652,23
5357,25,41,8,25,-5.550067480025435,16
5358,54,16,69,9,-5.552096999235808,7
5359,46,44,8,24,-5.553053726096312,20
5360,4,11,46,6,-5.55622187464566,5
5361,95,30,13,17,-5.556983808516705,13
5362,95,10,31,6,-5.5581891593402775,4
5363,20,63,107,36,-5.562332766197254,27
5364,88,98,86,57,-5.562390170991595,41
5365,38,23,7,13,-5.575438881033769,10
5366,44,22,20,13,-5.576158683247875,9
5367,86,38,69,22,-5.57780243243977,16
5368,88,14,14,8,-5.580858903619988,6
5369,53,13,89,7,-5.581720835788214,6
5370,58,23,16,14,-5.587223743497611,9
5371,34,14,102,9,-5.587343030075011,5
5372,96,38,20,23,-5.5910643603065,15
5373,64,17,80,9,-5.593698551425535,8
5374,77,25,30,15,-5.596876821609194,10
5375,10,11,23,6,-5.611414438981714,5
5376,60,13,72,8,-5.611432015329073,5
5377,90,14,30,8,-5.614315415339312,6
5378,91,26,68,14,-5.6194663727720915,12
5379,50,26,95,15,-5.619957219349124,11
5380,22,10,51,6,-5.620245273736576,4
5381,84,24,9,14,-5.622843694169617,10
5382,5,10,19,6,-5.6233787755961275,4
5383,17,21,5,14,-5.625033929201381,7
5384,73,28,86,15,-5.62531345595925,13
5385,20,16,78,9,-5.6294679305494935,7
5386,81,15,19,9,-5.630310593885413,6
5387,9,43,75,26,-5.632694127818325,17
5388,46,16,109,9,-5.636528034552768,7
5389,74,23,73,14,-5.649045009007229,9
5390,97,13,39,8,-5.649731064357227,5
5391,97,10,4,6,-5.649870700339136,4
5392,60,32,49,19,-5.652266603264942,13
5393,61,13,9,8,-5.652969843590385,5
5394,16,44,20,28,-5.653886889078911,16
5395,75,31,46,18,-5.654705399493304,13
5396,87,56,100,31,-5.658391007902432,25
5397,82,11,54,7,-5.66427830231393,4
5398,34,24,109,14,-5.665532316173583,10
5399,99,31,16,18,-5.66581833704302,13
5400,37,39,75,25,-5.670197882049106,14
5401,19,32,29,20,-5.671111826185553,12
5402,25,10,94,5,-5.671887186214519,5
5403,13,37,63,21,-5.677540897301028,16
5404,95,10,102,6,-5.68531996234082,4
5405,9,37,28,20,-5.685359581946876,17
5406,109,42,88,26,-5.687948871024874,16
5407,40,21,35,13,-5.689140213576859,8
5408,5,46,106,28,-5.689619439430468,18
5409,32,10,70,5,-5.692479372096212,5
5410,50,13,23,9,-5.694114757145069,4
5411,62,17,53,10,-5.701449545318568,7
5412,65,37,64,21,-5.704413748738565,16
5413,72,16,107,9,-5.708684864640733,7
5414,47,14,11,9,-5.7112915010697805,5
5415,12,16,69,8,-5.715951067980107,8
5416,102,25,100,16,-5.719538880425677,9
5417,17,13,98,7,-5.72342530511381,6
5418,51,26,25,15,-5.726135112848949,11
5419,9,14,45,9,-5.727853500458989,5
5420,25,48,13,26,-5.729332953997916,22
5421,30,24,29,15,-5.734998612686146,9
5422,106,42,25,26,-5.737688222420908,16
5423,39,50,40,30,-5.739978674185259,20
5424,15,11,84,6,-5.74240703223565,5
5425,77,12,36,7,-5.751140829309579,5
5426,19,13,104,8,-5.751508534333888,5
5427,47,13,23,8,-5.7551420632928085,5
5428,53,13,58,6,-5.756559382638664,7
5429,68,15,80,9,-5.759836210772863,6
5430,54,10,61,6,-5.763750710129652,4
5431,76,19,13,11,-5.766341264416831,8
5432,109,22,65,11,-5.769211228591334,11
5433,15,19,72,10,-5.769899156315003,9
5434,112,13,85,8,-5.770596297207226,5
5435,107,36,58,22,-5.784206862253102,14
5436,19,13,48,7,-5.7924314405881985,6
5437,51,45,78,24,-5.800274453414971,21
5438,31,19,91,12,-5.801858258461768,7
5439,106,11,10,8,-5.803672894932928,3
5440,98,19,8,12,-5.806615359942182,7
5441,20,13,79,8,-5.810117746469,5
5442,5,16,40,9,-5.82052725169565,7
5443,88,19,58,11,-5.842538876771353,8
5444,51,68,100,37,-5.844116232130888,31
5445,65,10,108,5,-5.847992745343311,5
5446,79,12,80,6,-5.851472407179256,6
5447,65,61,55,35,-5.858765777581568,26
5448,112,21,7,13,-5.863389950487481,8
5449,7,17,34,10,-5.863504951401834,7
5450,95,36,54,20,-5.865979569344108,16
5451,9,17,62,10,-5.866001447424248,7
5452,55,64,107,37,-5.87153194979236,27
5453,31,12,28,7,-5.87633787823225,5
5454,68,27,97,16,-5.880460614845397,11
5455,36,12,46,7,-5.88209418081934,5
5456,74,22,102,13,-5.882481039476403,9
5457,108,17,75,10,-5.88550634585497,7
5458,103,18,39,11,-5.887093677643695,7
5459,43,16,17,9,-5.888801333071093,7
5460,84,34,74,18,-5.89139952158172,16
5461,68,15,101,10,-5.891939886749793,5
5462,43,34,39,19,-5.8937669125434455,15
5463,91,16,51,10,-5.8958428007861405,6
5464,103,12,54,8,-5.896465334872947,4
5465,107,59,75,39,-5.896729059645905,20
5466,29,12,50,7,-5.9053142051653245,5
5467,57,27,84,14,-5.910397185802948,13
5468,65,82,104,47,-5.912154582043186,35
5469,7,23,78,12,-5.919551023484503,11
5470,93,14,75,8,-5.9232430439307135,6
5471,49,47,27,28,-5.9233145844446,19
5472,114,20,73,12,-5.924435121305104,8
5473,3,17,34,10,-5.941229806680978,7
5474,43,10,74,5,-5.941779824004124,5
5475,33,12,49,8,-5.9430630012189605,4
5476,53,15,28,9,-5.945744364633271,6
5477,76,31,28,17,-5.950271226300689,14
5478,10,12,97,6,-5.950831581917707,6
5479,53,52,68,31,-5.964244334939566,21
5480,40,18,97,11,-5.966918416140385,7
5481,87,21,102,13,-5.971447061156248,8
5482,18,20,64,12,-5.974775055211904,8
5483,27,17,81,10,-5.980960922697962,7
5484,86,22,29,13,-5.9859883975534425,9
5485,84,20,98,13,-5.9888897315784195,7
5486,77,19,78,11,-5.9894838962393475,8
5487,31,25,114,14,-5.9918765203954925,11
5488,54,21,94,12,-6.000772945562409,9
5489,37,60,87,36,-6.0118966801727876,24
5490,15,27,29,16,-6.01976791579235,11
5491,48,15,29,9,-6.020141509256062,6
5492,17,17,103,11,-6.022913063656272,6
5493,37,24,98,14,-6.023716027404387,10
5494,86,62,100,35,-6.024521465285828,27
5495,46,20,95,12,-6.027785407812037,8
5496,50,17,91,11,-6.027790824025908,6
5497,68,10,26,6,-6.030745942778486,4
5498,31,31,75,17,-6.03348213428737,14
5499,98,24,7,15,-6.033686003781978,9
5500,32,16,8,9,-6.041444852098721,7
5501,88,18,76,10,-6.043471817882156,8
5502,93,15,70,9,-6.04469500542117,6
5503,112,30,53,16,-6.0449768388221905,14
5504,18,24,63,15,-6.046455003215171,9
5505,14,14,39,8,-6.049336679853417,6
5506,60,43,23,26,-6.05331122826769,17
5507,65,57,30,34,-6.057922998064296,23
5508,41,27,23,16,-6.068042449918635,11
5509,88,64,65,40,-6.068722517026162,24
5510,16,23,6,12,-6.074728029131809,11
5511,102,13,23,7,-6.080684731147943,6
5512,72,21,85,14,-6.082147909318165,7
5513,107,23,111,12,-6.08814286411973,11
5514,108,14,96,8,-6.092516088942793,6
5515,46,24,57,14,-6.094749729993643,10
5516,47,11,54,6,-6.095812400128514,5
5517,69,16,62,9,-6.0981418118710495,7
5518,10,13,16,8,-6.102410867550437,5
5519,7,12,90,7,-6.108519045195329,5
5520,31,13,81,9,-6.1171597913254026,4
5521,88,35,25,23,-6.12387967695023,12
5522,43,40,107,24,-6.145089916465943,16
5523,47,27,75,18,-6.156969718274411,9
5524,81,11,50,6,-6.158903696641065,5
5525,12,20,16,12,-6.166025493420027,8
5526,36,47,13,29,-6.167141158071527,18
5527,8,14,43,8,-6.169495664997545,6
5528,77,23,107,13,-6.174961839792211,10
5529,93,10,80,5,-6.175234905241036,5
5530,81,17,114,9,-6.179669023614306,8
5531,94,16,114,9,-6.184621239792868,7
5532,71,12,91,7,-6.18747414228945,5
5533,19,48,87,29,-6.187717869450032,19
5534,97,26,87,17,-6.190868250218131,9
5535,65,54,27,33,-6.196724957991716,21
5536,2,28,63,16,-6.200018491851487,12
5537,20,49,65,31,-6.200424954113156,18
5538,70,28,74,15,-6.203999405338755,13
5539,12,14,63,7,-6.204748395941869,7
5540,84,15,35,9,-6.209299301194262,6
5541,70,24,114,15,-6.214622620602992,9
5542,49,25,54,14,-6.225454221982543,11
5543,91,42,16,27,-6.227187272730331,15
5544,55,26,111,16,-6.228608034123604,10
5545,50,41,104,25,-6.230364171354916,16
5546,3,39,7,24,-6.232217973074319,15
5547,86,31,34,18,-6.237009896243482,13
5548,5,48,114,28,-6.237633533478722,20
5549,95,12,15,7,-6.265255655621161,5
5550,8,94,16,57,-6.268098453986591,37
5551,5,45,20,28,-6.270373633442783,17
5552,4,21,86,13,-6.2794844995496994,8
5553,68,35,11,20,-6.280005613646358,15
5554,93,14,29,8,-6.281843189307091,6
5555,72,15,50,9,-6.282212191469299,6
5556,86,21,47,13,-6.282505529772493,8
5557,4,15,12,10,-6.285579029533407,5
5558,108,13,54,9,-6.288035508418626,4
5559,102,36,28,21,-6.294379170221602,15
5560,94,20,76,13,-6.29880756689131,7
5561,19,21,76,13,-6.301901405511211,8
5562,16,66,30,40,-6.310791816237723,26
5563,98,18,70,12,-6.319051319272617,6
5564,51,37,77,21,-6.323702748298249,16
5565,49,40,107,24,-6.324298903814961,16
5566,96,11,15,7,-6.332542018308189,4
5567,18,24,15,15,-6.3402318230961585,9
5568,96,17,85,12,-6.345069391274802,5
5569,39,35,84,20,-6.3525949898803695,15
5570,27,13,92,7,-6.356396578041118,6
5571,15,18,47,10,-6.359572158435768,8
5572,43,19,64,11,-6.3596171770522805,8
5573,56,21,7,12,-6.361794853449643,9
5574,50,12,57,8,-6.36698198689182,4
5575,102,15,33,9,-6.371524301983965,6
5576,57,35,87,21,-6.372641139100553,14
5577,27,16,28,11,-6.382931621067471,5
5578,51,29,108,17,-6.386940693154833,12
5579,96,13,33,6,-6.392035038140809,7
5580,109,18,100,12,-6.39941594100262,6
5581,37,20,80,12,-6.401050818487372,8
5582,54,18,91,10,-6.414686940093467,8
5583,23,10,61,6,-6.419517618014351,4
5584,80,23,96,14,-6.423400971659429,9
5585,100,21,75,11,-6.426877840881264,10
5586,33,16,40,11,-6.427211772717695,5
5587,107,16,89,10,-6.429821795264184,6
5588,94,18,69,11,-6.432434124144747,7
5589,23,47,13,26,-6.4340973489419495,21
5590,87,77,13,48,-6.437776756748542,29
5591,33,16,68,10,-6.451134609706938,6
5592,28,10,6,6,-6.452419128804086,4
5593,91,20,8,12,-6.453847873736644,8
5594,57,19,97,11,-6.465009515620628,8
5595,50,16,15,10,-6.46898110916802,6
5596,68,11,98,7,-6.4699276959750645,4
5597,9,20,70,13,-6.477071321597405,7
5598,103,10,18,7,-6.501498615339008,3
5599,55,29,74,17,-6.503619546467788,12
5600,112,20,3,11,-6.506335949972266,9
5601,77,24,41,15,-6.512816462619649,9
5602,79,15,76,10,-6.514592595269537,5
5603,66,20,60,13,-6.515171561917162,7
5604,49,69,39,43,-6.52686668255468,26
5605,38,12,102,9,-6.529266346603463,3
5606,80,13,91,8,-6.531108694088673,5
5607,29,23,98,14,-6.531113392896417,9
5608,8,27,78,17,-6.539735477431525,10
5609,70,58,54,35,-6.543056803225656,23
5610,112,16,58,9,-6.546457957272807,7
5611,23,32,106,17,-6.5490553960891695,15
5612,19,22,64,15,-6.56099923334209,7
5613,30,15,112,10,-6.562692428407148,5
5614,63,31,75,18,-6.570041946714375,13
5615,114,26,53,15,-6.571088082289226,11
5616,87,21,72,12,-6.57495584584389,9
5617,81,12,77,7,-6.5752456736487765,5
5618,101,11,27,7,-6.582303845846212,4
5619,67,16,34,8,-6.586851367561421,8
5620,79,20,30,13,-6.592079457136293,7
5621,63,31,64,18,-6.595351994440166,13
5622,102,28,65,18,-6.598986547888402,10
5623,35,25,11,15,-6.6098986532599575,10
5624,77,12,102,7,-6.618078815941928,5
5625,30,14,23,8,-6.618468991829209,6
5626,68,21,20,12,-6.619136630374986,9
5627,107,36,19,23,-6.620431832626574,13
5628,46,38,74,24,-6.622188071735937,14
5629,5,48,25,29,-6.626414170343123,19
5630,13,43,47,26,-6.630254291387857,17
5631,37,22,39,13,-6.632156694863052,9
5632,65,30,4,18,-6.635600395573753,12
5633,17,38,86,21,-6.641619574926921,17
5634,5,26,32,16,-6.6474470604519045,10
5635,63,59,8,34,-6.653552632837189,25
5636,37,19,71,11,-6.65399605348867,8
5637,71,11,83,6,-6.6562053803338666,5
5638,80,13,19,8,-6.6570365011750905,5
5639,57,12,10,8,-6.658857003244836,4
5640,54,20,85,13,-6.664179187550933,7
5641,68,31,23,17,-6.676959480055365,14
5642,98,24,11,14,-6.689063597940291,10
5643,28,54,104,32,-6.697414309723438,22
5644,106,11,111,8,-6.697425895741327,3
5645,86,18,10,10,-6.698064905065152,8
5646,23,25,63,16,-6.701335055503609,9
5647,38,11,108,7,-6.702463242169256,4
5648,74,15,83,8,-6.703298030488857,7
5649,97,35,28,22,-6.716635909782018,13
5650,32,10,65,6,-6.718474357729474,4
5651,95,13,14,8,-6.731405281187272,5
5652,96,38,74,24,-6.731828732252354,14
5653,69,20,15,13,-6.736896270525392,7
5654,29,10,18,7,-6.739197778395282,3
5655,48,26,84,16,-6.740791105108492,10
5656,68,13,45,8,-6.747691137383073,5
5657,71,10,94,6,-6.748460655059317,4
5658,97,54,86,32,-6.749652418711037,22
5659,109,27,63,15,-6.749986635160669,12
5660,50,17,33,10,-6.750798742645295,7
5661,8,39,13,24,-6.751757053519926,15
5662,96,82,86,50,-6.757041595559337,32
5663,65,27,49,16,-6.761581477384983,11
5664,63,63,51,35,-6.773843003389744,28
5665,42,10,8,5,-6.78054178477664,5
5666,55,28,109,15,-6.787411237199465,13
5667,87,35,48,22,-6.790488925793804,13
5668,38,14,2,8,-6.792448237787324,6
5669,81,34,86,23,-6.793767976423694,11
5670,31,10,55,6,-6.798197972656263,4
5671,87,23,108,14,-6.799580586486786,9
5672,49,16,28,9,-6.8012848235530035,7
5673,50,17,3,10,-6.80135709994392,7
5674,13,50,71,29,-6.804323620324037,21
5675,103,25,86,16,-6.806637205037491,9
5676,9,32,8,17,-6.810878783728156,15
5677,51,101,39,61,-6.8132830847231824,40
5678,4,13,56,7,-6.816273515879698,6
5679,31,69,68,41,-6.8216343585610195,28
5680,65,14,79,8,-6.821859416038812,6
5681,77,26,49,17,-6.8274953131174225,9
5682,106,25,95,16,-6.830338155584793,9
5683,51,28,62,17,-6.837263314130047,11
5684,51,99,7,62,-6.849475435937795,37
5685,37,25,30,16,-6.853302921187577,9
5686,60,18,108,11,-6.856532886501664,7
5687,86,47,41,30,-6.858675087687564,17
5688,4,43,60,24,-6.864343045215706,19
5689,98,12,3,6,-6.866274172778351,6
5690,87,104,16,63,-6.866672781099513,41
5691,87,58,68,35,-6.867242541807756,23
5692,69,19,29,11,-6.87026975866342,8
5693,38,12,34,8,-6.8714448233593854,4
5694,99,15,106,10,-6.882359612487446,5
5695,94,27,30,16,-6.8894939969363636,11
5696,67,13,88,9,-6.891493842154355,4
5697,62,33,107,18,-6.9022637475512845,15
5698,68,21,58,13,-6.90465268486649,8
5699,29,17,28,10,-6.905526522456792,7
5700,77,33,27,20,-6.913052068345059,13
5701,37,36,13,22,-6.914764249585317,14
5702,29,33,39,18,-6.938842255810811,15
5703,12,36,100,21,-6.93903973077968,15
5704,88,12,99,7,-6.939131232028662,5
5705,50,33,60,18,-6.944865376684973,15
5706,69,39,13,24,-6.946273853388926,15
5707,51,25,4,16,-6.952578906103856,9
5708,63,20,90,12,-6.95733483322538,8
5709,104,18,32,12,-6.959225086389547,6
5710,39,15,111,9,-6.9608600117118025,6
5711,36,34,16,21,-6.96230955324868,13
5712,97,23,18,14,-6.965163575719862,9
5713,109,20,43,13,-6.971508379947058,7
5714,68,22,29,14,-6.975698761703106,8
5715,30,30,53,18,-6.98498975026545,12
5716,3,25,104,15,-6.987282972364144,10
5717,55,20,17,11,-6.987444025974705,9
5718,13,23,111,13,-6.988942249892523,10
5719,5,15,62,9,-6.9927087595973925,6
5720,87,21,4,14,-6.993636995986407,7
5721,54,14,79,9,-6.993661154009002,5
5722,57,33,8,21,-6.998719542214547,12
5723,54,26,93,17,-7.002072182522708,9
5724,69,13,40,9,-7.006717860168283,4
5725,53,47,107,29,-7.009171118597259,18
5726,38,25,63,17,-7.013791456544737,8
5727,57,23,3,14,-7.014479906982348,9
5728,88,34,100,21,-7.018805733136069,13
5729,43,15,12,10,-7.021564164922878,5
5730,53,27,87,15,-7.0226395127694765,12
5731,40,15,95,9,-7.026458120737084,6
5732,13,13,89,7,-7.027546797235387,6
5733,48,15,76,10,-7.031929988428476,5
5734,29,19,49,11,-7.032846194426556,8
5735,27,19,37,12,-7.034792767414986,7
5736,60,18,94,11,-7.03515997246868,7
5737,114,11,72,6,-7.039741382461142,5
5738,97,25,55,16,-7.041738062020974,9
5739,19,14,17,9,-7.043328257314955,5
5740,73,16,65,10,-7.056062739811477,6
5741,36,18,99,12,-7.061516094995873,6
5742,63,27,98,16,-7.061533653908025,11
5743,12,11,52,6,-7.062340699088408,5
5744,53,10,85,7,-7.0781457464371815,3
5745,70,35,28,21,-7.078735797739843,14
5746,76,37,16,20,-7.082520344517178,17
5747,64,26,30,16,-7.0955835601535755,10
5748,17,14,38,8,-7.099034060595349,6
5749,45,10,1,6,-7.100044646871247,4
5750,54,32,100,20,-7.10626505268504,12
5751,7,33,45,20,-7.114147641228475,13
5752,83,30,86,20,-7.114862976089347,10
5753,76,27,65,18,-7.121500914302365,9
5754,107,12,67,8,-7.124134838046419,4
5755,38,11,62,7,-7.1316627039169695,4
5756,15,39,27,22,-7.136849333340001,17
5757,68,67,40,42,-7.1376072752934245,25
5758,57,35,11,19,-7.140027278328804,16
5759,78,13,33,8,-7.142209395263034,5
5760,55,50,40,31,-7.142420946012767,19
5761,60,17,5,11,-7.144002600647478,6
5762,69,12,111,7,-7.144443379259754,5
5763,51,26,97,17,-7.145200913148901,9
5764,19,18,84,11,-7.145362039647058,7
5765,37,14,29,8,-7.14724630286853,6
5766,30,13,80,8,-7.153305949978541,5
5767,33,19,8,12,-7.156947433543343,7
5768,14,14,86,8,-7.166696838482464,6
5769,55,39,104,24,-7.167673821947763,15
5770,57,19,114,12,-7.16817977917647,7
5771,61,13,30,8,-7.1697153559652405,5
5772,86,41,98,24,-7.171894084868248,17
5773,112,16,36,10,-7.175574629533439,6
5774,107,56,30,34,-7.185278655411904,22
5775,51,110,86,64,-7.186264009009979,46
5776,43,15,112,9,-7.1893251112725896,6
5777,22,13,109,8,-7.19047287621624,5
5778,27,28,72,16,-7.198042760659786,12
5779,52,22,86,14,-7.203855363753252,8
5780,8,27,18,18,-7.207241863382852,9
5781,76,21,100,12,-7.225478225762562,9
5782,40,27,114,18,-7.240772461331045,9
5783,5,14,31,9,-7.246607645789562,5
5784,96,12,69,8,-7.2527556906488755,4
5785,91,29,87,18,-7.256753645120718,11
5786,79,30,86,19,-7.258463117259924,11
5787,81,19,75,12,-7.259552889264539,7
5788,10,14,63,9,-7.261720580359904,5
5789,48,14,100,8,-7.263809625362936,6
5790,98,17,20,11,-7.267496359610283,6
5791,70,16,110,10,-7.267896542251016,6
5792,96,10,62,7,-7.268496266352443,3
5793,57,13,106,7,-7.272492874678534,6
5794,68,20,55,13,-7.273979151335479,7
5795,29,16,97,10,-7.284915525257297,6
5796,40,31,43,18,-7.287691070183636,13
5797,55,30,30,19,-7.297909474841512,11
5798,40,33,54,20,-7.298767912387552,13
5799,49,20,34,12,-7.304688788559015,8
5800,87,26,34,16,-7.317543768028026,10
5801,93,20,16,11,-7.319623013756244,9
5802,5,42,70,25,-7.323141246130922,17
5803,88,30,62,18,-7.323841783087013,12
5804,88,13,34,8,-7.324661467404561,5
5805,87,39,43,24,-7.327121204659327,15
5806,2,16,75,9,-7.332326563651874,7
5807,104,41,40,26,-7.342291894534161,15
5808,114,18,23,12,-7.344942637597017,6
5809,79,24,48,15,-7.345817828277464,9
5810,12,17,19,9,-7.3489102504137485,8
5811,103,15,34,10,-7.35445655282352,5
5812,9,19,17,11,-7.358179157868899,8
5813,8,25,73,15,-7.3587900254771785,10
5814,33,16,25,11,-7.36592627296452,5
5815,55,72,16,46,-7.367072119933609,26
5816,80,14,31,10,-7.367135464628977,4
5817,114,24,100,15,-7.3724280838709575,9
5818,71,10,73,6,-7.373234065194552,4
5819,81,19,71,12,-7.374213709282582,7
5820,30,21,34,13,-7.377448858621609,8
5821,94,31,27,19,-7.381571713402097,12
5822,71,29,50,17,-7.386130219514863,12
5823,5,10,1,6,-7.391988711274882,4
5824,94,11,20,7,-7.40491165274963,4
5825,20,30,70,19,-7.408681007686701,11
5826,41,34,36,18,-7.412500474371831,16
5827,57,15,9,9,-7.427077607114285,6
5828,9,46,16,30,-7.4405406867592765,16
5829,71,12,11,7,-7.444969376445684,5
5830,87,35,78,21,-7.455102886547994,14
5831,110,21,37,12,-7.457046552670356,9
5832,70,12,100,7,-7.4587771296449565,5
5833,53,12,45,7,-7.463487107897495,5
5834,39,18,110,12,-7.464111416570426,6
5835,8,31,34,19,-7.466974677979833,12
5836,31,37,64,23,-7.4738922265185375,14
5837,63,15,108,9,-7.475559971035059,6
5838,36,14,70,8,-7.476080415111231,6
5839,109,21,7,13,-7.49374057253885,8
5840,69,18,104,12,-7.510735223332436,6
5841,47,11,85,8,-7.514718359567324,3
5842,87,52,7,33,-7.517208318589071,19
5843,55,11,6,8,-7.526848268362213,3
5844,7,16,33,9,-7.532188482638043,7
5845,77,15,17,9,-7.533332094576503,6
5846,55,22,34,13,-7.5346031268462745,9
5847,46,10,85,7,-7.538229298143678,3
5848,55,13,49,8,-7.5458342197342585,5
5849,104,21,9,13,-7.555832585448779,8
5850,40,38,87,22,-7.562449238427529,16
5851,45,19,60,11,-7.562934672858015,8
5852,49,23,75,14,-7.565086245339051,9
5853,107,35,12,23,-7.568720059601813,12
5854,5,14,34,10,-7.5706698448560905,4
5855,77,12,46,7,-7.574271980014295,5
5856,114,31,28,18,-7.584853881328922,13
5857,36,10,72,6,-7.585561627806541,4
5858,103,24,11,16,-7.585830317962974,8
5859,64,24,55,16,-7.5905103785531685,8
5860,9,38,87,22,-7.592453429043,16
5861,36,20,18,12,-7.59490287850123,8
5862,88,79,54,49,-7.595941854238027,30
5863,7,30,37,18,-7.598616530184265,12
5864,58,18,54,10,-7.606404400860017,8
5865,88,25,108,16,-7.612957755702023,9
5866,69,32,60,18,-7.613845124007753,14
5867,72,22,54,14,-7.618738189484295,8
5868,27,14,71,9,-7.62097447229337,5
5869,19,22,28,14,-7.627099764741289,8
5870,61,11,69,8,-7.633216471104327,3
5871,5,29,97,19,-7.639418302115126,10
5872,60,11,70,7,-7.646435749026202,4
5873,31,13,33,7,-7.647223417443056,6
5874,60,39,104,27,-7.655966632440946,12
5875,66,11,104,8,-7.6588091193640615,3
5876,35,27,107,18,-7.659745377736293,9
5877,112,29,27,18,-7.661494705671572,11
5878,69,44,16,28,-7.665479946548732,16
5879,96,24,37,14,-7.66584492569651,10
5880,62,22,28,13,-7.667182073614821,9
5881,38,29,37,18,-7.668156637885105,11
5882,19,27,103,16,-7.669020445123164,11
5883,104,10,72,6,-7.673968450836452,4
5884,55,35,50,20,-7.677574556383835,15
5885,103,26,27,16,-7.681780370581866,10
5886,100,24,23,15,-7.684305486695593,9
5887,11,32,5,20,-7.6874421575338765,12
5888,7,25,111,15,-7.6903234257719815,10
5889,1,28,86,17,-7.696680317913658,11
5890,68,61,75,39,-7.698232004910782,22
5891,101,14,16,9,-7.729447625525013,5
5892,72,12,76,8,-7.731997605583364,4
5893,15,12,48,7,-7.733213395656077,5
5894,29,41,65,25,-7.736031171751763,16
5895,84,11,44,6,-7.741464370739851,5
5896,54,13,73,8,-7.746921178252214,5
5897,68,29,28,19,-7.7489930389673605,10
5898,25,49,37,29,-7.755599308877523,20
5899,73,11,53,7,-7.756297558195456,4
5900,18,22,50,13,-7.75840176806416,9
5901,114,14,92,10,-7.774797164908212,4
5902,111,10,47,6,-7.786638633209642,4
5903,78,11,108,7,-7.797957113003336,4
5904,110,12,114,8,-7.80031681097971,4
5905,22,10,34,6,-7.812715801410848,4
5906,46,46,25,27,-7.8204011950255445,19
5907,106,63,13,39,-7.824636159857551,24
5908,107,33,2,21,-7.828664599470125,12
5909,43,53,13,30,-7.830296166259035,23
5910,1,20,114,13,-7.837742070296789,7
5911,91,26,106,17,-7.859341034872017,9
5912,35,12,44,7,-7.859665557157517,5
5913,98,15,108,9,-7.863072789163925,6
5914,53,26,27,17,-7.864216242382975,9
5915,90,25,114,15,-7.8701656835045455,10
5916,100,35,104,22,-7.883509665470489,13
5917,46,13,19,8,-7.892870343532164,5
5918,29,16,17,9,-7.899676305324425,7
5919,90,14,53,9,-7.901032299292589,5
5920,31,11,78,6,-7.904414780494012,5
5921,38,13,71,9,-7.906029048659733,4
5922,82,10,88,6,-7.9125780836424955,4
5923,61,14,6,9,-7.915350050859162,5
5924,18,22,54,13,-7.917650548154778,9
5925,3,32,49,19,-7.921458159088598,13
5926,58,12,30,8,-7.929379399940004,4
5927,2,12,30,7,-7.930773013016298,5
5928,107,24,33,14,-7.934508031898854,10
5929,87,17,73,12,-7.94220715025842,5
5930,64,34,16,22,-7.948318536704253,12
5931,109,53,54,34,-7.951130265295214,19
5932,63,17,111,10,-7.959677987637775,7
5933,39,21,23,13,-7.9630880242589255,8
5934,5,25,65,15,-7.967561696591303,10
5935,68,20,34,12,-7.978044783319167,8
5936,76,26,112,15,-7.97915167815144,11
5937,84,28,5,17,-7.986435375626319,11
5938,3,19,20,12,-7.98758608002235,7
5939,70,16,13,10,-7.990308468406848,6
5940,6,22,44,15,-7.994067314889739,7
5941,96,19,102,12,-7.995631160966494,7
5942,29,15,46,7,-7.9982854128923,8
5943,88,42,39,26,-8.004378009209995,16
5944,81,18,41,12,-8.009042710590084,6
5945,98,31,91,19,-8.010154956050265,12
5946,114,16,76,11,-8.01045549406789,5
5947,88,47,63,31,-8.011636403272155,16
5948,9,11,35,6,-8.012816785902407,5
5949,52,12,63,7,-8.015196003418383,5
5950,3,47,16,30,-8.022951142726752,17
5951,50,41,75,27,-8.02466935745211,14
5952,29,27,84,16,-8.026114791649642,11
5953,46,45,16,29,-8.034750190065965,16
5954,84,36,20,25,-8.04861670328596,11
5955,15,10,35,5,-8.056529361763387,5
5956,15,15,12,9,-8.061809473862587,6
5957,46,13,53,8,-8.064750592390654,5
5958,68,38,76,27,-8.067259765332077,11
5959,70,18,50,10,-8.072010588554933,8
5960,97,16,110,10,-8.077466293642948,6
5961,74,12,89,7,-8.079770785030162,5
5962,5,61,8,37,-8.080732178020163,24
5963,4,17,43,10,-8.083539648296872,7
5964,8,44,109,26,-8.084532850874995,18
5965,78,45,27,30,-8.094234380040165,15
5966,46,42,37,28,-8.095895819595153,14
5967,49,11,95,8,-8.095998639719069,3
5968,19,17,38,12,-8.100688864380347,5
5969,13,45,81,29,-8.101358080411169,16
5970,85,10,3,5,-8.102330604310954,5
5971,48,15,74,8,-8.108554922899495,7
5972,74,16,34,11,-8.118744758398412,5
5973,111,11,81,8,-8.120062859865854,3
5974,110,11,20,7,-8.125291114928718,4
5975,41,33,11,22,-8.134701758810118,11
5976,107,14,56,8,-8.142413744294045,6
5977,112,10,4,6,-8.145974306589782,4
5978,112,16,18,11,-8.155957753880717,5
5979,20,17,33,11,-8.157924685534638,6
5980,9,20,76,13,-8.161384986883025,7
5981,81,15,47,10,-8.165398445346261,5
5982,88,122,16,78,-8.186735552225066,44
5983,39,25,74,15,-8.19553508787693,10
5984,69,26,58,15,-8.200000948757868,11
5985,93,24,87,15,-8.201353690040278,9
5986,51,42,64,26,-8.201880887276833,16
5987,63,75,16,47,-8.205892894816378,28
5988,40,14,112,8,-8.221202026655053,6
5989,71,10,99,6,-8.22496630028886,4
5990,106,21,69,13,-8.230262561693124,8
5991,15,29,8,17,-8.25475655550095,12
5992,94,12,103,7,-8.264881457481591,5
5993,14,12,37,7,-8.266467835075433,5
5994,19,21,41,14,-8.276612064828885,7
5995,91,18,41,12,-8.276671952774393,6
5996,106,31,90,21,-8.28384546124837,10
5997,41,21,8,14,-8.297019486473621,7
5998,56,17,86,11,-8.300855291965847,6
5999,109,23,74,15,-8.306575916019822,8
6000,81,15,104,8,-8.308547186806486,7
6001,48,13,90,8,-8.30973168111364,5
6002,43,18,57,13,-8.312131327998166,5
6003,108,16,19,10,-8.312758842928977,6
6004,9,15,25,10,-8.323455878342047,5
6005,89,12,48,9,-8.328549669565296,3
6006,39,93,16,58,-8.33759857757141,35
6007,96,25,48,16,-8.343995751105185,9
6008,31,32,41,20,-8.353957395244585,12
6009,5,22,7,14,-8.357081514884824,8
6010,25,45,7,29,-8.372806618348289,16
6011,68,25,62,15,-8.382615098007268,10
6012,98,21,13,14,-8.382728400092747,7
6013,62,10,43,6,-8.394379014204606,4
6014,19,17,63,11,-8.404706837961044,6
6015,67,14,109,7,-8.41022889195963,7
6016,102,21,50,12,-8.41869338516401,9
6017,27,74,16,47,-8.419832628912095,27
6018,102,12,41,8,-8.421036787338009,4
6019,90,19,73,12,-8.424101991862472,7
6020,103,14,88,9,-8.430464226549898,5
6021,114,20,55,13,-8.432483182241098,7
6022,70,24,96,13,-8.437417991026262,11
6023,37,20,41,13,-8.445393431529393,7
6024,96,14,95,9,-8.450373982592183,5
6025,3,24,114,16,-8.461132150785257,8
6026,106,16,12,11,-8.461406597257815,5
6027,107,39,48,24,-8.464254422847032,15
6028,20,37,63,22,-8.464473402081472,15
6029,112,26,39,16,-8.46467402651886,10
6030,79,13,112,8,-8.473860498540244,5
6031,85,14,55,9,-8.476039600481302,5
6032,77,14,74,9,-8.485489523270209,5
6033,12,17,28,11,-8.494896988707827,6
6034,40,28,64,18,-8.49607162432113,10
6035,34,18,29,11,-8.49996347208046,7
6036,45,10,91,6,-8.504304930616431,4
6037,40,23,62,12,-8.506273692628868,11
6038,6,21,13,13,-8.50747605743762,8
6039,69,22,81,13,-8.51799786685539,9
6040,61,20,53,14,-8.524850655507478,6
6041,63,11,110,7,-8.534985747455591,4
6042,35,12,94,7,-8.545638882275087,5
6043,63,11,93,7,-8.547776338932225,4
6044,67,15,16,10,-8.550473387804695,5
6045,2,11,94,7,-8.550586885180518,4
6046,36,11,78,7,-8.552435160203329,4
6047,66,15,65,10,-8.555650294431567,5
6048,80,12,41,8,-8.558761558111074,4
6049,93,10,49,6,-8.572163796775683,4
6050,55,23,95,15,-8.57500650986488,8
6051,77,18,53,11,-8.576780251337032,7
6052,68,13,108,8,-8.580585833252005,5
6053,93,44,65,26,-8.591281807406075,18
6054,14,22,16,14,-8.60697123103142,8
6055,65,24,1,14,-8.633116949744032,10
6056,97,19,41,12,-8.638943706099203,7
6057,35,17,27,11,-8.645931055549601,6
6058,58,12,70,8,-8.662523092509444,4
6059,54,11,53,7,-8.670288326383613,4
6060,31,12,19,8,-8.67684008479621,4
6061,31,31,9,20,-8.678153869820548,11
6062,68,67,39,41,-8.679610428054554,26
6063,20,41,39,24,-8.683414479878408,17
6064,76,49,86,30,-8.683760649202954,19
6065,94,31,13,20,-8.707460572078984,11
6066,86,15,45,9,-8.710518828201982,6
6067,45,10,58,6,-8.721721801464438,4
6068,87,59,27,37,-8.722585860088166,22
6069,8,20,62,14,-8.725180325771555,6
6070,17,22,4,15,-8.72773506800961,7
6071,106,14,38,7,-8.74501943352997,7
6072,3,25,19,16,-8.752555261006782,9
6073,64,17,70,12,-8.763483643924097,5
6074,1,27,16,19,-8.77734005429633,8
6075,18,23,106,15,-8.778191080978738,8
6076,37,16,94,10,-8.782776933637447,6
6077,99,14,77,10,-8.784719144285262,4
6078,107,11,26,7,-8.789963547813729,4
6079,28,17,41,11,-8.792780130820775,6
6080,42,10,106,7,-8.802546839644418,3
6081,63,24,57,14,-8.808573587871944,10
6082,47,18,36,12,-8.810892372607713,6
6083,77,22,63,15,-8.81999753264251,7
6084,36,19,63,12,-8.822881427312195,7
6085,50,17,85,11,-8.828432540960764,6
6086,12,10,20,6,-8.842914423325945,4
6087,87,15,32,10,-8.84415502943487,5
6088,51,16,35,10,-8.849945437990398,6
6089,66,22,107,14,-8.85129730206017,8
6090,30,24,50,15,-8.864762243264124,9
6091,12,15,6,8,-8.873687126500895,7
6092,53,11,49,7,-8.876928289416243,4
6093,13,23,90,15,-8.883764352926041,8
6094,109,18,75,12,-8.883837567249163,6
6095,97,12,69,8,-8.888377862411463,4
6096,104,12,48,8,-8.912185347145057,4
6097,60,22,17,14,-8.913811593594376,8
6098,25,19,110,13,-8.917701672558223,6
6099,88,10,26,6,-8.91952728239028,4
6100,49,17,72,11,-8.921503010914295,6
6101,13,27,58,19,-8.92184464761992,8
6102,91,10,11,7,-8.923724837318142,3
6103,51,48,76,32,-8.925061488027247,16
6104,84,22,13,15,-8.926224969766146,7
6105,12,14,98,9,-8.92802355273952,5
6106,31,12,73,8,-8.93891957013575,4
6107,74,26,51,18,-8.938947542412075,8
6108,109,20,53,13,-8.945178102898181,7
6109,11,35,100,23,-8.950423282440326,12
6110,104,15,78,10,-8.957766332972088,5
6111,18,30,68,19,-8.962998195734913,11
6112,32,11,28,7,-8.963821007682874,4
6113,81,14,11,9,-8.967824856070845,5
6114,114,20,47,12,-8.969382880850324,8
6115,36,18,97,11,-8.970668153566264,7
6116,112,20,88,13,-8.974262508725221,7
6117,52,15,28,9,-8.975367013246691,6
6118,81,10,48,7,-8.989696104511108,3
6119,80,15,78,10,-8.990142670025005,5
6120,72,10,38,6,-8.999506480702255,4
6121,88,30,30,18,-9.008031571554382,12
6122,36,15,5,9,-9.008614310253614,6
6123,33,16,63,10,-9.020049921268521,6
6124,45,16,35,9,-9.0400315918615,7
6125,3,55,13,36,-9.055927203589913,19
6126,86,29,44,19,-9.073857704921481,10
6127,107,39,80,26,-9.074881524481423,13
6128,40,16,57,10,-9.075047590769474,6
6129,55,11,89,7,-9.077967122900677,4
6130,8,34,95,21,-9.07920947405897,13
6131,75,12,94,8,-9.080901166069642,4
6132,6,10,15,7,-9.111932883212011,3
6133,31,15,109,10,-9.113887572404183,5
6134,17,11,92,7,-9.114563540800457,4
6135,102,17,30,10,-9.136610239450578,7
6136,106,25,39,15,-9.155969378752744,10
6137,5,43,50,26,-9.156049369840705,17
6138,63,21,62,13,-9.161474645821366,8
6139,72,14,63,10,-9.168022793278983,4
6140,40,15,92,10,-9.168940871834318,5
6141,29,22,112,14,-9.174610307731975,8
6142,91,13,15,7,-9.175439096539634,6
6143,38,14,53,9,-9.17946873124013,5
6144,91,14,23,8,-9.188824217195519,6
6145,63,16,81,10,-9.193429569946268,6
6146,76,36,63,24,-9.197425932191027,12
6147,40,17,73,11,-9.199997222971483,6
6148,90,11,93,7,-9.204947446014161,4
6149,12,27,78,19,-9.208018205719984,8
6150,108,16,48,11,-9.209950001192905,5
6151,103,21,107,14,-9.216518894849145,7
6152,69,16,70,11,-9.227346228401576,5
6153,3,17,54,10,-9.232444908063064,7
6154,20,23,91,14,-9.233435902067152,9
6155,62,12,18,8,-9.23480098215858,4
6156,48,34,86,22,-9.236642112579283,12
6157,53,15,78,9,-9.245467105519943,6
6158,51,22,34,14,-9.254702967852264,8
6159,29,14,70,8,-9.28377551108064,6
6160,112,16,49,10,-9.28817796315771,6
6161,18,17,100,10,-9.29762264727719,7
6162,29,26,100,16,-9.301757839272295,10
6163,38,10,45,7,-9.31109379184883,3
6164,84,10,77,7,-9.326879307665175,3
6165,51,15,111,10,-9.328246716797015,5
6166,2,29,28,19,-9.34282167881126,10
6167,87,20,1,12,-9.344990956449259,8
6168,23,19,55,11,-9.354242967773875,8
6169,34,13,94,8,-9.35579132587053,5
6170,84,21,104,13,-9.37162724208143,8
6171,4,16,27,10,-9.378715415982104,6
6172,16,25,81,16,-9.384174025613888,9
6173,12,31,60,17,-9.3846318247009,14
6174,36,11,109,8,-9.390936468630553,3
6175,38,16,27,11,-9.401601002215298,5
6176,41,25,100,16,-9.403294591957573,9
6177,57,17,103,11,-9.414120229975815,6
6178,2,15,13,9,-9.422510080465482,6
6179,63,11,32,7,-9.44232166344675,4
6180,89,19,41,13,-9.453124323035377,6
6181,96,47,16,33,-9.462953828826512,14
6182,60,29,100,19,-9.465662133176442,10
6183,15,23,43,15,-9.471477205647833,8
6184,57,16,23,10,-9.474501256774834,6
6185,77,15,72,9,-9.475978955314686,6
6186,3,10,37,6,-9.485691026106418,4
6187,88,40,15,28,-9.49255578246836,12
6188,84,11,18,7,-9.493458888054228,4
6189,99,22,37,15,-9.502759058160713,7
6190,51,35,15,22,-9.503627084553733,13
6191,2,13,114,8,-9.50915856241785,5
6192,80,14,90,10,-9.509239360264804,4
6193,69,13,33,8,-9.51115802646404,5
6194,36,17,8,11,-9.51236026695053,6
6195,64,14,62,8,-9.515284324050947,6
6196,9,27,18,18,-9.520249042639605,9
6197,25,32,20,21,-9.520523686179052,11
6198,31,22,1,13,-9.525804060927038,9
6199,51,15,48,8,-9.527077025607763,7
6200,75,11,20,7,-9.527707505687719,4
6201,108,13,106,9,-9.535201707134298,4
6202,34,13,18,9,-9.550016463821068,4
6203,103,12,49,7,-9.55110945659223,5
6204,13,23,26,16,-9.562123129591576,7
6205,31,28,27,16,-9.569633624787404,12
6206,48,12,17,7,-9.570482008629265,5
6207,7,20,73,12,-9.582485903794177,8
6208,112,27,64,19,-9.59501283307151,8
6209,53,13,8,9,-9.596286006275326,4
6210,84,18,83,11,-9.60947373437216,7
6211,8,14,99,8,-9.611065592860308,6
6212,109,17,70,11,-9.623350653501726,6
6213,12,18,103,10,-9.627784072806602,8
6214,53,23,41,15,-9.631953807885303,8
6215,114,10,22,5,-9.649313306364819,5
6216,75,11,85,8,-9.651599660168168,3
6217,13,10,101,7,-9.652646543094523,3
6218,71,12,100,8,-9.66068752031631,4
6219,60,47,64,32,-9.661747726131638,15
6220,69,27,78,17,-9.666260825143704,10
6221,114,34,8,23,-9.699231858321152,11
6222,84,30,8,20,-9.700360955856535,10
6223,11,18,75,11,-9.710887852205726,7
6224,8,30,68,19,-9.713048677811617,11
6225,8,15,52,10,-9.715026692600487,5
6226,37,12,78,8,-9.71930744346727,4
6227,31,19,43,9,-9.720852773553686,10
6228,3,20,72,12,-9.745718908399102,8
6229,18,49,16,33,-9.751591518104966,16
6230,53,14,15,9,-9.759389882181187,5
6231,83,24,37,15,-9.783726366978415,9
6232,93,10,62,6,-9.798162399200404,4
6233,62,16,114,10,-9.799890996069498,6
6234,55,20,27,14,-9.808864964478701,6
6235,19,18,34,12,-9.811807524582058,6
6236,17,24,40,16,-9.815776001763277,8
6237,57,13,54,10,-9.824315369895016,3
6238,69,17,47,11,-9.824856595944096,6
6239,47,17,9,11,-9.833363334347146,6
6240,98,10,53,6,-9.839111782848335,4
6241,3,10,74,7,-9.841517466916374,3
6242,13,21,44,14,-9.844973608163802,7
6243,33,26,51,19,-9.853114112635922,7
6244,12,20,104,13,-9.854826291134746,7
6245,27,28,54,18,-9.85712513922891,10
6246,57,14,38,8,-9.862555383696968,6
6247,27,12,22,8,-9.866452926590911,4
6248,1,17,75,12,-9.87310906944801,5
6249,71,15,17,9,-9.874078720771612,6
6250,54,17,2,12,-9.883928701627932,5
6251,49,33,100,21,-9.885330346900627,12
6252,29,14,20,9,-9.888770035938014,5
6253,16,20,110,13,-9.89345041941321,7
6254,51,18,79,10,-9.895968302837433,8
6255,83,14,11,10,-9.896151919094907,4
6256,54,47,37,31,-9.89694629679085,16
6257,68,21,103,13,-9.904114100948439,8
6258,75,35,28,23,-9.910859132469225,12
6259,60,34,54,23,-9.913747967452048,11
6260,70,18,30,11,-9.913973705469935,7
6261,57,11,1,7,-9.916035104284742,4
6262,39,50,30,31,-9.919924585068479,19
6263,84,50,63,31,-9.919938234846498,19
6264,2,10,95,7,-9.9203126299905,3
6265,29,15,75,9,-9.923300198268764,6
6266,50,16,78,11,-9.957089435942969,5
6267,90,14,46,9,-9.960134782518512,5
6268,88,18,73,12,-9.974203425238962,6
6269,12,21,53,13,-9.979940044053077,8
6270,109,14,93,9,-9.987067099161266,5
6271,65,25,95,16,-9.987438820754939,9
6272,84,27,30,19,-10.023299208241367,8
6273,91,19,30,13,-10.028289002870833,6
6274,107,13,110,9,-10.034721322746934,4
6275,46,14,78,8,-10.036009292919493,6
6276,38,10,44,7,-10.048373138060267,3
6277,83,23,13,15,-10.067954696106943,8
6278,19,41,27,28,-10.068063409604914,13
6279,49,16,40,10,-10.077718304922938,6
6280,106,12,79,8,-10.079963228120917,4
6281,17,17,23,11,-10.090670558592322,6
6282,76,32,23,20,-10.095144638641566,12
6283,3,15,17,9,-10.104489232217418,6
6284,70,30,87,18,-10.114463896406376,12
6285,36,36,53,25,-10.11473282468799,11
6286,114,12,78,7,-10.123963867745248,5
6287,109,10,92,7,-10.132066653367776,3
6288,31,37,53,23,-10.136338371296794,14
6289,57,21,79,13,-10.139577379833112,8
6290,109,15,94,9,-10.140509349254694,6
6291,23,11,96,7,-10.143008283174424,4
6292,68,16,92,11,-10.14730683848729,5
6293,81,32,51,20,-10.158277615855122,12
6294,49,27,98,18,-10.169586744689964,9
6295,9,12,6,7,-10.175309866966634,5
6296,60,46,27,32,-10.177471149675247,14
6297,37,41,97,27,-10.190687502541847,14
6298,33,13,71,9,-10.195530501937561,4
6299,2,15,98,9,-10.198603389321665,6
6300,104,19,90,12,-10.205908373136605,7
6301,39,24,91,16,-10.206322081312436,8
6302,28,14,10,10,-10.2079261309438,4
6303,31,17,30,10,-10.214096274935343,7
6304,91,35,63,24,-10.225389928816243,11
6305,23,21,49,14,-10.242959754676487,7
6306,106,16,67,10,-10.252161434234205,6
6307,39,43,18,29,-10.257246202371956,14
6308,84,16,103,9,-10.266610610260122,7
6309,68,22,72,15,-10.275897741373276,7
6310,112,24,60,16,-10.282975838759182,8
6311,107,23,45,15,-10.289536165233189,8
6312,31,29,107,16,-10.30345756995746,13
6313,88,43,53,29,-10.308417089519109,14
6314,15,13,108,9,-10.31501087444828,4
6315,65,10,35,7,-10.321578642281732,3
6316,10,14,11,9,-10.326527517070998,5
6317,46,18,30,12,-10.329090932236761,6
6318,1,13,37,8,-10.34216426905315,5
6319,102,16,40,10,-10.346146758066936,6
6320,27,15,17,9,-10.354549099588288,6
6321,7,10,94,7,-10.355621654064775,3
6322,88,39,50,25,-10.364860984100913,14
6323,69,24,63,16,-10.366973166191583,8
6324,55,16,15,12,-10.37053728825799,4
6325,93,16,106,10,-10.37915501513517,6
6326,92,14,16,11,-10.38158487536854,3
6327,35,26,76,17,-10.390096019432454,9
6328,103,14,72,9,-10.391960458595065,5
6329,114,19,95,12,-10.422604339796184,7
6330,57,17,76,12,-10.424696568875106,5
6331,39,16,44,10,-10.434810009571377,6
6332,9,17,43,10,-10.43571876790201,7
6333,94,10,77,7,-10.443428313097055,3
6334,33,11,30,8,-10.449500632702227,3
6335,31,10,6,6,-10.459894630543896,4
6336,49,14,94,10,-10.474432971630804,4
6337,48,37,63,25,-10.480037623792747,12
6338,48,10,62,6,-10.487894133335649,4
6339,9,27,64,19,-10.495957554452968,8
6340,102,16,63,10,-10.517349087153978,6
6341,37,14,89,8,-10.519274673853,6
6342,36,27,27,17,-10.523349599331356,10
6343,97,19,71,13,-10.523533962196899,6
6344,17,16,41,11,-10.533333329606139,5
6345,108,13,76,9,-10.539317855686345,4
6346,20,39,50,26,-10.540260354284218,13
6347,11,15,49,10,-10.54175783006079,5
6348,3,26,28,17,-10.54496551322771,9
6349,79,13,19,8,-10.549815768045496,5
6350,40,17,28,10,-10.551622113062638,7
6351,54,19,71,12,-10.56377327137223,7
6352,9,15,95,9,-10.569002592922953,6
6353,75,26,104,17,-10.574353916694225,9
6354,37,16,49,10,-10.578750157819186,6
6355,109,38,11,26,-10.59201718767136,12
6356,49,21,41,14,-10.608235357108475,7
6357,91,31,7,22,-10.60910028610159,9
6358,103,13,28,9,-10.6092467019397,4
6359,91,12,69,7,-10.612845012106748,5
6360,71,18,98,12,-10.627953776602759,6
6361,35,11,3,7,-10.637414854102069,4
6362,43,23,55,17,-10.640503492252689,6
6363,16,11,26,7,-10.641463660095837,4
6364,98,25,5,16,-10.662918685540621,9
6365,100,11,47,7,-10.66425762434052,4
6366,9,21,20,14,-10.676297323703047,7
6367,76,13,75,8,-10.684711333832395,5
6368,36,13,43,8,-10.713552025008546,5
6369,111,11,54,8,-10.714143810197228,3
6370,106,64,16,44,-10.722961682071126,20
6371,17,22,53,15,-10.723383781136489,7
6372,108,23,53,14,-10.749834986479383,9
6373,57,21,65,14,-10.760244548071404,7
6374,7,11,59,8,-10.771239818059199,3
6375,19,25,7,18,-10.775977198177875,7
6376,91,25,55,18,-10.791612827626562,7
6377,89,12,63,9,-10.816669680392751,3
6378,81,17,106,10,-10.816681182916206,7
6379,94,16,85,11,-10.818759630623866,5
6380,65,26,38,16,-10.83463870682702,10
6381,15,14,62,9,-10.843943580538047,5
6382,114,31,87,19,-10.855794018644563,12
6383,67,17,86,11,-10.856458271232285,6
6384,43,15,34,10,-10.890919445406585,5
6385,66,10,11,6,-10.898142591848792,4
6386,5,17,73,11,-10.90738305979487,6
6387,86,37,102,25,-10.919714046293317,12
6388,66,10,78,6,-10.927212098742269,4
6389,88,19,102,14,-10.972125082564368,5
6390,97,25,13,16,-10.985857531237674,9
6391,110,20,51,14,-11.000148170458745,6
6392,3,26,40,18,-11.007177692487943,8
6393,71,13,15,9,-11.00914391321026,4
6394,92,14,41,9,-11.016394202336143,5
6395,66,13,7,8,-11.034566799554375,5
6396,32,17,16,11,-11.045561391190384,6
6397,114,12,32,8,-11.045874107216177,4
6398,1,39,55,27,-11.047135752371082,12
6399,11,11,99,7,-11.04788337752713,4
6400,29,33,60,21,-11.07047089279055,12
6401,104,15,62,11,-11.098747349135209,4
6402,32,13,74,9,-11.101664191982367,4
6403,65,18,72,12,-11.109219542203151,6
6404,70,15,46,10,-11.123543654837002,5
6405,91,16,43,11,-11.128114127049445,5
6406,102,22,107,14,-11.147471989575463,8
6407,13,31,108,21,-11.148353863265475,10
6408,1,13,78,9,-11.156578268103178,4
6409,51,29,95,21,-11.161050582896516,8
6410,1,11,89,7,-11.20901106938993,4
6411,46,12,100,8,-11.210309669403358,4
6412,3,15,25,10,-11.21463496022273,5
6413,106,18,98,12,-11.217270403208776,6
6414,51,13,73,9,-11.219804453521853,4
6415,8,36,75,25,-11.220741251540183,11
6416,96,20,46,12,-11.223825219116964,8
6417,77,16,98,11,-11.231262510023575,5
6418,68,25,25,17,-11.235607083018872,8
6419,81,13,40,9,-11.249205674756395,4
6420,109,21,68,15,-11.251244714581787,6
6421,7,52,75,35,-11.2746633859962,17
6422,55,14,2,9,-11.276816159574057,5
6423,27,11,111,8,-11.279710088837586,3
6424,61,10,75,6,-11.283854363299366,4
6425,5,10,80,7,-11.295210617596885,3
6426,12,11,72,8,-11.296180739596437,3
6427,69,36,49,22,-11.300366835956483,14
6428,96,25,7,18,-11.300422106484014,7
6429,20,12,64,9,-11.331308462604776,3
6430,112,11,108,7,-11.335603356831987,4
6431,77,30,104,20,-11.335858846829382,10
6432,62,21,74,14,-11.355871307801838,7
6433,102,15,75,11,-11.3579023724584,4
6434,112,22,28,15,-11.372427658976596,7
6435,78,28,39,19,-11.374922957505097,9
6436,10,14,107,9,-11.38119632500004,5
6437,38,11,4,8,-11.395009854616482,3
6438,95,10,29,7,-11.401888238693147,3
6439,18,17,47,12,-11.411676107822032,5
6440,18,47,13,31,-11.43817217657445,16
6441,68,18,50,11,-11.447393428752164,7
6442,106,41,114,27,-11.462749893343954,14
6443,18,15,11,10,-11.496523839067972,5
6444,75,14,98,9,-11.497093707313171,5
6445,81,15,7,9,-11.525413070422037,6
6446,7,12,110,7,-11.526061320417652,5
6447,76,15,74,9,-11.544600382799558,6
6448,3,15,38,10,-11.55575224939262,5
6449,3,13,108,9,-11.562059375800661,4
6450,71,10,111,7,-11.563837134119527,3
6451,104,16,36,10,-11.564722196156035,6
6452,39,15,90,10,-11.577976501423594,5
6453,13,41,30,27,-11.600993566247702,14
6454,70,23,11,16,-11.609570033059052,7
6455,38,17,75,13,-11.628826987325242,4
6456,40,12,100,8,-11.638460148115906,4
6457,83,17,107,12,-11.644521740420235,5
6458,104,11,93,7,-11.670878710804795,4
6459,88,10,21,7,-11.67738292245627,3
6460,81,10,8,7,-11.678569579324556,3
6461,28,23,34,16,-11.682170467841411,7
6462,96,13,91,9,-11.692854193124042,4
6463,88,82,13,57,-11.731891784753874,25
6464,69,12,34,10,-11.742698738008174,2
6465,43,31,100,20,-11.757793113852523,11
6466,43,20,54,13,-11.759609270938485,7
6467,62,10,112,7,-11.78047192200998,3
6468,65,12,91,8,-11.784658313781671,4
6469,54,10,44,7,-11.791894285038754,3
6470,40,21,8,15,-11.791921402372775,6
6471,108,11,8,8,-11.805411430354427,3
6472,91,10,53,7,-11.811611902058761,3
6473,17,10,83,6,-11.812775268760374,4
6474,111,16,28,11,-11.820301223407922,5
6475,64,10,74,6,-11.828764368523549,4
6476,28,47,63,33,-11.828866423716303,14
6477,86,17,92,11,-11.83357437507567,6
6478,3,30,30,21,-11.833742535667648,9
6479,28,34,74,23,-11.834419909257845,11
6480,107,45,57,30,-11.845167977874887,15
6481,41,22,111,14,-11.859477089655313,8
6482,12,11,79,7,-11.866943529008417,4
6483,11,13,2,9,-11.88450219450607,4
6484,77,17,71,12,-11.915487518479782,5
6485,12,30,94,19,-11.933387464684667,11
6486,65,46,114,30,-11.938229846486397,16
6487,18,27,95,18,-11.951490678023534,9
6488,55,18,102,12,-11.983866194974432,6
6489,29,16,64,12,-12.010507228979478,4
6490,81,29,87,18,-12.01535695996611,11
6491,104,12,1,8,-12.020108292717424,4
6492,89,10,7,7,-12.029257289487045,3
6493,89,10,10,7,-12.051235053807009,3
6494,63,18,1,11,-12.054495717242014,7
6495,85,19,39,12,-12.059881057913875,7
6496,71,22,104,14,-12.060518806565574,8
6497,3,20,53,14,-12.068087567340713,6
6498,28,11,26,8,-12.079045982156575,3
6499,19,21,72,15,-12.088885005162664,6
6500,35,11,8,8,-12.093356369533684,3
6501,72,20,28,14,-12.11934808588004,6
6502,70,12,34,8,-12.123530804367727,4
6503,4,10,15,6,-12.1242208434208,4
6504,63,12,92,7,-12.136993324985582,5
6505,47,13,55,8,-12.137143102946048,5
6506,96,40,11,27,-12.14102850879166,13
6507,70,22,2,14,-12.153236389251056,8
6508,99,21,107,14,-12.174640608684573,7
6509,57,25,70,15,-12.177083859404236,10
6510,84,35,11,24,-12.189911906563859,11
6511,29,26,13,17,-12.196916226476912,9
6512,13,11,42,8,-12.203174115394757,3
6513,106,11,78,8,-12.21024325274275,3
6514,37,19,64,13,-12.216856507558585,6
6515,43,19,75,14,-12.224767647713705,5
6516,60,22,74,14,-12.230302476711504,8
6517,19,28,51,20,-12.24185979909306,8
6518,78,11,38,8,-12.248719399574965,3
6519,19,16,9,11,-12.252328421645837,5
6520,84,11,71,8,-12.255989147154674,3
6521,39,10,32,7,-12.25900875776762,3
6522,41,13,34,8,-12.262731570966233,5
6523,60,18,37,11,-12.263894360602317,7
6524,39,21,109,15,-12.264003725130951,6
6525,18,15,69,10,-12.281407888329312,5
6526,96,29,98,20,-12.301665445316491,9
6527,57,14,75,10,-12.306540056833528,4
6528,60,24,47,17,-12.306617941323186,7
6529,104,23,49,16,-12.322985298305156,7
6530,19,13,18,9,-12.34789234634166,4
6531,97,12,67,9,-12.35346782744064,3
6532,12,14,75,9,-12.356839423121746,5
6533,77,22,8,15,-12.389831393600819,7
6534,72,17,39,12,-12.40392712900527,5
6535,50,17,36,10,-12.423703215189779,7
6536,87,31,98,22,-12.43458344819276,9
6537,37,14,18,10,-12.438833593443572,4
6538,85,10,41,6,-12.470634664927642,4
6539,81,12,28,8,-12.485800898870087,4
6540,92,15,64,8,-12.492372460791037,7
6541,27,33,104,23,-12.514336487582195,10
6542,43,16,49,11,-12.516560129525121,5
6543,5,27,75,17,-12.535083552437035,10
6544,60,17,34,12,-12.542344059494537,5
6545,71,18,41,13,-12.557773267008848,5
6546,5,27,57,19,-12.572003913811173,8
6547,102,12,15,9,-12.597866884640942,3
6548,109,38,107,27,-12.59817428070907,11
6549,38,13,100,10,-12.638482369277126,3
6550,38,17,11,12,-12.666110828343466,5
6551,5,15,48,11,-12.675358072710548,4
6552,103,29,100,20,-12.678593336678208,9
6553,63,40,80,28,-12.682443988429267,12
6554,57,16,62,12,-12.692635812852643,4
6555,2,12,57,8,-12.707474284723991,4
6556,9,19,11,13,-12.708684805193936,6
6557,88,16,111,12,-12.710530076381987,4
6558,48,12,98,9,-12.72400980532305,3
6559,106,24,46,15,-12.725492516069489,9
6560,49,13,80,8,-12.731038457974943,5
6561,106,14,33,10,-12.736963404825662,4
6562,36,10,95,7,-12.746346244298937,3
6563,1,15,100,10,-12.750379039232412,5
6564,64,14,109,8,-12.756972146613661,6
6565,81,12,54,8,-12.757047966098474,4
6566,51,21,80,14,-12.779249811641693,7
6567,43,19,30,14,-12.796623632801937,5
6568,11,14,108,10,-12.798974196396992,4
6569,49,16,48,12,-12.810788363261887,4
6570,46,40,104,27,-12.826160652792538,13
6571,94,25,39,17,-12.842801062921897,8
6572,66,10,87,7,-12.884783195379665,3
6573,65,21,2,16,-12.8900275785182,5
6574,109,19,17,13,-12.911257852793488,6
6575,65,46,100,33,-12.913281442092941,13
6576,94,13,9,8,-12.936870793436032,5
6577,12,15,114,9,-12.949509468076533,6
6578,60,29,91,19,-12.952631394075716,10
6579,87,26,79,19,-12.964381621365796,7
6580,79,12,15,8,-13.059472232177564,4
6581,3,28,84,18,-13.065986590514674,10
6582,37,41,11,29,-13.080901694615491,12
6583,3,13,47,9,-13.091382859027684,4
6584,87,11,21,8,-13.114631052870209,3
6585,70,10,83,6,-13.118339150755117,4
6586,3,30,63,23,-13.136472607002512,7
6587,88,13,98,10,-13.137787822509532,3
6588,37,28,95,21,-13.149042342745602,7
6589,112,17,47,11,-13.19505835586536,6
6590,89,17,27,12,-13.200102555354917,5
6591,54,18,36,12,-13.217744798273172,6
6592,54,37,75,25,-13.241406019841683,12
6593,9,29,15,18,-13.254539415012557,11
6594,11,23,95,17,-13.263288005084238,6
6595,5,31,102,21,-13.269431869962297,10
6596,99,12,7,8,-13.274517260788413,4
6597,106,19,64,13,-13.295192075566398,6
6598,46,17,50,11,-13.310329365776978,6
6599,77,25,100,18,-13.319896480018867,7
6600,46,12,18,9,-13.322032493347338,3
6601,32,11,55,7,-13.36363963009391,4
6602,35,12,104,8,-13.369677424437175,4
6603,112,11,91,8,-13.423237527272477,3
6604,53,15,75,10,-13.423496737137004,5
6605,68,16,61,11,-13.424919545398375,5
6606,32,12,25,7,-13.427877456338663,5
6607,45,15,23,11,-13.436468047997268,4
6608,53,19,43,14,-13.438033142991657,5
6609,35,15,36,11,-13.440272285829963,4
6610,77,19,43,13,-13.44590515078262,6
6611,60,14,103,10,-13.46964943119417,4
6612,69,24,27,16,-13.483104419153626,8
6613,108,12,84,9,-13.488009207908556,3
6614,63,32,30,22,-13.49817196218878,10
6615,6,10,80,7,-13.522871173076245,3
6616,109,17,57,12,-13.555888364324371,5
6617,91,12,76,9,-13.56346091448288,3
6618,74,10,15,7,-13.56932630742914,3
6619,11,31,104,22,-13.57220534859567,9
6620,57,20,34,14,-13.584679931175108,6
6621,12,13,9,9,-13.614723999539923,4
6622,94,12,17,8,-13.646957443918598,4
6623,18,11,49,8,-13.655065375637419,3
6624,49,13,47,10,-13.686396277061279,3
6625,44,14,104,10,-13.703910249073422,4
6626,31,25,63,18,-13.714594813504094,7
6627,27,10,97,6,-13.735152835550487,4
6628,88,37,95,26,-13.752013257016609,11
6629,20,16,34,12,-13.76310700617088,4
6630,58,26,65,18,-13.766462789610351,8
6631,76,19,7,12,-13.791356001018313,7
6632,112,11,97,9,-13.794615799527321,2
6633,31,74,13,51,-13.800549608099518,23
6634,31,17,98,11,-13.805084918983175,6
6635,112,14,38,11,-13.819485047030144,3
6636,50,18,77,14,-13.854547351284703,4
6637,104,14,34,10,-13.864298464092721,4
6638,50,19,53,13,-13.883151416746287,6
6639,12,25,41,18,-13.88552635420771,7
6640,112,10,25,7,-13.919292260310078,3
6641,3,31,100,22,-13.921725717823314,9
6642,112,11,37,8,-13.937736127059297,3
6643,20,14,60,10,-13.93992645286088,4
6644,69,19,75,14,-13.94230448490658,5
6645,109,11,91,8,-13.94618860472034,3
6646,71,24,40,17,-13.948125771645659,7
6647,39,21,108,14,-13.94833446698378,7
6648,109,29,114,22,-13.961336538901845,7
6649,75,12,111,8,-13.972281809419961,4
6650,54,29,48,20,-14.01975726236914,9
6651,39,11,45,7,-14.033377854173942,4
6652,109,23,15,18,-14.044569549955568,5
6653,77,29,40,21,-14.048771071022598,8
6654,103,15,55,11,-14.058125972172373,4
6655,38,22,104,15,-14.071473191155556,7
6656,9,30,41,21,-14.113579732248974,9
6657,98,15,109,11,-14.143515346576434,4
6658,75,10,72,7,-14.207053385683185,3
6659,7,17,61,11,-14.217702740281519,6
6660,68,28,100,19,-14.286728990485932,9
6661,37,12,34,9,-14.300571264435137,3
6662,102,11,46,8,-14.307494713152051,3
6663,57,12,31,8,-14.310689026630849,4
6664,86,25,26,19,-14.32203675657022,6
6665,77,27,7,19,-14.33556677589385,8
6666,83,10,40,8,-14.347262135245904,2
6667,81,15,100,10,-14.382694095158195,5
6668,90,16,20,11,-14.40477443227545,5
6669,78,19,76,15,-14.413574538633682,4
6670,70,26,108,19,-14.427393649276276,7
6671,14,11,80,7,-14.435345395194508,4
6672,35,13,97,10,-14.4445517315995,3
6673,5,12,44,9,-14.447481002517355,3
6674,35,13,63,9,-14.450412261730216,4
6675,2,10,73,7,-14.457830254043136,3
6676,76,10,80,7,-14.461464881129865,3
6677,25,12,34,9,-14.468789684868275,3
6678,109,23,30,17,-14.492932426090908,6
6679,62,11,12,8,-14.509530975721363,3
6680,77,15,15,11,-14.526389381898245,4
6681,37,12,73,8,-14.533349572792924,4
6682,50,19,80,15,-14.554439051919099,4
6683,99,12,50,8,-14.581629542155014,4
6684,109,34,27,23,-14.672056456650022,11
6685,78,19,17,13,-14.709203332504178,6
6686,83,19,114,14,-14.71253096490687,5
6687,29,10,74,7,-14.72390247298373,3
6688,31,10,100,7,-14.730848989291465,3
6689,102,11,90,6,-14.739148726840858,5
6690,106,14,32,11,-14.741977351969277,3
6691,51,22,72,15,-14.75505634651796,7
6692,19,15,55,10,-14.762490489035601,5
6693,109,14,72,11,-14.772801167610014,3
6694,35,11,102,7,-14.787485364380144,4
6695,76,13,15,9,-14.81353391108204,4
6696,38,13,87,9,-14.859584047072818,4
6697,28,12,110,8,-14.8602682733133,4
6698,94,42,16,31,-14.871920571902171,11
6699,77,29,16,21,-14.872386678350562,8
6700,22,12,13,9,-14.994671319317485,3
6701,75,10,45,8,-15.003649946946844,2
6702,99,18,25,13,-15.014737107768294,5
6703,93,10,38,6,-15.046407356806796,4
6704,79,16,104,11,-15.05495488242158,5
6705,77,10,54,9,-15.067841236649627,1
6706,47,13,78,9,-15.091757543510102,4
6707,29,10,71,8,-15.14318831762859,2
6708,46,14,93,11,-15.251126640356869,3
6709,94,12,104,9,-15.27233865597327,3
6710,84,15,41,11,-15.33074063826509,4
6711,2,15,100,10,-15.363858490781986,5
6712,25,14,49,10,-15.43786379260084,4
6713,94,15,62,11,-15.456678982493086,4
6714,107,25,73,17,-15.460672720698524,8
6715,103,12,74,9,-15.463990000688312,3
6716,39,12,2,9,-15.473797666414958,3
6717,84,22,112,16,-15.486639525748986,6
6718,31,15,69,10,-15.502962092044207,5
6719,104,20,64,15,-15.515264160119221,5
6720,10,11,37,7,-15.516949569025604,4
6721,14,11,25,9,-15.536643242754739,2
6722,9,16,48,12,-15.537621007215709,4
6723,31,12,104,8,-15.561592201078605,4
6724,5,20,23,15,-15.563915929412014,5
6725,45,14,4,10,-15.600891470448104,4
6726,69,10,23,8,-15.603167423944376,2
6727,85,11,106,8,-15.605731963514037,3
6728,97,13,90,9,-15.62188808576594,4
6729,29,26,88,19,-15.663393885093672,7
6730,97,12,14,10,-15.664913845649806,2
6731,112,14,15,10,-15.700949053545525,4
6732,1,13,8,10,-15.702434313684371,3
6733,51,20,45,15,-15.703190735785386,5
6734,80,13,75,10,-15.71805205236554,3
6735,35,12,80,9,-15.72406211872363,3
6736,77,14,37,10,-15.73169378416834,4
6737,96,16,93,12,-15.73319462766121,4
6738,35,10,75,8,-15.755761764469415,2
6739,93,11,30,8,-15.77720736230077,3
6740,88,19,80,13,-15.78210749106585,6
6741,17,22,95,17,-15.802621580377178,5
6742,41,12,15,9,-15.83344464930069,3
6743,31,45,16,33,-15.837412153743443,12
6744,51,23,94,17,-15.876961640520744,6
6745,28,29,90,22,-15.880089586771652,7
6746,57,18,94,13,-15.891839037049907,5
6747,28,12,43,8,-15.894105628705272,4
6748,9,30,53,22,-15.894615033798411,8
6749,70,13,80,11,-15.90133341789594,2
6750,51,18,2,12,-15.90559711313002,6
6751,76,18,54,13,-15.916701819672275,5
6752,63,13,14,9,-15.961958621197994,4
6753,85,17,30,12,-15.962999516967606,5
6754,37,14,15,11,-16.033544043199246,3
6755,5,18,41,12,-16.050377082501456,6
6756,37,11,68,8,-16.057273622388774,3
6757,103,11,50,8,-16.107700105307455,3
6758,41,17,30,12,-16.109597077758615,5
6759,112,15,71,11,-16.11687592102847,4
6760,46,13,98,9,-16.12835125202737,4
6761,102,10,43,7,-16.154622115934174,3
6762,35,12,48,9,-16.1584671300222,3
6763,60,16,102,11,-16.199085660218575,5
6764,80,12,34,10,-16.269229317512288,2
6765,2,19,104,13,-16.35238800305578,6
6766,57,22,100,16,-16.352929528191847,6
6767,83,13,27,11,-16.36809252264109,2
6768,40,10,29,8,-16.37829418439082,2
6769,39,19,99,15,-16.42872930905631,4
6770,25,25,11,20,-16.429746187224737,5
6771,55,15,14,12,-16.464885141480416,3
6772,87,10,61,7,-16.482333693393567,3
6773,64,10,66,8,-16.526342406123632,2
6774,83,20,16,15,-16.531803021169054,5
6775,81,17,49,12,-16.548537671207548,5
6776,68,22,95,18,-16.550204863156033,4
6777,36,10,101,8,-16.627946704419497,2
6778,69,23,53,17,-16.67657945090473,6
6779,112,28,78,21,-16.679149831728488,7
6780,12,11,55,8,-16.70360942532312,3
6781,103,13,109,9,-16.7215146195565,4
6782,71,15,95,10,-16.72675418994599,5
6783,83,13,23,10,-16.744700089549813,3
6784,76,10,1,7,-16.815372977495876,3
6785,97,14,38,11,-16.838290194315167,3
6786,69,14,72,11,-16.843378758894527,3
6787,57,21,7,14,-16.86838035950274,7
6788,12,13,30,10,-16.886629998777657,3
6789,48,14,78,11,-16.88793509976696,3
6790,10,12,13,9,-16.89276746041982,3
6791,112,19,20,15,-16.964936240764274,4
6792,31,10,38,6,-16.97274158238424,4
6793,102,11,48,9,-16.98431234773642,2
6794,46,11,43,8,-16.991693442801246,3
6795,109,15,12,12,-17.036286111783696,3
6796,70,11,48,8,-17.04295857723929,3
6797,102,12,29,10,-17.056577765128154,2
6798,1,14,18,11,-17.058153705270225,3
6799,9,29,27,21,-17.072056537621457,8
6800,2,11,60,8,-17.11684300008854,3
6801,23,13,72,10,-17.14817782244225,3
6802,41,10,6,7,-17.168490702692317,3
6803,5,22,27,16,-17.186967099907662,6
6804,112,12,55,10,-17.232830626787052,2
6805,29,15,109,10,-17.260757725038395,5
6806,106,10,35,7,-17.319051156851785,3
6807,54,11,34,9,-17.37969504408319,2
6808,35,10,60,7,-17.41812694726481,3
6809,29,10,80,8,-17.457200220457587,2
6810,18,14,23,10,-17.468338798211544,4
6811,83,11,110,9,-17.575104905290946,2
6812,67,10,20,8,-17.6724550880506,2
6813,9,12,108,8,-17.689021813252335,4
6814,3,11,5,7,-17.694163901939547,4
6815,58,23,86,18,-17.708236566074184,5
6816,51,23,90,18,-17.7178788097309,5
6817,55,12,44,9,-17.771847163193563,3
6818,5,18,30,15,-17.81053305502534,3
6819,88,17,32,13,-17.824594134673823,4
6820,114,11,111,8,-17.846918134233796,3
6821,41,10,35,7,-17.84884882348167,3
6822,62,16,78,12,-17.89987876325871,4
6823,30,15,95,11,-17.91990160883281,4
6824,54,10,67,8,-18.121548101252507,2
6825,79,10,75,8,-18.185200748196127,2
6826,43,12,81,9,-18.327617727929386,3
6827,6,11,19,8,-18.335706204340305,3
6828,13,20,80,14,-18.335804849316276,6
6829,18,10,5,8,-18.464269170029826,2
6830,31,15,106,11,-18.52908676481624,4
6831,33,19,55,15,-18.562648470025508,4
6832,12,10,45,8,-18.65380711999512,2
6833,28,17,99,13,-18.754584808369174,4
6834,102,12,27,10,-18.772173343475483,2
6835,35,15,87,11,-18.824404565886294,4
6836,4,13,98,11,-18.936498509144613,2
6837,106,11,89,7,-18.95338953455919,4
6838,57,14,29,11,-18.996915689300955,3
6839,106,10,92,8,-19.041690772468705,2
6840,43,12,45,9,-19.04326521517843,3
6841,54,16,4,14,-19.244087603842104,2
6842,18,14,99,11,-19.290873438644514,3
6843,36,19,30,17,-19.30529767168729,2
6844,6,11,30,9,-19.605882514870544,2
6845,108,12,114,9,-19.622938702057745,3
6846,5,11,64,9,-19.698196874853632,2
6847,94,11,48,9,-19.702972057039275,2
6848,31,11,15,8,-19.738787942525683,3
6849,32,12,95,10,-19.760326388824467,2
6850,33,15,65,12,-19.770112976636934,3
6851,97,13,73,9,-19.966763707753135,4
6852,84,12,7,10,-20.160900959942534,2
6853,68,38,112,30,-20.161440612174857,8
6854,34,10,64,8,-20.224712091526342,2
6855,103,10,75,9,-20.241991505098973,1
6856,10,15,51,12,-20.332726180509006,3
6857,66,11,13,9,-20.385605001870267,2
6858,3,17,48,13,-20.442566414929487,4
6859,94,23,81,17,-20.51779847980575,6
6860,79,11,17,9,-20.72101316555543,2
6861,68,11,90,9,-20.787956198015944,2
6862,3,17,75,14,-20.897191698320935,3
6863,62,11,34,9,-20.901478916088543,2
6864,10,14,112,11,-21.02177070913973,3
6865,43,10,110,8,-21.055981543018305,2
6866,112,16,80,12,-21.10879540796462,4
6867,72,11,57,11,-21.2224791597557,0
6868,51,11,101,9,-21.22662017561448,2
6869,91,16,104,15,-21.31971827875211,1
6870,58,11,49,9,-21.376962439830404,2
6871,4,13,25,11,-21.42004260246313,2
6872,4,15,41,10,-21.480590173913868,5
6873,31,12,62,9,-21.790941067775986,3
6874,38,12,55,10,-22.071024000200875,2
6875,57,14,112,11,-22.163408269660163,3
6876,97,12,91,10,-22.175648770183788,2
6877,109,13,19,11,-22.638381086719185,2
6878,1,10,3,8,-22.67051623941871,2
6879,29,12,72,10,-22.84597050029316,2
6880,8,11,4,10,-23.17790508365148,1
6881,66,10,58,9,-23.43526848489906,1
6882,77,19,75,16,-23.528365703077355,3
6883,97,11,34,9,-24.058676404388496,2
6884,33,10,100,9,-24.40727081526952,1
6885,42,11,104,10,-24.554805995086454,1
6886,57,12,26,10,-24.80508950345583,2
6887,89,11,11,10,-25.076774065413545,1
6888,38,10,69,9,-27.695920761479563,1
6889,23,13,90,12,-28.362481429909796,1
6890,37,11,44,11,-29.883498899257123,0
6891,102,16,112,15,-31.192976791251173,1
