,againstHero,games,hero,losses,shift,wins
0,17,10,81,0,31.104140358623045,10
1,44,11,37,0,29.88349889925713,11
2,112,18,102,2,28.496084585485107,16
3,98,10,61,0,28.323329566102494,10
4,69,10,38,1,27.695920761479556,9
5,98,10,81,1,27.56322031639677,9
6,49,10,106,1,25.681632401928862,9
7,55,15,38,2,25.19286181976179,13
8,90,14,23,2,25.1914979759845,12
9,26,16,57,3,24.881124922939264,13
10,104,11,42,1,24.55480599508646,10
11,74,10,53,2,24.36471273024663,8
12,75,19,77,3,23.52836570307736,16
13,4,11,8,1,23.177905083651485,10
14,104,18,91,1,22.937436859705542,17
15,3,10,1,2,22.670516239418717,8
16,91,12,97,2,22.175648770183784,10
17,62,12,31,3,21.790941067775986,9
18,41,15,4,5,21.48059017391386,10
19,25,13,4,2,21.420042602463127,11
20,75,18,3,3,21.417290354619,15
21,101,11,51,2,21.226620175614492,9
22,76,11,31,1,21.157211826935978,10
23,80,16,112,4,21.108795407964617,12
24,51,16,10,3,21.051824036569297,13
25,109,10,90,1,21.034570289962243,9
26,100,12,33,2,21.028397065514316,10
27,112,14,10,3,21.021770709139737,11
28,3,10,95,2,20.57885087785416,8
29,34,11,77,1,20.530353874618392,10
30,81,23,94,6,20.517798479805748,17
31,30,11,10,2,20.38962047667116,9
32,76,14,43,2,20.242512745323427,12
33,75,10,103,1,20.24199150509897,9
34,112,38,68,8,20.161440612174868,30
35,7,12,84,2,20.160900959942538,10
36,48,22,3,5,20.04071280653289,17
37,4,17,54,2,19.994435391851386,15
38,73,13,97,4,19.966763707753138,9
39,30,12,6,2,19.865749004424455,10
40,89,12,106,4,19.849086778440608,8
41,95,12,32,2,19.760326388824467,10
42,15,11,31,3,19.738787942525676,8
43,64,11,5,2,19.698196874853622,9
44,80,11,29,2,19.670803114551134,9
45,114,12,29,3,19.392096732655677,9
46,64,14,34,3,19.390401823844165,11
47,30,19,36,2,19.305297671687292,17
48,99,14,18,3,19.290873438644518,11
49,34,13,62,3,19.217276142512915,10
50,92,10,106,2,19.04169077246869,8
51,98,13,4,2,18.93649850914462,11
52,34,12,97,3,18.831202908180163,9
53,55,20,33,4,18.82593244000092,16
54,27,12,102,2,18.772173343475483,10
55,99,17,28,4,18.75458480836917,13
56,112,16,57,4,18.741640604630682,12
57,48,14,94,3,18.679447719754858,11
58,95,16,30,4,18.59476138296642,12
59,106,15,31,4,18.52908676481623,11
60,72,13,81,4,18.287707067400415,9
61,29,20,57,4,18.20864139751641,16
62,67,10,54,2,18.121548101252504,8
63,54,21,76,5,18.08934803214948,16
64,35,10,41,3,17.84884882348167,7
65,111,11,114,3,17.846918134233793,8
66,32,17,88,4,17.824594134673823,13
67,48,13,35,3,17.821530991658573,10
68,30,18,5,3,17.81053305502534,15
69,35,13,109,3,17.789223446519653,10
70,85,10,15,2,17.788004047228643,8
71,44,12,55,3,17.77184716319358,9
72,90,12,68,3,17.719685937760904,9
73,81,16,43,4,17.708072706454832,12
74,5,11,3,4,17.694163901939536,7
75,20,10,67,2,17.672455088050597,8
76,102,18,60,5,17.60770484195146,13
77,104,13,94,3,17.60567868727478,10
78,109,11,18,3,17.59427158865158,8
79,110,11,83,2,17.575104905290953,9
80,108,11,109,3,17.40163308376229,8
81,94,12,72,3,17.39792400004009,9
82,35,10,106,3,17.31905115685177,7
83,27,22,5,6,17.18696709990766,16
84,88,28,29,7,17.154392005842116,21
85,60,11,2,3,17.116843000088547,8
86,18,15,46,3,17.114833090306377,12
87,27,29,9,8,17.072056537621442,21
88,18,14,1,3,17.058153705270215,11
89,73,13,37,4,17.032463348069772,9
90,90,25,51,6,16.98113610300884,19
91,38,10,31,4,16.97274158238423,6
92,20,19,112,4,16.964936240764278,15
93,43,12,46,3,16.90387334173946,9
94,22,10,41,2,16.895138763704843,8
95,13,12,10,3,16.89276746041981,9
96,26,11,12,3,16.87748269880037,8
97,37,12,10,4,16.877061428062927,8
98,80,21,13,7,16.796282689859083,14
99,77,15,76,3,16.756455650082987,12
100,60,10,26,3,16.74543091529222,7
101,23,13,83,3,16.74470008954982,10
102,95,15,71,5,16.726754189945982,10
103,78,28,112,7,16.67914983172849,21
104,53,23,69,6,16.676579450904736,17
105,101,10,36,2,16.627946704419482,8
106,30,25,41,6,16.625400058969603,19
107,95,22,68,4,16.55020486315604,18
108,17,12,79,3,16.528587589888392,9
109,34,10,61,1,16.513382683902012,9
110,16,46,31,12,16.494251500601973,34
111,14,15,55,3,16.46488514148042,12
112,74,12,64,4,16.440953543226588,8
113,19,11,37,2,16.4401797639671,9
114,99,19,39,4,16.42872930905631,15
115,14,14,63,4,16.386711509096077,10
116,29,10,40,2,16.378294184390825,8
117,110,11,43,3,16.376498956572302,8
118,27,13,83,2,16.3680925226411,11
119,104,19,2,6,16.35238800305577,13
120,25,12,14,2,16.337614979675553,10
121,65,16,33,4,16.286121361101067,12
122,34,12,80,2,16.26922931751229,10
123,18,11,89,3,16.194414256598467,8
124,98,13,46,4,16.128351252027375,9
125,71,15,112,4,16.11687592102847,11
126,87,19,35,6,16.11679485458087,13
127,41,18,5,6,16.050377082501452,12
128,53,31,9,8,16.014655893145633,23
129,8,13,108,3,16.00695825478633,10
130,57,11,90,3,15.975273202140915,8
131,62,12,48,4,15.963389974606171,8
132,80,13,70,2,15.901333417895945,11
133,90,29,28,7,15.88008958677165,22
134,80,14,76,4,15.87988367140994,10
135,93,15,46,3,15.866750824235567,12
136,95,22,17,5,15.802621580377183,17
137,12,18,62,5,15.77140020730931,13
138,110,13,28,4,15.75542536900984,9
139,17,13,94,4,15.746212612138288,9
140,93,16,96,4,15.733194627661216,12
141,80,12,35,3,15.724062118723628,9
142,75,13,80,3,15.718052052365538,10
143,15,14,112,4,15.700949053545523,10
144,14,12,97,2,15.664913845649805,10
145,90,13,97,4,15.621888085765939,9
146,106,11,85,3,15.605731963514026,8
147,4,14,45,4,15.60089147044811,10
148,100,10,90,2,15.59689537510572,8
149,23,21,5,5,15.554175057753397,16
150,69,15,31,5,15.502962092044207,10
151,9,15,12,4,15.494125308722385,11
152,112,23,84,6,15.486639525748984,17
153,2,12,39,3,15.473797666414951,9
154,73,25,107,8,15.46067272069853,17
155,5,11,18,3,15.389394006883377,8
156,100,15,2,5,15.36385849078198,10
157,114,15,108,4,15.270376800556944,11
158,27,10,90,2,15.266408205709798,8
159,100,36,3,9,15.17022099047744,27
160,48,31,54,9,15.15203502038891,22
161,71,10,29,2,15.143188317628589,8
162,43,13,102,4,15.12742817504257,9
163,86,29,58,7,15.095351107022626,22
164,60,16,20,4,15.074406318316193,12
165,25,18,99,5,15.014737107768298,13
166,45,10,75,2,15.00364994694684,8
167,13,12,22,3,14.994671319317483,9
168,80,14,49,5,14.99318638978968,9
169,49,10,44,3,14.992301775479177,7
170,104,24,38,7,14.977006233689528,17
171,74,15,103,4,14.97396136778404,11
172,111,18,88,4,14.891378091601458,14
173,38,12,93,5,14.887591780281296,7
174,102,11,35,4,14.787485364380144,7
175,7,11,89,3,14.785043291363074,8
176,17,21,109,6,14.77972719513033,15
177,11,26,25,6,14.778705544740387,20
178,32,14,106,3,14.741977351969275,11
179,100,10,31,3,14.730848989291468,7
180,7,28,77,8,14.729495105034692,20
181,114,19,83,5,14.712530964906861,14
182,55,15,12,4,14.659208117082445,11
183,23,17,45,5,14.633454544359154,12
184,8,25,77,7,14.612256603393078,18
185,18,16,34,4,14.60047624736332,12
186,50,14,103,4,14.598236066613513,10
187,50,12,99,4,14.581629542155012,8
188,90,10,18,3,14.572865755876737,7
189,34,18,20,4,14.557800978959818,14
190,80,19,50,4,14.554439051919097,15
191,27,25,69,8,14.53516647824794,17
192,38,15,112,3,14.502554093851142,12
193,34,10,108,2,14.47806718750258,8
194,19,12,6,4,14.46906875309814,8
195,34,12,25,3,14.468789684868279,9
196,73,10,2,3,14.457830254043134,7
197,17,22,78,7,14.455986406772633,15
198,44,12,5,3,14.447481002517359,9
199,97,13,35,3,14.444551731599496,10
200,80,11,14,4,14.435345395194517,7
201,108,26,70,7,14.427393649276278,19
202,47,19,112,6,14.35203478831677,13
203,40,10,83,2,14.347262135245902,8
204,54,10,10,3,14.334784055636703,7
205,26,25,86,6,14.322036756570213,19
206,45,15,43,5,14.31794966361631,10
207,31,12,57,4,14.310689026630854,8
208,48,10,112,2,14.307464286387091,8
209,19,20,109,6,14.305000975474687,14
210,23,15,18,5,14.275894417804937,10
211,16,22,83,6,14.273795003910386,16
212,83,11,17,4,14.269615650014424,7
213,114,30,109,7,14.263150833488547,23
214,34,25,57,7,14.246419359699368,18
215,61,17,7,6,14.217702740281522,11
216,50,18,46,6,14.208875687593249,12
217,72,10,75,3,14.207053385683185,7
218,33,10,19,4,14.198164828754605,6
219,90,10,9,3,14.073147353965513,7
220,74,24,48,9,14.067708006346335,15
221,40,29,77,8,14.0487710710226,21
222,15,14,52,4,14.026248257676636,10
223,41,31,9,9,13.990507643067811,22
224,111,12,75,4,13.972281809419972,8
225,104,37,27,11,13.967437214255792,26
226,58,12,29,3,13.952580214272475,9
227,40,24,71,7,13.948125771645659,17
228,75,19,69,5,13.942304484906572,14
229,37,11,112,3,13.937736127059289,8
230,25,10,112,3,13.919292260310073,7
231,45,11,12,3,13.905186638720528,8
232,34,15,41,5,13.902632667621374,10
233,78,18,48,5,13.897964627407003,13
234,72,10,53,3,13.882269785370534,7
235,97,11,112,2,13.794615799527316,9
236,47,13,57,4,13.774921234941399,9
237,100,20,81,7,13.76479826478321,13
238,61,12,87,4,13.760538340997263,8
239,18,15,29,4,13.759102795902567,11
240,97,10,27,4,13.735152835550473,6
241,95,25,11,7,13.725658005456241,18
242,63,25,31,7,13.714594813504087,18
243,112,10,109,3,13.713802849046607,7
244,45,21,51,6,13.706946532575506,15
245,34,10,95,3,13.704508911135058,7
246,57,28,5,8,13.702708831126637,20
247,92,10,25,3,13.698642336458672,7
248,60,11,35,4,13.648279310586378,7
249,108,16,11,4,13.647782335147589,12
250,75,15,12,5,13.63556285801919,10
251,41,29,12,8,13.623588976279665,21
252,48,13,70,4,13.615964738776976,9
253,41,19,84,6,13.556150264603875,13
254,80,10,6,3,13.522871173076231,7
255,87,19,38,6,13.505889307722844,13
256,55,13,112,3,13.49840576791747,10
257,84,12,108,3,13.488009207908556,9
258,109,18,98,5,13.444061011572101,13
259,38,12,43,5,13.44163918850029,7
260,36,15,35,4,13.440272285829971,11
261,25,12,32,5,13.427877456338669,7
262,61,16,68,5,13.424919545398383,11
263,75,15,53,5,13.423496737137011,10
264,58,14,103,4,13.42165289938014,10
265,71,15,84,4,13.41321574412034,11
266,80,22,51,7,13.405837899191413,15
267,74,12,3,3,13.385856762614395,9
268,43,20,53,5,13.37608227868746,15
269,104,12,35,4,13.369677424437175,8
270,108,10,12,4,13.367955655554766,6
271,17,14,48,5,13.364907872446567,9
272,55,11,32,4,13.363639630093912,7
273,35,18,45,7,13.348739323329763,11
274,108,13,9,5,13.341841222661904,8
275,11,16,18,5,13.321280125838719,11
276,15,17,37,4,13.319007709477827,13
277,9,17,19,5,13.31812011403307,12
278,8,12,35,3,13.311489751182302,9
279,80,20,88,7,13.305539707805673,13
280,8,14,1,4,13.305141225086524,10
281,64,19,106,6,13.295192075566392,13
282,104,43,46,14,13.294982678813746,29
283,100,33,68,11,13.287177831750675,22
284,7,12,99,4,13.27451726078842,8
285,48,20,49,5,13.272537147968347,15
286,15,38,109,10,13.249531706046113,28
287,95,39,88,12,13.236869470595256,27
288,36,18,54,6,13.217744798273168,12
289,109,20,29,8,13.210765864197802,12
290,19,14,79,5,13.189433599982168,9
291,108,18,3,5,13.149455786492918,13
292,95,28,37,7,13.149042342745599,21
293,13,32,29,11,13.136727901073607,21
294,48,13,103,3,13.133825600656486,10
295,94,10,91,2,13.125494056890847,8
296,74,23,62,7,13.07201740553172,16
297,55,14,47,5,13.036465008068177,9
298,15,18,55,4,13.03115867267244,14
299,27,43,109,14,13.01783435328702,29
300,63,14,35,5,12.998216518752985,9
301,65,25,57,7,12.982382134863352,18
302,92,10,84,4,12.962976398847768,6
303,98,19,106,6,12.954874150336938,13
304,64,20,37,6,12.946494518825181,14
305,64,10,94,4,12.918584959999516,6
306,2,21,65,5,12.890027578518191,16
307,42,10,41,3,12.856406375174817,7
308,53,24,109,7,12.84584836422391,17
309,64,22,29,5,12.835455672871142,17
310,1,11,76,4,12.827717897490277,7
311,13,13,66,4,12.789636021700206,9
312,49,15,25,5,12.785517383168523,10
313,84,31,3,11,12.7817713508444,20
314,76,18,89,5,12.75804553023341,13
315,100,15,1,5,12.750379039232417,10
316,95,10,36,3,12.746346244298936,7
317,11,44,37,14,12.738426249160874,30
318,98,33,87,9,12.73723226761893,24
319,33,14,106,4,12.736963404825657,10
320,27,13,45,4,12.720614115305077,9
321,27,22,89,6,12.719981225557996,16
322,64,21,104,6,12.715850674799656,15
323,13,76,31,25,12.705633823012963,51
324,80,40,63,12,12.682443988429267,28
325,38,16,97,5,12.68239796661763,11
326,104,13,31,5,12.68196482072701,8
327,48,15,5,4,12.675358072710559,11
328,7,23,57,9,12.666461617234948,14
329,85,20,94,6,12.645956344332358,14
330,30,34,63,11,12.643300278538094,23
331,39,20,85,7,12.618845399489865,13
332,53,24,108,9,12.606603502458741,15
333,47,19,49,5,12.600068108513417,14
334,2,21,51,8,12.59592396910538,13
335,41,18,71,5,12.557773267008855,13
336,63,32,3,8,12.548769683390436,24
337,42,12,13,3,12.522183516198908,9
338,64,15,92,7,12.492372460791035,8
339,111,24,41,8,12.478825250714587,16
340,23,11,69,3,12.468155133637696,8
341,79,30,87,8,12.466071130940087,22
342,18,14,37,4,12.438833593443572,10
343,36,17,50,7,12.423703215189775,10
344,53,11,91,3,12.419564767639509,8
345,12,24,109,7,12.4135045049996,17
346,34,16,38,4,12.397613710381254,12
347,49,12,92,4,12.374864484595678,8
348,67,12,97,3,12.353467827440639,9
349,13,91,88,27,12.345868204497036,64
350,39,12,66,4,12.326990757641061,8
351,13,34,94,11,12.315280597409904,23
352,98,18,88,5,12.300728896947142,13
353,69,15,18,5,12.281407888329316,10
354,40,15,81,4,12.276802562895192,11
355,98,30,96,9,12.27549839186978,21
356,49,29,11,8,12.265394797164886,21
357,73,19,88,6,12.262693289910839,13
358,32,10,39,3,12.259008757767624,7
359,100,25,57,8,12.24904881178982,17
360,64,14,20,3,12.230112840596973,11
361,75,19,43,5,12.224767647713705,14
362,33,19,20,6,12.22272846414757,13
363,15,10,97,3,12.205780494305644,7
364,78,13,89,4,12.201646848352171,9
365,34,15,54,4,12.199946008042932,11
366,2,15,11,5,12.196157085843712,10
367,75,11,35,3,12.188091693345983,8
368,75,21,109,6,12.181700739963029,15
369,78,23,62,8,12.17692984868392,15
370,107,21,99,7,12.174640608684578,14
371,2,22,70,8,12.153236389251047,14
372,53,20,50,7,12.152614797488543,13
373,11,40,96,13,12.141028508791658,27
374,93,13,104,4,12.138932518021328,9
375,15,10,4,4,12.124220843420797,6
376,45,11,38,3,12.11330845327379,8
377,107,18,83,5,12.107720877525319,13
378,76,15,91,4,12.09807191241983,11
379,16,49,94,14,12.097455142978449,35
380,87,13,85,4,12.077215618367395,9
381,100,17,38,4,12.063654867780365,13
382,1,18,63,7,12.054495717242016,11
383,10,10,89,3,12.05123505380701,7
384,30,20,46,6,12.044164698044929,14
385,43,14,28,5,12.028046594555397,9
386,98,35,49,11,12.02726278399483,24
387,1,12,104,4,12.02010829271743,8
388,102,32,5,11,12.011851390558954,21
389,102,18,55,6,11.983866194974429,12
390,37,15,77,5,11.967604181160285,10
391,76,22,57,6,11.963037229635306,16
392,95,27,18,9,11.951490678023532,18
393,28,13,81,4,11.947384191502273,9
394,70,27,57,10,11.940546365796532,17
395,114,46,65,16,11.938229846486395,30
396,108,16,68,5,11.92861631232352,11
397,71,17,77,5,11.915487518479784,12
398,98,18,31,7,11.908816140421921,11
399,79,11,12,4,11.866943529008417,7
400,53,16,38,5,11.864509466472807,11
401,72,11,58,3,11.847351060385245,8
402,92,11,109,3,11.825872450184745,8
403,94,22,57,7,11.796472246977714,15
404,8,21,40,6,11.791921402372768,15
405,44,10,54,3,11.791894285038762,7
406,51,34,81,12,11.790201731891965,22
407,112,10,62,3,11.780471922009976,7
408,49,21,81,8,11.780141471258919,13
409,62,19,94,6,11.771555517167428,13
410,55,18,19,6,11.767861803446278,12
411,74,24,60,9,11.762098333048542,15
412,63,17,102,6,11.747209471298389,11
413,34,12,69,2,11.742698738008174,10
414,55,25,43,6,11.714024478286158,19
415,81,14,109,4,11.703106695945644,10
416,100,36,103,12,11.698693937638303,24
417,91,13,96,4,11.692854193124049,9
418,34,23,28,7,11.682170467841413,16
419,8,10,81,3,11.678569579324542,7
420,7,26,19,7,11.65176644692338,19
421,55,23,23,9,11.64391055385205,14
422,15,34,9,14,11.64369161746246,20
423,100,12,40,4,11.638460148115916,8
424,11,10,110,2,11.637838089699006,8
425,75,17,38,4,11.628826987325251,13
426,55,18,103,5,11.613833617793848,13
427,75,16,29,6,11.609985031917775,10
428,11,23,70,7,11.609570033059047,16
429,15,10,45,3,11.60293644634431,7
430,43,18,91,5,11.584680594680322,13
431,33,11,43,4,11.58259324901405,7
432,23,11,11,3,11.568338446113309,8
433,36,16,104,6,11.564722196156035,10
434,111,10,71,3,11.563837134119524,7
435,21,13,87,4,11.56318091799384,9
436,53,14,46,5,11.556347535591735,9
437,63,25,69,8,11.548874027492651,17
438,87,34,81,13,11.530786241792942,21
439,18,12,84,4,11.526678691260484,8
440,110,12,7,5,11.526061320417648,7
441,98,21,77,6,11.52597944233578,15
442,7,15,81,6,11.525413070422038,9
443,7,20,76,8,11.522456617485858,12
444,35,11,65,3,11.518581403700487,8
445,98,14,75,5,11.497093707313164,9
446,68,12,37,4,11.496583691347068,8
447,94,10,89,2,11.466175489745245,8
448,114,41,106,14,11.462749893343949,27
449,34,20,60,6,11.434147211488856,14
450,77,20,50,5,11.423502497737047,15
451,75,39,54,14,11.408133317564468,25
452,73,10,75,5,11.395199340418811,5
453,4,11,38,3,11.395009854616482,8
454,16,48,77,16,11.380111902886718,32
455,75,15,102,4,11.357902372458392,11
456,78,17,53,6,11.357198680475333,11
457,52,11,108,3,11.346744817608853,8
458,58,15,66,4,11.346720879682533,11
459,108,11,112,4,11.335603356831966,7
460,104,15,44,5,11.332078649569057,10
461,49,15,55,5,11.3111037781176,10
462,69,13,91,5,11.30407928014614,8
463,74,17,76,7,11.297198648055824,10
464,80,10,5,3,11.295210617596885,7
465,111,11,27,3,11.279710088837586,8
466,2,14,55,5,11.276816159574052,9
467,75,52,7,17,11.2746633859962,35
468,83,11,70,5,11.265042422069474,6
469,34,21,76,8,11.25579697597524,13
470,53,23,17,7,11.244737606744525,16
471,46,25,106,10,11.236273437212292,15
472,25,25,68,8,11.235607083018879,17
473,45,12,39,5,11.230688824941206,7
474,46,20,96,8,11.223825219116968,12
475,25,15,3,5,11.214634960222725,10
476,100,12,46,4,11.210309669403342,8
477,89,11,1,4,11.209011069389932,7
478,87,37,114,14,11.160921669895089,23
479,72,17,23,6,11.160874339561767,11
480,78,13,1,4,11.156578268103182,9
481,27,49,19,15,11.141415326856121,34
482,104,34,11,11,11.141180204048961,23
483,58,12,45,4,11.132316744798048,8
484,78,12,66,4,11.131528298187064,8
485,46,15,70,5,11.123543654837006,10
486,48,11,102,3,11.116814719382416,8
487,46,12,102,4,11.102504599435605,8
488,74,13,32,4,11.10166419198237,9
489,79,23,57,8,11.10038188990658,15
490,11,36,84,12,11.100193468531899,24
491,64,29,112,8,11.096215333139424,21
492,38,27,65,10,11.074356765807053,17
493,99,11,11,4,11.04788337752713,7
494,55,39,1,12,11.047135752371082,27
495,32,12,114,4,11.045874107216173,8
496,16,17,32,6,11.045561391190379,11
497,47,10,84,3,11.043789003229906,7
498,91,31,60,12,11.03333094942879,19
499,41,14,92,5,11.016394202336146,9
500,100,56,65,18,11.012297063888095,38
501,15,13,71,4,11.00914391321025,9
502,51,20,110,6,11.00014817045874,14
503,13,25,97,9,10.985857531237667,16
504,63,37,91,11,10.96934953874397,26
505,72,19,29,7,10.96437258105495,12
506,65,29,58,10,10.961146082647751,19
507,63,48,28,15,10.937243385325443,33
508,6,12,41,5,10.932480964173765,7
509,44,17,39,6,10.931701642504198,11
510,55,28,64,8,10.917217929011832,20
511,30,30,43,8,10.908909228896231,22
512,48,22,9,7,10.894666127588817,15
513,79,13,106,4,10.885501834452416,9
514,86,17,67,6,10.856458271232293,11
515,11,15,81,5,10.851443298256322,10
516,104,32,77,11,10.833725252578544,21
517,100,41,49,14,10.82349227562521,27
518,106,17,81,7,10.816681182916202,10
519,85,12,75,3,10.8046837733115,9
520,55,25,91,7,10.79161282762655,18
521,101,12,13,3,10.774607059056445,9
522,59,11,7,3,10.7712398180592,8
523,23,15,91,6,10.74878606870166,9
524,106,14,108,4,10.746780907865295,10
525,26,12,89,4,10.740745132559544,8
526,5,19,60,6,10.737943337535818,13
527,11,12,91,3,10.737589094202368,9
528,54,11,111,3,10.714143810197234,8
529,37,19,60,8,10.713928216657274,11
530,43,13,36,5,10.713552025008552,8
531,63,17,33,6,10.663903494014164,11
532,30,24,91,7,10.658543869059741,17
533,104,25,12,8,10.646691739775022,17
534,28,13,103,4,10.609246701939709,9
535,7,31,91,9,10.609100286101583,22
536,104,26,75,9,10.574353916694225,17
537,78,15,47,6,10.571891033683885,9
538,95,15,9,6,10.569002592922947,9
539,64,13,102,4,10.555701452012437,9
540,28,17,40,7,10.551622113062646,10
541,49,11,38,3,10.545141985188474,8
542,50,19,68,8,10.535408083030939,11
543,93,12,90,4,10.530779388732013,8
544,71,19,97,6,10.523533962196902,13
545,27,27,36,10,10.52334959933135,17
546,109,23,39,7,10.513513507021566,16
547,8,10,26,4,10.512024852650757,6
548,30,20,85,7,10.510030437811338,13
549,100,34,29,12,10.507497913424638,22
550,64,27,9,8,10.495957554452962,19
551,43,17,9,7,10.435718767902006,10
552,78,15,46,6,10.435320162132959,9
553,9,15,94,6,10.428736566666437,9
554,103,13,38,3,10.428496638561521,10
555,19,21,81,7,10.4227612410005,14
556,30,30,38,8,10.418236156818491,22
557,28,40,75,13,10.392665070295688,27
558,63,16,10,5,10.390771257176633,11
559,72,19,48,8,10.39005352377676,11
560,62,10,81,3,10.381128876663768,7
561,106,16,93,6,10.37915501513517,10
562,50,39,88,14,10.364860984100918,25
563,94,10,7,3,10.355621654064775,7
564,40,16,102,6,10.346146758066931,10
565,37,48,54,16,10.345446907641227,32
566,74,37,28,13,10.332746781815512,24
567,91,12,112,4,10.264176950121668,8
568,67,16,106,6,10.252161434234207,10
569,12,18,106,5,10.245560433617426,13
570,75,12,79,4,10.235318929578343,8
571,16,49,96,14,10.230768867165024,35
572,64,49,60,15,10.225579774670619,34
573,97,10,48,4,10.2212335454347,6
574,30,17,31,7,10.214096274935345,10
575,90,19,104,7,10.205908373136616,12
576,97,42,37,14,10.199316810918761,28
577,98,15,2,6,10.198603389321663,9
578,71,13,33,4,10.195530501937558,9
579,90,14,48,5,10.193948361787585,9
580,22,14,27,5,10.193537492582191,9
581,6,12,9,5,10.175309866966638,7
582,54,24,43,9,10.170685643554325,15
583,12,44,107,13,10.16896739229528,31
584,78,30,34,11,10.167946698328937,19
585,76,31,35,11,10.147473531625215,20
586,92,16,68,5,10.147306838487294,11
587,50,41,20,14,10.147144974204984,27
588,96,11,23,4,10.143008283174428,7
589,53,37,31,14,10.136338371296794,23
590,53,36,36,11,10.114732824687982,25
591,40,16,49,6,10.077718304922936,10
592,64,16,76,6,10.071620985041546,10
593,73,18,40,6,10.060776256522114,12
594,107,16,10,6,10.056408787562026,10
595,44,10,38,3,10.048373138060263,7
596,30,16,61,5,10.045667078233517,11
597,65,50,93,19,10.04207995603563,31
598,80,11,43,4,10.040501076551807,7
599,70,10,3,3,10.036631807498475,7
600,110,13,107,4,10.034721322746927,9
601,28,21,72,7,10.026127135244147,14
602,30,27,84,8,10.023299208241372,19
603,111,19,63,7,10.01291034850113,12
604,104,23,71,9,10.004145398382484,14
605,58,11,61,4,9.991140661268366,7
606,95,25,65,9,9.98743882075493,16
607,114,16,12,7,9.985343546707197,9
608,16,67,106,22,9.984638821275349,45
609,99,10,19,3,9.983244859068366,7
610,6,15,61,5,9.976861344972216,10
611,43,26,77,9,9.972633937246163,17
612,76,25,78,7,9.960883913629875,18
613,89,12,102,5,9.960584439425153,7
614,46,14,90,5,9.960134782518509,9
615,27,52,60,16,9.950557521700256,36
616,39,44,20,17,9.93573323054779,27
617,29,31,86,10,9.927999065138597,21
618,104,13,66,3,9.923020394172244,10
619,95,10,2,3,9.920312629990494,7
620,74,42,46,14,9.91934754308771,28
621,1,11,57,4,9.916035104284747,7
622,30,18,70,7,9.91397370546994,11
623,15,10,33,3,9.911800000475987,7
624,85,12,64,4,9.89511233166771,8
625,110,20,16,7,9.893450419413218,13
626,30,10,97,3,9.882522031725548,7
627,39,30,94,11,9.877709275053967,19
628,17,15,71,6,9.87407872077162,9
629,87,34,91,11,9.869349002662766,23
630,11,35,41,11,9.869141213305255,24
631,9,32,31,11,9.853659783790295,21
632,53,10,98,4,9.839111782848335,6
633,9,17,47,6,9.833363334347133,11
634,7,26,96,8,9.825450759982106,18
635,54,13,57,3,9.824315369895022,10
636,44,23,13,8,9.816634162051665,15
637,40,24,17,8,9.815776001763272,16
638,80,12,3,5,9.815065017111898,7
639,104,18,79,7,9.811537818194267,11
640,106,24,18,8,9.811498602513073,16
641,53,45,88,15,9.809130380596871,30
642,111,10,70,4,9.807746966138032,6
643,114,16,62,6,9.799890996069497,10
644,60,38,29,14,9.79180298065323,24
645,72,33,51,13,9.79016781101138,20
646,17,21,19,7,9.789880941675225,14
647,49,26,23,9,9.783761857204421,17
648,37,24,83,9,9.783726366978422,15
649,108,37,13,13,9.76086171077813,24
650,38,20,3,7,9.756465034901842,13
651,34,14,70,5,9.755416516876581,9
652,39,27,112,10,9.753849767447484,17
653,104,10,47,2,9.753813502973621,8
654,63,52,84,20,9.74716223383734,32
655,102,38,86,13,9.743964141517802,25
656,19,16,89,5,9.736687292718283,11
657,35,14,15,6,9.721615421027133,8
658,43,19,31,10,9.72085277355369,9
659,52,15,8,5,9.715026692600484,10
660,28,18,111,6,9.712251206209237,12
661,100,16,48,6,9.709186246796259,10
662,54,36,60,12,9.70707038462816,24
663,8,34,114,11,9.699231858321156,23
664,66,12,64,4,9.686533226244311,8
665,88,22,112,8,9.681832903230312,14
666,60,21,45,8,9.677047968687354,13
667,54,58,109,19,9.67695339511369,39
668,79,18,65,7,9.67569283729834,11
669,100,12,71,4,9.660687520316314,8
670,102,29,87,10,9.659456627337189,19
671,21,11,88,4,9.657212734415223,7
672,22,10,114,5,9.649313306364824,5
673,26,25,13,8,9.644667177898787,17
674,75,40,8,13,9.637059553855455,27
675,41,23,53,8,9.631953807885305,15
676,70,17,109,6,9.623350653501722,11
677,107,49,109,17,9.622150173258799,32
678,80,17,30,6,9.61803117509945,11
679,99,14,8,6,9.611065592860317,8
680,83,18,84,7,9.609473734372155,11
681,16,15,10,5,9.607669865815327,10
682,8,13,53,4,9.596286006275319,9
683,76,28,9,9,9.591794162872961,19
684,39,32,78,11,9.58980155760674,21
685,102,16,34,5,9.587766586983141,11
686,92,10,31,4,9.586105290347549,6
687,73,20,7,8,9.582485903794176,12
688,47,18,3,6,9.572563324649543,12
689,27,28,31,12,9.569633624787398,16
690,100,38,60,13,9.561130090069941,25
691,17,17,3,7,9.550337372259282,10
692,94,34,12,13,9.548988489200946,21
693,39,26,106,10,9.547502317564264,16
694,42,10,51,3,9.543588102916445,7
695,63,40,76,13,9.537527582020362,27
696,20,11,75,4,9.527707505687728,7
697,92,11,97,5,9.525917165548373,6
698,1,22,31,9,9.525804060927042,13
699,20,32,25,11,9.520523686179047,21
700,8,17,36,6,9.512360266950532,11
701,33,13,69,5,9.51115802646404,8
702,114,13,2,5,9.509158562417845,8
703,16,84,27,30,9.503735028845306,54
704,37,22,99,7,9.502759058160704,15
705,75,29,5,12,9.487135559909316,17
706,23,16,57,6,9.474501256774843,10
707,11,25,89,8,9.473905386940322,17
708,23,35,76,13,9.453849648482663,22
709,89,12,114,5,9.444885030105086,7
710,32,11,63,4,9.44232166344675,7
711,23,16,47,5,9.428933500778964,11
712,13,15,2,6,9.422510080465475,9
713,16,13,56,4,9.403965360554954,9
714,70,17,69,5,9.402150324196048,12
715,109,11,36,3,9.390936468630548,8
716,73,14,54,5,9.38293263538315,9
717,29,13,95,5,9.382021477576467,8
718,100,36,41,13,9.381375330902392,23
719,54,13,77,3,9.380901529721797,10
720,27,16,4,6,9.378715415982096,10
721,23,10,89,3,9.369382103123732,7
722,28,19,12,6,9.364727152511893,13
723,28,24,62,9,9.3614354821999,15
724,26,12,28,4,9.352858082446945,8
725,1,20,87,8,9.344990956449255,12
726,57,27,46,10,9.344538995427152,17
727,54,13,81,5,9.33569894630605,8
728,77,10,84,3,9.326879307665175,7
729,18,30,9,10,9.325317307118523,20
730,77,19,81,7,9.279503184611324,12
731,62,24,40,11,9.275726600058688,13
732,78,12,106,4,9.274742533638902,8
733,104,23,84,9,9.26674641219393,14
734,87,27,93,10,9.26552442404966,17
735,55,12,72,4,9.264849417303106,8
736,20,16,90,6,9.256704804618028,10
737,29,20,69,8,9.248313015601626,12
738,30,34,88,14,9.246002926232096,20
739,74,26,39,10,9.238307519906488,16
740,18,12,62,4,9.234800982158571,8
741,91,23,20,9,9.233435902067155,14
742,100,35,77,12,9.214186476596144,23
743,62,14,93,6,9.214086704299504,8
744,49,40,69,17,9.212563576492524,23
745,30,35,109,11,9.211024491397644,24
746,79,10,41,4,9.204704069079494,6
747,40,28,3,9,9.202268323423784,19
748,95,21,114,8,9.195016624238175,13
749,81,16,63,6,9.193429569946275,10
750,68,31,18,11,9.190826393650621,20
751,100,10,66,3,9.189485891690612,7
752,54,19,58,8,9.183988111852093,11
753,112,22,29,8,9.174610307731976,14
754,34,15,37,5,9.170559355322496,10
755,75,12,61,5,9.169495709034498,7
756,62,21,63,8,9.161474645821357,13
757,76,14,10,5,9.157178184443993,9
758,50,43,5,17,9.15604936984071,26
759,1,11,5,4,9.143641454097294,7
760,49,27,43,9,9.143448784314831,18
761,58,10,8,4,9.142222913085968,6
762,28,23,112,8,9.12022356401639,15
763,57,13,2,5,9.119959996501729,8
764,92,11,17,4,9.114563540800479,7
765,109,15,31,5,9.11388757240418,10
766,58,18,15,6,9.107099163408304,12
767,94,12,75,4,9.080901166069646,8
768,57,54,107,21,9.078700261285773,33
769,53,21,3,7,9.076818822513886,14
770,8,13,103,4,9.075472836435573,9
771,57,16,40,6,9.075047590769481,10
772,80,39,107,13,9.074881524481428,26
773,95,31,51,10,9.060456234548898,21
774,85,17,65,6,9.053734140937447,11
775,111,16,39,6,9.048818598860482,10
776,16,10,42,4,9.042303853739883,6
777,7,55,87,19,9.031940434035894,36
778,72,13,104,5,9.028766073834529,8
779,13,24,83,9,9.019898615590662,15
780,100,46,12,17,9.018777204816933,29
781,5,15,36,6,9.008614310253613,9
782,85,19,50,7,9.007921978503543,12
783,8,64,5,24,9.002251377410767,40
784,1,25,65,10,9.00217902882169,15
785,92,19,86,8,8.99999904756414,11
786,76,23,72,7,8.997779491450276,16
787,30,14,93,5,8.997367289185707,9
788,78,15,80,5,8.990142670025016,10
789,111,26,107,11,8.980921347663001,15
790,63,16,89,5,8.974860507493934,11
791,97,18,36,7,8.970668153566256,11
792,47,20,114,8,8.969382880850313,12
793,73,11,70,5,8.94135129372028,6
794,57,26,109,10,8.940308236533028,16
795,51,26,74,8,8.938947542412071,18
796,73,12,31,4,8.93891957013575,8
797,84,29,29,11,8.921575167609982,18
798,26,10,88,4,8.919527282390272,6
799,11,35,103,11,8.918619326328123,24
800,89,22,103,9,8.918015663459965,13
801,110,19,25,6,8.91770167255822,13
802,27,37,77,13,8.902317857478243,24
803,76,10,52,4,8.902002264737622,6
804,12,24,15,9,8.901081094280315,15
805,60,25,112,9,8.892237229267325,16
806,27,30,53,10,8.892087302529344,20
807,69,12,97,4,8.888377862411463,8
808,100,43,11,15,8.886934672274428,28
809,90,23,13,8,8.883764352926049,15
810,34,21,103,7,8.883009589973751,14
811,45,24,107,9,8.882581208643296,15
812,112,12,98,4,8.873991556640124,8
813,6,15,12,7,8.87368712650089,8
814,86,26,52,9,8.860510586631698,17
815,47,28,60,10,8.854852442447159,18
816,34,21,68,8,8.850128344712713,13
817,20,20,3,7,8.846112059849583,13
818,37,15,1,6,8.845768047127498,9
819,32,15,87,5,8.844155029434871,10
820,51,28,33,8,8.842467587731502,20
821,47,18,18,6,8.827723884174087,12
822,63,19,36,7,8.822881427312195,12
823,63,22,77,7,8.819997532642512,15
824,84,19,19,7,8.813396640852732,12
825,36,18,47,6,8.810892372607718,12
826,19,24,108,9,8.805451324275152,15
827,106,10,42,3,8.802546839644403,7
828,63,18,19,6,8.792724982250471,12
829,6,12,46,5,8.791371018033741,7
830,77,14,99,4,8.784719144285264,10
831,18,17,19,6,8.772934483482583,11
832,74,37,84,16,8.764103490564013,21
833,8,34,84,12,8.76285424467774,22
834,28,16,52,6,8.75730555636181,10
835,41,12,85,5,8.754152386383817,7
836,15,28,76,11,8.747693902892903,17
837,38,14,106,7,8.745019433529976,7
838,65,11,32,4,8.739314169667136,7
839,4,22,17,7,8.727735068009611,15
840,7,14,66,6,8.72512173427205,8
841,49,13,53,5,8.697012890359371,8
842,27,30,112,11,8.685425209929864,19
843,19,12,31,4,8.67684008479621,8
844,53,11,54,4,8.67028832638361,7
845,70,12,58,4,8.66252309250944,8
846,73,28,8,11,8.656865963639591,17
847,57,18,72,5,8.656042983673217,13
848,13,52,18,19,8.653636499693642,33
849,60,33,69,14,8.651136747788067,19
850,65,18,66,6,8.642636100127188,12
851,13,22,6,8,8.600067561462977,14
852,2,34,107,12,8.596357154255273,22
853,63,41,48,15,8.591649372014341,26
854,4,22,87,7,8.590843038311563,15
855,94,14,38,5,8.588521468701918,9
856,95,23,55,8,8.57500650986488,15
857,9,22,104,8,8.574493523715214,14
858,49,10,93,4,8.57216379677568,6
859,91,27,39,10,8.567392835046919,17
860,91,13,71,5,8.567246551132914,8
861,26,14,16,6,8.561151203860886,8
862,103,23,68,9,8.554646323444773,14
863,78,11,36,4,8.552435160203324,7
864,94,11,2,4,8.550586885180525,7
865,16,15,67,5,8.550473387804702,10
866,33,26,107,11,8.550231212849107,15
867,94,12,35,5,8.545638882275084,7
868,68,34,8,13,8.545370564412986,21
869,110,11,63,4,8.534985747455591,7
870,53,20,61,6,8.524850655507475,14
871,13,62,3,22,8.519160791346222,40
872,81,22,69,9,8.517997866855394,13
873,20,22,9,8,8.515923532058864,14
874,80,11,77,4,8.51548819382583,7
875,95,35,8,14,8.511725721270738,21
876,33,10,109,4,8.506616474826911,6
877,39,40,29,17,8.504662903417357,23
878,91,10,45,4,8.504304930616431,6
879,64,28,40,10,8.496071624321134,18
880,29,15,37,6,8.491699980771868,9
881,104,12,103,5,8.48285234676064,7
882,17,18,77,7,8.466623444733871,11
883,50,20,48,7,8.466418162124782,13
884,63,37,20,15,8.464473402081477,22
885,53,23,12,9,8.46079762480418,14
886,18,49,39,18,8.452166369571016,31
887,103,34,19,13,8.451907756621258,21
888,95,14,96,5,8.450373982592184,9
889,17,16,27,7,8.447083930107876,9
890,8,24,41,8,8.446748885751393,16
891,96,24,70,11,8.437417991026258,13
892,55,20,114,7,8.432483182241096,13
893,49,23,103,9,8.430062008794607,14
894,73,19,90,7,8.424101991862461,12
895,109,14,67,7,8.410228891959635,7
896,72,25,68,9,8.400269184621727,16
897,69,12,61,3,8.397253145469621,9
898,72,32,3,13,8.389032282963832,19
899,7,45,25,16,8.3728066183483,29
900,7,22,5,8,8.357081514884822,14
901,41,33,31,12,8.353957395244583,21
902,48,25,96,9,8.343995751105185,16
903,44,30,86,11,8.339333779949047,19
904,34,29,51,11,8.335199043134844,18
905,25,15,9,5,8.323455878342038,10
906,79,20,51,9,8.309517555811908,11
907,37,43,46,14,8.306667442353499,29
908,49,37,3,15,8.305049665091294,22
909,91,13,109,5,8.302894097359495,8
910,98,25,29,9,8.302046476403795,16
911,92,13,63,6,8.301235837359338,7
912,86,17,56,6,8.300855291965847,11
913,49,24,29,9,8.30024160945298,15
914,48,17,15,7,8.294674307198186,10
915,90,31,106,10,8.283845461248369,21
916,62,22,57,7,8.282890505105964,15
917,15,14,79,6,8.279617988476957,8
918,41,18,91,6,8.2766719527744,12
919,37,12,14,5,8.26646783507543,7
920,85,12,47,3,8.252970893280144,9
921,93,10,76,4,8.25053412937542,6
922,75,18,1,6,8.241769187322511,12
923,11,15,83,5,8.230715708736339,10
924,69,21,106,8,8.230262561693127,13
925,37,31,7,12,8.226042864777218,19
926,99,10,71,4,8.224966300288866,6
927,112,14,40,6,8.221202026655064,8
928,80,11,81,5,8.214427134711954,6
929,15,44,88,14,8.213143448624798,30
930,27,45,15,18,8.204681610073107,27
931,43,10,61,4,8.197501979978238,6
932,75,17,57,6,8.19573859465214,11
933,15,13,6,4,8.195238270954562,9
934,94,30,51,11,8.188387798869615,19
935,54,33,27,13,8.18041909853592,20
936,38,16,57,7,8.179065570967875,9
937,60,38,12,17,8.176704391599657,21
938,51,18,92,7,8.176167071622316,11
939,49,27,104,10,8.170229238591212,17
940,70,19,64,6,8.153009023968611,13
941,4,10,112,4,8.145974306589784,6
942,56,14,107,6,8.142413744294041,8
943,107,17,61,7,8.134950583984788,10
944,50,36,55,15,8.131693382626922,21
945,16,80,63,30,8.13155611753475,50
946,20,11,110,4,8.125291114928707,7
947,9,12,98,5,8.123745049728663,7
948,81,11,111,3,8.120062859865856,8
949,73,14,51,5,8.09774388932274,9
950,16,52,76,22,8.092559503336217,30
951,3,31,57,12,8.088823479437657,19
952,43,17,4,7,8.083539648296874,10
953,8,17,32,7,8.079749532998788,10
954,110,16,97,6,8.077466293642962,10
955,50,18,70,8,8.072010588554928,10
956,110,19,39,6,8.071999499945951,13
957,98,44,86,17,8.071238892551682,27
958,27,23,55,7,8.063317604605784,16
959,97,29,68,11,8.062315589675796,18
960,19,15,46,6,8.056646218005667,9
961,20,36,84,11,8.048616703285955,25
962,89,19,37,9,8.048334757683454,10
963,16,78,55,28,8.046061626286074,50
964,98,15,48,5,8.040930745507078,10
965,63,27,38,8,8.035551882917902,19
966,49,22,37,9,8.028262573829634,13
967,100,43,43,17,8.027733318691846,26
968,63,12,52,5,8.01519600341839,7
969,35,11,9,5,8.012816785902414,6
970,65,28,5,11,8.012091300535628,17
971,91,31,98,12,8.010154956050263,19
972,18,28,65,11,8.006374014695185,17
973,102,19,96,7,7.995631160966492,12
974,98,16,40,7,7.993416961646092,9
975,5,28,84,11,7.986435375626316,17
976,89,12,34,5,7.976037737760557,7
977,75,44,50,15,7.963443352466475,29
978,114,17,30,7,7.958588719714499,10
979,39,70,68,28,7.951159079684658,42
980,98,10,83,3,7.946776918388257,7
981,98,19,71,7,7.940784287039028,12
982,17,23,64,9,7.937110775809494,14
983,104,41,60,13,7.929814398109314,28
984,30,60,39,25,7.929542337970754,35
985,102,20,88,6,7.922214123871077,14
986,33,13,91,6,7.9196550020319165,7
987,88,10,82,4,7.912578083642501,6
988,100,10,45,4,7.910416808186414,6
989,78,11,31,5,7.904414780494012,6
990,53,14,90,5,7.9010322992925905,9
991,17,16,29,7,7.899676305324428,9
992,80,30,87,11,7.899566888780317,19
993,61,11,54,4,7.891370825375349,7
994,54,34,40,13,7.877426017050995,21
995,114,25,90,10,7.870165683504547,15
996,28,30,2,11,7.862984699152351,19
997,44,12,35,5,7.859665557157527,7
998,23,12,10,5,7.85948423488221,7
999,62,16,38,5,7.859346684430756,11
1000,106,26,91,9,7.859341034872011,17
1001,16,16,92,4,7.858675892555915,12
1002,30,21,58,8,7.852822410978156,13
1003,94,19,60,7,7.840596501641602,12
1004,114,20,1,7,7.837742070296789,13
1005,70,16,93,6,7.834949393241649,10
1006,5,22,17,7,7.829641724195981,15
1007,54,14,108,4,7.821734358546891,10
1008,25,46,46,19,7.820401195025543,27
1009,75,29,47,9,7.802637218083723,20
1010,114,12,110,4,7.800316810979699,8
1011,72,32,49,12,7.791431121179823,20
1012,107,31,31,15,7.788469010128701,16
1013,111,25,13,11,7.788425056310504,14
1014,47,10,111,4,7.786638633209638,6
1015,17,18,43,7,7.779410969380074,11
1016,92,14,114,4,7.774797164908201,10
1017,72,16,34,6,7.77292036434715,10
1018,53,11,73,4,7.756297558195458,7
1019,111,19,51,7,7.750696049131197,12
1020,28,29,68,10,7.748993038967358,19
1021,15,11,46,4,7.742583584977325,7
1022,44,11,84,5,7.741464370739859,6
1023,46,18,29,9,7.738693511487552,9
1024,108,17,57,7,7.738005960337114,10
1025,27,13,46,4,7.731849992239067,9
1026,16,14,101,5,7.729447625525021,9
1027,78,17,104,6,7.72449974280056,11
1028,114,21,96,8,7.708209589747937,13
1029,44,24,6,8,7.699216026117287,16
1030,75,61,68,22,7.69823200491078,39
1031,86,28,1,11,7.696680317913666,17
1032,62,11,96,3,7.693312023908734,8
1033,111,25,7,10,7.690323425771979,15
1034,5,32,11,12,7.687442157533873,20
1035,90,22,63,9,7.68656156905561,13
1036,71,22,54,9,7.686527692328838,13
1037,87,39,70,17,7.68015007462121,22
1038,8,38,9,17,7.672754136226992,21
1039,41,31,77,10,7.669158331056241,21
1040,37,24,96,10,7.665844925696507,14
1041,30,55,13,21,7.665552464286545,34
1042,33,13,31,6,7.647223417443057,7
1043,70,11,60,4,7.646435749026204,7
1044,15,13,96,5,7.641753691009957,8
1045,97,29,5,10,7.639418302115126,19
1046,28,28,3,11,7.638630473496032,17
1047,71,14,27,5,7.6209744722933594,9
1048,16,56,18,20,7.62082144285743,36
1049,107,52,49,19,7.618746632426498,33
1050,18,45,87,18,7.611607014750331,27
1051,72,18,69,7,7.600823321303466,11
1052,51,20,91,7,7.599736540322733,13
1053,104,28,3,10,7.5966632679833825,18
1054,18,20,36,8,7.594902878501233,12
1055,103,18,84,8,7.589982363677433,10
1056,72,10,36,4,7.585561627806544,6
1057,28,31,114,13,7.584853881328921,18
1058,47,14,43,5,7.584709684437342,9
1059,3,12,85,6,7.584252500547151,6
1060,58,17,112,7,7.574468513714297,10
1061,53,31,112,14,7.574348903828081,17
1062,30,16,66,5,7.562731538961938,11
1063,85,10,46,3,7.538229298143683,7
1064,33,16,7,7,7.5321884826380465,9
1065,6,11,55,3,7.526848268362221,8
1066,58,27,39,11,7.5215555384091815,16
1067,6,11,31,5,7.520489323813347,6
1068,34,40,87,15,7.5172123307680465,25
1069,64,10,93,5,7.507177747442428,5
1070,78,14,37,5,7.49665243432836,9
1071,16,50,46,18,7.494318856216717,32
1072,7,21,109,8,7.493740572538848,13
1073,34,24,48,10,7.493315514142353,14
1074,16,28,1,9,7.488361785520795,19
1075,71,15,76,7,7.4875920550169335,8
1076,20,23,68,10,7.482872234261611,13
1077,41,23,89,8,7.477544889027711,15
1078,70,14,36,6,7.476080415111225,8
1079,45,12,53,5,7.463487107897499,7
1080,27,11,80,4,7.4617467678086795,7
1081,47,18,69,7,7.454070061027652,11
1082,74,16,77,6,7.445248923450912,10
1083,11,12,71,5,7.444969376445687,7
1084,13,66,43,28,7.440342784840276,38
1085,6,24,16,11,7.439865172191104,13
1086,73,18,5,7,7.416873021801379,11
1087,36,34,41,16,7.412500474371831,18
1088,68,25,109,9,7.412111880903939,16
1089,70,30,20,11,7.408681007686706,19
1090,77,10,91,4,7.405339289847274,6
1091,75,14,76,6,7.401272000460674,8
1092,10,15,28,5,7.394064388880875,10
1093,7,22,56,9,7.387479337914444,13
1094,64,48,51,19,7.3869058165331,29
1095,71,19,81,7,7.374213709282574,12
1096,73,10,71,4,7.373234065194549,6
1097,56,12,88,5,7.371104573008601,7
1098,31,14,80,4,7.367135464628979,10
1099,106,10,61,3,7.3668858265854,7
1100,25,16,33,5,7.365926272964513,11
1101,37,21,27,8,7.364913856955695,13
1102,78,13,114,6,7.362319764057864,7
1103,18,33,8,11,7.3619926735277295,22
1104,78,49,87,19,7.360452128651223,30
1105,41,11,61,4,7.351525315520968,7
1106,23,18,114,6,7.3449426375970175,12
1107,40,41,104,15,7.3422918945341555,26
1108,108,17,15,6,7.342094547015131,11
1109,75,16,2,7,7.332326563651876,9
1110,62,30,88,12,7.323841783087015,18
1111,70,42,5,17,7.323141246130925,25
1112,13,65,106,25,7.3036939245307035,40
1113,15,15,53,6,7.3015008185892984,9
1114,60,21,66,7,7.300914124516517,14
1115,5,27,98,11,7.298838761636912,16
1116,11,23,9,9,7.298808121542034,14
1117,23,32,68,14,7.289923232946887,18
1118,43,31,40,13,7.287691070183644,18
1119,2,18,54,6,7.287492324178089,12
1120,95,14,49,5,7.284298716033514,9
1121,94,15,34,6,7.27613843510101,9
1122,55,20,68,7,7.273979151335484,13
1123,86,84,96,32,7.269360183001262,52
1124,110,16,70,6,7.267896542251018,10
1125,75,19,81,7,7.259552889264536,12
1126,61,10,18,4,7.259552128825379,6
1127,69,12,96,4,7.2527556906488675,8
1128,13,42,8,16,7.249552270590032,26
1129,31,14,5,5,7.246607645789558,9
1130,114,27,40,9,7.240772461331045,18
1131,76,24,94,8,7.236263005031582,16
1132,58,12,57,5,7.2358962284082144,7
1133,3,12,90,5,7.229183550562688,7
1134,41,15,90,6,7.225732946536368,9
1135,72,12,108,4,7.213712770239643,8
1136,98,14,93,6,7.212314028509714,8
1137,14,14,95,5,7.1971223272437035,9
1138,112,15,43,6,7.1893251112725824,9
1139,90,18,39,8,7.18884605844648,10
1140,49,11,45,4,7.1803155778985435,7
1141,36,16,112,6,7.175574629533444,10
1142,30,47,11,18,7.1697256604701485,29
1143,60,37,15,15,7.16452361135591,22
1144,97,26,51,9,7.145200913148905,17
1145,111,12,69,5,7.144443379259749,7
1146,13,12,93,5,7.127658172301537,7
1147,7,100,51,37,7.124169403819477,63
1148,67,12,107,4,7.124134838046416,8
1149,30,12,45,4,7.122960634637173,8
1150,86,30,83,10,7.114862976089353,20
1151,45,33,7,13,7.114147641228474,20
1152,88,18,103,8,7.110825447996327,10
1153,78,32,3,14,7.109444491661279,18
1154,40,51,55,19,7.109300201154281,32
1155,1,10,45,4,7.100044646871245,6
1156,100,29,102,10,7.094058761081434,19
1157,48,17,89,5,7.093940889199019,12
1158,69,19,94,7,7.087672737054438,12
1159,16,137,88,52,7.08443502387227,85
1160,85,10,53,3,7.078145746437185,7
1161,11,23,38,9,7.075339060309606,14
1162,98,30,63,12,7.074142027349341,18
1163,109,19,64,9,7.07123676744315,10
1164,37,50,25,21,7.070541112352608,29
1165,17,14,62,6,7.064031186672311,8
1166,99,18,36,6,7.061516094995866,12
1167,63,25,18,9,7.057051865944985,16
1168,104,20,69,7,7.050658503403548,13
1169,41,10,33,3,7.049463752515185,7
1170,35,17,51,7,7.047942210096517,10
1171,75,25,49,10,7.046279748381454,15
1172,107,50,43,20,7.042608164642457,30
1173,95,15,40,6,7.026458120737086,9
1174,80,16,68,6,7.020946425736165,10
1175,48,24,108,9,7.014059937549278,15
1176,40,13,69,4,7.006717860168273,9
1177,74,12,29,5,6.99788298965225,7
1178,62,15,5,6,6.992708759597396,9
1179,17,20,55,9,6.987444025974706,11
1180,53,30,30,12,6.984989750265449,18
1181,18,23,97,9,6.9651635757198616,14
1182,16,34,36,13,6.962309553248682,21
1183,32,18,104,6,6.9592250863895515,12
1184,91,19,50,7,6.959059467736711,12
1185,4,25,51,9,6.952578906103851,16
1186,16,53,9,18,6.946689005583055,35
1187,99,12,88,5,6.93913123202866,7
1188,54,10,92,3,6.935475063385283,7
1189,47,44,13,17,6.918967707744426,27
1190,87,39,40,17,6.915208460636839,22
1191,98,31,76,12,6.9145039131956345,19
1192,103,25,60,10,6.9097130220483844,15
1193,58,21,68,8,6.904652684866492,13
1194,39,81,49,30,6.900466168563073,51
1195,41,31,3,10,6.894617259118267,21
1196,39,16,14,7,6.8922808961517115,9
1197,95,28,50,11,6.891870477756295,17
1198,88,13,67,4,6.891493842154361,9
1199,27,19,35,7,6.889601577867774,12
1200,12,32,11,13,6.888481262915148,19
1201,106,15,99,5,6.882359612487443,10
1202,29,36,30,13,6.871800956301801,23
1203,60,43,4,19,6.864343045215706,24
1204,39,62,60,26,6.846993632230984,36
1205,16,60,109,23,6.839893936386638,37
1206,85,28,72,10,6.836972195015779,18
1207,108,40,87,16,6.834140424334431,24
1208,20,15,29,6,6.832826874702712,9
1209,76,18,114,6,6.831521332050889,12
1210,95,25,106,9,6.830338155584791,16
1211,30,29,37,10,6.828235844394076,19
1212,27,22,38,7,6.822548072188939,15
1213,68,69,31,28,6.821634358561019,41
1214,94,22,109,10,6.819260229170754,12
1215,108,25,39,11,6.818183477112846,14
1216,56,13,4,6,6.816273515879686,7
1217,89,11,109,4,6.815319908032908,7
1218,50,22,102,10,6.809919414830619,12
1219,78,35,12,12,6.8074005280423115,23
1220,14,21,28,7,6.807027415542909,14
1221,28,14,108,6,6.806119384401875,8
1222,20,11,103,4,6.805078312960618,7
1223,28,16,49,7,6.801284823553006,9
1224,100,32,76,13,6.799440423110685,19
1225,79,15,108,5,6.783855393965387,10
1226,97,20,57,8,6.78123727728494,12
1227,8,10,42,5,6.780541784776636,5
1228,27,78,87,30,6.76879445534877,48
1229,39,43,88,17,6.751316626963761,26
1230,33,17,50,7,6.750798742645289,10
1231,63,27,109,12,6.749986635160673,15
1232,94,10,71,4,6.748460655059323,6
1233,12,30,77,12,6.742992963364651,18
1234,41,13,80,5,6.741244434437033,8
1235,54,63,70,25,6.740490617059239,38
1236,74,38,96,14,6.7318287322523656,24
1237,43,11,20,5,6.726970372628883,6
1238,13,49,23,22,6.72653700751392,27
1239,30,32,55,12,6.725062001131899,20
1240,54,18,103,6,6.724707925139226,12
1241,28,35,97,13,6.716635909782017,22
1242,83,15,74,7,6.703298030488861,8
1243,108,32,51,13,6.697498447878603,19
1244,3,21,94,9,6.694525909511697,12
1245,99,11,54,4,6.681725927932732,7
1246,64,38,31,15,6.680717740842574,23
1247,65,46,29,18,6.670792875820868,28
1248,14,15,88,6,6.669368246830069,9
1249,85,20,54,7,6.664179187550934,13
1250,83,11,71,5,6.6562053803338666,6
1251,87,71,19,27,6.6542546431739,44
1252,71,19,37,8,6.653996053488666,11
1253,32,26,5,10,6.647447060451906,16
1254,23,49,60,19,6.637846899098563,30
1255,74,16,71,7,6.635644376222863,9
1256,4,30,65,12,6.635600395573753,18
1257,62,26,68,11,6.63500576126116,15
1258,107,25,102,11,6.634183780588418,14
1259,25,48,5,19,6.626414170343125,29
1260,16,49,64,19,6.621781791045983,30
1261,51,67,63,29,6.61370980660726,38
1262,71,52,13,22,6.6022668326221785,30
1263,60,13,22,5,6.601421861223266,8
1264,73,16,13,6,6.598047492921335,10
1265,50,23,109,9,6.597376468902569,14
1266,74,14,30,6,6.593804524411076,8
1267,86,29,73,13,6.584732384148775,16
1268,27,11,101,4,6.582303845846215,7
1269,84,28,57,13,6.577348977317855,15
1270,76,57,51,21,6.576315704894317,36
1271,86,41,17,18,6.574590310379946,23
1272,34,38,8,15,6.573808773415803,23
1273,53,26,114,11,6.571088082289225,15
1274,75,31,63,13,6.570041946714362,18
1275,112,15,30,5,6.562692428407154,10
1276,100,33,7,13,6.554112823226252,20
1277,23,28,41,11,6.550829980754917,17
1278,106,32,23,15,6.549055396089183,17
1279,26,12,107,5,6.545382512387971,7
1280,29,33,15,14,6.541368078183932,19
1281,72,29,65,12,6.536977853075842,17
1282,15,46,51,19,6.5361142516646185,27
1283,91,13,80,5,6.531108694088667,8
1284,17,20,30,9,6.529732326409052,11
1285,102,12,38,3,6.529266346603467,9
1286,104,18,19,7,6.528809563809231,11
1287,44,16,64,6,6.52641817446092,10
1288,8,84,87,34,6.523741347061076,50
1289,37,30,38,12,6.5188975255259205,18
1290,55,66,65,27,6.5120252706716855,39
1291,74,29,55,12,6.5036195464677915,17
1292,20,13,100,5,6.503255223034949,8
1293,60,35,50,16,6.502388433089166,19
1294,90,11,102,6,6.502237322589013,5
1295,86,56,97,23,6.486588721597318,33
1296,41,17,45,6,6.481894211723943,11
1297,11,47,109,18,6.476747446179234,29
1298,98,11,68,4,6.469927695975062,7
1299,100,34,54,13,6.462414430425207,21
1300,43,36,109,13,6.458161765145549,23
1301,11,15,10,6,6.454288934219358,9
1302,8,20,91,8,6.453847873736635,12
1303,104,17,112,7,6.449220165667967,10
1304,39,12,79,4,6.437313974618905,8
1305,75,21,100,10,6.42687784088126,11
1306,69,30,57,11,6.426659822386942,19
1307,96,23,80,9,6.423400971659434,14
1308,108,21,98,9,6.422836015811619,12
1309,84,28,48,11,6.421668889523295,17
1310,61,10,23,4,6.419517618014351,6
1311,76,53,87,20,6.417754261076506,33
1312,64,33,63,14,6.4168724867260085,19
1313,7,20,62,8,6.416308867276496,12
1314,64,38,65,16,6.415105269042925,22
1315,6,11,72,5,6.413604067518454,6
1316,48,21,55,8,6.406579400537662,13
1317,80,20,37,8,6.401050818487377,12
1318,53,18,62,7,6.398470883121979,11
1319,43,19,103,7,6.396904626354191,12
1320,79,12,49,4,6.395374558799645,8
1321,33,13,96,7,6.392035038140804,6
1322,107,32,47,13,6.388799131361193,19
1323,28,16,27,5,6.382931621067466,11
1324,33,15,102,6,6.371524301983967,9
1325,56,10,37,4,6.3674406628794715,6
1326,7,24,46,8,6.3620461131037525,16
1327,46,14,77,6,6.346489877085669,8
1328,85,17,96,5,6.345069391274805,12
1329,87,61,20,25,6.343811823202865,36
1330,28,43,9,19,6.342362216975373,24
1331,15,16,91,8,6.341064031534598,8
1332,28,34,7,13,6.33926057444583,21
1333,54,37,95,16,6.3333929852257755,21
1334,107,29,103,12,6.313293915688408,17
1335,63,51,88,19,6.3108086639374505,32
1336,78,32,8,13,6.307058841419962,19
1337,19,37,3,16,6.306652908739436,21
1338,16,46,91,16,6.299398907548497,30
1339,28,36,102,15,6.294379170221607,21
1340,58,14,53,7,6.293430755494421,7
1341,100,18,84,6,6.292769168431847,12
1342,92,17,40,7,6.2908337110868535,10
1343,40,68,68,26,6.288399173895761,42
1344,12,15,4,5,6.2855790295334035,10
1345,3,25,18,9,6.280006323256653,16
1346,86,21,4,8,6.279484499549702,13
1347,34,28,49,12,6.274930419182151,16
1348,55,24,70,10,6.272647161931926,14
1349,20,45,5,17,6.2703736334427855,28
1350,89,46,87,18,6.269400679626851,28
1351,89,15,53,7,6.26765697101517,8
1352,15,12,95,5,6.265255655621168,7
1353,107,65,55,27,6.2629651896189,38
1354,13,31,76,12,6.256958483118664,19
1355,13,97,87,37,6.252442161567486,60
1356,39,24,81,9,6.2522820107309345,15
1357,39,18,83,7,6.251089662915293,11
1358,104,53,51,19,6.249711889194556,34
1359,43,38,15,15,6.241732052980607,23
1360,37,49,63,19,6.239339617220506,30
1361,114,48,5,20,6.2376335334787205,28
1362,95,10,94,5,6.229015093991729,5
1363,53,15,100,6,6.219411389232119,9
1364,55,14,58,6,6.218287556947672,8
1365,28,37,70,15,6.2149266559981875,22
1366,114,24,70,9,6.214622620602992,15
1367,68,70,87,28,6.212080199922705,42
1368,35,15,84,6,6.209299301194259,9
1369,108,26,88,10,6.206778138596414,16
1370,74,19,12,7,6.205068941759818,12
1371,50,30,71,13,6.204695227712774,17
1372,74,28,70,13,6.203999405338759,15
1373,63,28,2,12,6.2000184918514885,16
1374,11,38,68,16,6.199112684088247,22
1375,103,10,62,5,6.19870150631661,5
1376,87,46,9,19,6.192350375466498,27
1377,13,73,40,31,6.184837754544506,42
1378,91,14,65,6,6.1828302267581465,8
1379,47,17,28,7,6.182374184386464,10
1380,72,15,114,7,6.177191459236313,8
1381,80,10,93,5,6.175234905241023,5
1382,13,47,36,18,6.167141158071527,29
1383,86,57,75,25,6.165121325881464,32
1384,104,58,28,24,6.161167829833448,34
1385,23,26,100,11,6.160200190912252,15
1386,114,48,68,20,6.151577271829131,28
1387,73,24,74,9,6.15033234594065,15
1388,86,41,48,16,6.149343718525509,25
1389,23,15,43,6,6.148918923918834,9
1390,37,10,12,5,6.14536499227858,5
1391,39,33,38,13,6.133899975611789,20
1392,29,17,48,7,6.127198243730573,10
1393,107,50,53,20,6.123597161626504,30
1394,81,13,31,4,6.1171597913254,9
1395,107,24,66,10,6.115910396231512,14
1396,45,17,87,7,6.113368156873436,10
1397,10,13,48,5,6.110914502877383,8
1398,90,12,7,5,6.108519045195328,7
1399,86,131,51,58,6.101112922488334,73
1400,84,12,15,5,6.098921486728436,7
1401,62,16,69,7,6.098141811871047,9
1402,65,79,88,29,6.0963002360375524,50
1403,54,19,3,8,6.093256445559038,11
1404,65,40,102,15,6.092594212051893,25
1405,96,14,108,6,6.092516088942797,8
1406,9,26,84,11,6.089357364465301,15
1407,23,13,102,6,6.080684731147933,7
1408,27,64,86,25,6.065009426524368,39
1409,34,30,30,12,6.063291205291667,18
1410,98,22,84,8,6.0610062755899206,14
1411,77,15,57,6,6.055395238374115,9
1412,55,50,60,21,6.053838967638276,29
1413,41,22,28,9,6.053005216366935,13
1414,16,24,2,10,6.0520240829511485,14
1415,69,39,86,16,6.048519108301491,23
1416,58,29,87,12,6.043606512163311,17
1417,8,62,63,27,6.040704829296191,35
1418,104,41,55,17,6.036207114699971,24
1419,103,28,57,11,6.035618973069867,17
1420,7,24,98,9,6.033686003781979,15
1421,26,10,68,4,6.030745942778483,6
1422,27,58,65,23,6.029901089038052,35
1423,109,51,8,22,6.024347890240435,29
1424,51,33,89,13,6.020451115628476,20
1425,27,38,94,15,6.017224957482415,23
1426,81,50,13,19,6.016435190824958,31
1427,107,69,104,28,6.010771127855349,41
1428,13,53,64,24,6.0081721755801,29
1429,13,39,37,16,6.006726113746227,23
1430,65,51,9,20,6.006217714596818,31
1431,106,47,5,18,6.005839560090041,29
1432,94,21,54,9,6.000772945562414,12
1433,30,30,64,12,5.9999514079123175,18
1434,28,18,29,8,5.991947603875371,10
1435,114,25,31,11,5.991876520395493,14
1436,94,10,46,4,5.990564025353783,6
1437,108,11,18,4,5.985584696812657,7
1438,94,17,37,7,5.9815536162143665,10
1439,71,13,109,5,5.977466642753509,8
1440,39,58,3,26,5.976819773807986,32
1441,53,19,77,8,5.976513729958846,11
1442,16,142,87,59,5.975314362551954,83
1443,64,20,18,8,5.974775055211903,12
1444,114,18,94,8,5.974081788881617,10
1445,86,73,76,31,5.973230883413951,42
1446,97,18,40,7,5.96691841614039,11
1447,81,26,3,10,5.952983988314589,16
1448,97,12,10,6,5.950831581917697,6
1449,114,19,81,9,5.947687005963305,10
1450,28,15,53,6,5.945744364633269,9
1451,16,113,39,48,5.944915401569531,65
1452,53,26,104,11,5.936620222245529,15
1453,8,20,38,8,5.935271782387745,12
1454,73,20,114,8,5.924435121305104,12
1455,78,23,7,11,5.919551023484508,12
1456,54,39,68,15,5.918584354683418,24
1457,37,22,110,10,5.913666685850416,12
1458,27,55,78,20,5.9136640972441805,35
1459,65,51,20,19,5.912207435542769,32
1460,109,20,103,9,5.911371119054858,11
1461,34,18,22,7,5.906850849031522,11
1462,75,45,9,18,5.89399328159944,27
1463,63,22,43,9,5.8928094018567405,13
1464,101,15,68,5,5.891939886749792,10
1465,65,52,40,22,5.89106233992842,30
1466,37,11,3,5,5.8897383384754045,6
1467,10,15,57,5,5.8872808270615,10
1468,75,17,108,7,5.88550634585497,10
1469,46,12,36,5,5.882094180819337,7
1470,8,31,15,14,5.881893034376993,17
1471,41,27,19,10,5.880218602490821,17
1472,28,12,31,5,5.876337878232255,7
1473,55,18,98,7,5.870446924304782,11
1474,68,54,53,22,5.8668125784316985,32
1475,86,41,103,16,5.865642774610815,25
1476,107,28,77,12,5.863901908728825,16
1477,34,17,7,7,5.86350495140184,10
1478,7,21,112,8,5.863389950487476,13
1479,23,50,87,20,5.853226854544743,30
1480,80,12,79,6,5.851472407179259,6
1481,65,17,14,8,5.850273562995321,9
1482,65,39,3,15,5.850081377266891,24
1483,100,28,55,13,5.848018543019883,15
1484,49,11,74,5,5.844136641014432,6
1485,16,23,93,11,5.842811946264205,12
1486,88,13,66,5,5.838752373213262,8
1487,63,40,13,17,5.836981602703613,23
1488,23,48,88,18,5.836406273695647,30
1489,13,49,25,22,5.827601447712149,27
1490,8,37,93,16,5.8241714732303524,21
1491,112,13,45,6,5.8226535127240915,7
1492,79,13,20,5,5.810117746469002,8
1493,73,20,109,8,5.807578339260896,12
1494,8,19,98,7,5.806615359942182,12
1495,10,11,106,3,5.803672894932928,8
1496,91,19,31,7,5.801858258461762,12
1497,69,29,43,12,5.793217873056412,17
1498,50,29,30,12,5.790909551112376,17
1499,76,48,107,17,5.789796382951221,31
1500,17,21,9,9,5.788074839959892,12
1501,100,83,86,36,5.78783839779332,47
1502,104,16,81,8,5.786821230718973,8
1503,64,11,91,4,5.780157364605296,7
1504,43,64,87,26,5.77853968725232,38
1505,11,39,19,15,5.773505801410168,24
1506,62,16,109,8,5.770362238431112,8
1507,51,11,52,5,5.770255561533728,6
1508,51,28,29,12,5.763884020681298,16
1509,89,21,49,9,5.761917678895313,12
1510,41,53,86,20,5.761468508013489,33
1511,76,16,2,6,5.758955323935481,10
1512,89,18,72,7,5.758501533202008,11
1513,58,40,107,15,5.758436887559526,25
1514,47,12,12,5,5.753232192548286,7
1515,36,12,77,5,5.751140829309577,7
1516,107,64,20,27,5.747310682281416,37
1517,39,113,51,47,5.746736829097246,66
1518,50,25,18,11,5.745370532916838,14
1519,100,25,114,10,5.743860264273013,15
1520,17,24,60,10,5.742654989357159,14
1521,25,42,106,16,5.737688222420903,26
1522,80,10,109,5,5.736195162181013,5
1523,55,40,54,18,5.729162102948165,22
1524,45,14,9,5,5.727853500458992,9
1525,25,26,51,11,5.726135112848954,15
1526,57,16,53,7,5.724480397511021,9
1527,39,10,52,4,5.718885643095018,6
1528,69,16,12,8,5.715951067980107,8
1529,109,31,55,15,5.712408791206378,16
1530,15,13,74,5,5.7106976006271415,8
1531,69,16,48,7,5.704799954018799,9
1532,64,22,43,9,5.70244252837627,13
1533,16,144,107,55,5.702293802493127,89
1534,27,34,103,13,5.699010329914366,21
1535,70,10,32,5,5.692479372096221,5
1536,35,21,40,8,5.68914021357686,13
1537,27,21,48,8,5.686731307091657,13
1538,100,80,51,37,5.672256402276974,43
1539,94,10,25,5,5.671887186214522,5
1540,16,31,99,13,5.665818337043016,18
1541,23,10,38,4,5.6654185371586925,6
1542,54,11,82,4,5.664278302313932,7
1543,16,37,84,15,5.660913981238355,22
1544,25,36,88,13,5.660869431868405,23
1545,64,34,41,13,5.656501014375914,21
1546,30,13,2,6,5.655225265692614,7
1547,46,31,75,13,5.65470539949331,18
1548,45,18,86,7,5.65286827981522,11
1549,4,10,97,4,5.649870700339142,6
1550,30,42,3,15,5.646158452665144,27
1551,62,18,104,6,5.643310295152116,12
1552,109,16,46,7,5.636528034552761,9
1553,83,11,62,4,5.62718588507507,7
1554,13,34,19,13,5.62379896339533,21
1555,98,27,37,11,5.623553949033442,16
1556,19,10,5,4,5.623378775596124,6
1557,68,26,91,12,5.619466372772095,14
1558,102,16,98,7,5.616900846312717,9
1559,86,17,61,7,5.615128594276011,10
1560,76,41,68,14,5.614845988196357,27
1561,55,15,85,6,5.607159089440444,9
1562,87,60,49,27,5.602602853303668,33
1563,3,23,112,11,5.594463947840817,12
1564,80,17,64,8,5.593698551425533,9
1565,20,38,96,15,5.591064360306498,23
1566,20,22,44,9,5.576158683247873,13
1567,7,23,38,10,5.575438881033765,13
1568,75,20,11,9,5.568757481037147,11
1569,72,11,9,5,5.567587328744071,6
1570,37,14,108,6,5.561998311446509,8
1571,31,10,95,4,5.558189159340279,6
1572,18,11,57,4,5.557171046422163,7
1573,13,30,95,13,5.5569838085167085,17
1574,46,11,4,5,5.5562218746456535,6
1575,48,42,107,18,5.555372120517399,24
1576,8,44,46,20,5.5530537260963095,24
1577,69,16,54,7,5.552096999235809,9
1578,12,16,57,6,5.55204054213819,10
1579,8,41,25,16,5.550067480025429,25
1580,36,53,31,23,5.5485644604686595,30
1581,25,18,84,7,5.546687618128964,11
1582,18,42,75,18,5.546579166688547,24
1583,44,11,70,5,5.543204446478317,6
1584,15,14,102,5,5.539976966220617,9
1585,8,11,85,4,5.538404103047142,7
1586,58,35,13,13,5.535900844279714,22
1587,16,22,14,9,5.533520092369791,13
1588,13,24,48,10,5.520624456307565,14
1589,89,10,84,5,5.518590211576737,5
1590,43,52,86,22,5.516052651464386,30
1591,17,10,89,4,5.51177775189421,6
1592,15,25,77,10,5.511717697327578,15
1593,45,23,65,11,5.510611418282089,12
1594,95,19,83,7,5.510188596504651,12
1595,32,13,109,6,5.508051897308613,7
1596,64,26,49,10,5.508050470931365,16
1597,62,30,19,11,5.5079113606244,19
1598,87,51,41,22,5.506817320713421,29
1599,2,13,40,5,5.504797437287725,8
1600,5,10,111,4,5.501968622126493,6
1601,87,69,37,29,5.500923627593111,40
1602,67,10,102,4,5.497246561771851,6
1603,50,12,52,6,5.495642094131338,6
1604,111,27,55,11,5.492663797248297,16
1605,100,22,25,10,5.476003695191374,12
1606,72,22,17,9,5.472151820286164,13
1607,98,17,60,7,5.471299685170586,10
1608,28,31,17,13,5.468605078583842,18
1609,31,13,74,5,5.468299370651388,8
1610,57,13,50,5,5.46070428512311,8
1611,54,13,47,6,5.460215589598553,7
1612,54,34,49,14,5.449189781331788,20
1613,52,14,13,6,5.444984627732144,8
1614,51,55,11,21,5.443782340904029,34
1615,54,88,88,36,5.435654938222569,52
1616,71,29,68,11,5.435653336862239,18
1617,20,15,72,6,5.433880871316617,9
1618,12,44,3,17,5.423827966019923,27
1619,57,30,63,14,5.4237588746313765,16
1620,104,38,25,17,5.42238345531962,21
1621,23,10,58,4,5.417812881789321,6
1622,2,26,106,11,5.4140126266560475,15
1623,47,28,86,11,5.41387371009472,17
1624,30,32,94,14,5.413124377396745,18
1625,9,21,34,9,5.406001466575153,12
1626,78,14,81,7,5.405603948540433,7
1627,4,11,58,4,5.405037105567138,7
1628,112,29,76,13,5.403769892160428,16
1629,8,20,33,8,5.397787705463006,12
1630,17,53,51,24,5.396332747607754,29
1631,78,31,69,13,5.3911801118239975,18
1632,34,20,74,7,5.390554150511845,13
1633,6,14,106,6,5.390411966564587,8
1634,16,32,58,14,5.387307163471736,18
1635,98,15,30,7,5.370529040661889,8
1636,15,25,18,10,5.370261713586336,15
1637,84,36,39,16,5.369674486814979,20
1638,15,32,81,14,5.361832492910931,18
1639,20,13,12,6,5.360426970680711,7
1640,26,16,87,7,5.357273241874729,9
1641,7,35,97,16,5.356987360153854,19
1642,55,27,97,11,5.353622513986459,16
1643,20,18,98,7,5.3527413318584305,11
1644,78,18,50,7,5.342630350789609,11
1645,54,37,90,15,5.340914168653275,22
1646,97,14,102,5,5.335160623731833,9
1647,34,25,55,11,5.330528309819539,14
1648,5,33,51,12,5.328986421528186,21
1649,83,21,64,9,5.3288244180118385,12
1650,62,33,51,14,5.327533238316315,19
1651,39,25,48,9,5.326525646398726,16
1652,50,21,72,8,5.318024007082146,13
1653,7,40,3,16,5.315954351050264,24
1654,63,26,23,10,5.309010284156328,16
1655,34,38,86,16,5.308774927674142,22
1656,46,25,63,12,5.304512093520618,13
1657,73,19,87,6,5.303982369774461,13
1658,78,10,23,4,5.303068144131315,6
1659,57,26,37,11,5.296608425452367,15
1660,89,11,3,5,5.295815593088658,6
1661,99,21,86,8,5.291638236148403,13
1662,28,12,92,4,5.284547759707862,8
1663,108,11,77,4,5.283240563660736,7
1664,41,19,17,7,5.273986417758152,12
1665,88,20,6,8,5.272285617199486,12
1666,34,23,43,10,5.271948745922037,13
1667,103,17,69,8,5.270007364936181,9
1668,34,11,1,3,5.259854618241466,8
1669,43,40,65,18,5.2578263621348755,22
1670,68,18,33,7,5.257015515736626,11
1671,35,11,31,5,5.255104723881268,6
1672,39,39,77,17,5.251215890680744,22
1673,41,28,49,12,5.249338337674644,16
1674,16,38,53,15,5.248684423830758,23
1675,98,20,12,8,5.2458423308532485,12
1676,25,26,40,11,5.242222631716464,15
1677,19,29,77,13,5.239565380734288,16
1678,72,20,109,8,5.237390001234543,12
1679,91,21,25,9,5.236778929543698,12
1680,44,15,76,6,5.232736844369687,9
1681,75,60,107,21,5.231874163862643,39
1682,78,22,103,7,5.22979498937837,15
1683,17,12,57,4,5.228708389418874,8
1684,35,11,5,5,5.226534281744125,6
1685,92,23,39,11,5.223931097826436,12
1686,11,26,35,11,5.22379077829607,15
1687,54,54,106,25,5.222938310920245,29
1688,7,101,88,43,5.220134457500585,58
1689,10,20,86,9,5.219152465496855,11
1690,8,35,57,14,5.20816002573612,21
1691,46,25,39,13,5.196853389468726,12
1692,104,18,80,8,5.194103195079235,10
1693,40,13,113,5,5.1937263926866155,8
1694,6,10,71,4,5.19369227829273,6
1695,49,64,86,28,5.183923708261804,36
1696,75,17,97,7,5.1834390154874335,10
1697,91,12,48,6,5.179665478095687,6
1698,91,19,54,9,5.17957458706686,10
1699,74,14,112,6,5.173073586151801,8
1700,86,40,81,14,5.171821026076149,26
1701,11,19,32,9,5.1696009211826786,10
1702,77,15,94,6,5.169474708107541,9
1703,31,11,54,5,5.168002033532433,6
1704,65,29,96,13,5.165027076154164,16
1705,6,16,86,6,5.1642614081075955,10
1706,67,12,5,5,5.159840528973079,7
1707,47,16,30,8,5.159042864029295,8
1708,38,14,46,5,5.157148141301117,9
1709,35,16,28,8,5.153123660542294,8
1710,106,24,9,10,5.150083731218856,14
1711,11,13,97,6,5.149154391162877,7
1712,78,51,51,24,5.146999984101784,27
1713,18,18,112,7,5.144336665076299,11
1714,80,17,38,8,5.143241338130117,9
1715,13,17,70,7,5.142156998200086,10
1716,70,15,71,7,5.1409333575718525,8
1717,109,23,38,8,5.1369538890417745,15
1718,36,21,3,8,5.136055944816984,13
1719,40,30,58,14,5.133397385337806,16
1720,64,14,33,5,5.132334361355241,9
1721,3,16,98,8,5.130853741808972,8
1722,30,96,16,38,5.128993944452904,58
1723,100,47,15,20,5.123121997282322,27
1724,72,34,19,14,5.112933716380972,20
1725,100,26,109,10,5.108589932165321,16
1726,30,10,1,4,5.107240382060615,6
1727,11,55,88,22,5.106519046181128,33
1728,34,15,5,5,5.091205514677904,10
1729,32,10,20,3,5.082163415292113,7
1730,100,56,27,24,5.080984098773695,32
1731,7,16,10,7,5.0604070656519635,9
1732,78,27,77,12,5.0576925284957,15
1733,78,45,19,18,5.052434315983816,27
1734,12,12,17,5,5.051854355123882,7
1735,13,27,103,10,5.050931612605473,17
1736,95,20,75,8,5.05026015248493,12
1737,20,23,2,10,5.048117889239678,13
1738,40,16,91,7,5.034652795604085,9
1739,100,24,74,10,5.032874442379239,14
1740,74,26,93,12,5.031462008142043,14
1741,49,38,60,16,5.030495378918768,22
1742,112,12,34,5,5.029259987635679,7
1743,34,16,15,6,5.02872812747396,10
1744,41,34,109,13,5.028182630199459,21
1745,60,29,38,12,5.0278953790273215,17
1746,16,111,8,46,5.024155840812808,65
1747,55,19,18,9,5.012210431301632,10
1748,93,12,63,5,5.011120266810436,7
1749,112,17,94,6,5.010192110959227,11
1750,102,13,83,5,5.00532757458449,8
1751,93,26,5,10,5.00446052682132,16
1752,7,41,106,20,5.003800212982274,21
1753,49,21,58,10,5.003014201039977,11
1754,51,23,96,10,5.001175453325252,13
1755,64,49,86,21,4.998572503617502,28
1756,50,23,31,10,4.99199978599778,13
1757,70,16,29,8,4.990481050245631,8
1758,63,19,94,8,4.988953899876627,11
1759,77,14,114,7,4.986921402992951,7
1760,16,53,17,20,4.978051363186689,33
1761,70,30,65,11,4.973765781446556,19
1762,80,10,44,5,4.973541413806906,5
1763,106,13,3,5,4.972676967703688,8
1764,12,44,13,15,4.971947648890687,29
1765,98,11,23,5,4.9699651611390046,6
1766,27,21,114,9,4.967571693509975,12
1767,96,23,90,9,4.963939687748074,14
1768,62,16,64,8,4.958930096475882,8
1769,114,26,3,10,4.954476539328307,16
1770,77,10,89,5,4.949600502404531,5
1771,7,32,47,13,4.949472292851426,19
1772,56,19,68,9,4.948132166753329,10
1773,80,29,106,12,4.946009667025369,17
1774,38,17,41,8,4.943011461235353,9
1775,40,15,78,5,4.942465399220725,10
1776,28,14,32,6,4.94214857785708,8
1777,49,11,71,5,4.940945789460408,6
1778,30,38,77,16,4.936309113355669,22
1779,63,17,85,8,4.93137224468223,9
1780,86,40,36,17,4.92743325124,23
1781,108,17,63,7,4.925158043652065,10
1782,74,56,106,24,4.924754963776783,32
1783,95,16,109,6,4.923183536193761,10
1784,48,11,77,4,4.913344813951473,7
1785,38,12,28,6,4.907164394244709,6
1786,47,30,68,13,4.897107609370838,17
1787,12,24,34,10,4.89000244569124,14
1788,39,10,101,4,4.88974127810336,6
1789,94,12,18,5,4.884425557504234,7
1790,23,19,17,8,4.884057347144711,11
1791,69,11,95,4,4.882909765417967,7
1792,63,20,79,8,4.882182316485546,12
1793,87,29,97,11,4.880674129028667,18
1794,86,39,62,17,4.879705109009971,22
1795,3,14,35,6,4.877634175071101,8
1796,13,26,98,10,4.873807977215297,16
1797,88,26,57,12,4.870812248870149,14
1798,20,12,94,5,4.869855233645218,7
1799,18,30,30,13,4.868176896140197,17
1800,29,11,1,4,4.866934575588788,7
1801,5,10,89,3,4.862465640901744,7
1802,16,57,50,23,4.861557430443652,34
1803,100,31,112,14,4.858414274039207,17
1804,72,12,42,5,4.857673633217595,7
1805,97,12,32,5,4.8514593495768255,7
1806,39,22,96,8,4.8469385601006945,14
1807,47,17,100,7,4.837634135475298,10
1808,100,80,87,36,4.8353266225993385,44
1809,8,15,67,6,4.831909846155588,9
1810,87,49,57,21,4.830115478356609,28
1811,114,21,15,9,4.8260102326414716,12
1812,31,19,25,9,4.8238393010997695,10
1813,14,15,54,5,4.820525855929134,10
1814,12,20,64,8,4.814047437556215,12
1815,74,11,85,5,4.812388004493801,6
1816,13,23,79,9,4.81127521378253,14
1817,104,34,63,15,4.811269466320185,19
1818,77,11,20,5,4.809570789797778,6
1819,13,47,54,20,4.8086934753533885,27
1820,89,14,68,6,4.806077051288233,8
1821,1,16,12,7,4.804302234326604,9
1822,75,22,96,7,4.801381492311929,15
1823,66,21,86,9,4.801113262592308,12
1824,41,22,97,10,4.799957538599524,12
1825,111,11,25,5,4.797175922879401,6
1826,104,89,65,39,4.7968264881701845,50
1827,52,13,20,5,4.795236183864799,8
1828,5,12,10,6,4.788462999241516,6
1829,86,53,78,24,4.786494656983801,29
1830,41,20,81,8,4.785164896950242,12
1831,47,10,45,4,4.780410761983768,6
1832,9,12,5,5,4.777710715122406,7
1833,70,21,98,8,4.776806059512886,13
1834,33,14,23,6,4.772846471482117,8
1835,90,13,70,6,4.771084444295363,7
1836,12,15,31,7,4.7706324645211815,8
1837,18,15,98,8,4.768289045671959,7
1838,30,71,65,30,4.766897212102786,41
1839,30,20,108,8,4.765041003995002,12
1840,13,28,84,11,4.762106527456084,17
1841,106,14,62,6,4.759729251582843,8
1842,72,21,60,9,4.758851391736089,12
1843,13,69,46,28,4.756415151860812,41
1844,7,23,50,10,4.754905099968973,13
1845,62,13,20,5,4.748945383379627,8
1846,25,16,77,7,4.745845616411634,9
1847,93,29,54,11,4.739093565612782,18
1848,25,13,108,5,4.7274242554223145,8
1849,75,32,31,15,4.721982750346428,17
1850,58,21,88,9,4.7114818888953405,12
1851,20,23,46,8,4.7087130702664775,15
1852,4,18,81,7,4.707056678124466,11
1853,98,34,107,15,4.703806209041121,19
1854,111,13,106,4,4.703726078810505,9
1855,88,32,38,12,4.688975834537393,20
1856,28,18,15,8,4.685699256091646,10
1857,40,51,39,21,4.685059105758992,30
1858,109,25,3,11,4.677062907217812,14
1859,12,24,8,10,4.6768486824589965,14
1860,75,10,92,4,4.670779177266828,6
1861,11,26,98,12,4.667493378770945,14
1862,86,43,72,18,4.662359318084507,25
1863,61,19,60,9,4.656026056433547,10
1864,104,48,50,20,4.65583203026361,28
1865,25,15,47,7,4.65539023183265,8
1866,27,13,79,6,4.651583262533679,7
1867,15,16,1,6,4.649350840919032,10
1868,63,39,96,15,4.649023449526141,24
1869,12,17,58,7,4.645880660678281,10
1870,72,39,11,17,4.645432567168801,22
1871,80,11,69,5,4.638884395252672,6
1872,60,22,25,10,4.636282806493919,12
1873,17,32,49,16,4.635564491950155,16
1874,106,15,110,7,4.633960085739291,8
1875,102,16,91,7,4.632859199025978,9
1876,51,41,19,16,4.631222093494114,25
1877,16,94,100,40,4.621171653003923,54
1878,72,10,40,4,4.616108231770902,6
1879,85,20,68,7,4.615895850726344,13
1880,74,11,57,5,4.613445177041246,6
1881,103,21,17,8,4.609264222789528,13
1882,75,40,37,15,4.608119905928104,25
1883,13,21,96,9,4.6080585972764805,12
1884,80,18,39,8,4.600479594629686,10
1885,41,60,107,23,4.597389180870248,37
1886,100,22,18,10,4.596212969192917,12
1887,50,32,96,14,4.592653394244439,18
1888,16,117,65,51,4.591775644110771,66
1889,108,15,38,6,4.591465457156278,9
1890,9,15,37,7,4.590013554185222,8
1891,99,16,65,7,4.579704538683154,9
1892,7,23,58,11,4.575034525669341,12
1893,99,14,95,6,4.572737764013049,8
1894,60,43,114,22,4.570942388181804,21
1895,99,16,104,8,4.5627492392393005,8
1896,74,23,109,9,4.56252527772352,14
1897,19,37,57,17,4.559363107017674,20
1898,43,18,5,8,4.559277543830878,10
1899,70,15,23,7,4.554568026577774,8
1900,77,45,51,21,4.55315042575402,24
1901,83,15,46,7,4.551826612706294,8
1902,99,18,15,7,4.5514613106187225,11
1903,77,22,11,10,4.543733506971011,12
1904,93,29,28,11,4.540056078542574,18
1905,16,64,3,26,4.533666295550078,38
1906,106,23,75,11,4.532198108241351,12
1907,55,44,28,18,4.526943972884062,26
1908,57,19,48,8,4.524936793492175,11
1909,89,20,15,9,4.523922474853295,11
1910,74,23,50,10,4.520207268757788,13
1911,49,18,112,8,4.517911222226071,10
1912,63,64,54,27,4.513765725874224,37
1913,57,10,96,5,4.511509669176178,5
1914,39,40,43,18,4.51050839778733,22
1915,15,13,70,7,4.501454445796363,6
1916,108,10,46,3,4.49601960881211,7
1917,13,23,89,9,4.495493504352194,14
1918,78,32,49,15,4.488412556658529,17
1919,16,109,7,48,4.487436298549418,61
1920,75,44,71,17,4.485645835804012,27
1921,7,46,64,21,4.481240056988839,25
1922,77,20,112,10,4.474967763642619,10
1923,96,31,25,14,4.472832877552797,17
1924,108,11,94,5,4.472725388082187,6
1925,49,20,18,7,4.468014752855383,13
1926,39,23,37,10,4.467775271301239,13
1927,37,18,32,8,4.466542082918524,10
1928,100,30,34,14,4.464826340973105,16
1929,85,16,57,7,4.462920901490054,9
1930,69,24,109,10,4.462898820440799,14
1931,79,15,54,6,4.462814449138745,9
1932,96,11,49,5,4.460220810874951,6
1933,19,14,85,6,4.456802611003388,8
1934,77,11,97,4,4.454901155383994,7
1935,94,18,49,7,4.445619988851261,11
1936,27,66,3,29,4.445164613495208,37
1937,19,45,107,18,4.439050926597956,27
1938,100,22,50,9,4.4360869713146975,13
1939,78,16,96,6,4.433803384678502,10
1940,76,17,90,6,4.433393911042905,11
1941,37,39,70,16,4.433263990915909,23
1942,17,10,58,6,4.43139506148379,4
1943,87,32,53,15,4.429162896361546,17
1944,23,14,20,6,4.427778675436007,8
1945,99,30,13,13,4.4209668288342625,17
1946,108,14,49,6,4.420404027662396,8
1947,11,33,3,14,4.420072692894771,19
1948,27,54,49,23,4.420016941836881,31
1949,84,30,70,13,4.416286467774103,17
1950,7,64,53,28,4.4162137369106675,36
1951,86,118,5,51,4.415256493878053,67
1952,71,14,108,6,4.402422140240555,8
1953,76,35,5,15,4.400670357773005,20
1954,90,26,65,13,4.399856936469097,13
1955,97,39,16,18,4.395866715554318,21
1956,54,20,29,8,4.381395329954479,12
1957,87,33,25,15,4.379098196808539,18
1958,30,24,103,10,4.3756528534434045,14
1959,86,103,88,45,4.37292356531332,58
1960,40,23,23,10,4.3684233268033035,13
1961,74,15,9,6,4.367415226980933,9
1962,49,17,70,8,4.364791676107706,9
1963,47,32,88,14,4.36195323618654,18
1964,95,20,23,9,4.361896262769256,11
1965,64,31,71,12,4.3594731378011655,19
1966,19,11,83,5,4.359398192701059,6
1967,3,38,29,16,4.3554842742728415,22
1968,65,16,6,7,4.346168811124805,9
1969,95,19,41,8,4.332143979792181,11
1970,19,14,80,6,4.328848204649311,8
1971,37,75,86,34,4.327795117897226,41
1972,3,26,64,12,4.321344224546427,14
1973,4,22,40,10,4.316643149060887,12
1974,8,61,65,27,4.314970047229393,34
1975,97,23,17,10,4.313428551304965,13
1976,86,64,104,28,4.3129795987995365,36
1977,106,27,53,13,4.3023196001359025,14
1978,37,45,55,21,4.3010010805888355,24
1979,30,54,49,23,4.293465853324729,31
1980,68,32,78,14,4.290052324917813,18
1981,48,48,87,19,4.286667160277857,29
1982,50,22,69,11,4.283220710932241,11
1983,74,51,65,23,4.282390955650973,28
1984,30,18,90,8,4.279146936241298,10
1985,23,28,15,12,4.277369019757655,16
1986,23,12,103,5,4.2708753291504635,7
1987,9,20,100,8,4.263839107868786,12
1988,37,55,106,26,4.262507559544696,29
1989,69,32,68,14,4.253129950198649,18
1990,76,28,60,11,4.2507308281171925,17
1991,71,14,38,5,4.250425614356073,9
1992,100,13,70,6,4.2466986166827585,7
1993,13,42,69,18,4.244765914439893,24
1994,106,14,34,7,4.243674039664676,7
1995,16,53,69,22,4.243264956504184,31
1996,16,44,71,18,4.24180487871631,26
1997,71,31,87,14,4.240167636343153,17
1998,30,20,62,9,4.230291626453226,11
1999,43,17,89,8,4.227307951626208,9
2000,48,12,46,5,4.225391974153922,7
2001,9,21,38,9,4.22415659668818,12
2002,71,11,44,5,4.2235243488394545,6
2003,28,29,100,12,4.22112967447295,17
2004,4,19,18,8,4.220670692754495,11
2005,43,19,84,9,4.214619850887415,10
2006,52,10,48,4,4.211289472665269,6
2007,17,21,20,9,4.207666463256874,12
2008,65,56,36,24,4.205692860728478,32
2009,107,57,23,26,4.195631697148178,31
2010,29,25,34,12,4.194433318367099,13
2011,29,15,93,7,4.1887249261114,8
2012,39,15,97,6,4.184940668998106,9
2013,93,11,43,5,4.184906166012258,6
2014,23,27,25,12,4.182190113226041,15
2015,60,28,46,12,4.181848371447908,16
2016,18,13,103,5,4.1752141807255745,8
2017,60,24,96,8,4.164982345638217,16
2018,83,40,5,19,4.163709904424498,21
2019,64,20,46,8,4.163045047710225,12
2020,30,17,52,7,4.158499353957516,10
2021,92,14,27,7,4.157793062407016,7
2022,114,14,67,6,4.15758676403295,8
2023,19,10,2,5,4.15617878328422,5
2024,27,24,84,11,4.15605922191636,13
2025,99,12,17,5,4.148375833376951,7
2026,50,77,28,33,4.143924434349459,44
2027,53,47,71,20,4.141303557057989,27
2028,87,18,66,8,4.140314373651453,10
2029,71,11,20,4,4.1364305573939655,7
2030,83,15,50,8,4.131296712002355,7
2031,42,14,87,6,4.125698672116465,8
2032,7,12,2,5,4.115660194227726,7
2033,85,20,51,9,4.111259035742407,11
2034,108,17,55,7,4.110943675956946,10
2035,97,30,63,13,4.107378727934814,17
2036,75,48,51,22,4.10605342104463,26
2037,83,20,93,9,4.100880722204595,11
2038,20,24,35,10,4.098728722002916,14
2039,111,15,8,7,4.091375789332372,8
2040,36,11,19,5,4.088590218421681,6
2041,95,47,16,22,4.085164151883546,25
2042,78,17,98,8,4.084899624702052,9
2043,91,21,75,13,4.084376386784757,8
2044,85,17,11,7,4.074093197649269,10
2045,30,14,33,5,4.072796165922766,9
2046,95,21,46,9,4.071848693893571,12
2047,69,15,37,7,4.071098728743587,8
2048,75,17,93,8,4.069384641387428,9
2049,7,68,31,30,4.069172309295859,38
2050,65,19,73,8,4.067312461469672,11
2051,43,12,95,5,4.065288768086309,7
2052,76,21,48,8,4.063944654554617,13
2053,72,39,27,18,4.063603110178614,21
2054,56,11,39,6,4.061429150921742,5
2055,68,28,49,12,4.0611103765436,16
2056,15,16,75,6,4.056062954518072,10
2057,14,10,20,4,4.051966837258039,6
2058,32,10,40,5,4.050021677419865,5
2059,84,12,69,5,4.046782427990891,7
2060,15,28,78,14,4.041757900414731,14
2061,104,39,100,17,4.040446439481136,22
2062,100,35,78,15,4.039033914310789,20
2063,1,10,43,5,4.0389767157587135,5
2064,63,41,114,15,4.037972989054357,26
2065,60,23,57,10,4.037432638780123,13
2066,30,34,57,13,4.033172714117432,21
2067,66,15,15,7,4.02908475103322,8
2068,29,14,79,5,4.020689709966037,9
2069,28,25,19,10,4.019180575644085,15
2070,76,34,109,13,4.013784930537313,21
2071,8,20,110,8,4.013172679497399,12
2072,5,18,77,8,4.010067732208506,10
2073,89,25,86,12,4.002412442274511,13
2074,31,16,112,6,4.001730552260444,10
2075,107,30,35,12,3.9981582817027532,18
2076,112,12,14,6,3.993235963114864,6
2077,80,35,55,17,3.984081280103419,18
2078,107,41,38,17,3.9835241995724298,24
2079,60,18,97,9,3.9792005525226397,9
2080,83,10,76,4,3.9791717561004964,6
2081,96,12,14,5,3.975747798085741,7
2082,109,12,58,6,3.9746303755307224,6
2083,13,25,62,11,3.969870239284988,14
2084,41,13,102,5,3.968301975819481,8
2085,84,11,94,5,3.968156665744439,6
2086,39,31,72,14,3.965512114394319,17
2087,10,21,84,9,3.9602546020658425,12
2088,40,23,37,11,3.9558411724945226,12
2089,8,26,3,13,3.9551370260288135,13
2090,9,15,91,7,3.9508212932565088,8
2091,67,11,104,5,3.95056976239549,6
2092,35,19,43,9,3.946831407739411,10
2093,6,11,40,5,3.9442678680230885,6
2094,62,26,8,11,3.9420545038632544,15
2095,84,22,76,10,3.938973343504664,12
2096,18,15,20,6,3.930360704025332,9
2097,5,28,2,12,3.9232778253201652,16
2098,76,45,49,19,3.92111761126653,26
2099,11,28,47,12,3.9192520826064863,16
2100,51,53,46,23,3.917943537235088,30
2101,75,29,64,13,3.9160007140392388,16
2102,23,14,48,6,3.910408208571404,8
2103,86,67,46,27,3.9036534898053614,40
2104,55,30,63,14,3.9003771949656936,16
2105,64,24,19,9,3.897841875409208,15
2106,62,12,47,5,3.8975081676650087,7
2107,1,25,54,11,3.8929886538978153,14
2108,87,81,3,35,3.8919625985848327,46
2109,40,17,5,8,3.8914877974226934,9
2110,8,19,19,8,3.8866341483098394,11
2111,6,12,57,5,3.882176264826061,7
2112,102,11,49,4,3.8805789709331324,7
2113,8,15,112,6,3.8800170080974894,9
2114,13,102,107,45,3.875896696379633,57
2115,2,11,48,4,3.8719596921161834,7
2116,90,16,80,6,3.867067615214411,10
2117,20,54,28,24,3.866248630000691,30
2118,40,50,107,20,3.8570605527160113,30
2119,85,17,17,7,3.8507511089593,10
2120,28,39,76,18,3.848512689408892,21
2121,41,22,50,9,3.845767300582984,13
2122,18,23,31,11,3.8430258307678673,12
2123,111,11,12,6,3.8360170890156353,5
2124,51,62,41,28,3.827557123973995,34
2125,4,11,3,5,3.8250463920918434,6
2126,48,12,75,5,3.823943527087417,7
2127,114,40,51,19,3.8167576032502186,21
2128,5,28,91,11,3.8146250930665184,17
2129,100,86,107,41,3.81426815907971,45
2130,110,16,5,7,3.8138584796050914,9
2131,28,27,71,11,3.8126316435493948,16
2132,74,86,86,40,3.8093023861998647,46
2133,13,49,11,21,3.8069597302365823,28
2134,109,22,77,10,3.802610927611434,12
2135,114,24,46,10,3.798669441811228,14
2136,6,11,39,5,3.7966207547038127,6
2137,49,31,62,12,3.793599031346923,19
2138,25,29,54,13,3.788520356553666,16
2139,106,52,51,23,3.7850976424308236,29
2140,104,28,98,15,3.783243181516933,13
2141,7,10,93,5,3.780231549016956,5
2142,43,21,18,11,3.7780523238060235,10
2143,114,47,13,24,3.775914918731173,23
2144,11,47,54,21,3.7735514931953094,26
2145,87,21,17,9,3.7733166042192914,12
2146,55,27,9,11,3.772633679119087,16
2147,60,59,86,26,3.7680795314200566,33
2148,102,14,17,6,3.765627490194506,8
2149,23,24,39,11,3.756334637991312,13
2150,30,25,48,10,3.7536152956466684,15
2151,52,13,107,5,3.753558475982526,8
2152,41,24,37,10,3.7456130176699944,14
2153,50,37,76,19,3.7437752407401974,18
2154,53,42,40,19,3.7429391558119973,23
2155,28,58,54,25,3.7427833536169195,33
2156,49,40,77,17,3.742548604574208,23
2157,51,55,84,24,3.742451182902999,31
2158,1,13,4,5,3.736039087851971,8
2159,29,46,19,19,3.7351953785375813,27
2160,60,59,40,26,3.735016412978284,33
2161,15,19,50,8,3.731886058645917,11
2162,90,31,5,13,3.729228130116929,18
2163,15,13,40,6,3.725578311667862,7
2164,91,40,86,18,3.721705750823955,22
2165,18,58,53,27,3.720925458312455,31
2166,81,31,16,14,3.7185584556590716,17
2167,15,21,5,8,3.7147342263498166,13
2168,1,21,64,10,3.714096825641645,11
2169,100,70,13,32,3.7127466967472085,38
2170,95,42,87,20,3.706416281336596,22
2171,112,10,35,5,3.7046440124812365,5
2172,29,15,108,7,3.6991799646967536,8
2173,17,12,108,5,3.6979659768897495,7
2174,23,19,28,9,3.6970356039584327,10
2175,54,72,51,32,3.676698399835987,40
2176,38,21,84,10,3.669980206703245,11
2177,28,20,85,9,3.6675135147560156,11
2178,29,16,102,6,3.661932828184928,10
2179,39,24,31,10,3.6610558433956144,14
2180,90,10,71,5,3.6561036030201173,5
2181,107,21,32,10,3.6546977761524615,11
2182,17,11,18,6,3.651905683853184,5
2183,64,20,108,9,3.648889859577028,11
2184,114,16,98,7,3.6481628146735163,9
2185,9,13,23,6,3.6475995665029006,7
2186,14,10,70,5,3.647042134114854,5
2187,63,17,12,9,3.6338048171297044,8
2188,47,17,81,7,3.6281046116933036,10
2189,55,51,5,22,3.6280461911141377,29
2190,80,26,28,12,3.6230809501897743,14
2191,11,16,66,8,3.62198826525064,8
2192,112,15,79,7,3.621796379179409,8
2193,1,36,88,17,3.612486249864132,19
2194,12,46,27,19,3.60812267367479,27
2195,86,24,32,11,3.600337352350485,13
2196,65,88,41,36,3.5987797514188595,52
2197,34,23,79,9,3.5987779482770503,14
2198,62,30,71,14,3.5956607664822755,16
2199,75,57,16,26,3.5952902080350215,31
2200,106,14,57,7,3.593618983726931,7
2201,104,61,5,28,3.5931408944870395,33
2202,16,60,37,27,3.5920272636761035,33
2203,7,22,11,9,3.5909071733141316,13
2204,97,10,95,4,3.589432471334791,6
2205,14,18,11,7,3.5868100547047623,11
2206,88,62,5,29,3.583030843412137,33
2207,41,10,62,5,3.5810735995056335,5
2208,33,14,78,6,3.5759620126343448,8
2209,14,22,87,9,3.574657228905804,13
2210,13,48,78,21,3.5732041834288704,27
2211,25,19,43,7,3.573077352948072,12
2212,6,21,87,9,3.566989216260901,12
2213,6,28,7,15,3.5631855242339134,13
2214,60,12,79,5,3.555370933230572,7
2215,28,19,36,9,3.554999615354129,10
2216,62,21,37,8,3.552668728814333,13
2217,40,16,19,6,3.5456118713031146,10
2218,33,11,70,5,3.5452850377562246,6
2219,47,29,27,13,3.543966431934925,16
2220,23,37,8,16,3.5407673906896986,21
2221,40,65,36,28,3.54008292473436,37
2222,28,32,30,15,3.539926425473853,17
2223,41,23,29,10,3.5398297136431847,13
2224,58,15,47,6,3.535505795510924,9
2225,44,15,7,7,3.5352660207554565,8
2226,85,26,84,10,3.5349178606931724,16
2227,6,10,62,4,3.534555615892036,6
2228,65,27,109,13,3.530447741364183,14
2229,93,17,25,8,3.5300397889756283,9
2230,37,55,50,26,3.5287986061002155,29
2231,89,16,74,7,3.5219803445540374,9
2232,9,32,54,15,3.5206046809983693,17
2233,89,42,16,19,3.5193714307593913,23
2234,100,15,108,6,3.5153991595907637,9
2235,11,24,17,11,3.5151101549695944,13
2236,102,19,3,8,3.5088603359734862,11
2237,74,16,23,7,3.505315761927062,9
2238,25,27,109,12,3.5041369262347244,15
2239,73,17,98,8,3.503959852428817,9
2240,3,30,77,14,3.5028026588503227,16
2241,47,22,15,11,3.5019607775766484,11
2242,97,36,114,16,3.494809729950692,20
2243,20,26,109,10,3.4929177397438647,16
2244,6,10,54,5,3.4921987314309866,5
2245,14,16,5,6,3.490369625649153,10
2246,23,14,53,6,3.489897713169177,8
2247,62,13,36,6,3.4895283270523723,7
2248,94,13,50,5,3.4892669802483653,8
2249,94,46,87,22,3.487474186460591,24
2250,36,30,51,14,3.487460022502504,16
2251,87,129,107,58,3.4871862799766844,71
2252,25,20,70,9,3.4845181159437417,11
2253,34,41,27,19,3.4773981792874973,22
2254,50,21,49,10,3.4685004795882266,11
2255,33,23,5,11,3.4543275091771948,12
2256,37,21,23,10,3.4530437057487378,11
2257,112,14,114,7,3.4529529803290564,7
2258,63,97,86,40,3.452765603775126,57
2259,54,85,16,39,3.4509458652322422,46
2260,88,85,107,36,3.4500810163394413,49
2261,103,25,12,13,3.4495496342358525,12
2262,7,94,86,40,3.4487912180291196,54
2263,49,25,63,12,3.435463908483024,13
2264,7,52,27,24,3.4308990471010516,28
2265,4,12,37,5,3.4218717037755013,7
2266,64,24,11,9,3.420093692917575,15
2267,28,18,78,9,3.417711658801108,9
2268,17,11,36,6,3.417273645156761,5
2269,79,22,11,9,3.411899322441769,13
2270,4,13,28,6,3.394082491248691,7
2271,73,10,104,4,3.3914910994647243,6
2272,36,28,55,13,3.3833365772573503,15
2273,70,15,43,6,3.3830636227591584,9
2274,75,28,27,12,3.382934039982325,16
2275,70,20,75,10,3.379349863200628,10
2276,74,16,91,7,3.3793273468188416,9
2277,73,18,96,8,3.3726024221333364,10
2278,91,31,107,13,3.3692392206395296,18
2279,13,56,28,26,3.3671896375902834,30
2280,65,47,11,22,3.3651164472660025,25
2281,40,17,20,7,3.3649339637959685,10
2282,54,25,97,12,3.3648153427656786,13
2283,14,23,8,10,3.3634201583462153,13
2284,9,14,61,6,3.362078776884604,8
2285,14,17,106,7,3.360059412826618,10
2286,16,27,45,11,3.3506732016294225,16
2287,78,37,60,17,3.348403443672673,20
2288,83,10,20,5,3.3478898251644154,5
2289,15,19,20,8,3.345564249700581,11
2290,68,32,12,15,3.341405752135098,17
2291,68,13,5,6,3.3380294056441113,7
2292,80,17,48,7,3.3356230533911297,10
2293,50,12,81,6,3.335453957922903,6
2294,2,15,38,7,3.331749539896775,8
2295,13,85,55,38,3.325656298998864,47
2296,98,14,97,7,3.3185319117606134,7
2297,97,16,84,6,3.3164282058099306,10
2298,96,59,54,29,3.314517669950013,30
2299,13,46,77,20,3.313982424227239,26
2300,12,41,87,18,3.311210658261355,23
2301,86,66,25,31,3.3097455853588773,35
2302,41,14,96,5,3.3088942892360294,9
2303,69,37,3,15,3.3087662316726303,22
2304,107,43,64,20,3.307651233136555,23
2305,19,21,20,10,3.306390497523301,11
2306,3,41,43,18,3.3062727025950664,23
2307,65,33,50,15,3.3047538561922973,18
2308,114,21,64,9,3.3046667254482807,12
2309,47,13,61,6,3.3043540506366393,7
2310,12,11,90,4,3.304244091296132,7
2311,41,35,104,17,3.298393432816602,18
2312,50,18,19,8,3.2983343340311553,10
2313,34,11,98,6,3.2977526881218022,5
2314,63,28,15,12,3.2961749452345925,16
2315,76,17,79,7,3.2930359935936755,10
2316,15,10,38,4,3.290523774376458,6
2317,55,15,35,7,3.2899027901624844,8
2318,13,37,1,15,3.287939891614485,22
2319,68,63,107,30,3.262613498145854,33
2320,7,24,74,9,3.2574931437928867,15
2321,64,31,8,13,3.2562336911280285,18
2322,114,47,25,20,3.2540864225169726,27
2323,29,25,68,11,3.253332721067045,14
2324,81,19,65,8,3.2504513606416725,11
2325,54,32,72,13,3.24739358559799,19
2326,64,10,96,4,3.2470341038418864,6
2327,23,12,81,5,3.2407035870769985,7
2328,100,42,88,18,3.2386401365610333,24
2329,99,25,60,11,3.238194459102711,14
2330,107,49,36,23,3.2348387046482587,26
2331,3,14,97,7,3.230803945654674,7
2332,88,48,109,20,3.230101069602965,28
2333,23,50,65,24,3.229242004811313,26
2334,54,16,12,8,3.22546532700851,8
2335,100,10,80,4,3.221630002984554,6
2336,55,18,94,8,3.2183549150249444,10
2337,72,14,64,7,3.21744827694827,7
2338,17,16,74,7,3.211770551027834,9
2339,50,19,97,8,3.210625734622635,11
2340,60,47,31,24,3.209470727487928,23
2341,63,18,72,7,3.209203933965973,11
2342,56,12,97,6,3.2085312435870676,6
2343,60,38,41,19,3.2070562991666334,19
2344,106,28,17,11,3.2039846830051175,17
2345,64,24,45,10,3.20075696622173,14
2346,36,41,39,18,3.1998605067578247,23
2347,69,15,8,7,3.191300471105285,8
2348,17,22,90,9,3.1908484224220683,13
2349,54,31,114,15,3.18479213160143,16
2350,78,29,54,13,3.1794235894954275,16
2351,106,25,60,10,3.1712615038081853,15
2352,55,26,20,12,3.1691541193918384,14
2353,41,30,69,12,3.1671568486745967,18
2354,63,20,66,9,3.166079264336923,11
2355,107,55,9,27,3.1653943190937825,28
2356,93,16,109,7,3.1609286434035413,9
2357,75,19,4,8,3.1591429263358246,11
2358,86,21,82,9,3.158656091984634,12
2359,104,51,7,23,3.158219418007501,28
2360,11,43,57,22,3.1565311276310086,21
2361,75,23,23,12,3.1487336010920157,11
2362,114,23,9,8,3.1400252375404265,15
2363,47,24,41,12,3.137759511909013,12
2364,3,24,76,11,3.1320099121348606,13
2365,6,11,28,5,3.131247568187587,6
2366,17,37,107,17,3.127832561498684,20
2367,87,61,50,29,3.123710809883347,32
2368,100,34,63,17,3.1200171001381665,17
2369,28,36,48,16,3.118969087107223,20
2370,72,21,88,9,3.118023866621951,12
2371,36,11,80,5,3.1158574211756562,6
2372,76,32,55,13,3.1154560441471983,19
2373,25,25,17,11,3.1106502600539123,14
2374,50,24,4,12,3.1105592371369686,12
2375,13,80,60,34,3.1063619078243834,46
2376,111,21,86,9,3.1037611827633476,12
2377,98,24,100,10,3.102517713271864,14
2378,9,20,57,9,3.1019493918441285,11
2379,92,15,60,6,3.101629065738577,9
2380,99,14,68,6,3.1001036150844774,8
2381,88,16,74,6,3.1000151762465453,10
2382,17,29,54,14,3.099464272586133,15
2383,104,34,54,16,3.0987784259955395,18
2384,34,28,19,12,3.0972119799619953,16
2385,85,10,109,3,3.0954068823106935,7
2386,6,17,27,8,3.0947871865212933,9
2387,93,17,50,7,3.089216846430406,10
2388,107,59,37,27,3.087858660035621,32
2389,66,12,28,6,3.0826665795427424,6
2390,55,16,62,7,3.0797392954165557,9
2391,97,23,104,11,3.078979141926911,12
2392,51,99,65,44,3.0776235709217983,55
2393,43,37,7,15,3.0706324410883696,22
2394,75,30,25,13,3.0695517335408993,17
2395,16,161,51,76,3.0672990902119097,85
2396,71,18,25,8,3.0644100067848137,10
2397,17,21,63,10,3.0560482096450983,11
2398,7,45,55,19,3.054761469393279,26
2399,86,28,93,13,3.0472078293797855,15
2400,38,13,96,6,3.0422152322461717,7
2401,30,22,79,9,3.0387025691085756,13
2402,25,39,65,16,3.0368934823131166,23
2403,66,11,49,5,3.0343057959347575,6
2404,63,46,41,21,3.0272340731708356,25
2405,86,38,79,17,3.025515072530802,21
2406,40,17,33,6,3.0217035797006977,11
2407,20,48,16,20,3.014886072612058,28
2408,74,42,63,20,3.0096162132471513,22
2409,50,20,108,10,3.0061866874624097,10
2410,96,14,34,6,3.001763014782561,8
2411,4,11,69,5,2.99948417666171,6
2412,85,23,13,9,2.985985548040522,14
2413,46,13,1,7,2.9771068452784517,6
2414,18,11,72,7,2.976476380286215,4
2415,16,61,23,28,2.9759826631167945,33
2416,84,36,106,18,2.975473960825013,18
2417,11,33,43,15,2.9751377683179343,18
2418,43,28,41,13,2.9751067750185944,15
2419,36,32,4,13,2.9739066740354216,19
2420,2,21,37,10,2.96975801126945,11
2421,90,26,50,12,2.969099568178274,14
2422,49,38,51,18,2.967933172070934,20
2423,73,16,63,8,2.966556049159884,8
2424,25,18,57,8,2.9649349505538733,10
2425,114,23,57,10,2.9591464136641084,13
2426,55,11,66,5,2.9570964571041585,6
2427,111,34,16,16,2.9513696994671306,18
2428,71,18,46,9,2.9448527741935377,9
2429,9,18,1,10,2.9438107743951836,8
2430,16,63,5,26,2.9385145168648896,37
2431,83,27,65,13,2.938404758323202,14
2432,36,20,87,8,2.93557325089767,12
2433,33,21,28,11,2.934003356051797,10
2434,12,18,40,9,2.93028970370934,9
2435,3,10,33,4,2.927658221464771,6
2436,37,14,103,5,2.9215508243945583,9
2437,1,14,62,7,2.921521583990398,7
2438,88,21,61,8,2.9209863910476948,13
2439,102,19,106,10,2.9207255392565106,9
2440,29,10,47,4,2.9199833749969137,6
2441,109,17,9,9,2.91854195196147,8
2442,55,11,31,5,2.9183781753906346,6
2443,37,10,33,4,2.9157377490462264,6
2444,104,12,10,6,2.9113530030237116,6
2445,95,29,53,11,2.9078610003173133,18
2446,62,19,9,9,2.9069158954391607,10
2447,16,33,79,14,2.9049583801159358,19
2448,29,21,43,9,2.9011864295713177,12
2449,30,34,71,16,2.8915964337712703,18
2450,8,33,27,16,2.8813894658039874,17
2451,88,18,48,7,2.8781551150447946,11
2452,11,36,20,15,2.8760492087904987,21
2453,17,25,46,11,2.875672610475698,14
2454,106,14,77,7,2.875589368126161,7
2455,75,21,30,10,2.874328227945732,11
2456,108,10,2,4,2.873465048153021,6
2457,57,16,89,8,2.873156488945959,8
2458,112,14,1,5,2.872325056767921,9
2459,30,95,87,43,2.8710649309032963,52
2460,83,25,87,12,2.871024026015094,13
2461,103,16,94,8,2.8705816929887495,8
2462,53,32,55,14,2.8682065355723365,18
2463,28,70,84,31,2.8670003890442093,39
2464,108,14,78,6,2.8642940930834624,8
2465,69,25,28,12,2.861912956405139,13
2466,86,157,87,76,2.8585449867468666,81
2467,16,96,28,43,2.854985092700266,53
2468,39,51,53,23,2.8501763309992625,28
2469,97,13,33,6,2.848649622206162,7
2470,4,25,16,13,2.8411046840521457,12
2471,107,51,106,24,2.8408623146416336,27
2472,86,104,28,46,2.8374089851944673,58
2473,39,11,35,5,2.8361547619317555,6
2474,75,21,112,9,2.8242194050340816,12
2475,18,13,71,6,2.821320109059585,7
2476,68,14,48,7,2.8206443314688054,7
2477,97,26,76,12,2.8180456861896697,14
2478,9,48,40,21,2.81743847104381,27
2479,60,31,109,14,2.8109683593595354,17
2480,1,32,36,16,2.809530345293069,16
2481,78,31,43,13,2.808792064889392,18
2482,99,15,41,7,2.8081672918617295,8
2483,65,42,71,18,2.8056942435602363,24
2484,106,14,112,7,2.805082024542774,7
2485,30,20,12,9,2.8020124275112575,11
2486,48,26,65,13,2.800978027003418,13
2487,33,15,27,7,2.7980319906219515,8
2488,83,32,8,16,2.795775595052069,16
2489,23,15,50,5,2.795623997234249,10
2490,68,14,44,7,2.7953277213928227,7
2491,7,26,1,12,2.793205495238505,14
2492,100,13,36,6,2.7923934619121074,7
2493,70,12,102,7,2.7906887378625385,5
2494,85,14,112,6,2.788857070839814,8
2495,69,19,39,9,2.785474853322304,10
2496,18,30,40,12,2.780722164544755,18
2497,10,17,87,8,2.7770692343126595,9
2498,93,12,100,5,2.7764313127252507,7
2499,107,40,62,20,2.7755749146997823,20
2500,62,32,3,14,2.7719381715786184,18
2501,51,52,109,20,2.7686239064931364,32
2502,27,60,88,29,2.7660588381556592,31
2503,15,23,69,10,2.7652098531538094,13
2504,64,24,23,11,2.763646390912283,13
2505,103,10,53,3,2.7626913899775767,7
2506,1,17,94,9,2.7623810098011936,8
2507,97,34,96,17,2.7556888339056833,17
2508,3,16,46,8,2.752172231930853,8
2509,12,41,51,19,2.750892681987319,22
2510,71,26,51,12,2.748484052918404,14
2511,39,80,107,37,2.7469032653332537,43
2512,53,45,64,20,2.7453777698168924,25
2513,89,10,75,5,2.7450238265363027,5
2514,13,115,51,56,2.744637990046723,59
2515,54,35,102,16,2.738133577396994,19
2516,99,12,63,6,2.737725340993938,6
2517,35,29,86,12,2.735934113725711,17
2518,104,67,13,30,2.733835584620105,37
2519,35,18,30,8,2.7335215300448548,10
2520,89,16,65,7,2.732610790712205,9
2521,68,24,57,12,2.731461721250245,12
2522,102,13,77,6,2.7262279934205442,7
2523,49,11,5,5,2.7256599500520577,6
2524,44,16,88,8,2.7255415222047095,8
2525,37,30,84,14,2.7240272709777176,16
2526,34,16,88,7,2.7175195012540176,9
2527,63,20,4,9,2.7170319642618375,11
2528,30,48,15,21,2.7124708522281957,27
2529,38,21,29,10,2.711869147927812,11
2530,114,66,88,31,2.711653784187521,35
2531,94,26,29,12,2.7112074149721908,14
2532,23,23,77,11,2.7061500660226216,12
2533,20,27,7,13,2.7023319306021247,14
2534,43,45,60,21,2.6992549601571802,24
2535,87,63,106,30,2.6977525519324614,33
2536,43,20,37,10,2.6945517502192464,10
2537,20,27,41,14,2.6942971523502353,13
2538,30,42,68,20,2.69417991123464,22
2539,10,11,65,5,2.691616036034299,6
2540,87,23,31,11,2.6915087275033063,12
2541,13,20,102,8,2.68911865765018,12
2542,74,61,5,29,2.685625674476677,32
2543,63,13,103,5,2.6855582456044873,8
2544,39,25,5,12,2.6791322172692817,13
2545,46,36,87,15,2.6745789000356535,21
2546,25,17,44,8,2.67353547628176,9
2547,11,97,86,45,2.6726601869988587,52
2548,13,118,7,55,2.6708973171944725,63
2549,37,67,104,30,2.6697156594454787,37
2550,71,17,5,8,2.668348512437488,9
2551,16,182,86,79,2.6669149010376003,103
2552,19,33,86,16,2.6647937741985714,17
2553,40,24,27,13,2.6563176029466624,11
2554,16,39,80,16,2.655474856892814,23
2555,20,14,73,6,2.6543798385197754,8
2556,55,52,11,22,2.6542455471400306,30
2557,57,13,36,5,2.6531160901053727,8
2558,103,22,41,11,2.6487253088558034,11
2559,104,39,109,18,2.643837630094446,21
2560,39,17,89,7,2.637403555239235,10
2561,110,13,54,6,2.635884902993451,7
2562,51,12,22,5,2.6349206585516356,7
2563,95,34,39,16,2.633907594970311,18
2564,54,21,98,10,2.6338814908595602,11
2565,95,34,107,16,2.633836762476072,18
2566,76,25,88,12,2.6331924139366394,13
2567,39,42,28,20,2.6233394077803616,22
2568,104,41,95,18,2.6172247089757974,23
2569,86,48,12,22,2.616723025406273,26
2570,63,18,45,8,2.611830236832499,10
2571,40,29,1,13,2.6081027273161883,16
2572,50,37,51,18,2.606142976623963,19
2573,36,23,91,10,2.600483205457642,13
2574,57,47,51,22,2.599162353840762,25
2575,62,12,77,5,2.5961939184273137,7
2576,20,48,37,23,2.5936827651590773,25
2577,102,27,37,12,2.5931875377695404,15
2578,1,10,109,5,2.5929606771402334,5
2579,28,71,65,31,2.5907378992374,40
2580,33,15,88,6,2.581178022844097,9
2581,50,22,112,9,2.578275791966451,13
2582,81,14,108,7,2.5758573743146345,7
2583,16,24,35,10,2.575434774594282,14
2584,1,29,51,14,2.574119304918465,15
2585,38,14,76,8,2.5739884202864642,6
2586,48,14,25,7,2.5710538086168517,7
2587,33,26,13,12,2.569937378676217,14
2588,78,50,107,22,2.5669006033975177,28
2589,86,48,90,21,2.566035530404322,27
2590,7,109,68,50,2.5626001746544613,59
2591,48,21,51,11,2.5619467431523466,10
2592,86,14,14,7,2.5565201304900285,7
2593,73,19,1,8,2.5534291003907317,11
2594,9,44,39,22,2.551362349935293,22
2595,71,14,47,7,2.5504632262813383,7
2596,7,74,36,34,2.54935875079736,40
2597,11,66,46,30,2.543747274872027,36
2598,60,70,88,31,2.540682618011766,39
2599,97,35,65,16,2.539739428020559,19
2600,70,22,9,9,2.5390649499197586,13
2601,8,14,89,6,2.5350410826092795,8
2602,40,60,88,27,2.532837544735202,33
2603,7,29,17,13,2.532089441361393,16
2604,61,10,62,5,2.53075507416622,5
2605,44,15,107,7,2.530544567099409,8
2606,99,19,30,8,2.530388293684778,11
2607,78,32,30,15,2.5287150917106826,17
2608,77,41,87,19,2.5281436463062663,22
2609,36,33,9,15,2.527924078037464,18
2610,68,27,46,12,2.520930145642669,15
2611,104,77,16,35,2.5182352258511727,42
2612,97,18,29,8,2.5164381029243006,10
2613,12,15,36,7,2.516319942513756,8
2614,89,17,104,8,2.5139241654919755,9
2615,30,69,107,30,2.513798209453786,39
2616,87,15,92,7,2.5078466479835897,8
2617,39,47,104,21,2.5072894343981114,26
2618,114,63,86,30,2.5031933128077988,33
2619,84,13,67,7,2.500709874534178,6
2620,71,27,9,12,2.485839871550415,15
2621,28,25,79,12,2.485405030035431,13
2622,65,25,103,10,2.4852149334196074,15
2623,87,58,28,28,2.477822962643624,30
2624,65,52,106,24,2.474183582331677,28
2625,13,52,15,25,2.4673961616838107,27
2626,74,17,69,9,2.466497282082459,8
2627,17,17,1,8,2.462761073509875,9
2628,102,32,25,15,2.460889696925051,17
2629,110,17,86,8,2.459712460283758,9
2630,40,10,84,5,2.4542210673969374,5
2631,58,16,50,8,2.4508398898046,8
2632,61,17,65,9,2.4487309858444046,8
2633,63,15,61,6,2.445410080263457,9
2634,90,38,87,19,2.4450741783684653,19
2635,32,10,50,6,2.4440541907162885,4
2636,23,56,7,26,2.4411917402729504,30
2637,107,50,3,25,2.4400027665406854,25
2638,68,53,3,26,2.437668230604428,27
2639,14,19,51,7,2.433844123091522,12
2640,3,17,96,8,2.432078371197565,9
2641,72,32,77,15,2.428129578165291,17
2642,109,11,99,5,2.4195174025010506,6
2643,57,61,15,29,2.4170316454638145,32
2644,8,98,107,48,2.4151763973518863,50
2645,28,19,94,8,2.4149604753175544,11
2646,15,32,7,17,2.4130666365885896,15
2647,8,40,50,17,2.4122569104172085,23
2648,12,27,23,13,2.408330439629221,14
2649,54,22,23,10,2.4071199385443034,12
2650,19,18,58,8,2.406497773380725,10
2651,88,57,104,25,2.406185933878753,32
2652,16,81,49,37,2.404650030921449,44
2653,20,26,80,12,2.4033351571638515,14
2654,74,14,33,7,2.401214003272284,7
2655,100,27,94,10,2.400243221659601,17
2656,8,36,76,16,2.3997351089247143,20
2657,97,21,109,10,2.398141101921517,11
2658,103,56,16,28,2.39452116720106,28
2659,39,53,54,25,2.3874161960295956,28
2660,4,21,71,8,2.387175011736595,13
2661,96,25,104,11,2.386641983915838,14
2662,75,13,56,5,2.3840139649043484,8
2663,100,58,19,26,2.382850378134939,32
2664,54,11,66,5,2.382433829903063,6
2665,86,90,84,45,2.3816790899230798,45
2666,88,92,51,47,2.379271211176054,45
2667,15,52,107,21,2.3786357884173874,31
2668,71,40,107,17,2.376060967609246,23
2669,90,19,84,9,2.374748457023267,10
2670,72,36,100,17,2.3699375895329595,19
2671,25,32,63,16,2.3688265373602633,16
2672,40,24,50,10,2.367144047455048,14
2673,19,30,60,15,2.366878047373235,15
2674,99,23,5,11,2.36162190226428,12
2675,102,17,39,8,2.3613393535898353,9
2676,70,34,76,16,2.358420872168424,18
2677,100,14,97,6,2.358325970901081,8
2678,43,16,58,7,2.3567163693861573,9
2679,96,14,109,6,2.3566759619593634,8
2680,8,27,17,13,2.354578898260205,14
2681,40,17,109,7,2.3545763145612293,10
2682,99,12,33,5,2.354570382478152,7
2683,4,36,31,15,2.353535596679466,21
2684,57,12,33,5,2.3532372822710057,7
2685,79,10,96,5,2.351992111457352,5
2686,88,70,68,32,2.348799110697707,38
2687,60,23,48,11,2.3452069486573284,12
2688,13,44,72,21,2.3449450257806985,23
2689,78,10,45,5,2.343791897433706,5
2690,58,30,69,15,2.3378190755068298,15
2691,38,21,19,8,2.334542521998157,13
2692,80,37,86,17,2.3309612757843783,20
2693,25,28,53,14,2.3301510854690863,14
2694,109,51,5,25,2.3285813949081624,26
2695,34,53,107,23,2.32807475083319,30
2696,84,35,50,17,2.3257021134383256,18
2697,65,25,34,11,2.3212579900106842,14
2698,104,21,102,11,2.3206272974702777,10
2699,3,23,61,8,2.318754532374438,15
2700,111,18,87,8,2.316389144833365,10
2701,88,32,91,15,2.315767764685106,17
2702,8,58,96,27,2.313991189820113,31
2703,71,31,63,14,2.311262987331468,17
2704,63,28,70,13,2.309911464577443,15
2705,76,13,69,5,2.308555624427584,8
2706,35,13,70,7,2.3047047876076423,6
2707,38,11,98,5,2.303289795541877,6
2708,87,27,112,13,2.3028409213342953,14
2709,60,26,95,12,2.300035058084818,14
2710,86,23,33,10,2.299697494324661,13
2711,80,20,7,9,2.2986689861273377,11
2712,63,42,50,19,2.2950983829965117,23
2713,100,24,5,11,2.293242743404467,13
2714,106,13,4,7,2.287883468044358,6
2715,8,76,28,35,2.28759259007733,41
2716,73,16,16,8,2.286947763730408,8
2717,89,13,20,6,2.2819892797426884,7
2718,38,10,81,5,2.2819621266449914,5
2719,77,12,69,6,2.2797993708458937,6
2720,65,14,92,7,2.2769844774151653,7
2721,40,14,74,6,2.2751378053719047,8
2722,13,68,27,32,2.274081632265013,36
2723,61,10,31,5,2.2696136748473625,5
2724,28,66,96,31,2.2674069446039304,35
2725,85,12,7,5,2.267272935114745,7
2726,62,12,98,6,2.263618494828719,6
2727,15,41,3,19,2.263363137566217,22
2728,98,16,17,8,2.2572460925395315,8
2729,74,13,41,7,2.2545650248033358,6
2730,95,30,25,14,2.253973143655666,16
2731,51,34,103,15,2.2523561426908394,19
2732,63,11,83,4,2.2518527555221,7
2733,86,16,113,7,2.2517990720455145,9
2734,70,10,27,5,2.2432632584575636,5
2735,108,13,65,7,2.2401098494637828,6
2736,64,41,39,19,2.23942050343346,22
2737,4,26,114,13,2.2345648368573663,13
2738,46,18,65,7,2.232998478058108,11
2739,90,16,25,7,2.2261576936837093,9
2740,78,18,20,9,2.2240641682142104,9
2741,98,13,99,7,2.2212581677933705,6
2742,75,23,84,11,2.2186834285684545,12
2743,5,50,96,22,2.21142719225076,28
2744,68,109,13,51,2.203259504991036,58
2745,54,45,19,19,2.199905055467105,26
2746,91,12,56,6,2.199268647174773,6
2747,7,75,40,33,2.195752128306479,42
2748,60,32,75,15,2.194819750320694,17
2749,68,35,106,16,2.193685806982791,19
2750,17,38,39,17,2.193005161454297,21
2751,7,19,72,9,2.1917063339887894,10
2752,64,10,69,4,2.1864749506825825,6
2753,55,24,77,11,2.1857007329001785,13
2754,27,76,107,34,2.1737890157942084,42
2755,5,10,29,4,2.165232041865749,6
2756,40,20,45,9,2.160407922723577,11
2757,3,17,79,7,2.155492099627798,10
2758,10,21,8,9,2.147315002146761,12
2759,55,11,69,5,2.141856565606561,6
2760,71,39,39,18,2.1402119009407667,21
2761,102,22,74,10,2.1384304011801003,12
2762,66,13,31,6,2.1367157981218847,7
2763,8,26,102,13,2.1358165667375633,13
2764,107,22,89,11,2.1353078245406363,11
2765,2,12,61,5,2.133108515807604,7
2766,98,10,43,4,2.1302778964437667,6
2767,16,139,13,63,2.1299224675207302,76
2768,107,27,81,13,2.1289588783710056,14
2769,41,61,88,27,2.1276735354556675,34
2770,8,85,88,40,2.1249214472921283,45
2771,108,10,95,4,2.124107159080121,6
2772,102,32,114,14,2.1240842876015136,18
2773,7,62,9,31,2.12190310948229,31
2774,87,55,109,24,2.1192896636396394,31
2775,104,34,70,16,2.118226250740968,18
2776,53,11,70,5,2.1174802085363624,6
2777,16,63,62,27,2.1158722554695206,36
2778,50,56,107,27,2.1132862646405495,29
2779,69,11,25,5,2.112059751085251,6
2780,68,28,94,13,2.106511062546953,15
2781,33,22,11,12,2.098758142334807,10
2782,64,17,57,7,2.0964467583954445,10
2783,97,22,8,11,2.094799206270942,11
2784,40,18,11,9,2.0894421004610075,9
2785,15,12,94,5,2.08916589041162,7
2786,64,43,68,18,2.0864244028015833,25
2787,60,19,83,9,2.080593849514111,10
2788,20,68,54,35,2.0740616245882637,33
2789,30,32,104,16,2.073588127852212,16
2790,89,16,55,8,2.073523664632458,8
2791,104,16,20,8,2.0724807758275627,8
2792,27,20,23,10,2.0722628371370155,10
2793,84,30,34,14,2.067010635537676,16
2794,57,19,20,9,2.0635570646445043,10
2795,13,20,92,11,2.054986448369509,9
2796,109,28,102,13,2.052816303469014,15
2797,16,79,68,35,2.0462981602365193,44
2798,45,14,68,6,2.0416275962437833,8
2799,12,14,7,7,2.0405365521973633,7
2800,8,58,39,29,2.0392287633719337,29
2801,11,18,93,10,2.0391902780828315,8
2802,60,40,8,20,2.033286998314092,20
2803,91,14,114,7,2.031242634143403,7
2804,19,36,94,18,2.0287789057822354,18
2805,32,11,13,5,2.0261815070275424,6
2806,28,52,51,26,2.025017303726126,26
2807,17,34,50,17,2.0227689416055807,17
2808,16,54,70,24,2.0212880671139883,30
2809,114,27,17,11,2.021159075364864,16
2810,65,44,17,18,2.020871434980538,26
2811,49,40,65,19,2.019905367784044,21
2812,8,37,90,16,2.0194647820717773,21
2813,111,10,10,4,2.0194606727691027,6
2814,93,11,60,4,2.018629631632228,7
2815,80,37,54,19,2.0181573041232794,18
2816,84,37,54,17,2.0154202399698513,20
2817,68,29,70,14,2.015118158104632,15
2818,112,13,103,6,2.012520719272728,7
2819,83,22,97,12,2.0076368732075736,10
2820,43,14,90,6,2.005339357933236,8
2821,48,29,11,13,2.003568336649414,16
2822,114,26,74,13,1.9975972531686852,13
2823,48,12,81,5,1.9888329395840285,7
2824,3,16,93,9,1.9887992190402266,7
2825,53,19,4,9,1.9876947928926743,10
2826,100,12,79,5,1.9822381822120898,7
2827,68,30,38,13,1.98112771845421,17
2828,76,19,108,9,1.9804363984704085,10
2829,88,32,70,15,1.9762934359596307,17
2830,55,31,84,15,1.9725581442910776,16
2831,54,10,35,4,1.970607603878345,6
2832,39,25,34,12,1.9686602327127705,13
2833,43,53,94,25,1.9677758823914582,28
2834,102,11,95,5,1.9663297200367644,6
2835,28,33,91,15,1.9649527402335243,18
2836,41,24,112,11,1.9642201479007209,13
2837,80,11,97,5,1.9631828964682283,6
2838,39,14,33,7,1.960095595226131,7
2839,41,21,78,9,1.9597162558523102,12
2840,50,18,29,9,1.959231338964665,9
2841,50,11,35,5,1.9581460146246819,6
2842,20,13,38,5,1.9557732518764164,8
2843,36,34,64,17,1.9485056781764578,17
2844,13,22,61,9,1.9474617025071013,13
2845,25,20,55,9,1.9429576796619987,11
2846,60,81,77,38,1.9426493005944157,43
2847,107,38,112,19,1.9399789809753514,19
2848,23,14,31,6,1.9392936999416412,8
2849,110,13,104,5,1.938847445081051,8
2850,71,49,7,25,1.9387153694352726,24
2851,32,10,98,5,1.938005226383161,5
2852,23,14,97,7,1.9330528734436583,7
2853,41,26,76,14,1.9323052199492383,12
2854,65,30,84,14,1.928864673268391,16
2855,70,19,40,8,1.9276789997691242,11
2856,102,23,51,11,1.9242622041835236,12
2857,114,21,18,10,1.9235772497574426,11
2858,16,64,72,29,1.9235174892718676,35
2859,99,11,76,6,1.9173589523208294,5
2860,97,32,106,16,1.9159665785715103,16
2861,110,11,17,5,1.9155371371930712,6
2862,8,65,74,29,1.9128656065638743,36
2863,17,39,34,20,1.911801999559805,19
2864,68,38,1,18,1.9099752765436635,20
2865,37,20,109,9,1.908398750070837,11
2866,78,37,63,18,1.905896647305326,19
2867,93,12,9,5,1.9054646427528432,7
2868,39,81,13,38,1.9038228253048934,43
2869,30,12,111,5,1.9021634173356627,7
2870,55,27,99,12,1.895072402151854,15
2871,85,12,98,5,1.892963761582925,7
2872,29,48,87,22,1.8921228743126288,26
2873,71,44,86,22,1.8883807510456327,22
2874,25,23,64,11,1.8857238852847764,12
2875,96,16,30,7,1.8850748786904798,9
2876,2,41,8,20,1.8848654476169666,21
2877,98,17,19,7,1.875761702707658,10
2878,39,62,27,28,1.8742568395293475,34
2879,30,16,81,8,1.8705842587540351,8
2880,104,15,92,8,1.8690561053420138,7
2881,8,62,51,30,1.8690209653489374,32
2882,53,13,47,6,1.867452050486345,7
2883,60,13,33,5,1.8644268792007332,8
2884,29,36,27,16,1.862710190219295,20
2885,93,21,97,10,1.8583722279909525,11
2886,106,15,66,6,1.8543998994283266,9
2887,53,22,97,10,1.8492466822191047,12
2888,50,13,73,5,1.8439270323254195,8
2889,12,18,85,9,1.8411131730635333,9
2890,84,38,96,19,1.8356486827006806,19
2891,17,18,38,8,1.835044678880425,10
2892,95,22,20,11,1.8350043196326213,11
2893,3,12,66,6,1.8347522062759387,6
2894,38,17,72,9,1.8294765096627927,8
2895,74,29,13,14,1.8278354237299024,15
2896,44,13,114,6,1.8263733365516688,7
2897,13,44,75,20,1.82625422828726,24
2898,43,53,19,25,1.8262026945752656,28
2899,94,28,86,13,1.8256273703234354,15
2900,102,13,99,6,1.821289341303691,7
2901,76,25,37,10,1.8207875520541696,15
2902,55,18,29,9,1.8130539080836594,9
2903,40,18,111,9,1.8104998545748747,9
2904,36,22,25,11,1.807144013826855,11
2905,70,57,86,26,1.80463722039498,31
2906,51,34,31,14,1.8036645224364263,20
2907,29,18,9,9,1.8021042570677095,9
2908,62,19,102,9,1.8008214371485478,10
2909,88,13,45,7,1.7936864388197336,6
2910,107,33,85,16,1.7927255981297012,17
2911,114,35,39,18,1.7909993968165154,17
2912,20,19,48,8,1.7888857426975104,11
2913,97,27,46,13,1.7888516310767923,14
2914,37,25,90,12,1.7816453937181727,13
2915,62,47,87,22,1.7735628992287058,25
2916,65,95,107,45,1.7733589716431564,50
2917,9,19,30,8,1.7725720850396782,11
2918,58,16,77,7,1.7691785236904847,9
2919,29,18,23,9,1.768903884608291,9
2920,30,49,51,23,1.7674253182266604,26
2921,53,51,65,25,1.7628403003306898,26
2922,37,98,5,47,1.7580752219846099,51
2923,91,29,13,15,1.7567935360990932,14
2924,54,78,8,34,1.7565177133908374,44
2925,50,48,11,23,1.7551842799258404,25
2926,88,37,18,18,1.7539193639392456,19
2927,85,17,88,8,1.7507571303795118,9
2928,87,83,88,40,1.748805765879452,43
2929,79,23,107,10,1.7474071801332398,13
2930,50,26,64,13,1.7443555357645693,13
2931,41,50,27,22,1.7436572730759,28
2932,76,30,27,13,1.7427067110546455,17
2933,60,33,36,16,1.7416473627060738,17
2934,18,11,6,5,1.7414584600944842,6
2935,36,37,88,16,1.7392851936744356,21
2936,11,28,102,14,1.7387973463291377,14
2937,9,23,112,10,1.7370284161007252,13
2938,111,16,9,7,1.7347101097492736,9
2939,16,27,44,12,1.7334648777380284,15
2940,103,20,3,11,1.732990158940766,9
2941,106,38,96,17,1.7318320126651967,21
2942,89,15,100,7,1.7317538752294916,8
2943,32,13,68,5,1.7311662598089266,8
2944,8,65,11,31,1.7307656592660734,34
2945,60,24,1,11,1.730552170717301,13
2946,27,38,43,18,1.7274963713159432,20
2947,77,10,28,5,1.7274479044716262,5
2948,8,98,55,49,1.7228795986298449,49
2949,47,21,72,8,1.72259491799794,13
2950,88,25,77,11,1.7210000447837095,14
2951,74,17,43,9,1.720220429736231,8
2952,104,24,83,10,1.7171480590838881,14
2953,5,51,54,23,1.7127518345022985,28
2954,88,62,28,29,1.7102908597256317,33
2955,77,10,2,5,1.7047420693819304,5
2956,20,16,102,8,1.6989391239814888,8
2957,49,15,33,6,1.6985707880959617,9
2958,36,15,23,9,1.697287527418564,6
2959,63,17,95,8,1.6923751834394967,9
2960,65,30,78,13,1.6922088418099972,17
2961,87,104,65,49,1.6895189939198372,55
2962,72,34,78,18,1.6894090900721692,16
2963,73,20,28,10,1.687006788072292,10
2964,55,58,88,25,1.6855630045879748,33
2965,55,40,106,18,1.6835382667235024,22
2966,39,43,12,20,1.6799981271423818,23
2967,16,41,90,20,1.6799312140304254,21
2968,63,45,7,18,1.673573876629926,27
2969,48,14,104,6,1.673511883025235,8
2970,46,39,28,17,1.6724095749961827,22
2971,11,23,94,10,1.671556142402879,13
2972,87,45,84,20,1.6712785926609632,25
2973,45,28,31,13,1.6710870406691025,15
2974,17,17,112,8,1.670998049379022,9
2975,54,19,33,8,1.6683853925492595,11
2976,85,21,16,9,1.6660938255041766,12
2977,114,13,34,7,1.6642874528280043,6
2978,37,47,74,23,1.66281633297112,24
2979,63,24,47,10,1.6623324282821739,14
2980,57,30,43,13,1.6612981568954175,17
2981,114,32,20,15,1.6576211464865755,17
2982,39,47,19,20,1.6563754565915598,27
2983,41,30,1,13,1.6558361653082903,17
2984,72,18,62,8,1.6557951231896935,10
2985,57,16,104,6,1.6527114989919929,10
2986,36,23,68,11,1.651168634820273,12
2987,13,51,109,25,1.6395687372615342,26
2988,49,33,12,19,1.6371252398943674,14
2989,104,26,18,11,1.6361581237581893,15
2990,6,18,68,10,1.6346986227731617,8
2991,64,12,84,7,1.6272082249846804,5
2992,7,22,30,12,1.6270647619511827,10
2993,106,46,88,20,1.6248459493396556,26
2994,87,58,60,30,1.6223072521777593,28
2995,69,18,20,8,1.617076755581312,10
2996,17,14,80,6,1.6140041509212482,8
2997,30,29,69,14,1.6139022710932394,15
2998,15,26,54,14,1.6106595014683187,12
2999,76,17,18,8,1.601109520179619,9
3000,100,60,39,29,1.6010134961541473,31
3001,51,56,37,24,1.5992269438266569,32
3002,91,12,38,6,1.5959128745414664,6
3003,14,11,75,5,1.594721022285634,6
3004,51,24,98,11,1.5914965104039462,13
3005,65,36,76,15,1.5910282606529313,21
3006,65,114,63,54,1.5897439715876234,60
3007,114,42,7,19,1.5876978285125964,23
3008,104,18,23,10,1.586371905318577,8
3009,27,20,98,10,1.5846794804650375,10
3010,2,15,25,8,1.5845186001024,7
3011,2,34,97,16,1.581483466739766,18
3012,86,87,20,41,1.5804412903724692,46
3013,55,22,90,12,1.578656952498875,10
3014,76,20,95,10,1.5773440780858254,10
3015,68,39,77,17,1.5766153992257432,22
3016,74,59,16,29,1.5763144198537753,30
3017,96,34,88,17,1.5755489762598094,17
3018,72,27,43,13,1.57449773007736,14
3019,4,61,13,28,1.56876063127331,33
3020,16,43,38,17,1.5626325984818243,26
3021,80,20,11,10,1.5532652275466894,10
3022,60,32,9,14,1.541763907829675,18
3023,60,80,7,38,1.5400508999434617,42
3024,68,19,81,9,1.5385400494517059,10
3025,22,10,86,5,1.5381482899799122,5
3026,94,35,107,14,1.5336456044178703,21
3027,98,13,79,6,1.5335435073226167,7
3028,60,24,58,12,1.5296571105675618,12
3029,114,20,84,9,1.5282826629009736,11
3030,23,49,86,23,1.5258006277824925,26
3031,35,14,37,7,1.523131742310598,7
3032,66,19,51,9,1.521191963579343,10
3033,46,12,55,5,1.514859018089967,7
3034,30,42,54,20,1.505912608605317,22
3035,68,53,63,25,1.50575560658607,28
3036,27,25,50,10,1.5040884605682736,15
3037,39,52,57,24,1.5029089864695706,28
3038,23,24,3,11,1.50147747590911,13
3039,46,52,5,24,1.4974094901037533,28
3040,107,47,25,23,1.4967278623744338,24
3041,112,16,11,8,1.4950492246382474,8
3042,13,86,86,39,1.4942238545984032,47
3043,2,23,74,10,1.4920197761473226,13
3044,88,16,94,9,1.488282221240778,7
3045,3,23,50,11,1.4863990456698133,12
3046,27,10,95,4,1.4847422192138044,6
3047,60,74,71,35,1.4843115108657066,39
3048,86,44,77,21,1.4836620718907323,23
3049,30,21,102,11,1.483382510488162,10
3050,67,20,34,8,1.482087506365966,12
3051,64,18,77,7,1.4804278853158328,11
3052,37,38,17,16,1.479924510472103,22
3053,68,10,84,4,1.4788993773509214,6
3054,103,17,79,8,1.4762996181953671,9
3055,106,50,11,21,1.4751786277994416,29
3056,35,24,7,12,1.4676220715119486,12
3057,6,13,69,7,1.4672562795661197,6
3058,2,47,50,22,1.4655399199134267,25
3059,6,10,49,4,1.4632163711361081,6
3060,40,64,51,31,1.4624658901194083,33
3061,31,21,47,10,1.4606130980712677,11
3062,12,18,52,8,1.4597821535609574,10
3063,25,23,83,10,1.459720188055504,13
3064,107,131,86,63,1.4543099391367897,68
3065,91,14,90,7,1.453639559044283,7
3066,65,33,80,16,1.4513664238423436,17
3067,106,55,63,27,1.448556681809942,28
3068,75,44,39,23,1.4473715172929777,21
3069,29,45,107,18,1.4469723177138325,27
3070,27,20,81,10,1.446682198592998,10
3071,12,21,38,10,1.44606768522066,11
3072,99,14,27,6,1.4451774655149798,8
3073,65,33,69,16,1.4425642416495112,17
3074,19,22,112,11,1.4419647960353517,11
3075,20,21,97,11,1.4395279608818752,10
3076,50,28,25,14,1.4391705454909005,14
3077,89,21,60,11,1.4364501610048446,10
3078,36,35,45,19,1.423273124508118,16
3079,65,39,111,17,1.4217415135333136,22
3080,88,24,35,12,1.4205575592973045,12
3081,1,11,53,5,1.4196819324858239,6
3082,16,49,29,24,1.4188154130480974,25
3083,30,23,106,11,1.4150001393849174,12
3084,12,20,71,10,1.4059148964814137,10
3085,46,25,9,13,1.4052752923291445,12
3086,70,17,95,9,1.4011695857654891,8
3087,30,58,60,25,1.4011348149570484,33
3088,74,12,98,6,1.394136813126094,6
3089,19,29,12,16,1.3921833318008658,13
3090,95,12,80,6,1.3888115326852126,6
3091,36,11,29,6,1.3837445576600509,5
3092,62,14,84,7,1.3810102415014267,7
3093,106,30,41,15,1.3806292559177726,15
3094,52,11,55,5,1.3787566985994324,6
3095,94,22,65,12,1.3778845805510187,10
3096,86,79,3,39,1.3757666811474318,40
3097,104,29,15,14,1.3712105407530093,15
3098,39,37,62,17,1.3681155062123813,20
3099,87,61,55,30,1.3657748995370722,31
3100,25,26,30,14,1.363384718034573,12
3101,41,35,40,18,1.358626645359705,17
3102,50,70,54,34,1.3558875691745103,36
3103,97,37,88,18,1.3490743629309014,19
3104,108,17,40,9,1.3479697301696891,8
3105,86,89,8,46,1.3465074887539425,43
3106,65,53,15,26,1.3449057106427964,27
3107,8,44,104,21,1.3410693202324964,23
3108,6,10,23,5,1.3385415186806267,5
3109,41,41,57,19,1.3346067759194706,22
3110,49,27,109,13,1.3289589421166759,14
3111,91,15,57,8,1.3279179810680901,7
3112,16,75,19,33,1.3261572129763854,42
3113,72,53,87,26,1.320143251933304,27
3114,74,18,80,9,1.319966132866856,9
3115,16,48,48,25,1.3151995623254895,23
3116,62,32,65,16,1.314337298660698,16
3117,94,11,40,5,1.3131730085845268,6
3118,78,17,38,8,1.312421560246772,9
3119,112,32,65,16,1.3122977163439495,16
3120,88,66,49,31,1.312293038683479,35
3121,68,52,9,25,1.3104638696206712,27
3122,9,28,58,13,1.310268135821897,15
3123,32,14,51,7,1.3093866254236395,7
3124,41,28,114,14,1.307338108043566,14
3125,107,74,63,39,1.3057879270213837,35
3126,5,44,13,21,1.3023509853743034,23
3127,15,41,68,18,1.2999611619233393,23
3128,41,47,68,23,1.2976062488793099,24
3129,11,27,29,13,1.2961292923128658,14
3130,7,22,8,10,1.2952715014492373,12
3131,88,39,4,19,1.294921220761057,20
3132,51,46,43,23,1.2927213961905486,23
3133,51,19,99,10,1.2892082407104484,9
3134,76,34,19,16,1.2877409537338131,18
3135,39,50,47,23,1.2793416824524833,27
3136,96,59,107,27,1.2779661064945878,32
3137,34,10,91,5,1.2767116469837227,5
3138,57,13,35,5,1.2766228565175344,8
3139,71,11,1,6,1.2732152302328021,5
3140,60,29,28,16,1.272111001147211,13
3141,57,18,49,8,1.2683352845717475,10
3142,92,12,107,5,1.2625916923530776,7
3143,81,20,18,10,1.2612198373935404,10
3144,47,17,19,8,1.2608828610261413,9
3145,93,10,79,5,1.2606355667564615,5
3146,114,18,49,10,1.2604600332250735,8
3147,9,37,63,18,1.2589023707877973,19
3148,38,20,51,10,1.2575366142186466,10
3149,17,42,13,21,1.2570532505054286,21
3150,13,61,9,28,1.2504419702657084,33
3151,11,31,74,15,1.2464065422784565,16
3152,51,69,60,30,1.2442757806235896,39
3153,91,20,37,10,1.2413018923540677,10
3154,71,25,31,12,1.2380158081615484,13
3155,39,42,50,20,1.237297066410004,22
3156,68,76,27,36,1.2367720795392603,40
3157,28,39,25,17,1.2338977751460145,22
3158,66,16,9,7,1.2335487286820452,9
3159,3,46,60,22,1.224317367731729,24
3160,55,17,41,8,1.220974525083998,9
3161,112,51,16,25,1.2207004808764241,26
3162,107,46,70,24,1.2201940929331918,22
3163,71,37,88,16,1.218508421155273,21
3164,86,70,55,33,1.2139036480148047,37
3165,25,33,97,16,1.2112097532933517,17
3166,8,33,48,16,1.2090868114966704,17
3167,28,65,5,32,1.2040234196998174,33
3168,90,15,33,7,1.2020135668608967,8
3169,43,18,62,9,1.197090981091843,9
3170,20,20,76,11,1.195513412586339,9
3171,25,67,16,32,1.1932865297100734,35
3172,68,18,74,7,1.1930607364890244,11
3173,87,16,110,7,1.1878037867151132,9
3174,49,28,9,15,1.1870965912725642,13
3175,76,31,96,14,1.1853039288193863,17
3176,33,12,77,6,1.1756675735500741,6
3177,83,35,55,18,1.174944809247691,17
3178,44,13,75,7,1.169380882277211,6
3179,100,34,62,17,1.1692002604569447,17
3180,16,40,47,19,1.1653415017893014,21
3181,54,85,107,42,1.1626549744549326,43
3182,70,24,41,13,1.154537329956712,11
3183,47,12,94,6,1.1540186483091397,6
3184,79,17,7,8,1.150116600366683,9
3185,51,19,58,9,1.150079328736186,10
3186,98,17,57,8,1.1470460176345278,9
3187,17,10,33,5,1.1464162819529016,5
3188,39,14,98,6,1.1463977441558346,8
3189,38,16,54,8,1.1438367497110855,8
3190,8,14,56,7,1.138262181129431,7
3191,87,26,52,13,1.137456454355296,13
3192,88,27,90,12,1.1337889641393057,15
3193,95,11,64,6,1.1310441974354588,5
3194,36,26,106,13,1.1307287364062795,13
3195,3,26,31,14,1.1304098830558913,12
3196,51,93,107,40,1.1261649710981219,53
3197,79,17,88,8,1.1249704502892566,9
3198,69,28,19,13,1.12274464710603,15
3199,57,42,13,22,1.1222847149141768,20
3200,28,25,57,12,1.1208866402447313,13
3201,29,19,7,7,1.117067463392933,12
3202,100,14,61,7,1.1138239851805005,7
3203,63,17,58,7,1.1113806593996052,10
3204,73,13,55,6,1.1082443575059628,7
3205,4,32,107,15,1.1053879522342496,17
3206,96,18,2,9,1.1039761816908875,9
3207,27,37,57,19,1.1033906612223556,18
3208,70,39,106,20,1.1024614638047314,19
3209,34,24,50,12,1.1020664531949347,12
3210,18,35,41,18,1.098384167284529,17
3211,19,17,102,7,1.0910566361497018,10
3212,42,14,69,7,1.0889746986073447,7
3213,39,55,41,29,1.0871035103792377,26
3214,93,11,94,4,1.0822019157683678,7
3215,62,23,76,11,1.0792355388180026,12
3216,75,27,74,12,1.0761366724331511,15
3217,64,19,97,9,1.0748997556853976,10
3218,28,61,109,28,1.0738097371372834,33
3219,46,13,103,6,1.0718715021600824,7
3220,88,21,89,10,1.0718351353910898,11
3221,9,16,97,9,1.0715415510849877,7
3222,67,20,37,9,1.070770052763525,11
3223,58,14,71,7,1.0679524363994424,7
3224,100,14,44,7,1.0590413147864144,7
3225,86,39,38,18,1.0547313169805967,21
3226,13,36,38,15,1.0523988581053296,21
3227,66,19,72,8,1.0523369485237943,11
3228,30,19,23,9,1.0508168359836587,10
3229,68,42,104,21,1.0507036529928548,21
3230,71,18,45,10,1.0500246166344471,8
3231,60,94,16,46,1.0486299464835127,48
3232,104,23,17,11,1.0458379273038076,12
3233,49,11,91,5,1.0426488720953477,6
3234,104,16,33,7,1.0375486456158094,9
3235,80,17,60,9,1.0365050448794264,8
3236,60,54,65,29,1.0350242100510143,25
3237,104,38,74,17,1.0321539192468763,21
3238,19,11,52,6,1.0319605986693652,5
3239,19,29,88,15,1.0300321093866873,14
3240,63,20,44,9,1.0233184771026445,11
3241,64,12,90,6,1.0226762518657313,6
3242,33,31,16,17,1.021253352666774,14
3243,8,34,49,17,1.020408759114468,17
3244,79,13,9,7,1.0203716742776936,6
3245,15,22,62,11,1.0190475345508367,11
3246,30,66,19,31,1.01819608239916,35
3247,77,36,65,19,1.0154517929662803,17
3248,20,17,85,8,1.0120202947249686,9
3249,53,25,81,12,1.007220979224658,13
3250,91,20,18,9,1.0069076377111847,11
3251,68,74,86,37,1.0064238301014834,37
3252,114,11,93,6,1.0049906589581667,5
3253,87,37,75,18,1.0026365052951263,19
3254,86,31,53,13,0.9974427707068927,18
3255,76,37,39,16,0.9969073892313128,21
3256,43,13,48,7,0.9891423928749106,6
3257,37,42,65,19,0.988736357368918,23
3258,69,32,107,15,0.9867318989974718,17
3259,54,19,112,9,0.9843355592348286,10
3260,43,10,92,4,0.9836040223889839,6
3261,86,38,2,20,0.9822306710469796,18
3262,7,81,41,40,0.9794700083084562,41
3263,16,63,43,29,0.9789822885028281,34
3264,93,19,84,8,0.9776365381665071,11
3265,61,13,39,7,0.9776304076631862,6
3266,68,15,102,7,0.9774478191416416,8
3267,34,54,16,25,0.9766224223662846,29
3268,107,65,5,32,0.9748363761521168,33
3269,70,10,62,5,0.9747108971050832,5
3270,78,12,9,6,0.9745877106891233,6
3271,27,51,11,24,0.9732339024459763,27
3272,15,44,11,21,0.9697461090332393,23
3273,7,91,65,47,0.9659125099226098,44
3274,77,35,18,15,0.9630191535077136,20
3275,71,34,8,17,0.9628252268322728,17
3276,104,38,106,19,0.9604760273979267,19
3277,54,21,41,10,0.9584988310988216,11
3278,15,55,19,26,0.9578260835405309,29
3279,11,35,78,18,0.953806154754928,17
3280,108,42,107,20,0.9533935254940742,22
3281,63,23,53,11,0.9461903574639025,12
3282,58,24,3,10,0.9398086601291825,14
3283,90,10,103,5,0.937267034161119,5
3284,3,30,9,15,0.9265694640511716,15
3285,55,24,4,12,0.9256101911535765,12
3286,95,32,7,15,0.9236786450564196,17
3287,75,27,114,13,0.9181862737012535,14
3288,39,14,1,5,0.9120351629887123,9
3289,36,35,75,19,0.9076169876586814,16
3290,6,14,50,7,0.9048960894988062,7
3291,60,12,111,7,0.901998030050083,5
3292,62,14,50,6,0.9017457082495477,8
3293,78,17,55,9,0.9002458878614119,8
3294,12,16,76,9,0.897464731380323,7
3295,107,91,28,43,0.8970764795683025,48
3296,39,24,70,11,0.8958543413772162,13
3297,106,71,28,34,0.8945808420172994,37
3298,65,16,52,7,0.8934919273094462,9
3299,64,16,47,7,0.8911330622653795,9
3300,55,27,3,13,0.889351927209094,14
3301,9,19,69,9,0.8879210172039291,10
3302,103,27,29,14,0.8849451648943778,13
3303,83,21,88,11,0.8798897555023121,10
3304,12,13,29,6,0.8751444942400031,7
3305,41,15,48,7,0.8735829617761527,8
3306,104,22,43,10,0.8731107554850521,12
3307,66,12,27,6,0.8729397609022103,6
3308,27,15,1,6,0.8721383199452204,9
3309,60,17,84,10,0.8716143564890761,7
3310,10,10,114,4,0.8617397018011357,6
3311,27,14,20,7,0.8592360695737239,7
3312,77,18,95,9,0.8578881973965213,9
3313,16,10,22,5,0.856518199490958,5
3314,63,31,27,14,0.8537649484268142,17
3315,41,10,72,5,0.8522199406343116,5
3316,33,15,95,7,0.8491128905949068,8
3317,86,91,39,46,0.8455481573588908,45
3318,79,23,84,11,0.8428978656974995,12
3319,100,13,52,7,0.8342784296066278,6
3320,13,34,34,17,0.8338743360773314,17
3321,2,16,46,8,0.8285194662826778,8
3322,29,12,106,6,0.8264692442725412,6
3323,81,27,88,13,0.8225284845495021,14
3324,84,15,95,7,0.8218033746912392,8
3325,114,19,45,9,0.820568913201756,10
3326,23,11,19,5,0.8175991137149171,6
3327,13,15,35,7,0.81376153494348,8
3328,64,48,88,22,0.8099410279440211,26
3329,56,14,40,7,0.8062835825274118,7
3330,100,22,17,9,0.8054576821865731,13
3331,63,54,87,25,0.8053876890559839,29
3332,30,26,40,13,0.8045580871786273,13
3333,64,31,27,15,0.8011389808774306,16
3334,27,13,58,7,0.8008533054928186,6
3335,2,22,88,11,0.7956469041111253,11
3336,1,36,107,18,0.792741418555241,18
3337,33,22,87,10,0.791696856133381,12
3338,65,61,12,31,0.7915819769678686,30
3339,87,57,64,29,0.7914391628763572,28
3340,28,16,89,7,0.7901986413516666,9
3341,75,14,33,6,0.7900898585820573,8
3342,19,34,68,16,0.7895435672953289,18
3343,4,18,104,10,0.7872554057904755,8
3344,109,16,47,8,0.7871811619003324,8
3345,75,58,65,29,0.7869787896039603,29
3346,76,28,29,14,0.7851537514376851,14
3347,68,23,43,12,0.7846724466731662,11
3348,87,22,99,10,0.7762165713325079,12
3349,88,32,69,15,0.7753807063240763,17
3350,95,14,100,6,0.7733599760917211,8
3351,68,64,60,33,0.7655380923161711,31
3352,47,27,65,13,0.7649117411143579,14
3353,95,55,86,25,0.7570140635444287,30
3354,8,68,37,34,0.7513899671656665,34
3355,14,15,13,6,0.751185424264851,9
3356,51,15,44,9,0.7467242677105251,6
3357,46,24,84,11,0.7446057703540031,13
3358,107,43,97,21,0.7437976748281456,22
3359,36,13,74,5,0.7437175733038418,8
3360,7,12,108,5,0.7404080910313966,7
3361,25,24,15,13,0.7394428200536313,11
3362,40,77,86,36,0.735275767181436,41
3363,28,57,11,27,0.733863128330741,30
3364,19,34,65,17,0.7329370882543191,17
3365,103,12,106,5,0.7328239321562169,7
3366,39,67,65,35,0.7318202375681624,32
3367,95,41,5,21,0.7316066534315495,20
3368,68,89,51,41,0.7293513016782857,48
3369,11,40,60,19,0.72826726677922,21
3370,46,58,54,29,0.7282188233281477,29
3371,71,10,96,5,0.7278695572627853,5
3372,57,10,4,4,0.7276499847388465,6
3373,92,31,88,15,0.7260589770500642,16
3374,72,24,8,13,0.7207287736417779,11
3375,15,22,64,10,0.7194942356138029,12
3376,37,51,28,24,0.7168710662114339,27
3377,61,18,40,9,0.715489570683085,9
3378,8,72,106,37,0.7133251026811394,35
3379,20,37,106,18,0.712249966486841,19
3380,43,18,71,10,0.7122285277146779,8
3381,87,18,44,9,0.7101293456244441,9
3382,15,46,72,21,0.7098564723413425,25
3383,39,27,103,14,0.7080660099283345,13
3384,64,23,38,11,0.707451399642146,12
3385,106,18,27,7,0.7074485049679642,11
3386,12,21,43,9,0.703043870685561,12
3387,3,76,51,40,0.6997524893198291,36
3388,45,16,3,8,0.6997435754221073,8
3389,50,29,9,14,0.6932669196756267,15
3390,100,19,85,9,0.692145009111035,10
3391,78,29,84,15,0.6870815538251351,14
3392,18,19,25,10,0.6816652439852796,9
3393,51,21,112,10,0.6806874161227705,11
3394,69,40,87,21,0.6806817652073741,19
3395,29,24,8,10,0.6801150064661755,14
3396,72,13,91,6,0.6793597084818658,7
3397,50,10,38,4,0.6752935140977933,6
3398,93,18,37,8,0.6735242225279052,10
3399,81,33,60,16,0.6720214795360957,17
3400,71,24,55,13,0.6670673084821276,11
3401,114,14,38,7,0.6611905347022533,7
3402,12,22,72,12,0.6575846906143135,10
3403,68,76,65,38,0.6569278898882531,38
3404,74,16,90,9,0.65421251535055,7
3405,49,34,7,16,0.6498930091293172,18
3406,50,19,12,11,0.6495798025400275,8
3407,75,50,88,24,0.6490595256191717,26
3408,108,33,86,15,0.6486162394260825,18
3409,2,10,109,5,0.6444253237530845,5
3410,12,11,48,6,0.6408934180995783,5
3411,85,15,69,7,0.6408165415497196,8
3412,25,25,41,14,0.6394054706376694,11
3413,15,36,49,16,0.6386914766589886,20
3414,6,18,51,10,0.6381605805799537,8
3415,50,22,43,12,0.638144064643618,10
3416,111,17,36,8,0.6365354853619519,9
3417,86,39,18,18,0.6339719448588468,21
3418,13,34,20,16,0.6324978295967632,18
3419,4,28,64,13,0.6316212138641669,15
3420,51,43,53,20,0.6305373025227956,23
3421,87,11,22,4,0.6297643541071193,7
3422,109,30,84,14,0.6283430275726476,16
3423,36,33,71,17,0.6241330409639588,16
3424,9,17,81,8,0.6212818094890723,9
3425,40,12,38,5,0.617907919478443,7
3426,31,22,58,11,0.616855370373501,11
3427,47,34,51,18,0.6110799388757175,16
3428,76,29,46,14,0.6078150500139488,15
3429,91,16,70,7,0.6063303701253766,9
3430,27,63,30,30,0.6054226529240675,33
3431,63,15,34,7,0.6010869874219991,8
3432,71,32,106,15,0.6009609652453838,17
3433,71,10,23,4,0.6000287508458293,6
3434,79,22,8,10,0.596047638444006,12
3435,78,27,88,14,0.5921971540070259,13
3436,76,13,36,4,0.5885035889042637,9
3437,13,27,45,13,0.582600698562669,14
3438,16,44,108,21,0.5813349705715658,23
3439,15,17,17,9,0.5792844725575113,8
3440,28,26,98,11,0.5775231479620817,15
3441,70,33,51,17,0.5766573461400448,16
3442,88,60,9,29,0.5756732724314684,31
3443,41,32,75,17,0.57538170131953,15
3444,100,13,6,6,0.5735558500429735,7
3445,69,15,71,8,0.5724150990318982,7
3446,64,17,81,8,0.5669312262343831,9
3447,71,13,78,6,0.56619632387446,7
3448,64,29,100,13,0.5620875680015568,16
3449,83,10,2,5,0.5594397265150789,5
3450,16,78,57,37,0.5586005055740995,41
3451,34,19,104,9,0.5522514451212648,10
3452,74,44,54,21,0.5510628960849681,23
3453,92,17,7,7,0.5480230211986085,10
3454,39,53,63,30,0.5419385401942971,23
3455,106,10,1,5,0.5396528610114324,5
3456,6,22,107,11,0.5355439544398269,11
3457,17,11,88,4,0.5330720941070787,7
3458,100,26,69,13,0.5321674487070288,13
3459,16,78,15,38,0.5305739271493691,40
3460,34,15,90,7,0.5269213195319896,8
3461,4,24,77,12,0.5234491201479384,12
3462,97,10,43,5,0.5231950290778637,5
3463,74,14,27,8,0.5219215520059601,6
3464,29,15,53,6,0.5213542793701306,9
3465,89,13,62,7,0.5207091343493782,6
3466,112,10,66,4,0.5146742754382652,6
3467,4,18,9,9,0.5118055197130298,9
3468,54,41,7,20,0.5072416292031929,21
3469,87,37,47,19,0.5071641743984844,18
3470,111,51,68,26,0.5032623987049997,25
3471,15,58,87,30,0.5013909785258698,28
3472,88,35,31,18,0.4999807976090581,17
3473,39,84,87,41,0.49441966475995214,43
3474,78,13,64,7,0.4915455324385215,6
3475,62,12,97,6,0.490051403125013,6
3476,84,80,107,39,0.48662393295564865,41
3477,88,40,20,21,0.4827222531499379,19
3478,7,19,48,10,0.48075396413828586,9
3479,54,20,62,10,0.48075198509246564,10
3480,107,72,114,36,0.4790116249707105,36
3481,95,28,74,13,0.4784255086028103,15
3482,25,51,39,26,0.47594650511842773,25
3483,38,17,18,9,0.4756313871056426,8
3484,7,60,18,31,0.4748651156903118,29
3485,62,33,27,15,0.4732354134121797,18
3486,63,42,5,18,0.4718441296207792,24
3487,86,87,54,44,0.47142532561470823,43
3488,86,58,9,30,0.4708339780440975,28
3489,23,36,51,18,0.4693009266846338,18
3490,65,54,31,26,0.4691388746969232,28
3491,7,10,22,5,0.46832977832412503,5
3492,5,10,78,6,0.46671252280804226,4
3493,106,101,86,50,0.4658315283344795,51
3494,87,86,11,41,0.46375399577571214,45
3495,65,11,21,6,0.46273082007848293,5
3496,107,36,46,19,0.458246310756249,17
3497,106,45,50,21,0.450853387486715,24
3498,16,47,114,22,0.4504343015160457,25
3499,11,99,16,45,0.4485581507564439,54
3500,13,33,112,17,0.44654566712440297,16
3501,80,11,9,7,0.4439834453330443,4
3502,34,32,11,15,0.44290735124632996,17
3503,12,39,16,19,0.4428683237403392,20
3504,90,15,11,7,0.4409004522210786,8
3505,40,49,63,25,0.43519783962840436,24
3506,30,27,72,13,0.43109002799049145,14
3507,40,43,31,22,0.4296271974626762,21
3508,103,46,87,22,0.4284991346596859,24
3509,114,23,43,10,0.4272286402576001,13
3510,27,15,61,8,0.4250644477983035,7
3511,112,18,69,10,0.4198013383725023,8
3512,16,31,98,16,0.41976347120600754,15
3513,5,14,38,7,0.41683785462955975,7
3514,109,30,34,15,0.41518711983885753,15
3515,31,33,86,17,0.41076921803924654,16
3516,96,39,55,20,0.40999901205957556,19
3517,50,18,79,9,0.40910464935228613,9
3518,17,11,26,5,0.4065653808604262,6
3519,3,23,34,12,0.40655658936544,11
3520,63,54,11,24,0.4051858334293069,30
3521,60,35,18,17,0.40000420272155157,18
3522,13,97,49,44,0.3942725488337287,53
3523,54,70,87,36,0.39160858634995355,34
3524,102,14,84,7,0.3912018744364834,7
3525,8,13,44,6,0.3904420875790021,7
3526,50,19,89,9,0.3889433495588358,10
3527,69,30,36,15,0.38598798110098687,15
3528,79,12,78,6,0.38583207842589995,6
3529,86,42,112,20,0.385667209943051,22
3530,103,26,15,12,0.37964583424350207,14
3531,114,28,71,14,0.3795577437704564,14
3532,37,13,48,6,0.3793970201456422,7
3533,77,16,103,8,0.37880904328887244,8
3534,70,22,97,12,0.3783758219642569,10
3535,14,18,84,8,0.3778390349649412,10
3536,63,27,60,13,0.37326617266532824,14
3537,40,21,75,10,0.3686371386700514,11
3538,95,26,28,12,0.36814720179538235,14
3539,49,52,19,25,0.3612989094697539,27
3540,28,14,44,8,0.3571298728778931,6
3541,34,13,75,6,0.35287672494659683,7
3542,53,59,13,31,0.3521849621376953,28
3543,86,101,65,53,0.3518381709926007,48
3544,108,11,69,7,0.3504283321129652,4
3545,78,57,57,28,0.3500760488841161,29
3546,63,11,82,5,0.34593533956848593,6
3547,94,16,33,8,0.34380946136701285,8
3548,111,12,18,6,0.34349474631160665,6
3549,48,15,19,8,0.3426076067275109,7
3550,57,15,95,6,0.3413524322360248,9
3551,17,12,69,6,0.3399205773020941,6
3552,84,19,91,9,0.338597737579075,10
3553,109,13,4,6,0.33809070228925237,7
3554,5,61,87,30,0.3370261398348081,31
3555,83,20,106,11,0.3316445649094074,9
3556,29,32,78,15,0.330661445705034,17
3557,15,65,86,31,0.3295736091699068,34
3558,39,55,55,26,0.327344669064615,29
3559,8,57,70,28,0.32660941887077904,29
3560,87,26,2,13,0.32619162405938884,13
3561,80,17,71,9,0.3237123360021252,8
3562,57,26,102,13,0.3234085467610229,13
3563,18,46,28,22,0.32313224084926334,24
3564,3,25,71,13,0.3227486223779461,12
3565,50,63,86,33,0.32248983371062373,30
3566,83,25,28,14,0.31931308670237557,11
3567,50,46,13,23,0.3183740832997801,23
3568,8,49,20,24,0.31827353747839543,25
3569,114,22,69,10,0.3170624988990175,12
3570,27,25,108,13,0.3163478963551657,12
3571,11,16,114,9,0.31453322621159063,7
3572,16,41,40,20,0.3129456302783174,21
3573,107,44,18,24,0.3125789428020784,20
3574,112,29,63,14,0.3118959489167526,15
3575,60,48,53,25,0.3118269913878406,23
3576,96,51,87,26,0.31095451157976556,25
3577,15,19,41,10,0.3105460012311623,9
3578,54,12,89,5,0.3104560755780585,7
3579,88,39,3,19,0.31011533930810997,20
3580,64,12,28,6,0.3078927557568371,6
3581,23,19,111,11,0.30722018824926817,8
3582,86,76,57,37,0.305605360891705,39
3583,85,34,86,16,0.30043079848706666,18
3584,54,113,65,56,0.29533232300367135,57
3585,90,28,60,13,0.29376548989314444,15
3586,54,26,18,13,0.2929951334431298,13
3587,47,13,91,6,0.2919938008476733,7
3588,27,17,25,9,0.2912949474117434,8
3589,20,11,108,6,0.2890337641084793,5
3590,43,20,8,11,0.28422499135382606,9
3591,90,10,98,5,0.2818861887378333,5
3592,67,12,25,6,0.2816428039469052,6
3593,96,12,67,7,0.2799650125910983,5
3594,7,20,70,8,0.27895885562123496,12
3595,53,18,5,8,0.2778213329671466,10
3596,97,14,49,8,0.276775832531503,6
3597,29,12,104,6,0.273728492117864,6
3598,76,27,103,11,0.2722714478274841,16
3599,36,11,38,4,0.2667921507986764,7
3600,22,16,109,8,0.26617483465115477,8
3601,17,15,91,7,0.26423233992702466,8
3602,39,19,4,9,0.2603628586605467,10
3603,4,32,68,16,0.2573095525279982,16
3604,4,16,30,8,0.2549680926160687,8
3605,39,75,11,36,0.2525614439173285,39
3606,40,25,47,14,0.24655985846699083,11
3607,39,11,93,6,0.24650819188031292,5
3608,69,43,51,22,0.24445202829272475,21
3609,72,27,107,13,0.2408089842705413,14
3610,114,42,37,22,0.24001106634510702,20
3611,65,10,110,6,0.23968670854518379,4
3612,51,16,61,6,0.23498173360609398,10
3613,88,25,93,14,0.2346836303137904,11
3614,93,13,51,7,0.23291171077771639,6
3615,69,28,11,15,0.2315545134863033,13
3616,65,10,101,5,0.22906131925900258,5
3617,79,31,48,16,0.22311337916674606,15
3618,82,15,28,8,0.2205286984952181,7
3619,60,68,107,33,0.21980397725110012,35
3620,37,38,88,19,0.21837047991817124,19
3621,17,21,84,10,0.21599839278237065,11
3622,53,21,44,9,0.21221133134211373,12
3623,106,20,48,10,0.20449983406695527,10
3624,78,22,94,11,0.20381830464933717,11
3625,20,42,51,23,0.1988107846378192,19
3626,43,36,88,17,0.198258565418297,19
3627,72,28,103,15,0.19533082235939656,13
3628,112,18,72,9,0.19365171750841212,9
3629,7,79,39,41,0.19327466006546398,38
3630,29,32,77,17,0.19273897993718236,15
3631,81,10,89,4,0.18700691582910417,6
3632,60,24,108,12,0.18600364710584247,12
3633,44,15,65,6,0.18351226600641293,9
3634,50,25,114,12,0.18060110833647136,13
3635,43,23,106,11,0.17255495280345076,12
3636,16,64,78,31,0.17169919756193136,33
3637,106,28,100,13,0.1677556244233467,15
3638,23,20,112,11,0.1668608245805679,9
3639,17,29,68,15,0.16206629975870687,14
3640,74,20,108,11,0.16204972626611253,9
3641,7,51,4,26,0.16136746029798288,25
3642,76,39,104,18,0.16127355259141732,21
3643,7,16,83,7,0.15765677447455673,9
3644,86,84,109,42,0.15434062460878212,42
3645,58,11,11,6,0.15424713213438873,5
3646,79,14,55,7,0.15414527044248416,7
3647,41,22,94,10,0.14625612851966724,12
3648,87,47,104,25,0.14556556548476493,22
3649,29,22,89,11,0.14330420337783004,11
3650,41,60,16,31,0.1387348814216499,29
3651,73,10,25,5,0.13287312364388484,5
3652,100,25,37,13,0.13255630995179785,12
3653,33,16,114,9,0.1306594611288726,7
3654,69,25,7,13,0.12779683769017072,12
3655,62,22,11,11,0.11780987624417447,11
3656,52,17,16,9,0.1158049551506922,8
3657,86,100,30,52,0.11564281595283787,48
3658,80,23,84,12,0.11286096846693006,11
3659,68,10,79,4,0.11002938828097016,6
3660,97,10,94,6,0.10576953599255426,4
3661,11,67,107,32,0.10573856763834147,35
3662,106,28,109,13,0.10546217863429572,15
3663,11,10,73,5,0.1054273387277771,5
3664,2,18,84,9,0.10504403066305122,9
3665,41,23,46,12,0.10439214573758943,11
3666,74,39,25,20,0.09563368284675952,19
3667,114,29,36,13,0.0921312858778607,16
3668,60,21,62,10,0.09015235921891117,11
3669,78,17,109,9,0.08773786963571444,8
3670,76,13,47,4,0.0865785795700381,9
3671,114,48,104,25,0.08363522002227851,23
3672,84,37,88,17,0.08333477514829642,20
3673,62,10,95,5,0.0814782186148065,5
3674,18,34,12,18,0.07971490225606083,16
3675,97,36,74,17,0.07931920932357457,19
3676,74,24,18,13,0.07395269221669398,11
3677,27,18,18,9,0.07186590608419113,9
3678,106,21,40,10,0.0680825308022658,11
3679,8,44,30,23,0.06496408593076701,21
3680,51,56,9,27,0.06289520250725894,29
3681,75,46,55,21,0.06023477871620806,25
3682,48,23,109,11,0.056413754859006945,12
3683,87,47,74,23,0.05355029116061811,24
3684,55,66,51,33,0.050276849060499694,33
3685,98,21,50,11,0.04841640747209045,10
3686,39,74,15,39,0.04795986285008121,35
3687,73,16,106,8,0.047003862193632395,8
3688,83,17,51,10,0.04607341431682118,7
3689,13,80,41,39,0.04561700625054859,41
3690,31,11,97,5,0.04256244744109594,6
3691,9,10,73,5,0.04170228259349536,5
3692,51,69,27,35,0.04111199988019485,34
3693,76,35,30,19,0.03906954275326707,16
3694,100,44,8,22,0.03778187011993821,22
3695,112,12,12,7,0.037452763165636206,5
3696,23,18,109,9,0.03305007667392977,9
3697,88,12,110,7,0.03270549440561658,5
3698,51,40,18,18,0.03150467733021017,22
3699,31,11,8,5,0.02937900525924807,6
3700,58,18,100,10,0.023617119288312536,8
3701,54,30,64,14,0.022365756253541966,16
3702,13,113,65,55,0.02222718726600467,58
3703,11,48,76,24,0.020340477309469307,24
3704,51,81,87,40,0.018852714002807584,41
3705,30,61,100,32,0.01716820889939381,29
3706,46,67,88,35,0.014583283352867883,32
3707,80,18,8,10,0.01264063172158774,8
3708,109,17,83,7,0.009729329647016893,10
3709,57,25,55,14,0.005686766813275881,11
3710,7,100,107,55,0.0045269968653226115,45
3711,107,100,7,45,-0.004526996865322238,55
3712,55,25,57,11,-0.005686766813278013,14
3713,106,47,76,26,-0.009505075346388465,21
3714,83,17,109,10,-0.009729329647015561,7
3715,8,18,80,8,-0.012640631721588136,10
3716,88,67,46,32,-0.014583283352867446,35
3717,100,61,30,29,-0.01716820889939227,32
3718,87,81,51,41,-0.018852714002807264,40
3719,65,113,13,58,-0.022227187266005175,55
3720,64,30,54,16,-0.02236575625354161,14
3721,100,18,58,8,-0.023617119288314115,10
3722,8,11,31,6,-0.02937900525924678,5
3723,18,40,51,22,-0.03150467733021017,18
3724,110,12,88,5,-0.032705494405616285,7
3725,109,18,23,9,-0.033050076673930166,9
3726,12,12,112,5,-0.037452763165636206,7
3727,8,44,100,22,-0.03778187011993732,22
3728,30,35,76,16,-0.03906954275326525,19
3729,27,69,51,34,-0.04111199988019529,35
3730,73,10,9,5,-0.04170228259349358,5
3731,97,11,31,6,-0.04256244744109594,5
3732,41,80,13,41,-0.04561700625054864,39
3733,51,17,83,7,-0.04607341431682181,10
3734,106,16,73,8,-0.04700386219363217,8
3735,15,74,39,35,-0.04795986285008198,39
3736,50,21,98,10,-0.048416407472091784,11
3737,51,66,55,33,-0.05027684906049733,33
3738,74,47,87,24,-0.053550291160618865,23
3739,109,23,48,12,-0.05641375485900662,11
3740,55,46,75,25,-0.060234778716207416,21
3741,9,56,51,29,-0.06289520250725868,27
3742,30,44,8,21,-0.06496408593076741,23
3743,40,21,106,11,-0.06808253080226648,10
3744,18,18,27,9,-0.07186590608419152,9
3745,18,24,74,11,-0.07395269221669472,13
3746,74,36,97,19,-0.07931920932357497,17
3747,12,34,18,16,-0.07971490225606166,18
3748,95,10,62,5,-0.08147821861480545,5
3749,88,37,84,20,-0.08333477514829642,17
3750,104,48,114,23,-0.08363522002227874,25
3751,47,13,76,9,-0.08657857957003784,4
3752,109,17,78,8,-0.08773786963571381,9
3753,62,21,60,11,-0.09015235921891082,10
3754,36,29,114,16,-0.09213128587785951,13
3755,25,39,74,19,-0.09563368284675924,20
3756,46,23,41,11,-0.10439214573758882,12
3757,84,18,2,9,-0.10504403066305122,9
3758,73,10,11,5,-0.10542733872777674,5
3759,109,28,106,15,-0.10546217863429604,13
3760,94,10,97,4,-0.10576953599255319,6
3761,79,10,68,6,-0.11002938828097086,4
3762,84,23,80,11,-0.11286096846693021,12
3763,30,100,86,48,-0.11564281595283737,52
3764,16,17,52,8,-0.11580495515069199,9
3765,11,22,62,11,-0.11780987624417284,11
3766,7,25,69,12,-0.12779683769017072,13
3767,114,16,33,7,-0.13065946112887206,9
3768,37,25,100,12,-0.13255630995179643,13
3769,25,10,73,5,-0.13287312364388448,5
3770,16,60,41,29,-0.1387348814216501,31
3771,89,22,29,11,-0.14330420337783067,11
3772,104,47,87,22,-0.1455655654847638,25
3773,94,22,41,12,-0.1462561285196677,10
3774,55,14,79,7,-0.1541452704424852,7
3775,11,11,58,5,-0.15424713213438873,6
3776,109,84,86,42,-0.15434062460878234,42
3777,83,16,7,9,-0.15765677447455717,7
3778,104,39,76,21,-0.1612735525914166,18
3779,4,51,7,25,-0.16136746029798252,26
3780,108,20,74,9,-0.16204972626611233,11
3781,68,29,17,14,-0.16206629975870612,15
3782,112,20,23,9,-0.16686082458056523,11
3783,100,28,106,15,-0.1677556244233485,13
3784,107,40,90,21,-0.16941940404881964,19
3785,78,64,16,33,-0.17169919756193258,31
3786,106,23,43,12,-0.17255495280344985,11
3787,114,25,50,13,-0.18060110833647136,12
3788,65,15,44,9,-0.18351226600641318,6
3789,108,24,60,12,-0.1860036471058429,12
3790,89,10,81,6,-0.1870069158291045,4
3791,77,32,29,15,-0.1927389799371823,17
3792,39,79,7,38,-0.19327466006546265,41
3793,72,18,112,9,-0.1936517175084127,9
3794,103,28,72,13,-0.19533082235939617,15
3795,88,36,43,19,-0.19825856541829623,17
3796,51,42,20,19,-0.19881078463781776,23
3797,94,22,78,11,-0.20381830464933726,11
3798,44,21,53,12,-0.2122113313421144,9
3799,84,21,17,11,-0.21599839278237148,10
3800,88,38,37,19,-0.21837047991817116,19
3801,107,68,60,35,-0.21980397725110012,33
3802,28,15,82,7,-0.2205286984952181,8
3803,48,31,79,15,-0.22311337916674676,16
3804,76,30,102,14,-0.22819923054500169,16
3805,101,10,65,5,-0.22906131925900355,5
3806,11,28,69,13,-0.23155451348630315,15
3807,51,13,93,6,-0.2329117107777153,7
3808,93,25,88,11,-0.23468363031378975,14
3809,61,16,51,10,-0.23498173360609353,6
3810,110,10,65,4,-0.2396867085451845,6
3811,37,42,114,20,-0.24001106634510735,22
3812,107,27,72,14,-0.2408089842705413,13
3813,51,43,69,21,-0.24445202829272533,22
3814,93,11,39,5,-0.24650819188031328,6
3815,47,25,40,11,-0.2465598584669911,14
3816,11,75,39,39,-0.25256144391732716,36
3817,30,16,4,8,-0.25496809261606845,8
3818,68,32,4,16,-0.25730955252800053,16
3819,4,19,39,10,-0.26036285866054654,9
3820,91,15,17,8,-0.2642323399270249,7
3821,109,16,22,8,-0.2661748346511539,8
3822,38,11,36,7,-0.26679215079867674,4
3823,103,27,76,16,-0.2722714478274842,11
3824,104,12,29,6,-0.27372849211786426,6
3825,49,14,97,6,-0.27677583253150245,8
3826,5,18,53,10,-0.27782133296714684,8
3827,70,20,7,12,-0.2789588556212364,8
3828,67,12,96,5,-0.2799650125910977,7
3829,25,12,67,6,-0.2816428039469052,6
3830,98,10,90,5,-0.2818861887378329,5
3831,8,20,43,9,-0.28422499135382606,11
3832,108,11,20,5,-0.289033764108479,6
3833,25,17,27,8,-0.29129494741174317,9
3834,91,13,47,7,-0.2919938008476733,6
3835,18,26,54,13,-0.2929951334431304,13
3836,60,28,90,15,-0.29376548989314333,13
3837,65,113,54,57,-0.2953323230036715,56
3838,86,34,85,18,-0.30043079848706633,16
3839,57,76,86,39,-0.3056053608917043,37
3840,111,19,23,8,-0.3072201882492683,11
3841,28,12,64,6,-0.3078927557568362,6
3842,3,39,88,20,-0.3101153393081098,19
3843,89,12,54,7,-0.3104560755780576,5
3844,41,19,15,9,-0.3105460012311613,10
3845,87,51,96,25,-0.3109545115797648,26
3846,53,48,60,23,-0.3118269913878415,25
3847,63,29,112,15,-0.3118959489167515,14
3848,18,44,107,20,-0.3125789428020779,24
3849,40,41,16,21,-0.3129456302783173,20
3850,114,16,11,7,-0.3145332262115904,9
3851,108,25,27,12,-0.31634789635516514,13
3852,69,22,114,12,-0.3170624988990179,10
3853,20,49,8,25,-0.31827353747839576,24
3854,13,46,50,23,-0.31837408329978034,23
3855,28,25,83,11,-0.31931308670237585,14
3856,12,27,88,13,-0.32231282630184194,14
3857,86,63,50,30,-0.322489833710624,33
3858,71,25,3,12,-0.32274862237794577,13
3859,28,46,18,24,-0.3231322408492643,22
3860,102,26,57,13,-0.3234085467610242,13
3861,71,17,80,8,-0.32371233600212634,9
3862,2,26,87,13,-0.326191624059389,13
3863,70,57,8,29,-0.32660941887077916,28
3864,55,55,39,29,-0.32734466906461546,26
3865,86,65,15,34,-0.3295736091699076,31
3866,78,32,29,17,-0.33066144570503364,15
3867,106,20,83,9,-0.33164456490940797,11
3868,87,61,5,31,-0.3370261398348085,30
3869,4,13,109,7,-0.33809070228925137,6
3870,91,19,84,10,-0.33859773757907446,9
3871,69,12,17,6,-0.3399205773020955,6
3872,95,15,57,9,-0.341352432236026,6
3873,19,15,48,7,-0.3426076067275114,8
3874,18,12,111,6,-0.3434947463116063,6
3875,33,16,94,8,-0.3438094613670113,8
3876,82,11,63,6,-0.3459353395684866,5
3877,57,57,78,29,-0.35007604888411786,28
3878,69,11,108,4,-0.3504283321129657,7
3879,65,101,86,48,-0.35183817099260034,53
3880,13,59,53,28,-0.3521849621376959,31
3881,75,13,34,7,-0.35287672494659683,6
3882,44,14,28,6,-0.35712987287789527,8
3883,19,52,49,27,-0.3612989094697535,25
3884,28,26,95,14,-0.3681472017953835,12
3885,75,21,40,11,-0.36863713867005155,10
3886,60,27,63,14,-0.3732661726653274,13
3887,84,18,14,10,-0.37783903496494214,8
3888,97,22,70,10,-0.37837582196425723,12
3889,103,16,77,8,-0.378809043288872,8
3890,48,13,37,7,-0.3793970201456411,6
3891,71,28,114,14,-0.3795577437704577,14
3892,15,26,103,14,-0.3796458342435015,12
3893,112,42,86,22,-0.385667209943052,20
3894,78,12,79,6,-0.3858320784259002,6
3895,36,30,69,15,-0.38598798110098714,15
3896,89,19,50,10,-0.3889433495588358,9
3897,30,25,20,12,-0.3894382571190694,13
3898,44,13,8,7,-0.39044208757900134,6
3899,84,14,102,7,-0.39120187443648163,7
3900,87,70,54,34,-0.39160858634995066,36
3901,107,62,74,30,-0.39404353085897736,32
3902,49,97,13,53,-0.39427254883372803,44
3903,18,35,60,18,-0.40000420272155135,17
3904,11,54,63,30,-0.40518583342930764,24
3905,34,23,3,11,-0.40655658936543876,12
3906,26,11,17,6,-0.4065653808604267,5
3907,79,18,50,9,-0.40910464935228674,9
3908,55,39,96,19,-0.4099990120595754,20
3909,86,33,31,16,-0.4107692180392456,17
3910,34,30,109,15,-0.41518711983885837,15
3911,38,14,5,7,-0.41683785462955825,7
3912,98,31,16,15,-0.41976347120600693,16
3913,69,18,112,8,-0.4198013383725037,10
3914,61,15,27,7,-0.42506444779830493,8
3915,43,23,114,13,-0.4272286402576001,10
3916,87,46,103,24,-0.42849913465968587,22
3917,31,43,40,21,-0.4296271974626759,22
3918,72,27,30,14,-0.43109002799049106,13
3919,63,49,40,24,-0.4351978396284048,25
3920,11,15,90,8,-0.4409004522210788,7
3921,16,39,12,20,-0.4428683237403408,19
3922,11,32,34,17,-0.44290735124633074,15
3923,9,11,80,4,-0.4439834453330441,7
3924,112,33,13,16,-0.44654566712440186,17
3925,114,47,16,25,-0.45043430151604597,22
3926,50,45,106,24,-0.45085338748671533,21
3927,46,36,107,17,-0.4582463107562494,19
3928,21,11,65,5,-0.4627308200784832,6
3929,11,86,87,45,-0.46375399577571347,41
3930,78,10,5,4,-0.466712522808043,6
3931,22,10,7,5,-0.4683297783241262,5
3932,31,54,65,28,-0.46913887469692556,26
3933,51,36,23,18,-0.4693009266846344,18
3934,9,58,86,28,-0.47083397804409705,30
3935,54,87,86,43,-0.47142532561470823,44
3936,5,42,63,24,-0.4718441296207794,18
3937,27,33,62,18,-0.473235413412179,15
3938,18,60,7,29,-0.47486511569031375,31
3939,18,17,38,8,-0.475631387105643,9
3940,39,51,25,25,-0.47594650511842646,26
3941,74,28,95,15,-0.47842550860281247,13
3942,114,72,107,36,-0.4790116249707105,36
3943,62,20,54,10,-0.48075198509246597,10
3944,48,19,7,9,-0.48075396413828564,10
3945,107,80,84,41,-0.4866239329556469,39
3946,97,12,62,6,-0.490051403125013,6
3947,64,13,78,6,-0.4915455324385215,7
3948,87,84,39,43,-0.4944196647599508,41
3949,31,35,88,17,-0.49998079760905945,18
3950,87,58,15,28,-0.5013909785258694,30
3951,68,51,111,25,-0.5032623987049999,26
3952,47,37,87,18,-0.5071641743984844,19
3953,7,41,54,21,-0.507241629203192,20
3954,9,18,4,9,-0.5118055197130301,9
3955,66,10,112,6,-0.514674275438265,4
3956,62,13,89,6,-0.520709134349379,7
3957,53,15,29,9,-0.5213542793701312,6
3958,27,14,74,6,-0.5219215520059618,8
3959,43,10,97,5,-0.5231950290778634,5
3960,77,24,4,12,-0.5234491201479363,12
3961,90,15,34,8,-0.5269213195319893,7
3962,15,78,16,40,-0.5305739271493686,38
3963,69,26,100,13,-0.5321674487070279,13
3964,88,11,17,7,-0.5330720941070791,4
3965,107,22,6,11,-0.5355439544398289,11
3966,1,10,106,5,-0.5396528610114331,5
3967,63,53,39,23,-0.5419385401942962,30
3968,7,17,92,10,-0.5480230211986078,7
3969,54,44,74,23,-0.551062896084969,21
3970,104,19,34,10,-0.5522514451212651,9
3971,57,78,16,41,-0.5586005055740971,37
3972,2,10,83,5,-0.5594397265150782,5
3973,100,29,64,16,-0.562087568001556,13
3974,78,13,71,7,-0.5661963238744604,6
3975,81,17,64,9,-0.5669312262343831,8
3976,71,15,69,7,-0.5724150990318982,8
3977,6,13,100,7,-0.5735558500429735,6
3978,75,32,41,15,-0.57538170131953,17
3979,9,60,88,31,-0.575673272431468,29
3980,51,33,70,16,-0.5766573461400448,17
3981,98,26,28,15,-0.5775231479620817,11
3982,17,17,15,8,-0.5792844725575107,9
3983,108,44,16,23,-0.5813349705715667,21
3984,45,27,13,14,-0.5826006985626689,13
3985,20,29,74,14,-0.5870486229107592,15
3986,36,13,76,9,-0.5885035889042627,4
3987,88,27,78,13,-0.5921971540070258,14
3988,8,22,79,12,-0.5960476384440053,10
3989,23,10,71,6,-0.6000287508458285,4
3990,106,32,71,17,-0.6009609652453864,15
3991,34,15,63,8,-0.6010869874220004,7
3992,30,63,27,33,-0.6054226529240674,30
3993,70,16,91,9,-0.6063303701253768,7
3994,46,29,76,15,-0.6078150500139491,14
3995,51,34,47,16,-0.611079938875716,18
3996,58,22,31,11,-0.6168553703734997,11
3997,38,12,40,7,-0.6179079194784425,5
3998,81,17,9,9,-0.6212818094890713,8
3999,71,33,36,16,-0.6241330409639583,17
4000,84,30,109,16,-0.6283430275726473,14
4001,22,11,87,7,-0.62976435410712,4
4002,53,43,51,23,-0.6305373025227932,20
4003,64,28,4,15,-0.6316212138641667,13
4004,20,34,13,18,-0.6324978295967627,16
4005,18,39,86,21,-0.633971944858847,18
4006,36,17,111,9,-0.6365354853619519,8
4007,43,22,50,10,-0.6381440646436153,12
4008,51,18,6,8,-0.6381605805799541,10
4009,49,36,15,20,-0.6386914766589882,16
4010,41,25,25,11,-0.6394054706376703,14
4011,69,15,85,8,-0.6408165415497192,7
4012,48,11,12,5,-0.6408934180995783,6
4013,109,10,2,5,-0.6444253237530845,5
4014,86,33,108,18,-0.6486162394260832,15
4015,88,50,75,26,-0.6490595256191716,24
4016,12,19,50,8,-0.6495798025400292,11
4017,7,34,49,18,-0.6498930091293155,16
4018,102,31,16,16,-0.6515407877418993,15
4019,90,16,74,7,-0.6542125153505499,9
4020,65,76,68,38,-0.6569278898882535,38
4021,72,22,12,10,-0.6575846906143128,12
4022,38,14,114,7,-0.6611905347022546,7
4023,55,24,71,11,-0.6670673084821287,13
4024,60,33,81,17,-0.6720214795360956,16
4025,37,18,93,10,-0.6735242225279054,8
4026,38,10,50,6,-0.6752935140977925,4
4027,91,13,72,7,-0.6793597084818637,6
4028,8,24,29,14,-0.6801150064661755,10
4029,87,40,69,19,-0.6806817652073719,21
4030,112,21,51,11,-0.6806874161227696,10
4031,25,19,18,9,-0.6816652439852798,10
4032,84,29,78,14,-0.6870815538251354,15
4033,85,19,100,10,-0.6921450091110348,9
4034,9,29,50,15,-0.6932669196756251,14
4035,3,16,45,8,-0.6997435754221075,8
4036,51,76,3,36,-0.6997524893198293,40
4037,43,21,12,12,-0.7030438706855594,9
4038,27,18,106,11,-0.7074485049679631,7
4039,38,23,64,12,-0.707451399642147,11
4040,103,27,39,13,-0.7080660099283356,14
4041,72,46,15,25,-0.709856472341342,21
4042,44,18,87,9,-0.7101293456244435,9
4043,71,18,43,8,-0.7122285277146747,10
4044,106,37,20,19,-0.7122499664868411,18
4045,106,72,8,35,-0.7133251026811389,37
4046,40,18,61,9,-0.7154895706830842,9
4047,28,51,37,27,-0.7168710662114356,24
4048,64,22,15,12,-0.7194942356138038,10
4049,8,24,72,11,-0.720728773641778,13
4050,88,31,92,16,-0.7260589770500645,15
4051,4,10,57,6,-0.7276499847388429,4
4052,96,10,71,5,-0.7278695572627853,5
4053,54,58,46,29,-0.7282188233281477,29
4054,60,40,11,21,-0.7282672667792206,19
4055,51,89,68,48,-0.7293513016782857,41
4056,5,41,95,20,-0.7316066534315485,21
4057,65,67,39,32,-0.7318202375681632,35
4058,106,12,103,7,-0.7328239321562183,5
4059,65,34,19,17,-0.7329370882543196,17
4060,11,57,28,30,-0.7338631283307411,27
4061,86,77,40,41,-0.7352757671814358,36
4062,15,24,25,11,-0.7394428200536325,13
4063,108,12,7,7,-0.7404080910313966,5
4064,74,13,36,8,-0.743717573303843,5
4065,97,43,107,22,-0.7437976748281456,21
4066,84,24,46,13,-0.7446057703540044,11
4067,44,15,51,6,-0.7467242677105268,9
4068,13,15,14,9,-0.7511854242648529,6
4069,37,68,8,34,-0.7513899671656677,34
4070,86,55,95,30,-0.7570140635444291,25
4071,65,27,47,14,-0.7649117411143566,13
4072,60,64,68,31,-0.7655380923161712,33
4073,100,14,95,8,-0.7733599760917202,6
4074,69,32,88,17,-0.7753807063240763,15
4075,99,22,87,12,-0.7762165713325068,10
4076,43,23,68,11,-0.7846724466731662,12
4077,29,28,76,14,-0.7851537514376848,14
4078,65,58,75,29,-0.7869787896039598,29
4079,47,16,109,8,-0.7871811619003327,8
4080,104,18,4,8,-0.7872554057904768,10
4081,68,34,19,18,-0.7895435672953282,16
4082,33,14,75,8,-0.7900898585820583,6
4083,89,16,28,9,-0.790198641351668,7
4084,64,57,87,28,-0.7914391628763577,29
4085,12,61,65,30,-0.7915819769678688,31
4086,87,22,33,12,-0.7916968561333828,10
4087,107,36,1,18,-0.7927414185552435,18
4088,88,22,2,11,-0.7956469041111253,11
4089,58,13,27,6,-0.800853305492819,7
4090,27,31,64,16,-0.801138980877431,15
4091,40,26,30,13,-0.804558087178627,13
4092,87,54,63,29,-0.8053876890559841,25
4093,17,22,100,13,-0.8054576821865715,9
4094,40,14,56,7,-0.8062835825274137,7
4095,88,48,64,26,-0.8099410279440218,22
4096,35,15,13,8,-0.8137615349434785,7
4097,19,11,23,6,-0.8175991137149161,5
4098,45,19,114,10,-0.8205689132017555,9
4099,95,15,84,8,-0.8218033746912397,7
4100,88,27,81,14,-0.8225284845495021,13
4101,106,12,29,6,-0.8264692442725412,6
4102,46,16,2,8,-0.8285194662826783,8
4103,34,34,13,17,-0.8338743360773311,17
4104,52,13,100,6,-0.8342784296066272,7
4105,84,23,79,12,-0.8428978656974985,11
4106,39,91,86,45,-0.8455481573588913,46
4107,95,15,33,8,-0.8491128905949085,7
4108,72,10,41,5,-0.852219940634312,5
4109,27,31,63,17,-0.8537649484268146,14
4110,22,10,16,5,-0.8565181994909576,5
4111,95,18,77,9,-0.8578881973965208,9
4112,20,14,27,7,-0.8592360695737256,7
4113,114,10,10,6,-0.8617397018011352,4
4114,84,17,60,7,-0.8716143564890748,10
4115,1,15,27,9,-0.87213831994522,6
4116,27,12,66,6,-0.8729397609022106,6
4117,43,22,104,12,-0.8731107554850513,10
4118,48,15,41,8,-0.8735829617761531,7
4119,29,13,12,7,-0.8751444942400025,6
4120,88,21,83,10,-0.8798897555023121,11
4121,29,27,103,13,-0.8849451648943776,14
4122,69,19,9,10,-0.887921017203931,9
4123,3,27,55,14,-0.8893519272090935,13
4124,47,16,64,9,-0.8911330622653786,7
4125,52,16,65,9,-0.8934919273094457,7
4126,28,71,106,37,-0.8945808420172991,34
4127,70,24,39,13,-0.8958543413772138,11
4128,28,91,107,48,-0.897076479568304,43
4129,76,16,12,7,-0.8974647313803197,9
4130,55,17,78,8,-0.9002458878614126,9
4131,50,14,62,8,-0.9017457082495483,6
4132,111,12,60,5,-0.9019980300500823,7
4133,50,14,6,7,-0.9048960894988056,7
4134,75,35,36,16,-0.9076169876586808,19
4135,1,14,39,9,-0.9120351629887133,5
4136,114,27,75,14,-0.9181862737012525,13
4137,7,32,95,17,-0.9236786450564201,15
4138,4,24,55,12,-0.9256101911535772,12
4139,9,30,3,15,-0.9265694640511721,15
4140,74,62,107,33,-0.9344905666009985,29
4141,103,10,90,5,-0.9372670341611201,5
4142,3,24,58,14,-0.9398086601291817,10
4143,53,23,63,12,-0.9461903574639031,11
4144,107,42,108,22,-0.9533935254940735,20
4145,78,35,11,17,-0.9538061547549292,18
4146,19,55,15,29,-0.9578260835405312,26
4147,41,21,54,11,-0.9584988310988228,10
4148,106,38,104,19,-0.960476027397927,19
4149,8,34,71,17,-0.9628252268322751,17
4150,18,35,77,20,-0.9630191535077128,15
4151,65,91,7,44,-0.9659125099226101,47
4152,11,44,15,23,-0.9697461090332403,21
4153,11,51,27,27,-0.9732339024459766,24
4154,9,12,78,6,-0.9745877106891233,6
4155,62,10,70,5,-0.9747108971050835,5
4156,5,65,107,33,-0.9748363761521173,32
4157,16,54,34,29,-0.9766224223662847,25
4158,102,15,68,8,-0.9774478191416431,7
4159,39,13,61,6,-0.9776304076631851,7
4160,84,19,93,11,-0.9776365381665065,8
4161,43,63,16,34,-0.9789822885028281,29
4162,41,81,7,41,-0.9794700083084553,40
4163,2,38,86,18,-0.9822306710469797,20
4164,92,10,43,6,-0.9836040223889839,4
4165,112,19,54,10,-0.9843355592348288,9
4166,107,32,69,17,-0.9867318989974727,15
4167,65,42,37,23,-0.9887363573689177,19
4168,48,13,43,6,-0.9891423928749106,7
4169,39,37,76,21,-0.9969073892313127,16
4170,53,31,86,18,-0.9974427707068911,13
4171,75,37,87,19,-1.0026365052951276,18
4172,93,11,114,5,-1.0049906589581687,6
4173,86,74,68,37,-1.0064238301014836,37
4174,18,20,91,11,-1.0069076377111847,9
4175,81,25,53,13,-1.0072209792246578,12
4176,85,17,20,9,-1.0120202947249695,8
4177,65,36,77,17,-1.0154517929662812,19
4178,19,66,30,35,-1.0181960823991612,31
4179,62,22,15,11,-1.0190475345508372,11
4180,9,13,79,6,-1.0203716742776934,7
4181,49,34,8,17,-1.020408759114468,17
4182,16,31,33,14,-1.021253352666775,17
4183,90,12,64,6,-1.0226762518657317,6
4184,44,20,63,11,-1.023318477102645,9
4185,88,29,19,14,-1.0300321093866864,15
4186,52,11,19,5,-1.031960598669366,6
4187,74,38,104,21,-1.0321539192468763,17
4188,65,54,60,25,-1.0350242100510147,29
4189,60,17,80,8,-1.0365050448794266,9
4190,33,16,104,9,-1.0375486456158098,7
4191,91,11,49,6,-1.0426488720953466,5
4192,17,23,104,12,-1.0458379273038074,11
4193,16,94,60,48,-1.048629946483514,46
4194,45,18,71,8,-1.050024616634447,10
4195,104,42,68,21,-1.050703652992856,21
4196,23,19,30,10,-1.0508168359836585,9
4197,72,19,66,11,-1.0523369485237928,8
4198,38,36,13,21,-1.0523988581053303,15
4199,38,39,86,21,-1.0547313169805972,18
4200,44,14,100,7,-1.0590413147864146,7
4201,71,14,58,7,-1.0679524363994422,7
4202,37,20,67,11,-1.0707700527635227,9
4203,97,16,9,7,-1.0715415510849884,9
4204,89,21,88,11,-1.071835135391089,10
4205,103,13,46,7,-1.0718715021600842,6
4206,109,61,28,33,-1.0738097371372815,28
4207,97,19,64,10,-1.0748997556853979,9
4208,74,27,75,15,-1.0761366724331527,12
4209,76,23,62,12,-1.0792355388180024,11
4210,94,11,93,7,-1.0822019157683698,4
4211,107,67,11,36,-1.0836548390306746,31
4212,41,55,39,26,-1.0871035103792377,29
4213,69,14,42,7,-1.0889746986073443,7
4214,102,17,19,10,-1.0910566361497027,7
4215,41,35,18,17,-1.0983841672845305,18
4216,50,24,34,12,-1.102066453194935,12
4217,106,39,70,19,-1.1024614638047314,20
4218,57,37,27,18,-1.1033906612223547,19
4219,2,18,96,9,-1.1039761816908868,9
4220,107,32,4,17,-1.1053879522342505,15
4221,55,13,73,7,-1.1082443575059626,6
4222,86,101,106,52,-1.11125626745342,49
4223,58,17,63,10,-1.1113806593996047,7
4224,61,14,100,7,-1.113823985180499,7
4225,16,99,11,55,-1.1139444797450426,44
4226,7,19,29,12,-1.1170674633929336,7
4227,57,25,28,13,-1.1208866402447324,12
4228,13,42,57,20,-1.1222847149141768,22
4229,19,28,69,15,-1.1227446471060296,13
4230,88,17,79,9,-1.1249704502892561,8
4231,107,93,51,53,-1.1261649710981219,40
4232,31,26,3,12,-1.130409883055891,14
4233,106,26,36,13,-1.1307287364062797,13
4234,64,11,95,5,-1.1310441974354575,6
4235,90,27,88,15,-1.133788964139305,12
4236,52,26,87,13,-1.137456454355295,13
4237,56,14,8,7,-1.138262181129433,7
4238,54,16,38,8,-1.1438367497110864,8
4239,98,14,39,8,-1.1463977441558344,6
4240,33,10,17,5,-1.1464162819529,5
4241,57,17,98,9,-1.1470460176345267,8
4242,58,19,51,10,-1.1500793287361857,9
4243,7,17,79,9,-1.1501166003666843,8
4244,94,12,47,6,-1.1540186483091384,6
4245,41,24,70,11,-1.1545373299567132,13
4246,107,85,54,43,-1.162654974454932,42
4247,47,40,16,21,-1.1653415017893018,19
4248,62,34,100,17,-1.1692002604569451,17
4249,75,13,44,6,-1.169380882277211,7
4250,55,35,83,17,-1.1749448092476902,18
4251,77,12,33,6,-1.1756675735500741,6
4252,96,31,76,17,-1.185303928819388,14
4253,9,28,49,13,-1.1870965912725648,15
4254,110,16,87,9,-1.1878037867151126,7
4255,74,18,68,11,-1.1930607364890227,7
4256,16,67,25,35,-1.1932865297100739,32
4257,76,20,20,9,-1.195513412586338,11
4258,62,18,43,9,-1.1970909810918426,9
4259,33,15,90,8,-1.202013566860897,7
4260,5,65,28,33,-1.204023419699817,32
4261,48,33,8,17,-1.2090868114966702,16
4262,97,33,25,17,-1.2112097532933537,16
4263,55,70,86,37,-1.213903648014805,33
4264,88,37,71,21,-1.2185084211552721,16
4265,70,46,107,22,-1.2201940929331903,24
4266,16,51,112,26,-1.2207004808764241,25
4267,41,17,55,9,-1.2209745250839978,8
4268,60,46,3,24,-1.224317367731728,22
4269,9,16,66,9,-1.2335487286820448,7
4270,25,39,28,22,-1.2338977751460154,17
4271,27,76,68,40,-1.23677207953926,36
4272,50,42,39,22,-1.237297066410006,20
4273,93,21,107,10,-1.2375139728583175,11
4274,31,25,71,13,-1.2380158081615487,12
4275,37,20,91,10,-1.2413018923540673,10
4276,60,69,51,39,-1.2442757806235896,30
4277,74,31,11,16,-1.2464065422784565,15
4278,9,61,13,33,-1.2504419702657081,28
4279,13,42,17,21,-1.2570532505054302,21
4280,51,20,38,10,-1.2575366142186466,10
4281,63,37,9,19,-1.258902370787797,18
4282,49,18,114,8,-1.2604600332250737,10
4283,79,10,93,5,-1.2606355667564606,5
4284,19,17,47,9,-1.260882861026141,8
4285,18,20,81,10,-1.2612198373935393,10
4286,14,15,107,7,-1.2621804963006722,8
4287,107,12,92,7,-1.2625916923530782,5
4288,49,18,57,10,-1.2683352845717475,8
4289,28,29,60,13,-1.2721110011472117,16
4290,1,11,71,5,-1.2732152302328026,6
4291,35,13,57,8,-1.2766228565175344,5
4292,91,10,34,5,-1.2767116469837234,5
4293,107,59,96,32,-1.2779661064945875,27
4294,47,50,39,27,-1.2793416824524835,23
4295,19,34,76,18,-1.287740953733813,16
4296,99,19,51,9,-1.289208240710447,10
4297,43,46,51,23,-1.2927213961905477,23
4298,4,39,88,20,-1.2949212207610556,19
4299,8,22,7,12,-1.2952715014492375,10
4300,29,27,11,14,-1.2961292923128658,13
4301,68,47,41,24,-1.2976062488793096,23
4302,68,41,15,23,-1.299961161923338,18
4303,13,44,5,23,-1.3023509853743045,21
4304,63,74,107,35,-1.3057879270213841,39
4305,114,28,41,14,-1.3073381080435666,14
4306,51,14,32,7,-1.3093866254236384,7
4307,58,28,9,15,-1.3102681358218982,13
4308,9,52,68,27,-1.3104638696206719,25
4309,49,66,88,35,-1.3122930386834788,31
4310,65,32,112,16,-1.312297716343949,16
4311,38,17,78,9,-1.3124215602467724,8
4312,40,11,94,6,-1.3131730085845275,5
4313,65,32,62,16,-1.314337298660698,16
4314,48,48,16,23,-1.3151995623254868,25
4315,80,18,74,9,-1.3199661328668553,9
4316,87,53,72,27,-1.320143251933304,26
4317,19,75,16,42,-1.326157212976386,33
4318,57,15,91,7,-1.3279179810680901,8
4319,109,27,49,14,-1.3289589421166776,13
4320,57,41,41,22,-1.334606775919469,19
4321,23,10,6,5,-1.3385415186806273,5
4322,104,44,8,23,-1.3410693202324977,21
4323,15,53,65,27,-1.3449057106427944,26
4324,8,89,86,43,-1.3465074887539428,46
4325,40,17,108,8,-1.3479697301696891,9
4326,88,37,97,19,-1.3490743629309023,18
4327,54,70,50,36,-1.35588756917451,34
4328,40,35,41,17,-1.3586266453597045,18
4329,30,26,25,12,-1.3633847180345748,14
4330,76,47,106,22,-1.3637390504385927,25
4331,76,48,11,25,-1.3649753504739304,23
4332,55,61,87,31,-1.3657748995370729,30
4333,62,37,39,20,-1.3681155062123829,17
4334,15,29,104,15,-1.3712105407530093,14
4335,3,79,86,40,-1.3757666811474325,39
4336,20,19,93,11,-1.3777307962484893,8
4337,65,22,94,10,-1.3778845805510185,12
4338,55,11,52,6,-1.3787566985994324,5
4339,41,30,106,15,-1.3806292559177735,15
4340,84,14,62,7,-1.3810102415014252,7
4341,29,11,36,5,-1.3837445576600507,6
4342,80,12,95,6,-1.3888115326852122,6
4343,12,29,19,13,-1.392183331800866,16
4344,98,12,74,6,-1.3941368131260956,6
4345,60,58,30,33,-1.4011348149570484,25
4346,95,17,70,8,-1.4011695857654893,9
4347,9,25,46,12,-1.4052752923291463,13
4348,71,20,12,10,-1.4059148964814134,10
4349,106,23,30,12,-1.4150001393849163,11
4350,29,49,16,25,-1.4188154130480974,24
4351,53,11,1,6,-1.4196819324858234,5
4352,35,24,88,12,-1.4205575592973034,12
4353,111,39,65,22,-1.4217415135333136,17
4354,45,35,36,16,-1.423273124508117,19
4355,60,21,89,10,-1.4364501610048455,11
4356,25,28,50,14,-1.4391705454909005,14
4357,97,21,20,10,-1.439527960881876,11
4358,112,22,19,11,-1.441964796035352,11
4359,69,33,65,17,-1.4425642416495132,16
4360,27,14,99,8,-1.4451774655149787,6
4361,38,21,12,11,-1.4460676852206606,10
4362,81,20,27,10,-1.4466821985929976,10
4363,107,45,29,27,-1.446972317713833,18
4364,39,44,75,21,-1.4473715172929773,23
4365,63,55,106,28,-1.448556681809941,27
4366,80,33,65,17,-1.4513664238423445,16
4367,90,14,91,7,-1.4536395590442823,7
4368,86,131,107,68,-1.454309939136791,63
4369,83,23,25,13,-1.459720188055503,10
4370,52,18,12,10,-1.4597821535609574,8
4371,47,21,31,11,-1.460613098071267,10
4372,51,64,40,33,-1.462465890119408,31
4373,49,10,6,6,-1.4632163711361088,4
4374,50,47,2,25,-1.465539919913427,22
4375,69,13,6,6,-1.467256279566122,7
4376,7,24,35,12,-1.4676220715119488,12
4377,11,50,106,29,-1.475178627799442,21
4378,79,17,103,9,-1.476299618195366,8
4379,84,10,68,6,-1.4788993773509216,4
4380,17,38,37,22,-1.4799245104721017,16
4381,77,18,64,11,-1.4804278853158346,7
4382,34,20,67,12,-1.4820875063659655,8
4383,77,44,86,23,-1.4836620718907318,21
4384,71,74,60,39,-1.4843115108657063,35
4385,95,10,27,6,-1.484742219213803,4
4386,50,23,3,12,-1.4863990456698133,11
4387,94,16,88,7,-1.488282221240779,9
4388,74,23,2,13,-1.4920197761473217,10
4389,86,86,13,47,-1.4942238545984032,39
4390,11,16,112,8,-1.4950492246382474,8
4391,25,47,107,24,-1.4967278623744342,23
4392,5,52,46,28,-1.4974094901037531,24
4393,3,24,23,13,-1.50147747590911,11
4394,57,52,39,28,-1.5029089864695722,24
4395,50,25,27,15,-1.504088460568275,10
4396,63,53,68,28,-1.50575560658607,25
4397,54,42,30,22,-1.5059126086053172,20
4398,55,12,46,7,-1.5148590180899666,5
4399,51,19,66,10,-1.5211919635793434,9
4400,37,14,35,7,-1.5231317423105963,7
4401,86,49,23,26,-1.525800627782492,23
4402,84,20,114,11,-1.5282826629009745,9
4403,58,24,60,12,-1.5296571105675618,12
4404,79,13,98,7,-1.5335435073226167,6
4405,107,35,94,21,-1.5336456044178708,14
4406,86,10,22,5,-1.5381482899799122,5
4407,81,19,68,10,-1.5385400494517059,9
4408,7,80,60,42,-1.540050899943462,38
4409,9,32,60,18,-1.5417639078296765,14
4410,11,20,80,10,-1.5532652275466878,10
4411,38,43,16,26,-1.5626325984818243,17
4412,13,61,4,33,-1.5687606312733104,28
4413,16,31,102,16,-1.574061760944104,15
4414,43,27,72,14,-1.57449773007736,13
4415,88,34,96,17,-1.5755489762598094,17
4416,16,59,74,30,-1.5763144198537735,29
4417,77,39,68,22,-1.576615399225744,17
4418,95,20,76,10,-1.5773440780858252,10
4419,90,22,55,10,-1.5786569524988743,12
4420,20,87,86,46,-1.5804412903724692,41
4421,97,34,2,18,-1.581483466739766,16
4422,25,15,2,7,-1.5845186001024003,8
4423,98,20,27,10,-1.5846794804650377,10
4424,23,18,104,8,-1.586371905318577,10
4425,7,42,114,23,-1.5876978285125973,19
4426,63,114,65,60,-1.5897439715876238,54
4427,76,36,65,21,-1.5910282606529318,15
4428,98,24,51,13,-1.5914965104039467,11
4429,75,11,14,6,-1.594721022285634,5
4430,38,12,91,6,-1.5959128745414664,6
4431,37,56,51,32,-1.5992269438266566,24
4432,39,60,100,31,-1.6010134961541473,29
4433,18,17,76,9,-1.6011095201796195,8
4434,54,26,15,12,-1.6106595014683187,14
4435,69,29,30,15,-1.6139022710932387,14
4436,80,14,17,8,-1.614004150921247,6
4437,20,18,69,10,-1.6170767555813117,8
4438,60,58,87,28,-1.6223072521777597,30
4439,88,46,106,26,-1.6248459493396543,20
4440,30,22,7,10,-1.627064761951183,12
4441,84,12,64,5,-1.627208224984681,7
4442,68,18,6,8,-1.6346986227731621,10
4443,18,26,104,15,-1.6361581237581888,11
4444,12,33,49,14,-1.6371252398943674,19
4445,109,51,13,26,-1.6395687372615342,25
4446,68,23,36,12,-1.6511686348202723,11
4447,104,16,57,10,-1.6527114989919918,6
4448,62,18,72,10,-1.6557951231896935,8
4449,1,30,41,17,-1.6558361653082898,13
4450,19,47,39,27,-1.6563754565915603,20
4451,20,32,114,17,-1.657621146486575,15
4452,43,30,57,17,-1.6612981568954168,13
4453,47,24,63,14,-1.6623324282821748,10
4454,74,47,37,24,-1.6628163329711194,23
4455,34,13,114,6,-1.6642874528280043,7
4456,16,21,85,12,-1.666093825504177,9
4457,33,19,54,11,-1.6683853925492602,8
4458,112,17,17,9,-1.6709980493790215,8
4459,31,28,45,15,-1.671087040669103,13
4460,84,45,87,25,-1.6712785926609635,20
4461,94,23,11,13,-1.6715561424028802,10
4462,28,39,46,22,-1.6724095749961831,17
4463,104,14,48,8,-1.6735118830252353,6
4464,7,45,63,27,-1.6735738766299257,18
4465,90,41,16,21,-1.6799312140304263,20
4466,12,43,39,23,-1.6799981271423823,20
4467,106,40,55,22,-1.6835382667235006,18
4468,88,58,55,33,-1.6855630045879748,25
4469,28,20,73,10,-1.687006788072292,10
4470,78,34,72,16,-1.6894090900721699,18
4471,65,104,87,55,-1.6895189939198356,49
4472,78,30,65,17,-1.6922088418099988,13
4473,95,17,63,9,-1.6923751834394962,8
4474,23,15,36,6,-1.697287527418564,9
4475,33,15,49,9,-1.6985707880959628,6
4476,102,16,20,8,-1.698939123981487,8
4477,2,10,77,5,-1.7047420693819315,5
4478,28,62,88,33,-1.710290859725632,29
4479,54,51,5,28,-1.712751834502299,23
4480,83,24,104,14,-1.7171480590838877,10
4481,43,17,74,8,-1.7202204297362316,9
4482,77,25,88,14,-1.7210000447837082,11
4483,72,21,47,13,-1.7225949179979394,8
4484,55,98,8,49,-1.722879598629846,49
4485,28,10,77,5,-1.7274479044716256,5
4486,43,38,27,20,-1.7274963713159421,18
4487,1,24,60,13,-1.730552170717303,11
4488,11,65,8,34,-1.7307656592660727,31
4489,68,13,32,8,-1.7311662598089272,5
4490,100,15,89,8,-1.731753875229494,7
4491,96,38,106,21,-1.7318320126651956,17
4492,3,20,103,9,-1.7329901589407666,11
4493,44,27,16,15,-1.7334648777380282,12
4494,9,16,111,9,-1.7347101097492725,7
4495,112,23,9,13,-1.7370284161007248,10
4496,102,28,11,14,-1.7387973463291375,14
4497,88,37,36,21,-1.7392851936744365,16
4498,6,11,18,6,-1.741458460094483,5
4499,36,33,60,17,-1.7416473627060736,16
4500,27,30,76,17,-1.7427067110546453,13
4501,27,50,41,28,-1.7436572730759008,22
4502,64,26,50,13,-1.7443555357645713,13
4503,107,23,79,13,-1.7474071801332414,10
4504,88,83,87,43,-1.7488057658794518,40
4505,88,17,85,9,-1.7507571303795124,8
4506,18,37,88,19,-1.753919363939246,18
4507,11,48,50,25,-1.75518427992584,23
4508,8,78,54,44,-1.7565177133908372,34
4509,13,29,91,14,-1.7567935360990936,15
4510,5,98,37,51,-1.758075221984611,47
4511,65,51,53,26,-1.762840300330691,25
4512,51,49,30,26,-1.7674253182266604,23
4513,23,18,29,9,-1.7689038846082912,9
4514,77,16,58,9,-1.7691785236904847,7
4515,30,19,9,11,-1.7725720850396791,8
4516,107,95,65,50,-1.773358971643156,45
4517,87,47,62,25,-1.7735628992287054,22
4518,90,25,37,13,-1.7816453937181718,12
4519,46,27,97,14,-1.7888516310767928,13
4520,48,19,20,11,-1.788885742697511,8
4521,39,35,114,17,-1.7909993968165168,18
4522,85,33,107,17,-1.792725598129701,16
4523,45,13,88,6,-1.7936864388197342,7
4524,102,19,62,10,-1.8008214371485478,9
4525,9,18,29,9,-1.8021042570677102,9
4526,31,34,51,20,-1.8036645224364254,14
4527,86,57,70,31,-1.8046372203949796,26
4528,25,22,36,11,-1.807144013826857,11
4529,111,18,40,9,-1.8104998545748772,9
4530,29,18,55,9,-1.8130539080836594,9
4531,37,25,76,15,-1.8207875520541705,10
4532,99,13,102,7,-1.8212893413036917,6
4533,86,28,94,15,-1.8256273703234374,13
4534,19,53,43,28,-1.8262026945752656,25
4535,75,44,13,24,-1.82625422828726,20
4536,114,13,44,7,-1.8263733365516681,6
4537,13,29,74,15,-1.8278354237299026,14
4538,72,17,38,8,-1.8294765096627916,9
4539,66,12,3,6,-1.8347522062759392,6
4540,20,22,95,11,-1.8350043196326247,11
4541,38,18,17,10,-1.8350446788804244,8
4542,96,38,84,19,-1.8356486827006808,19
4543,85,18,12,9,-1.8411131730635322,9
4544,73,13,50,8,-1.8439270323254189,5
4545,97,22,53,12,-1.8492466822191038,10
4546,66,15,106,9,-1.8543998994283264,6
4547,97,21,93,11,-1.8583722279909514,10
4548,27,36,29,20,-1.862710190219295,16
4549,33,13,60,8,-1.8644268792007352,5
4550,47,13,53,7,-1.867452050486345,6
4551,51,62,8,32,-1.8690209653489385,30
4552,92,15,104,7,-1.8690561053420156,8
4553,81,16,30,8,-1.8705842587540342,8
4554,27,62,39,34,-1.874256839529348,28
4555,19,17,98,10,-1.8757617027076587,7
4556,8,41,2,21,-1.884865447616968,20
4557,30,16,96,9,-1.885074878690478,7
4558,64,23,25,12,-1.885723885284777,11
4559,86,44,71,22,-1.8883807510456327,22
4560,90,40,107,20,-1.8898084470141447,20
4561,87,48,29,26,-1.8921228743126288,22
4562,98,12,85,7,-1.8929637615829242,5
4563,99,27,55,15,-1.895072402151854,12
4564,111,12,30,7,-1.9021634173356625,5
4565,13,81,39,43,-1.9038228253048914,38
4566,9,12,93,7,-1.9054646427528426,5
4567,63,37,78,19,-1.905896647305327,18
4568,109,20,37,11,-1.9083987500708364,9
4569,1,38,68,20,-1.9099752765436626,18
4570,34,39,17,19,-1.9118019995598055,20
4571,74,65,8,36,-1.912865606563874,29
4572,17,11,110,6,-1.9155371371930692,5
4573,106,32,97,16,-1.9159665785715099,16
4574,76,11,99,5,-1.9173589523208294,6
4575,102,30,76,17,-1.9232165665181344,13
4576,72,64,16,35,-1.9235174892718683,29
4577,18,21,114,11,-1.9235772497574435,10
4578,51,23,102,12,-1.9242622041835242,11
4579,40,19,70,11,-1.9276789997691235,8
4580,84,30,65,16,-1.9288646732683914,14
4581,76,26,41,12,-1.9323052199492383,14
4582,97,14,23,7,-1.933052873443659,7
4583,98,10,32,5,-1.938005226383161,5
4584,7,49,71,24,-1.9387153694352721,25
4585,104,13,110,8,-1.938847445081051,5
4586,31,14,23,8,-1.9392936999416412,6
4587,112,38,107,19,-1.9399789809753514,19
4588,77,81,60,43,-1.9426493005944152,38
4589,55,20,25,11,-1.9429576796619983,9
4590,61,22,13,13,-1.9474617025071013,9
4591,64,34,36,17,-1.9485056781764574,17
4592,38,13,20,8,-1.955773251876416,5
4593,35,11,50,6,-1.9581460146246799,5
4594,29,18,50,9,-1.9592313389646654,9
4595,78,21,41,12,-1.9597162558523098,9
4596,33,14,39,7,-1.9600955952261323,7
4597,97,11,80,6,-1.9631828964682283,5
4598,112,24,41,13,-1.9642201479007202,11
4599,91,33,28,18,-1.9649527402335243,15
4600,95,11,102,6,-1.9663297200367658,5
4601,94,53,43,28,-1.967775882391458,25
4602,34,25,39,13,-1.9686602327127705,12
4603,35,10,54,6,-1.970607603878344,4
4604,84,31,55,16,-1.972558144291078,15
4605,70,32,88,17,-1.97629343595963,15
4606,108,19,76,10,-1.980436398470409,9
4607,38,30,68,17,-1.98112771845421,13
4608,79,12,100,7,-1.9822381822120907,5
4609,4,19,53,10,-1.9876947928926731,9
4610,93,16,3,7,-1.988799219040227,9
4611,81,12,48,7,-1.988832939584028,5
4612,74,26,114,13,-1.9975972531686852,13
4613,90,14,43,8,-2.0053393579332366,6
4614,97,22,83,10,-2.0076368732075736,12
4615,103,13,112,7,-2.012520719272728,6
4616,70,29,68,15,-2.0151181581046322,14
4617,54,37,84,20,-2.015420239969851,17
4618,54,37,80,18,-2.018157304123278,19
4619,60,11,93,7,-2.0186296316322276,4
4620,10,10,111,6,-2.019460672769103,4
4621,90,37,8,21,-2.019464782071777,16
4622,65,40,49,21,-2.0199053677840455,19
4623,17,44,65,26,-2.0208714349805383,18
4624,17,27,114,16,-2.0211590753648663,11
4625,70,54,16,30,-2.021288067113987,24
4626,50,34,17,17,-2.022768941605581,17
4627,51,52,28,26,-2.0250173037261257,26
4628,13,11,32,6,-2.0261815070275415,5
4629,94,36,19,18,-2.0287789057822345,18
4630,114,14,91,7,-2.031242634143404,7
4631,8,40,60,20,-2.033286998314092,20
4632,93,18,11,8,-2.03919027808283,10
4633,39,58,8,29,-2.039228763371934,29
4634,7,14,12,7,-2.0405365521973633,7
4635,68,14,45,8,-2.0416275962437833,6
4636,68,79,16,44,-2.0462981602365193,35
4637,102,28,109,15,-2.052816303469013,13
4638,92,20,13,9,-2.0549864483695095,11
4639,20,19,57,10,-2.0635570646445043,9
4640,34,30,84,16,-2.067010635537675,14
4641,23,20,27,10,-2.072262837137015,10
4642,20,16,104,8,-2.072480775827561,8
4643,55,16,89,8,-2.0735236646324586,8
4644,104,32,30,16,-2.073588127852211,16
4645,54,68,20,33,-2.0740616245882655,35
4646,83,19,60,10,-2.080593849514112,9
4647,68,43,64,25,-2.086424402801581,18
4648,94,12,15,7,-2.089165890411621,5
4649,11,18,40,9,-2.0894421004610075,9
4650,8,22,97,11,-2.094799206270942,11
4651,57,17,64,10,-2.0964467583954454,7
4652,11,22,33,10,-2.0987581423348063,12
4653,94,28,68,15,-2.106511062546954,13
4654,25,11,69,6,-2.1120597510852503,5
4655,107,56,50,29,-2.1132862646405504,27
4656,62,63,16,36,-2.1158722554695197,27
4657,70,11,53,6,-2.117480208536361,5
4658,70,34,104,18,-2.118226250740967,16
4659,109,55,87,31,-2.1192896636396386,24
4660,9,62,7,31,-2.12190310948229,31
4661,114,32,102,18,-2.1240842876015145,14
4662,95,10,108,6,-2.124107159080121,4
4663,88,85,8,45,-2.124921447292129,40
4664,88,61,41,34,-2.127673535455668,27
4665,81,27,107,14,-2.128958878371003,13
4666,13,139,16,76,-2.1299224675207293,63
4667,43,10,98,6,-2.130277896443765,4
4668,61,12,2,7,-2.1331085158076037,5
4669,89,22,107,11,-2.1353078245406376,11
4670,102,26,8,13,-2.1358165667375646,13
4671,31,13,66,7,-2.1367157981218847,6
4672,39,39,71,21,-2.1402119009407663,18
4673,69,11,55,6,-2.141856565606561,5
4674,8,21,10,12,-2.1473150021467613,9
4675,79,17,3,10,-2.1554920996277978,7
4676,45,20,40,11,-2.1604079227235773,9
4677,29,10,5,6,-2.165232041865749,4
4678,107,76,27,42,-2.1737890157942092,34
4679,77,24,55,13,-2.185700732900179,11
4680,69,10,64,6,-2.1864749506825816,4
4681,72,19,7,10,-2.1917063339887886,9
4682,39,38,17,21,-2.193005161454297,17
4683,106,35,68,19,-2.1936858069827916,16
4684,75,32,60,17,-2.194819750320694,15
4685,40,75,7,42,-2.1957521283064794,33
4686,56,12,91,6,-2.1992686471747738,6
4687,19,45,54,26,-2.1999050554671054,19
4688,13,109,68,58,-2.2032595049910353,51
4689,96,50,5,28,-2.21142719225076,22
4690,84,23,75,12,-2.2186834285684554,11
4691,99,13,98,6,-2.221258167793369,7
4692,20,18,78,9,-2.2240641682142086,9
4693,25,16,90,9,-2.2261576936837106,7
4694,65,18,46,11,-2.2329984780581085,7
4695,114,26,4,13,-2.2345648368573663,13
4696,39,41,64,22,-2.2394205034334607,19
4697,65,13,108,6,-2.240109849463783,7
4698,27,10,70,5,-2.2432632584575636,5
4699,113,16,86,9,-2.251799072045514,7
4700,83,11,63,7,-2.2518527555220995,4
4701,103,34,51,19,-2.252356142690839,15
4702,74,29,20,16,-2.2532656544174667,13
4703,25,30,95,16,-2.253973143655665,14
4704,41,13,74,6,-2.2545650248033335,7
4705,17,16,98,8,-2.257246092539532,8
4706,3,41,15,22,-2.2633631375662158,19
4707,98,12,62,6,-2.263618494828718,6
4708,7,12,85,7,-2.267272935114745,5
4709,96,66,28,35,-2.2674069446039304,31
4710,31,10,61,5,-2.2696136748473643,5
4711,27,68,13,36,-2.2740816322650126,32
4712,74,14,40,8,-2.2751378053719047,6
4713,92,14,65,7,-2.2769844774151675,7
4714,69,12,77,6,-2.279799370845894,6
4715,81,10,38,5,-2.281962126644993,5
4716,20,13,89,7,-2.2819892797426893,6
4717,16,16,73,8,-2.2869477637304083,8
4718,28,76,8,41,-2.287592590077328,35
4719,4,13,106,6,-2.2878834680443574,7
4720,5,24,100,13,-2.293242743404464,11
4721,50,42,63,23,-2.295098382996511,19
4722,7,20,80,11,-2.2986689861273364,9
4723,33,23,86,13,-2.2996974943246613,10
4724,95,26,60,14,-2.300035058084819,12
4725,112,27,87,14,-2.3028409213342935,13
4726,98,11,38,6,-2.303289795541878,5
4727,70,13,35,6,-2.304704787607643,7
4728,69,13,76,8,-2.308555624427584,5
4729,70,28,63,15,-2.309911464577443,13
4730,63,31,71,17,-2.3112629873314674,14
4731,96,58,8,31,-2.313991189820115,27
4732,91,32,88,17,-2.315767764685104,15
4733,87,18,111,10,-2.3163891448333644,8
4734,61,23,3,15,-2.318754532374438,8
4735,102,21,104,10,-2.3206272974702777,11
4736,34,25,65,14,-2.3212579900106842,11
4737,50,35,84,18,-2.3257021134383264,17
4738,107,53,34,30,-2.3280747508331903,23
4739,5,51,109,26,-2.3285813949081633,25
4740,53,28,25,14,-2.330151085469087,14
4741,86,37,80,20,-2.3309612757843783,17
4742,19,21,38,13,-2.3345425219981566,8
4743,69,30,58,15,-2.3378190755068298,15
4744,45,10,78,5,-2.343791897433706,5
4745,72,44,13,23,-2.3449450257806976,21
4746,48,23,60,12,-2.3452069486573284,11
4747,68,70,88,38,-2.348799110697708,32
4748,96,10,79,5,-2.3519921114573528,5
4749,33,12,57,7,-2.353237282271007,5
4750,31,36,4,21,-2.353535596679466,15
4751,33,12,99,7,-2.354570382478151,5
4752,109,17,40,10,-2.3545763145612293,7
4753,17,27,8,14,-2.3545788982602027,13
4754,109,14,96,8,-2.3566759619593642,6
4755,58,16,43,9,-2.35671636938616,7
4756,97,14,100,8,-2.358325970901079,6
4757,76,34,70,18,-2.358420872168422,16
4758,39,17,102,9,-2.361339353589837,8
4759,5,23,99,12,-2.361621902264283,11
4760,60,30,19,15,-2.366878047373235,15
4761,50,24,40,14,-2.3671440474550494,10
4762,63,32,25,16,-2.3688265373602633,16
4763,100,36,72,19,-2.36993758953296,17
4764,84,19,90,10,-2.374748457023267,9
4765,107,40,71,23,-2.3760609676092463,17
4766,107,52,15,31,-2.378635788417388,21
4767,51,92,88,45,-2.379271211176053,47
4768,84,90,86,45,-2.3816790899230793,45
4769,66,11,54,6,-2.382433829903063,5
4770,19,58,100,32,-2.382850378134941,26
4771,56,13,75,8,-2.3840139649043497,5
4772,104,25,96,14,-2.3866419839158373,11
4773,71,21,4,13,-2.387175011736595,8
4774,54,53,39,28,-2.3874161960295965,25
4775,16,56,103,28,-2.394521167201059,28
4776,109,21,97,11,-2.3981411019215164,10
4777,76,36,8,20,-2.3997351089247143,16
4778,94,27,100,17,-2.4002432216595997,10
4779,33,14,74,7,-2.401214003272286,7
4780,80,26,20,14,-2.403335157163852,12
4781,49,81,16,44,-2.40465003092145,37
4782,104,57,88,32,-2.406185933878752,25
4783,58,18,19,10,-2.4064977733807265,8
4784,23,22,54,12,-2.4071199385443034,10
4785,23,27,12,14,-2.4083304396292196,13
4786,50,40,8,23,-2.412256910417208,17
4787,7,32,15,15,-2.41306663658859,17
4788,94,19,28,11,-2.4149604753175535,8
4789,107,98,8,50,-2.415176397351887,48
4790,15,61,57,32,-2.417031645463815,29
4791,99,11,109,6,-2.419517402501051,5
4792,77,32,72,17,-2.428129578165289,15
4793,96,17,3,9,-2.4320783711975644,8
4794,51,19,14,12,-2.433844123091522,7
4795,3,53,68,27,-2.4376682306044293,26
4796,3,50,107,25,-2.4400027665406845,25
4797,7,56,23,30,-2.44119174027295,26
4798,50,10,32,4,-2.4440541907162885,6
4799,87,38,90,19,-2.4450741783684653,19
4800,61,15,63,9,-2.445410080263457,6
4801,65,17,61,8,-2.4487309858444055,9
4802,50,16,58,8,-2.4508398898046004,8
4803,84,10,40,5,-2.454221067396937,5
4804,86,17,110,9,-2.4597124602837575,8
4805,25,32,102,17,-2.460889696925049,15
4806,1,17,17,9,-2.462761073509874,8
4807,69,17,74,8,-2.466497282082459,9
4808,15,52,13,27,-2.4673961616838103,25
4809,106,52,65,28,-2.4741835823316767,24
4810,28,58,87,30,-2.4778229626436263,28
4811,103,25,65,15,-2.4852149334196065,10
4812,79,25,28,13,-2.4854050300354316,12
4813,9,27,71,15,-2.485839871550414,12
4814,67,13,84,6,-2.500709874534178,7
4815,86,63,114,33,-2.5031933128077966,30
4816,104,47,39,26,-2.5072894343981122,21
4817,92,15,87,8,-2.5078466479835875,7
4818,104,17,89,9,-2.5139241654919746,8
4819,36,15,12,8,-2.516319942513754,7
4820,29,18,97,10,-2.5164381029242997,8
4821,16,77,104,42,-2.5182352258511704,35
4822,46,27,68,15,-2.520930145642669,12
4823,9,33,36,18,-2.527924078037464,15
4824,87,41,77,22,-2.528143646306266,19
4825,30,32,78,17,-2.5287150917106826,15
4826,30,19,99,11,-2.530388293684777,8
4827,107,15,44,8,-2.5305445670994096,7
4828,62,10,61,5,-2.530755074166221,5
4829,17,29,7,16,-2.532089441361392,13
4830,88,60,40,33,-2.532837544735202,27
4831,89,14,8,8,-2.5350410826092786,6
4832,9,22,70,13,-2.539064949919759,9
4833,65,35,97,19,-2.5397394280205594,16
4834,88,70,60,39,-2.5406826180117665,31
4835,20,40,88,20,-2.541950104212901,20
4836,46,66,11,36,-2.5437472748720262,30
4837,36,74,7,40,-2.5493587507973596,34
4838,47,14,71,7,-2.550463226281338,7
4839,39,44,9,22,-2.551362349935292,22
4840,1,19,73,11,-2.5534291003907312,8
4841,51,21,48,10,-2.5619467431523475,11
4842,68,109,7,59,-2.5626001746544604,50
4843,90,48,86,27,-2.5660355304043208,21
4844,107,50,78,28,-2.5669006033975164,22
4845,13,26,33,14,-2.5699373786762183,12
4846,25,14,48,7,-2.5710538086168517,7
4847,76,14,38,6,-2.573988420286464,8
4848,51,29,1,15,-2.5741193049184647,14
4849,35,24,16,14,-2.575434774594282,10
4850,108,14,81,7,-2.575857374314636,7
4851,112,22,50,13,-2.578275791966451,9
4852,88,15,33,9,-2.581178022844097,6
4853,65,71,28,40,-2.5907378992374013,31
4854,109,10,1,5,-2.5929606771402347,5
4855,37,27,102,15,-2.5931875377695413,12
4856,37,48,20,25,-2.593682765159078,23
4857,77,12,62,7,-2.5961939184273137,5
4858,51,47,57,25,-2.599162353840763,22
4859,91,23,36,13,-2.6004832054576417,10
4860,51,37,50,19,-2.6061429766239623,18
4861,1,29,40,16,-2.6081027273161874,13
4862,45,18,63,10,-2.6118302368324993,8
4863,12,48,86,26,-2.6167230254062717,22
4864,95,41,104,23,-2.6172247089757983,18
4865,28,42,39,22,-2.6233394077803625,20
4866,88,25,76,13,-2.6331924139366385,12
4867,107,34,95,18,-2.633836762476073,16
4868,98,21,54,11,-2.633881490859558,10
4869,39,34,95,18,-2.633907594970312,16
4870,22,12,51,7,-2.634920658551637,5
4871,54,13,110,7,-2.6358849029934506,6
4872,89,17,39,10,-2.637403555239236,7
4873,109,39,104,21,-2.643837630094446,18
4874,41,22,103,11,-2.648725308855804,11
4875,36,13,57,8,-2.65311609010537,5
4876,11,52,55,30,-2.65424554714003,22
4877,73,14,20,8,-2.6543798385197737,6
4878,80,39,16,23,-2.655474856892815,16
4879,27,24,40,11,-2.6563176029466633,13
4880,86,33,19,17,-2.664793774198572,16
4881,86,182,16,103,-2.666914901037599,79
4882,5,17,71,9,-2.668348512437487,8
4883,104,67,37,37,-2.6697156594454787,30
4884,7,118,13,63,-2.670897317194471,55
4885,44,17,25,9,-2.67353547628176,8
4886,87,36,46,21,-2.674578900035653,15
4887,5,25,39,13,-2.679132217269281,12
4888,107,21,93,12,-2.6848247910711347,9
4889,103,13,63,8,-2.685558245604488,5
4890,5,61,74,32,-2.685625674476679,29
4891,102,20,13,12,-2.6891186576501824,8
4892,31,23,87,12,-2.691508727503307,11
4893,65,11,10,6,-2.6916160360342993,5
4894,68,42,30,22,-2.694179911234638,20
4895,41,27,20,13,-2.6942971523502353,14
4896,37,20,43,10,-2.694551750219246,10
4897,106,63,87,33,-2.697752551932461,30
4898,60,45,43,24,-2.6992549601571807,21
4899,7,27,20,14,-2.7023319306021247,13
4900,77,23,23,12,-2.706150066022622,11
4901,29,26,94,14,-2.7112074149721894,12
4902,88,66,114,35,-2.711653784187523,31
4903,29,21,38,11,-2.7118691479278114,10
4904,15,48,30,27,-2.7124708522281957,21
4905,4,20,63,11,-2.717031964261838,9
4906,88,16,34,9,-2.717519501254015,7
4907,84,30,37,16,-2.724027270977717,14
4908,88,16,44,8,-2.725541522204711,8
4909,5,11,49,6,-2.7256599500520573,5
4910,77,13,102,7,-2.726227993420544,6
4911,88,27,12,15,-2.7283951011988448,12
4912,57,24,68,12,-2.731461721250245,12
4913,65,16,89,9,-2.7326107907122044,7
4914,30,18,35,10,-2.73352153004485,8
4915,13,67,104,37,-2.7338355846201052,30
4916,86,29,35,17,-2.735934113725711,12
4917,63,12,99,6,-2.7377253409939395,6
4918,102,35,54,19,-2.738133577396995,16
4919,51,115,13,59,-2.7446379900467215,56
4920,75,10,89,5,-2.7450238265363023,5
4921,64,45,53,25,-2.745377769816893,20
4922,107,80,39,43,-2.746903265333253,37
4923,51,26,71,14,-2.7484840529184043,12
4924,51,41,12,22,-2.7508926819873185,19
4925,46,16,3,8,-2.7521722319308535,8
4926,96,34,97,17,-2.7556888339056824,17
4927,94,17,1,8,-2.7623810098011927,9
4928,53,10,103,7,-2.7626913899775767,3
4929,23,24,64,13,-2.7636463909122835,11
4930,69,23,15,13,-2.7652098531538085,10
4931,88,60,27,31,-2.7660588381556592,29
4932,109,52,51,32,-2.7686239064931333,20
4933,3,32,62,18,-2.7719381715786175,14
4934,62,40,107,20,-2.775574914699783,20
4935,100,12,93,7,-2.776431312725252,5
4936,87,17,10,9,-2.7770692343126613,8
4937,40,30,18,18,-2.780722164544755,12
4938,39,19,69,10,-2.7854748533223024,9
4939,112,14,85,8,-2.7888570708398155,6
4940,102,12,70,5,-2.7906887378625385,7
4941,36,13,100,7,-2.7923934619121082,6
4942,1,26,7,14,-2.7932054952385057,12
4943,44,14,68,7,-2.795327721392822,7
4944,50,15,23,10,-2.79562399723425,5
4945,8,32,83,16,-2.795775595052068,16
4946,27,15,33,8,-2.798031990621951,7
4947,65,26,48,13,-2.800978027003419,13
4948,112,14,106,7,-2.805082024542775,7
4949,71,42,65,24,-2.8056942435602354,18
4950,41,15,99,8,-2.808167291861728,7
4951,43,31,78,18,-2.808792064889392,13
4952,36,32,1,16,-2.8095303452930676,16
4953,109,31,60,17,-2.8109683593595367,14
4954,40,48,9,27,-2.81743847104381,21
4955,76,26,97,14,-2.8180456861896683,12
4956,48,14,68,7,-2.8206443314688054,7
4957,71,13,18,7,-2.821320109059585,6
4958,112,21,75,12,-2.824219405034082,9
4959,35,11,39,6,-2.836154761931755,5
4960,28,104,86,58,-2.8374089851944664,46
4961,16,25,4,12,-2.8411046840521466,13
4962,33,13,97,7,-2.8486496222061612,6
4963,53,51,39,28,-2.850176330999263,23
4964,28,96,16,53,-2.854985092700266,43
4965,28,25,69,13,-2.8619129564051375,12
4966,78,14,108,8,-2.8642940930834624,6
4967,84,70,28,39,-2.8670003890442084,31
4968,55,32,53,18,-2.868206535572335,14
4969,94,16,103,8,-2.870581692988751,8
4970,87,25,83,13,-2.871024026015094,12
4971,87,95,30,52,-2.8710649309032963,43
4972,1,14,112,9,-2.8723250567679224,5
4973,89,16,57,8,-2.87315648894596,8
4974,2,10,108,6,-2.87346504815302,4
4975,30,21,75,11,-2.8743282279457314,10
4976,77,14,106,7,-2.8755893681261617,7
4977,46,25,17,14,-2.875672610475698,11
4978,20,36,11,21,-2.8760492087904987,15
4979,48,18,88,11,-2.878155115044796,7
4980,27,33,8,17,-2.8813894658039882,16
4981,71,34,30,18,-2.8915964337712703,16
4982,43,21,29,12,-2.901186429571315,9
4983,79,33,16,19,-2.9049583801159375,14
4984,20,25,30,14,-2.905326304581671,11
4985,9,19,62,10,-2.9069158954391585,9
4986,53,29,95,18,-2.9078610003173133,11
4987,10,12,104,6,-2.911353003023708,6
4988,33,10,37,6,-2.9157377490462273,4
4989,31,11,55,6,-2.9183781753906346,5
4990,9,17,109,8,-2.91854195196147,9
4991,47,10,29,6,-2.919983374996915,4
4992,106,19,102,9,-2.920725539256512,10
4993,61,21,88,13,-2.9209863910476948,8
4994,62,14,1,7,-2.9215215839903967,7
4995,103,14,37,9,-2.9215508243945587,5
4996,33,10,3,6,-2.927658221464772,4
4997,40,18,12,9,-2.9302897037093416,9
4998,28,21,33,10,-2.934003356051797,11
4999,87,20,36,12,-2.935573250897671,8
5000,65,27,83,14,-2.938404758323202,13
5001,5,63,16,37,-2.93851451686489,26
5002,1,18,9,8,-2.9438107743951827,10
5003,46,18,71,9,-2.9448527741935377,9
5004,16,34,111,18,-2.951369699467131,16
5005,66,11,55,6,-2.95709645710416,5
5006,93,19,20,9,-2.9574857323051185,10
5007,57,23,114,13,-2.9591464136641092,10
5008,57,18,25,10,-2.9649349505538742,8
5009,63,16,73,8,-2.966556049159883,8
5010,51,38,49,20,-2.9679331720709357,18
5011,50,26,90,14,-2.969099568178274,12
5012,37,21,2,11,-2.969758011269449,10
5013,4,32,36,19,-2.973906674035423,13
5014,41,28,43,15,-2.9751067750185958,13
5015,43,33,11,18,-2.9751377683179347,15
5016,106,36,84,18,-2.975473960825012,18
5017,23,61,16,33,-2.975982663116796,28
5018,72,11,18,4,-2.976476380286214,7
5019,1,13,46,6,-2.9771068452784513,7
5020,13,23,85,14,-2.985985548040523,9
5021,69,11,4,6,-2.9994841766617113,5
5022,34,14,96,8,-3.001763014782561,6
5023,108,20,50,10,-3.006186687462408,10
5024,63,42,74,22,-3.0096162132471513,20
5025,16,48,20,28,-3.0148860726120588,20
5026,33,17,40,11,-3.0217035797006964,6
5027,79,38,86,21,-3.025515072530801,17
5028,41,46,63,25,-3.0272340731708356,21
5029,49,11,66,6,-3.034305795934758,5
5030,65,39,25,23,-3.0368934823131153,16
5031,79,22,30,13,-3.038702569108576,9
5032,96,13,38,7,-3.042215232246171,6
5033,93,28,86,15,-3.047207829379784,13
5034,55,45,7,26,-3.0547614693932803,19
5035,63,21,17,11,-3.0560482096450983,10
5036,25,18,71,10,-3.0644100067848146,8
5037,51,161,16,85,-3.0672990902119115,76
5038,25,30,75,17,-3.0695517335408993,13
5039,7,37,43,22,-3.070632441088369,15
5040,65,99,51,55,-3.077623570921798,44
5041,104,23,97,12,-3.0789791419269115,11
5042,62,16,55,9,-3.0797392954165557,7
5043,28,12,66,6,-3.0826665795427424,6
5044,37,59,107,32,-3.087858660035623,27
5045,50,17,93,10,-3.0892168464304066,7
5046,27,17,6,9,-3.094787186521295,8
5047,109,10,85,7,-3.095406882310694,3
5048,19,28,34,16,-3.0972119799619966,12
5049,54,34,104,18,-3.0987784259955413,16
5050,54,29,17,15,-3.099464272586132,14
5051,74,16,88,10,-3.1000151762465453,6
5052,68,14,99,8,-3.100103615084475,6
5053,60,15,92,9,-3.1016290657385786,6
5054,57,20,9,11,-3.1019493918441303,9
5055,100,24,98,14,-3.102517713271865,10
5056,86,21,111,12,-3.1037611827633467,9
5057,60,80,13,46,-3.1063619078243834,34
5058,4,24,50,12,-3.110559237136967,12
5059,17,25,25,14,-3.1106502600539123,11
5060,55,32,76,19,-3.115456044147197,13
5061,80,11,36,6,-3.115857421175655,5
5062,88,21,72,12,-3.1180238666219515,9
5063,48,36,28,20,-3.1189690871072235,16
5064,63,34,100,17,-3.120017100138165,17
5065,50,61,87,32,-3.1237108098833493,29
5066,107,37,17,20,-3.1278325614986824,17
5067,28,11,6,6,-3.131247568187587,5
5068,76,24,3,13,-3.1320099121348606,11
5069,41,24,47,12,-3.137759511909013,12
5070,9,23,114,15,-3.140025237540426,8
5071,23,23,75,11,-3.148733601092015,12
5072,57,43,11,21,-3.1565311276310086,22
5073,7,51,104,28,-3.1582194180075027,23
5074,82,21,86,12,-3.1586560919846343,9
5075,4,19,75,11,-3.1591429263358264,8
5076,9,55,107,28,-3.165394319093782,27
5077,66,20,63,11,-3.166079264336923,9
5078,69,30,41,18,-3.1671568486745967,12
5079,20,26,55,14,-3.1691541193918393,12
5080,60,25,106,15,-3.171261503808185,10
5081,54,29,78,16,-3.1794235894954275,13
5082,114,31,54,16,-3.1847921316014287,15
5083,90,22,17,13,-3.190848422422067,9
5084,8,15,69,8,-3.1913004711052855,7
5085,39,41,36,23,-3.1998605067578247,18
5086,45,24,64,14,-3.2007569662217303,10
5087,17,28,106,17,-3.2039846830051175,11
5088,41,38,60,19,-3.207056299166633,19
5089,97,12,56,6,-3.20853124358707,6
5090,72,18,63,11,-3.2092039339659753,7
5091,31,47,60,23,-3.209470727487928,24
5092,97,19,50,11,-3.210625734622635,8
5093,74,16,17,9,-3.211770551027836,7
5094,64,14,72,7,-3.21744827694827,7
5095,94,18,55,10,-3.2183549150249458,8
5096,80,10,100,6,-3.221630002984554,4
5097,12,16,54,8,-3.22546532700851,8
5098,65,50,23,26,-3.2292420048113133,24
5099,97,14,3,7,-3.230803945654675,7
5100,36,49,107,26,-3.2348387046482574,23
5101,60,25,99,14,-3.23819445910271,11
5102,88,42,100,24,-3.2386401365610324,18
5103,81,12,23,7,-3.240703587077,5
5104,96,10,64,6,-3.2470341038418864,4
5105,72,32,54,19,-3.2473935855979894,13
5106,65,19,81,11,-3.2504513606416716,8
5107,68,25,29,14,-3.253332721067046,11
5108,25,47,114,27,-3.2540864225169717,20
5109,8,31,64,18,-3.256233691128028,13
5110,74,24,7,15,-3.2574931437928867,9
5111,107,63,68,33,-3.262613498145852,30
5112,87,157,86,82,-3.2776519602007257,75
5113,1,37,13,22,-3.2879398916144846,15
5114,35,15,55,8,-3.2899027901624853,7
5115,38,10,15,6,-3.2905237743764575,4
5116,79,17,76,10,-3.2930359935936764,7
5117,15,28,63,16,-3.2961749452345943,12
5118,98,11,34,5,-3.2977526881218022,6
5119,19,18,50,10,-3.298334334031155,8
5120,104,35,41,18,-3.298393432816603,17
5121,61,13,47,7,-3.3043540506366402,6
5122,64,21,114,12,-3.3046667254482798,9
5123,50,33,65,18,-3.3047538561923004,15
5124,43,41,3,23,-3.3062727025950673,18
5125,20,21,19,11,-3.3063904975233007,10
5126,64,43,107,23,-3.3076512331365557,20
5127,3,37,69,22,-3.30876623167263,15
5128,96,14,41,9,-3.3088942892360294,5
5129,25,66,86,35,-3.3097455853588764,31
5130,87,41,12,23,-3.3112106582613565,18
5131,77,46,13,26,-3.3139824242272384,20
5132,54,59,96,30,-3.3145176699500087,29
5133,84,16,97,10,-3.3164282058099315,6
5134,97,14,98,7,-3.3185319117606134,7
5135,55,85,13,47,-3.325656298998864,38
5136,38,15,2,8,-3.3317495398967756,7
5137,81,12,50,6,-3.335453957922903,6
5138,48,17,80,10,-3.335623053391129,7
5139,5,13,68,7,-3.3380294056441095,6
5140,86,97,11,53,-3.338046515987457,44
5141,12,32,68,17,-3.3414057521350977,15
5142,20,19,15,11,-3.3455642497005824,8
5143,20,10,83,5,-3.3478898251644154,5
5144,107,15,14,9,-3.3479962116917648,6
5145,60,37,78,20,-3.348403443672673,17
5146,45,27,16,16,-3.3506732016294216,11
5147,106,17,14,10,-3.3600594128266157,7
5148,61,14,9,8,-3.362078776884604,6
5149,8,23,14,13,-3.3634201583462144,10
5150,97,25,54,13,-3.3648153427656795,12
5151,20,17,40,10,-3.3649339637959677,7
5152,11,47,65,25,-3.365116447266004,22
5153,28,56,13,30,-3.367189637590283,26
5154,107,31,91,18,-3.369239220639531,13
5155,96,18,73,10,-3.3726024221333355,8
5156,91,16,74,9,-3.379327346818842,7
5157,75,20,70,10,-3.3793498632006282,10
5158,27,28,75,16,-3.3829340399823242,12
5159,43,15,70,9,-3.383063622759158,6
5160,55,28,36,15,-3.38333657725735,13
5161,104,10,73,6,-3.3914910994647247,4
5162,28,13,4,7,-3.394082491248691,6
5163,11,22,79,13,-3.411899322441765,9
5164,36,11,17,5,-3.4172736451567602,6
5165,78,18,28,9,-3.4177116588011063,9
5166,11,24,64,15,-3.420093692917574,9
5167,37,12,4,7,-3.4218717037755013,5
5168,27,52,7,28,-3.4308990471010476,24
5169,48,20,106,11,-3.4316235296616595,9
5170,63,25,49,13,-3.435463908483024,12
5171,86,94,7,54,-3.44879121802912,40
5172,12,25,103,12,-3.4495496342358525,13
5173,16,85,54,46,-3.4509458652322422,39
5174,86,97,63,57,-3.452765603775126,40
5175,114,14,112,7,-3.452952980329055,7
5176,23,21,37,11,-3.4530437057487378,10
5177,5,23,33,12,-3.4543275091771934,11
5178,49,21,50,11,-3.468500479588225,10
5179,27,41,34,22,-3.4773981792874955,19
5180,70,20,25,11,-3.484518115943742,9
5181,51,30,36,16,-3.4874600225025043,14
5182,87,46,94,24,-3.487474186460591,22
5183,50,13,94,8,-3.4892669802483667,5
5184,36,13,62,7,-3.4895283270523745,6
5185,53,14,23,8,-3.489897713169178,6
5186,5,16,14,10,-3.4903696256491523,6
5187,54,10,6,5,-3.4921987314309866,5
5188,109,26,20,16,-3.4929177397438647,10
5189,114,36,97,20,-3.4948097299506924,16
5190,15,22,47,11,-3.501960777576647,11
5191,77,30,3,16,-3.5028026588503223,14
5192,98,17,73,9,-3.5039598524288147,8
5193,109,27,25,15,-3.504136926234722,12
5194,23,16,74,9,-3.505315761927062,7
5195,3,19,102,11,-3.508860335973488,8
5196,17,24,11,13,-3.5151101549695967,11
5197,108,15,100,9,-3.5153991595907663,6
5198,16,42,89,23,-3.519371430759391,19
5199,54,32,9,17,-3.52060468099837,15
5200,74,16,89,9,-3.5219803445540383,7
5201,50,55,37,29,-3.5287986061002137,26
5202,25,17,93,9,-3.53003978897563,8
5203,109,27,65,14,-3.5304477413641826,13
5204,62,10,6,6,-3.5345556158920366,4
5205,84,26,85,16,-3.5349178606931724,10
5206,7,15,44,8,-3.535266020755458,7
5207,47,15,58,9,-3.535505795510925,6
5208,29,23,41,13,-3.5398297136431847,10
5209,30,32,28,17,-3.5399264254738525,15
5210,36,65,40,37,-3.5400829247343593,28
5211,8,37,23,21,-3.5407673906896964,16
5212,27,29,47,16,-3.543966431934924,13
5213,70,11,33,6,-3.545285037756224,5
5214,19,16,40,10,-3.545611871303118,6
5215,37,21,62,13,-3.5526687288143344,8
5216,36,19,28,10,-3.554999615354129,9
5217,79,12,60,7,-3.555370933230573,5
5218,7,28,6,13,-3.563185524233912,15
5219,87,21,6,12,-3.566989216260902,9
5220,43,19,25,12,-3.5730773529480713,7
5221,78,48,13,27,-3.57320418342887,21
5222,87,22,14,13,-3.5746572289058025,9
5223,78,14,33,8,-3.5759620126343434,6
5224,62,10,41,5,-3.5810735995056335,5
5225,5,62,88,33,-3.583030843412139,29
5226,11,18,14,11,-3.5868100547047623,7
5227,95,10,97,6,-3.5894324713347885,4
5228,11,22,7,13,-3.590907173314133,9
5229,37,60,16,33,-3.592027263676104,27
5230,5,61,104,33,-3.5931408944870395,28
5231,57,14,106,7,-3.59361898372693,7
5232,16,57,75,31,-3.59529020803502,26
5233,71,30,62,16,-3.595660766482277,14
5234,79,23,34,14,-3.5987779482770503,9
5235,41,88,65,52,-3.5987797514188595,36
5236,32,24,86,13,-3.600337352350486,11
5237,27,46,12,27,-3.608122673674791,19
5238,88,36,1,19,-3.6124862498641357,17
5239,79,15,112,8,-3.621796379179409,7
5240,66,16,11,8,-3.6219882652506383,8
5241,28,26,80,14,-3.6230809501897747,12
5242,5,51,55,29,-3.628046191114139,22
5243,81,17,47,10,-3.6281046116933027,7
5244,12,17,63,8,-3.633804817129702,9
5245,70,10,14,5,-3.647042134114855,5
5246,23,13,9,7,-3.6475995665029,6
5247,98,16,114,9,-3.6481628146735163,7
5248,108,20,64,11,-3.648889859577028,9
5249,18,11,17,5,-3.651905683853183,6
5250,32,21,107,11,-3.65469777615246,10
5251,71,10,90,5,-3.6561036030201173,5
5252,31,24,39,14,-3.6610558433956157,10
5253,102,16,29,10,-3.6619328281849266,6
5254,85,20,28,11,-3.6675135147560156,9
5255,84,21,38,11,-3.6699802067032445,10
5256,51,72,54,40,-3.676698399835986,32
5257,28,19,23,10,-3.6970356039584327,9
5258,108,12,17,7,-3.6979659768897495,5
5259,108,15,29,8,-3.6991799646967554,7
5260,35,10,112,5,-3.704644012481239,5
5261,87,42,95,22,-3.706416281336595,20
5262,13,70,100,38,-3.7127466967472116,32
5263,64,21,1,11,-3.7140968256416436,10
5264,5,21,15,13,-3.7147342263498166,8
5265,16,31,81,17,-3.7185584556590716,14
5266,53,58,18,31,-3.7209254583124536,27
5267,86,40,91,22,-3.721705750823955,18
5268,107,69,30,40,-3.725108710079059,29
5269,40,13,15,7,-3.72557831166786,6
5270,5,31,90,18,-3.72922813011693,13
5271,50,19,15,11,-3.7318860586459177,8
5272,40,59,60,33,-3.7350164129782835,26
5273,19,46,29,27,-3.73519537853758,19
5274,4,13,1,8,-3.7360390878519705,5
5275,84,55,51,31,-3.742451182903001,24
5276,77,40,49,23,-3.742548604574207,17
5277,54,58,28,33,-3.742783353616919,25
5278,40,42,53,23,-3.7429391558119973,19
5279,76,37,50,18,-3.7437752407401983,19
5280,37,24,41,14,-3.745613017669992,10
5281,107,13,52,8,-3.7535584759825276,5
5282,48,25,30,15,-3.7536152956466697,10
5283,39,24,23,13,-3.7563346379913134,11
5284,17,14,102,8,-3.765627490194505,6
5285,86,59,60,33,-3.768079531420056,26
5286,9,27,55,16,-3.772633679119087,11
5287,17,21,87,12,-3.7733166042192905,9
5288,54,47,11,26,-3.773551493195308,21
5289,13,47,114,23,-3.7759149187311722,24
5290,18,21,43,10,-3.778052323806025,11
5291,93,10,7,5,-3.7802315490169547,5
5292,98,28,104,13,-3.783243181516934,15
5293,51,52,106,29,-3.7850976424308227,23
5294,54,29,25,16,-3.7885203565536667,13
5295,62,31,49,19,-3.7935990313469223,12
5296,39,11,6,6,-3.796620754703812,5
5297,46,24,114,14,-3.7986694418112292,10
5298,77,22,109,12,-3.8026109276114344,10
5299,11,49,13,28,-3.806959730236584,21
5300,86,86,74,46,-3.8093023861998665,40
5301,71,27,28,16,-3.8126316435493957,11
5302,5,16,110,9,-3.8138584796050905,7
5303,107,86,100,45,-3.8142681590797096,41
5304,91,28,5,17,-3.814625093066518,11
5305,51,40,114,21,-3.8167576032502195,19
5306,75,12,48,7,-3.8239435270874167,5
5307,3,11,4,6,-3.8250463920918425,5
5308,41,62,51,34,-3.8275571239739956,28
5309,12,11,111,5,-3.8360170890156358,6
5310,31,23,18,12,-3.8430258307678686,11
5311,50,22,41,13,-3.845767300582984,9
5312,76,39,28,21,-3.8485126894088935,18
5313,17,17,85,10,-3.8507511089593,7
5314,107,50,40,30,-3.8570605527160122,20
5315,28,54,20,30,-3.866248630000691,24
5316,80,16,90,10,-3.8670676152144083,6
5317,48,11,2,7,-3.8719596921161834,4
5318,107,102,13,57,-3.8758966963796313,45
5319,112,15,8,9,-3.8800170080974894,6
5320,49,11,102,7,-3.880578970933132,4
5321,57,12,6,7,-3.882176264826061,5
5322,19,19,8,11,-3.8866341483098394,8
5323,5,17,40,9,-3.8914877974226956,8
5324,3,81,87,46,-3.8919625985848327,35
5325,54,25,1,14,-3.8929886538978145,11
5326,47,12,62,7,-3.897508167665008,5
5327,19,24,64,15,-3.8978418754092083,9
5328,63,30,55,16,-3.900377194965691,14
5329,46,67,86,40,-3.9036534898053623,27
5330,48,14,23,8,-3.910408208571404,6
5331,64,29,75,16,-3.916000714039239,13
5332,46,53,51,30,-3.917943537235088,23
5333,47,28,11,16,-3.9192520826064863,12
5334,49,45,76,26,-3.921117611266529,19
5335,2,28,5,16,-3.923277825320164,12
5336,20,15,18,9,-3.9303607040253326,6
5337,76,22,84,12,-3.9389733435046645,10
5338,8,26,62,15,-3.942054503863254,11
5339,40,11,6,6,-3.944267868023087,5
5340,43,19,35,10,-3.946831407739412,9
5341,104,11,67,6,-3.9505697623954874,5
5342,91,15,9,8,-3.9508212932565088,7
5343,3,26,8,13,-3.9551370260288152,13
5344,37,23,40,12,-3.9558411724945217,11
5345,84,21,10,12,-3.960254602065843,9
5346,72,31,39,17,-3.9655121143943206,14
5347,94,11,84,6,-3.9681566657444405,5
5348,102,13,41,8,-3.968301975819481,5
5349,62,25,13,14,-3.96987023928499,11
5350,58,12,109,6,-3.974630375530721,6
5351,14,12,96,7,-3.975747798085742,5
5352,76,10,83,6,-3.979171756100496,4
5353,97,18,60,9,-3.9792005525226384,9
5354,38,41,107,24,-3.98352419957243,17
5355,55,35,80,18,-3.9840812801034198,17
5356,107,129,87,72,-3.991424357413359,57
5357,14,12,112,6,-3.9932359631148633,6
5358,35,30,107,18,-3.998158281702754,12
5359,112,16,31,10,-4.001730552260444,6
5360,86,25,89,13,-4.002412442274511,12
5361,77,18,5,10,-4.010067732208504,8
5362,110,20,8,12,-4.013172679497397,8
5363,109,34,76,21,-4.013784930537313,13
5364,19,25,28,15,-4.019180575644085,10
5365,79,14,29,9,-4.020689709966037,5
5366,15,15,66,8,-4.029084751033218,7
5367,57,34,30,21,-4.033172714117429,13
5368,57,23,60,13,-4.037432638780123,10
5369,114,41,63,26,-4.0379729890543565,15
5370,43,10,1,5,-4.038976715758714,5
5371,78,35,100,20,-4.03903391431079,15
5372,100,39,104,22,-4.040446439481137,17
5373,78,28,15,14,-4.041757900414731,14
5374,69,12,84,7,-4.046782427990892,5
5375,40,10,32,5,-4.050021677419865,5
5376,20,10,14,6,-4.05196683725804,4
5377,75,16,15,10,-4.056062954518072,6
5378,49,28,68,16,-4.061110376543601,12
5379,39,11,56,5,-4.061429150921741,6
5380,27,39,72,21,-4.063603110178614,18
5381,48,21,76,13,-4.063944654554619,8
5382,95,12,43,7,-4.065288768086308,5
5383,73,19,65,11,-4.067312461469671,8
5384,31,68,7,38,-4.069172309295861,30
5385,93,17,75,9,-4.069384641387427,8
5386,37,15,69,8,-4.071098728743587,7
5387,46,21,95,12,-4.071848693893571,9
5388,33,14,30,9,-4.072796165922766,5
5389,11,17,85,10,-4.074093197649269,7
5390,75,21,91,8,-4.084376386784757,13
5391,98,17,78,9,-4.084899624702052,8
5392,16,47,95,25,-4.085164151883546,22
5393,19,11,36,6,-4.08859021842168,5
5394,8,15,111,8,-4.091375789332371,7
5395,35,24,20,14,-4.0987287220029165,10
5396,93,20,83,11,-4.100880722204596,9
5397,51,48,75,26,-4.10605342104463,22
5398,63,30,97,17,-4.107378727934816,13
5399,55,17,108,10,-4.110943675956946,7
5400,51,20,85,11,-4.111259035742405,9
5401,2,12,7,7,-4.115660194227728,5
5402,87,14,42,8,-4.125698672116462,6
5403,50,15,83,7,-4.131296712002355,8
5404,106,51,107,28,-4.131711792879515,23
5405,20,11,71,7,-4.1364305573939655,4
5406,66,18,87,10,-4.140314373651453,8
5407,71,47,53,27,-4.141303557057989,20
5408,28,77,50,44,-4.143924434349461,33
5409,17,12,99,7,-4.148375833376952,5
5410,84,24,27,13,-4.156059221916358,11
5411,2,10,19,5,-4.15617878328422,5
5412,67,14,114,8,-4.157586764032949,6
5413,27,14,92,7,-4.157793062407015,7
5414,52,17,30,10,-4.158499353957514,7
5415,46,20,64,12,-4.163045047710226,8
5416,5,40,83,21,-4.163709904424498,19
5417,96,24,60,16,-4.164982345638217,8
5418,103,13,18,8,-4.1752141807255745,5
5419,46,28,60,16,-4.181848371447909,12
5420,25,27,23,15,-4.182190113226042,12
5421,43,11,93,6,-4.184906166012258,5
5422,97,15,39,9,-4.184940668998107,6
5423,93,15,29,8,-4.188724926111399,7
5424,34,25,29,13,-4.194433318367101,12
5425,23,57,107,31,-4.195631697148174,26
5426,36,56,65,32,-4.205692860728478,24
5427,20,21,17,12,-4.207666463256875,9
5428,48,10,52,6,-4.211289472665269,4
5429,84,19,43,10,-4.2146198508874155,9
5430,18,19,4,11,-4.220670692754496,8
5431,100,29,28,17,-4.221129674472951,12
5432,44,11,71,6,-4.223524348839454,5
5433,38,21,9,12,-4.2241565966881796,9
5434,46,12,48,7,-4.225391974153922,5
5435,89,17,43,9,-4.227307951626209,8
5436,11,29,48,17,-4.229170885335417,12
5437,62,20,30,11,-4.230291626453229,9
5438,87,31,71,17,-4.240167636343153,14
5439,71,44,16,26,-4.24180487871631,18
5440,69,53,16,31,-4.243264956504184,22
5441,34,14,106,7,-4.243674039664677,7
5442,69,42,13,24,-4.244765914439893,18
5443,70,13,100,7,-4.246698616682759,6
5444,38,14,71,9,-4.250425614356072,5
5445,60,28,76,17,-4.2507308281171925,11
5446,68,32,69,18,-4.253129950198648,14
5447,106,55,37,29,-4.262507559544696,26
5448,100,20,9,12,-4.263839107868786,8
5449,103,12,23,7,-4.270875329150464,5
5450,15,28,23,16,-4.277369019757658,12
5451,90,18,30,10,-4.2791469362412995,8
5452,65,51,74,28,-4.282390955650973,23
5453,69,22,50,11,-4.283220710932239,11
5454,78,32,68,18,-4.290052324917813,14
5455,49,54,30,31,-4.293465853324729,23
5456,55,45,37,24,-4.301001080588835,21
5457,53,27,106,14,-4.302319600135904,13
5458,104,64,86,36,-4.312979598799538,28
5459,17,23,97,13,-4.313428551304964,10
5460,65,61,8,34,-4.3149700472293935,27
5461,40,22,4,12,-4.316643149060886,10
5462,64,26,3,14,-4.321344224546426,12
5463,86,75,37,41,-4.327795117897229,34
5464,80,14,19,8,-4.32884820464931,6
5465,41,19,95,11,-4.33214397979218,8
5466,6,16,65,9,-4.346168811124804,7
5467,29,38,3,22,-4.355484274272842,16
5468,83,11,19,6,-4.35939819270106,5
5469,71,31,64,19,-4.3594731378011655,12
5470,23,20,95,11,-4.361896262769259,9
5471,88,32,47,18,-4.361953236186541,14
5472,70,17,49,9,-4.364791676107705,8
5473,9,15,74,9,-4.367415226980933,6
5474,23,23,40,13,-4.368423326803304,10
5475,88,103,86,58,-4.3729235653133225,45
5476,103,24,30,14,-4.3756528534434045,10
5477,25,33,87,18,-4.379098196808539,15
5478,29,20,54,12,-4.381395329954479,8
5479,16,39,97,21,-4.395866715554319,18
5480,65,26,90,13,-4.399856936469098,13
5481,5,35,76,20,-4.4006703577730075,15
5482,108,14,71,8,-4.402422140240555,6
5483,5,118,86,67,-4.4152564938780525,51
5484,53,64,7,36,-4.416213736910667,28
5485,70,30,84,17,-4.416286467774103,13
5486,49,54,27,31,-4.42001694183688,23
5487,3,33,11,19,-4.420072692894771,14
5488,49,14,108,8,-4.420404027662396,6
5489,13,30,99,17,-4.4209668288342625,13
5490,20,14,23,8,-4.427778675436007,6
5491,53,32,87,17,-4.429162896361546,15
5492,58,10,17,4,-4.43139506148379,6
5493,70,39,37,23,-4.433263990915908,16
5494,90,17,76,11,-4.433393911042904,6
5495,96,16,78,10,-4.433803384678501,6
5496,50,22,100,13,-4.4360869713147,9
5497,107,45,19,27,-4.439050926597956,18
5498,107,85,88,50,-4.442479980707134,35
5499,3,66,27,37,-4.4451646134952085,29
5500,49,18,94,11,-4.445619988851259,7
5501,97,11,77,7,-4.454901155383995,4
5502,85,14,19,8,-4.456802611003387,6
5503,49,11,96,6,-4.460220810874953,5
5504,54,15,79,9,-4.4628144491387465,6
5505,109,24,69,14,-4.462898820440797,10
5506,57,16,85,9,-4.462920901490054,7
5507,34,30,100,16,-4.464826340973108,14
5508,32,18,37,10,-4.466542082918523,8
5509,37,23,39,13,-4.467775271301241,10
5510,18,20,49,13,-4.468014752855383,7
5511,94,11,108,6,-4.472725388082187,5
5512,25,31,96,17,-4.472832877552796,14
5513,112,20,77,10,-4.47496776364262,10
5514,64,46,7,25,-4.481240056988838,21
5515,71,44,75,27,-4.485645835804011,17
5516,7,109,16,61,-4.487436298549421,48
5517,49,32,78,17,-4.488412556658531,15
5518,89,23,13,14,-4.495493504352196,9
5519,46,10,108,7,-4.49601960881211,3
5520,70,13,15,6,-4.5014544457963614,7
5521,43,40,39,22,-4.510508397787332,18
5522,96,10,57,5,-4.51150966917618,5
5523,54,64,63,37,-4.513765725874225,27
5524,112,18,49,10,-4.51791122222607,8
5525,50,23,74,13,-4.520207268757789,10
5526,15,20,89,11,-4.523922474853296,9
5527,48,19,57,11,-4.524936793492176,8
5528,28,44,55,26,-4.526943972884062,18
5529,75,23,106,12,-4.532198108241352,11
5530,3,64,16,38,-4.533666295550079,26
5531,28,29,93,18,-4.540056078542574,11
5532,11,22,77,12,-4.543733506971011,10
5533,15,18,99,11,-4.551461310618722,7
5534,46,15,83,8,-4.551826612706295,7
5535,51,45,77,24,-4.553150425754021,21
5536,23,15,70,8,-4.554568026577774,7
5537,5,18,43,10,-4.559277543830877,8
5538,57,37,19,20,-4.559363107017673,17
5539,104,16,99,8,-4.5627492392393005,8
5540,114,43,60,21,-4.570942388181802,22
5541,95,14,99,8,-4.572737764013049,6
5542,58,23,7,12,-4.5750345256693405,11
5543,65,16,99,9,-4.579704538683155,7
5544,37,15,9,8,-4.590013554185221,7
5545,38,15,108,9,-4.591465457156278,6
5546,65,117,16,66,-4.591775644110769,51
5547,96,32,50,18,-4.592653394244438,14
5548,18,22,100,12,-4.596212969192917,10
5549,107,60,41,37,-4.597389180870248,23
5550,39,18,80,10,-4.600479594629686,8
5551,96,21,13,12,-4.608058597276484,9
5552,37,40,75,25,-4.608119905928107,15
5553,17,21,103,13,-4.6092642227895295,8
5554,57,11,74,6,-4.613445177041247,5
5555,68,20,85,13,-4.615895850726343,7
5556,40,10,72,6,-4.616108231770903,4
5557,100,94,16,54,-4.621171653003923,40
5558,19,41,51,25,-4.631222093494112,16
5559,91,16,102,9,-4.632859199025976,7
5560,110,15,106,8,-4.633960085739292,7
5561,49,32,17,16,-4.635564491950155,16
5562,25,22,60,12,-4.63628280649392,10
5563,69,11,80,6,-4.638884395252672,5
5564,11,39,72,22,-4.645432567168801,17
5565,58,17,12,10,-4.645880660678283,7
5566,96,39,63,24,-4.649023449526143,15
5567,1,16,15,10,-4.649350840919031,6
5568,79,13,27,7,-4.651583262533679,6
5569,47,15,25,8,-4.655390231832651,7
5570,50,48,104,28,-4.65583203026361,20
5571,60,19,61,10,-4.6560260564335465,9
5572,72,43,86,25,-4.662359318084506,18
5573,98,26,11,14,-4.667493378770945,12
5574,92,10,75,6,-4.670779177266829,4
5575,8,24,12,14,-4.676848682458997,10
5576,3,25,109,14,-4.677062907217811,11
5577,39,51,40,30,-4.685059105758994,21
5578,15,18,28,10,-4.685699256091646,8
5579,38,32,88,20,-4.688975834537393,12
5580,106,13,111,9,-4.703726078810505,4
5581,107,34,98,19,-4.703806209041121,15
5582,81,18,4,11,-4.707056678124466,7
5583,46,23,20,15,-4.708713070266477,8
5584,88,21,58,12,-4.71148188889534,9
5585,31,32,75,17,-4.72198275034643,15
5586,108,13,25,8,-4.727424255422313,5
5587,54,29,93,18,-4.739093565612781,11
5588,77,16,25,9,-4.745845616411634,7
5589,20,13,62,8,-4.7489453833796285,5
5590,50,23,7,13,-4.754905099968972,10
5591,46,69,13,41,-4.756415151860815,28
5592,60,21,72,12,-4.758851391736088,9
5593,62,14,106,8,-4.759729251582842,6
5594,84,28,13,17,-4.762106527456084,11
5595,108,20,30,12,-4.765041003995,8
5596,65,71,30,41,-4.766897212102787,30
5597,98,15,18,7,-4.76828904567196,8
5598,31,15,12,8,-4.7706324645211815,7
5599,70,13,90,7,-4.771084444295364,6
5600,23,14,33,8,-4.772846471482117,6
5601,98,21,70,13,-4.776806059512888,8
5602,5,12,9,7,-4.777710715122406,5
5603,45,10,47,6,-4.780410761983769,4
5604,81,20,41,12,-4.785164896950242,8
5605,78,53,86,29,-4.786494656983798,24
5606,10,12,5,6,-4.788462999241516,6
5607,20,13,52,8,-4.795236183864798,5
5608,65,89,104,50,-4.796826488170186,39
5609,25,11,111,6,-4.797175922879401,5
5610,97,22,41,12,-4.799957538599525,10
5611,86,21,66,12,-4.801113262592311,9
5612,96,22,75,15,-4.801381492311929,7
5613,12,16,1,9,-4.804302234326604,7
5614,68,14,89,8,-4.8060770512882325,6
5615,54,47,13,27,-4.808693475353388,20
5616,20,11,77,6,-4.80957078979778,5
5617,63,34,104,19,-4.811269466320188,15
5618,79,23,13,14,-4.81127521378253,9
5619,85,11,74,6,-4.8123880044938,5
5620,64,20,12,12,-4.814047437556217,8
5621,54,15,14,10,-4.820525855929134,5
5622,25,19,31,10,-4.823839301099769,9
5623,15,21,114,12,-4.8260102326414716,9
5624,57,49,87,28,-4.830115478356606,21
5625,67,15,8,9,-4.831909846155587,6
5626,87,80,100,44,-4.83532662259934,36
5627,100,17,47,10,-4.8376341354753,7
5628,96,22,39,14,-4.8469385601006945,8
5629,32,12,97,7,-4.851459349576825,5
5630,42,12,72,7,-4.857673633217596,5
5631,112,31,100,17,-4.858414274039207,14
5632,50,57,16,34,-4.86155743044365,23
5633,89,10,5,7,-4.8624656409017435,3
5634,1,11,29,7,-4.866934575588786,4
5635,30,30,18,17,-4.868176896140198,13
5636,94,12,20,7,-4.86985523364522,5
5637,57,26,88,14,-4.87081224887015,12
5638,98,26,13,16,-4.873807977215298,10
5639,35,14,3,8,-4.8776341750711,6
5640,62,39,86,22,-4.879705109009967,17
5641,97,29,87,18,-4.880674129028665,11
5642,79,20,63,12,-4.882182316485546,8
5643,95,11,69,7,-4.882909765417964,4
5644,17,19,23,11,-4.884057347144711,8
5645,18,12,94,7,-4.884425557504233,5
5646,101,10,39,6,-4.889741278103361,4
5647,34,24,12,14,-4.890002445691241,10
5648,68,30,47,17,-4.897107609370838,13
5649,28,12,38,6,-4.907164394244709,6
5650,77,11,48,7,-4.913344813951473,4
5651,109,16,95,10,-4.92318353619376,6
5652,106,56,74,32,-4.924754963776781,24
5653,63,17,108,10,-4.925158043652064,7
5654,36,40,86,23,-4.92743325124,17
5655,85,17,63,9,-4.93137224468223,8
5656,77,38,30,22,-4.936309113355669,16
5657,71,11,49,6,-4.9409457894604065,5
5658,32,14,28,8,-4.942148577857081,6
5659,78,15,40,10,-4.942465399220725,5
5660,41,17,38,9,-4.943011461235353,8
5661,106,29,80,17,-4.946009667025367,12
5662,109,48,88,29,-4.946124278822101,19
5663,68,19,56,10,-4.94813216675333,9
5664,47,32,7,19,-4.949472292851426,13
5665,89,10,77,5,-4.9496005024045315,5
5666,3,26,114,16,-4.9544765393283035,10
5667,64,16,62,8,-4.958930096475884,8
5668,90,23,96,14,-4.963939687748074,9
5669,114,21,27,12,-4.967571693509976,9
5670,23,11,98,6,-4.969965161139004,5
5671,13,44,12,29,-4.971947648890687,15
5672,3,13,106,8,-4.972676967703687,5
5673,44,10,80,5,-4.973541413806903,5
5674,65,30,70,19,-4.973765781446556,11
5675,17,53,16,33,-4.978051363186692,20
5676,114,14,77,7,-4.98692140299295,7
5677,94,19,63,11,-4.988953899876627,8
5678,29,16,70,8,-4.990481050245632,8
5679,31,23,50,13,-4.991999785997779,10
5680,86,49,64,28,-4.9985725036175035,21
5681,96,23,51,13,-5.001175453325252,10
5682,58,21,49,11,-5.003014201039977,10
5683,106,41,7,21,-5.003800212982271,20
5684,5,26,93,16,-5.004460526821323,10
5685,83,13,102,8,-5.005327574584489,5
5686,94,17,112,11,-5.010192110959226,6
5687,63,12,93,7,-5.011120266810433,5
5688,18,19,55,10,-5.012210431301632,9
5689,8,111,16,65,-5.024155840812807,46
5690,38,29,60,17,-5.02789537902732,12
5691,109,34,41,21,-5.028182630199461,13
5692,15,16,34,10,-5.028728127473961,6
5693,34,12,112,7,-5.029259987635679,5
5694,60,38,49,22,-5.030495378918765,16
5695,93,26,74,14,-5.031462008142044,12
5696,74,24,100,14,-5.032874442379239,10
5697,91,16,40,9,-5.034652795604084,7
5698,2,23,20,13,-5.04811788923968,10
5699,75,20,95,12,-5.050260152484929,8
5700,103,27,13,17,-5.050931612605477,10
5701,17,12,12,7,-5.051854355123881,5
5702,19,45,78,27,-5.052434315983816,18
5703,77,27,78,15,-5.057692528495698,12
5704,10,16,7,9,-5.060407065651965,7
5705,27,56,100,32,-5.080984098773694,24
5706,20,10,32,7,-5.082163415292113,3
5707,5,15,34,10,-5.091205514677906,5
5708,88,55,11,33,-5.1065190461811305,22
5709,1,10,30,6,-5.107240382060614,4
5710,109,26,100,16,-5.10858993216532,10
5711,19,34,72,20,-5.112933716380972,14
5712,15,47,100,27,-5.123121997282324,20
5713,16,96,30,58,-5.128993944452904,38
5714,98,16,3,8,-5.13085374180897,8
5715,33,14,64,9,-5.132334361355243,5
5716,58,30,40,16,-5.133397385337805,14
5717,3,21,36,13,-5.136055944816982,8
5718,38,23,109,15,-5.136953889041774,8
5719,71,15,70,8,-5.140933357571855,7
5720,70,17,13,10,-5.142156998200086,7
5721,38,17,80,9,-5.143241338130117,8
5722,112,18,18,11,-5.1443366650763,7
5723,51,51,78,27,-5.146999984101788,24
5724,97,13,11,7,-5.1491543911628765,6
5725,9,24,106,14,-5.150083731218857,10
5726,28,16,35,8,-5.153123660542294,8
5727,46,14,38,9,-5.157148141301116,5
5728,30,16,47,8,-5.159042864029296,8
5729,5,12,67,7,-5.159840528973079,5
5730,86,16,6,10,-5.164261408107595,6
5731,96,29,65,16,-5.165027076154164,13
5732,54,11,31,6,-5.168002033532433,5
5733,94,15,77,9,-5.169474708107542,6
5734,32,19,11,10,-5.169600921182679,9
5735,81,40,86,26,-5.171821026076151,14
5736,112,14,74,8,-5.173073586151801,6
5737,54,19,91,10,-5.179574587066859,9
5738,48,12,91,6,-5.179665478095682,6
5739,97,17,75,10,-5.1834390154874335,7
5740,86,64,49,36,-5.183923708261802,28
5741,71,10,6,6,-5.193692278292731,4
5742,113,13,40,8,-5.1937263926866155,5
5743,80,18,104,10,-5.194103195079235,8
5744,39,25,46,12,-5.196853389468726,13
5745,57,35,8,21,-5.208160025736119,14
5746,86,20,10,11,-5.2191524654968555,9
5747,88,101,7,58,-5.220134457500585,43
5748,106,54,54,29,-5.222938310920246,25
5749,35,26,11,15,-5.223790778296071,11
5750,39,23,92,12,-5.223931097826435,11
5751,5,11,35,6,-5.226534281744123,5
5752,57,12,17,8,-5.228708389418875,4
5753,103,22,78,15,-5.22979498937837,7
5754,107,60,75,39,-5.231874163862644,21
5755,76,15,44,9,-5.232736844369689,6
5756,25,21,91,12,-5.236778929543696,9
5757,109,20,72,12,-5.237390001234544,8
5758,77,29,19,16,-5.239565380734289,13
5759,40,26,25,15,-5.242222631716464,11
5760,12,20,98,12,-5.2458423308532485,8
5761,53,38,16,23,-5.24868442383076,15
5762,49,28,41,16,-5.249338337674644,12
5763,77,39,39,22,-5.251215890680743,17
5764,31,11,35,6,-5.255104723881266,5
5765,33,18,68,11,-5.257015515736626,7
5766,65,40,43,22,-5.257826362134877,18
5767,1,11,34,8,-5.259854618241466,3
5768,69,17,103,9,-5.270007364936181,8
5769,43,23,34,13,-5.271948745922039,10
5770,6,20,88,12,-5.272285617199486,8
5771,17,19,41,12,-5.273986417758153,7
5772,77,11,108,7,-5.283240563660734,4
5773,92,12,28,8,-5.284547759707863,4
5774,86,21,99,13,-5.291638236148404,8
5775,3,11,89,6,-5.295815593088658,5
5776,37,26,57,15,-5.296608425452367,11
5777,23,10,78,6,-5.303068144131312,4
5778,87,19,73,13,-5.303982369774458,6
5779,63,25,46,13,-5.304512093520618,12
5780,86,38,34,22,-5.308774927674139,16
5781,23,26,63,16,-5.3090102841563285,10
5782,3,40,7,24,-5.315954351050264,16
5783,72,21,50,13,-5.318024007082145,8
5784,48,25,39,16,-5.326525646398726,9
5785,51,33,62,19,-5.327533238316313,14
5786,64,21,83,12,-5.328824418011839,9
5787,51,33,5,21,-5.328986421528186,12
5788,55,25,34,14,-5.330528309819539,11
5789,102,14,97,9,-5.335160623731833,5
5790,90,37,54,22,-5.340914168653277,15
5791,50,18,78,11,-5.342630350789609,7
5792,98,18,20,11,-5.352741331858431,7
5793,97,27,55,16,-5.353622513986461,11
5794,97,35,7,19,-5.356987360153852,16
5795,87,16,26,9,-5.357273241874729,7
5796,12,13,20,7,-5.360426970680715,6
5797,81,32,15,18,-5.361832492910932,14
5798,39,36,84,20,-5.36967448681498,16
5799,18,25,15,15,-5.370261713586335,10
5800,30,15,98,8,-5.370529040661888,7
5801,58,32,16,18,-5.387307163471736,14
5802,106,14,6,8,-5.390411966564588,6
5803,74,20,34,13,-5.390554150511844,7
5804,69,31,78,18,-5.391180111823998,13
5805,51,53,17,29,-5.396332747607756,24
5806,33,20,8,12,-5.397787705463005,8
5807,76,29,112,16,-5.403769892160428,13
5808,58,11,4,7,-5.405037105567137,4
5809,81,14,78,7,-5.405603948540432,7
5810,34,21,9,12,-5.406001466575153,9
5811,94,32,30,18,-5.413124377396745,14
5812,86,28,47,17,-5.4138737100947205,11
5813,106,26,2,15,-5.41401262665605,11
5814,58,10,23,6,-5.417812881789321,4
5815,25,38,104,21,-5.422383455319622,17
5816,63,30,57,16,-5.4237588746313765,14
5817,3,44,12,27,-5.423827966019925,17
5818,72,15,20,9,-5.433880871316618,6
5819,68,29,71,18,-5.43565333686224,11
5820,88,88,54,52,-5.435654938222569,36
5821,11,55,51,34,-5.443782340904028,21
5822,13,14,52,8,-5.444984627732146,6
5823,49,34,54,20,-5.449189781331788,14
5824,47,13,54,7,-5.460215589598553,6
5825,50,13,57,8,-5.460704285123109,5
5826,74,13,31,8,-5.4682993706513905,5
5827,17,31,28,18,-5.468605078583842,13
5828,60,17,98,10,-5.471299685170585,7
5829,17,22,72,13,-5.472151820286163,9
5830,25,22,100,12,-5.476003695191376,10
5831,55,27,111,16,-5.492663797248299,11
5832,52,12,50,6,-5.49564209413134,6
5833,102,10,67,6,-5.497246561771854,4
5834,37,69,87,40,-5.500923627593116,29
5835,111,10,5,6,-5.501968622126494,4
5836,40,13,2,8,-5.504797437287728,5
5837,41,51,87,29,-5.506817320713419,22
5838,19,30,62,19,-5.507911360624397,11
5839,49,26,64,16,-5.508050470931367,10
5840,109,13,32,7,-5.508051897308614,6
5841,83,19,95,12,-5.510188596504651,7
5842,65,23,45,12,-5.510611418282088,11
5843,77,25,15,15,-5.5117176973275805,10
5844,89,10,17,6,-5.511777751894211,4
5845,86,52,43,30,-5.516052651464388,22
5846,84,10,89,5,-5.518590211576736,5
5847,48,24,13,14,-5.520624456307564,10
5848,13,35,58,22,-5.535900844279715,13
5849,85,11,8,7,-5.538404103047143,4
5850,102,14,15,9,-5.539976966220618,5
5851,70,11,44,6,-5.543204446478318,5
5852,75,42,18,24,-5.546579166688548,18
5853,84,18,25,11,-5.546687618128967,7
5854,31,53,36,30,-5.548564460468655,23
5855,25,41,8,25,-5.550067480025429,16
5856,57,16,12,10,-5.552040542138188,6
5857,54,16,69,9,-5.552096999235808,7
5858,46,44,8,24,-5.55305372609631,20
5859,107,42,48,24,-5.555372120517398,18
5860,4,11,46,6,-5.556221874645653,5
5861,95,30,13,17,-5.5569838085167085,13
5862,57,11,18,7,-5.557171046422164,4
5863,95,10,31,6,-5.5581891593402775,4
5864,108,14,37,8,-5.561998311446509,6
5865,9,11,72,6,-5.567587328744072,5
5866,11,20,75,11,-5.5687574810371485,9
5867,38,23,7,13,-5.5754388810337625,10
5868,44,22,20,13,-5.576158683247873,9
5869,96,38,20,23,-5.591064360306497,15
5870,64,17,80,9,-5.593698551425533,8
5871,112,23,3,12,-5.594463947840817,11
5872,102,21,30,11,-5.601838212614089,10
5873,49,60,87,33,-5.602602853303667,27
5874,85,15,55,9,-5.607159089440444,6
5875,68,41,76,27,-5.614845988196357,14
5876,61,17,86,10,-5.615128594276013,7
5877,98,16,102,9,-5.616900846312716,7
5878,91,26,68,14,-5.619466372772095,12
5879,5,10,19,6,-5.623378775596125,4
5880,37,27,98,16,-5.623553949033444,11
5881,19,34,13,21,-5.623798963395328,13
5882,62,11,83,7,-5.627185885075068,4
5883,87,48,48,30,-5.631302033442318,18
5884,46,16,109,9,-5.636528034552761,7
5885,104,18,62,12,-5.643310295152116,6
5886,3,42,30,27,-5.646158452665143,15
5887,97,10,4,6,-5.649870700339141,4
5888,86,18,45,11,-5.65286827981522,7
5889,75,31,46,18,-5.654705399493309,13
5890,2,13,30,7,-5.655225265692612,6
5891,41,34,64,21,-5.6565010143759125,13
5892,88,36,25,23,-5.660869431868404,13
5893,84,37,16,22,-5.660913981238356,15
5894,82,11,54,7,-5.664278302313933,4
5895,38,10,23,6,-5.6654185371586925,4
5896,99,31,16,18,-5.665818337043018,13
5897,25,10,94,5,-5.671887186214522,5
5898,51,80,100,43,-5.672256402276974,37
5899,48,21,27,13,-5.686731307091653,8
5900,40,21,35,13,-5.68914021357686,8
5901,32,10,70,5,-5.69247937209622,5
5902,103,34,27,21,-5.6990103299143655,13
5903,107,144,16,89,-5.7022938024931324,55
5904,43,22,64,13,-5.702442528376269,9
5905,48,16,69,9,-5.7047999540187995,7
5906,74,13,15,8,-5.7106976006271415,5
5907,55,31,109,16,-5.712408791206378,15
5908,12,16,69,8,-5.715951067980106,8
5909,52,10,39,6,-5.718885643095016,4
5910,53,16,57,9,-5.72448039751102,7
5911,51,26,25,15,-5.726135112848953,11
5912,9,14,45,9,-5.7278535004589894,5
5913,54,40,55,22,-5.729162102948166,18
5914,109,10,80,5,-5.736195162181013,5
5915,106,42,25,26,-5.737688222420903,16
5916,60,24,17,14,-5.742654989357156,10
5917,114,25,100,15,-5.743860264273012,10
5918,18,25,50,14,-5.74537053291684,11
5919,51,113,39,66,-5.746736829097245,47
5920,20,64,107,37,-5.747310682281413,27
5921,77,12,36,7,-5.751140829309575,5
5922,12,12,47,7,-5.753232192548286,5
5923,107,40,58,25,-5.758436887559522,15
5924,72,18,89,11,-5.758501533202007,7
5925,2,16,76,10,-5.758955323935481,6
5926,86,53,41,33,-5.761468508013489,20
5927,49,21,89,12,-5.761917678895315,9
5928,29,28,51,16,-5.7638840206812985,12
5929,52,11,51,6,-5.770255561533728,5
5930,109,16,62,8,-5.770362238431113,8
5931,19,39,11,24,-5.773505801410168,15
5932,87,64,43,38,-5.778539687252324,26
5933,91,11,64,7,-5.780157364605295,4
5934,81,16,104,8,-5.786821230718971,8
5935,86,83,100,47,-5.78783839779332,36
5936,9,21,17,12,-5.788074839959892,9
5937,107,48,76,31,-5.789796382951222,17
5938,30,29,50,17,-5.790909551112376,12
5939,43,29,69,17,-5.793217873056412,12
5940,31,19,91,12,-5.801858258461764,7
5941,106,11,10,8,-5.803672894932926,3
5942,98,19,8,12,-5.806615359942181,7
5943,109,20,73,12,-5.807578339260897,8
5944,20,13,79,8,-5.810117746469003,5
5945,45,13,112,7,-5.822653512724091,6
5946,93,37,8,21,-5.824171473230354,16
5947,25,49,13,27,-5.82760144771215,22
5948,88,48,23,30,-5.836406273695646,18
5949,13,40,63,23,-5.83698160270361,17
5950,66,13,88,8,-5.8387523732132625,5
5951,93,23,16,12,-5.842811946264205,11
5952,74,11,49,6,-5.844136641014432,5
5953,55,28,100,15,-5.848018543019886,13
5954,3,39,65,24,-5.850081377266889,15
5955,14,17,65,9,-5.850273562995321,8
5956,79,12,80,6,-5.851472407179259,6
5957,87,50,23,30,-5.853226854544745,20
5958,112,21,7,13,-5.863389950487477,8
5959,7,17,34,10,-5.863504951401842,7
5960,77,28,107,16,-5.863901908728823,12
5961,103,41,86,25,-5.865642774610811,16
5962,53,54,68,32,-5.8668125784316985,22
5963,98,18,55,11,-5.870446924304781,7
5964,31,12,28,7,-5.876337878232255,5
5965,19,27,41,17,-5.880218602490824,10
5966,15,31,8,17,-5.881893034376993,14
5967,36,12,46,7,-5.882094180819337,5
5968,74,22,102,13,-5.882481039476397,9
5969,108,17,75,10,-5.885506345854971,7
5970,57,15,10,10,-5.887280827061498,5
5971,3,11,37,6,-5.889738338475403,5
5972,40,52,65,30,-5.891062339928423,22
5973,68,15,101,10,-5.891939886749792,5
5974,43,22,63,13,-5.892809401856746,9
5975,9,45,75,27,-5.89399328159944,18
5976,22,18,34,11,-5.906850849031522,7
5977,103,20,109,11,-5.911371119054858,9
5978,20,51,65,32,-5.9122074355427685,19
5979,78,55,27,35,-5.9136640972441805,20
5980,110,22,37,12,-5.913666685850415,10
5981,68,39,54,24,-5.918584354683417,15
5982,7,23,78,12,-5.919551023484507,11
5983,114,20,73,12,-5.924435121305102,8
5984,38,20,8,12,-5.935271782387747,8
5985,104,26,53,15,-5.936620222245529,11
5986,39,113,16,65,-5.944915401569531,48
5987,53,15,28,9,-5.94574436463327,6
5988,81,19,114,10,-5.947687005963305,9
5989,10,12,97,6,-5.9508315819177,6
5990,3,26,81,16,-5.95298398831459,10
5991,40,18,97,11,-5.9669184161403885,7
5992,76,73,86,42,-5.973230883413954,31
5993,94,18,114,10,-5.974081788881618,8
5994,18,20,64,12,-5.974775055211903,8
5995,77,19,53,11,-5.976513729958847,8
5996,3,58,39,32,-5.976819773807988,26
5997,109,13,71,8,-5.977466642753509,5
5998,37,17,94,10,-5.9815536162143665,7
5999,18,11,108,7,-5.985584696812657,4
6000,46,10,94,6,-5.990564025353785,4
6001,31,25,114,14,-5.991876520395491,11
6002,29,18,28,10,-5.99194760387537,8
6003,64,30,30,18,-5.9999514079123175,12
6004,54,21,94,12,-6.000772945562414,9
6005,5,47,106,29,-6.005839560090041,18
6006,9,51,65,31,-6.006217714596816,20
6007,37,39,13,23,-6.006726113746223,16
6008,64,53,13,29,-6.008172175580099,24
6009,104,69,107,41,-6.010771127855346,28
6010,13,50,81,31,-6.016435190824957,19
6011,94,38,27,23,-6.017224957482415,15
6012,89,33,51,20,-6.020451115628474,13
6013,8,51,109,29,-6.024347890240435,22
6014,65,58,27,35,-6.029901089038054,23
6015,68,10,26,6,-6.030745942778485,4
6016,98,24,7,15,-6.033686003781979,9
6017,57,28,103,17,-6.035618973069869,11
6018,55,41,104,24,-6.036207114699969,17
6019,63,62,8,35,-6.040704829296192,27
6020,87,29,58,17,-6.043606512163315,12
6021,86,39,69,23,-6.048519108301492,16
6022,2,24,16,14,-6.05202408295115,10
6023,28,22,41,13,-6.053005216366935,9
6024,60,50,55,29,-6.053838967638277,21
6025,57,15,77,9,-6.055395238374117,6
6026,84,22,98,14,-6.061006275589921,8
6027,30,30,34,18,-6.063291205291665,12
6028,86,64,27,39,-6.065009426524368,25
6029,102,13,23,7,-6.080684731147932,6
6030,84,26,9,15,-6.089357364465301,11
6031,108,14,96,8,-6.092516088942799,6
6032,102,40,65,25,-6.0925942120518926,15
6033,3,19,54,11,-6.093256445559035,8
6034,88,79,65,50,-6.09630023603755,29
6035,69,16,62,9,-6.098141811871047,7
6036,15,12,84,7,-6.098921486728437,5
6037,51,131,86,73,-6.101112922488334,58
6038,7,12,90,7,-6.108519045195328,5
6039,48,13,10,8,-6.11091450287738,5
6040,87,17,45,10,-6.1133681568734355,7
6041,66,24,107,14,-6.11591039623151,10
6042,31,13,81,9,-6.117159791325402,4
6043,53,50,107,30,-6.123597161626503,20
6044,48,17,29,10,-6.127198243730572,7
6045,38,33,39,20,-6.133899975611791,13
6046,12,10,37,5,-6.145364992278579,5
6047,43,15,23,9,-6.148918923918837,6
6048,48,41,86,25,-6.14934371852551,16
6049,74,24,73,15,-6.15033234594065,9
6050,68,48,114,28,-6.151577271829131,20
6051,100,26,23,15,-6.1602001909122555,11
6052,28,58,104,34,-6.1611678298334525,24
6053,75,57,86,32,-6.1651213258814614,25
6054,36,47,13,29,-6.167141158071527,18
6055,93,10,80,5,-6.175234905241022,5
6056,114,15,72,8,-6.1771914592363135,7
6057,28,17,47,10,-6.182374184386464,7
6058,65,14,91,8,-6.182830226758147,6
6059,40,73,13,42,-6.184837754544506,31
6060,9,46,87,27,-6.192350375466503,19
6061,62,10,103,5,-6.198701506316608,5
6062,68,38,11,22,-6.199112684088249,16
6063,2,28,63,16,-6.200018491851488,12
6064,70,28,74,15,-6.203999405338757,13
6065,71,30,50,17,-6.204695227712774,13
6066,88,26,108,16,-6.206778138596414,10
6067,84,15,35,9,-6.209299301194261,6
6068,87,70,68,42,-6.212080199922706,28
6069,70,24,114,15,-6.214622620602995,9
6070,70,37,28,22,-6.2149266559981875,15
6071,58,14,55,8,-6.218287556947674,6
6072,100,15,53,9,-6.219411389232117,6
6073,94,10,95,5,-6.229015093991729,5
6074,5,48,114,28,-6.237633533478719,20
6075,63,49,37,30,-6.239339617220504,19
6076,15,38,43,23,-6.241732052980609,15
6077,51,53,104,34,-6.249711889194555,19
6078,83,18,39,11,-6.2510896629152946,7
6079,81,24,39,15,-6.2522820107309345,9
6080,87,97,13,60,-6.252442161567486,37
6081,76,31,13,19,-6.256958483118661,12
6082,55,65,107,38,-6.262965189618901,27
6083,95,12,15,7,-6.265255655621165,5
6084,53,15,89,8,-6.26765697101517,7
6085,87,46,89,28,-6.26940067962685,18
6086,5,45,20,28,-6.270373633442779,17
6087,70,24,55,14,-6.2726471619319275,10
6088,49,28,34,16,-6.274930419182151,12
6089,4,21,86,13,-6.279484499549702,8
6090,18,25,3,16,-6.280006323256652,9
6091,4,15,12,10,-6.285579029533404,5
6092,68,68,40,42,-6.288399173895761,26
6093,40,17,92,10,-6.290833711086854,7
6094,84,18,100,12,-6.292769168431846,6
6095,53,14,58,7,-6.29343075549442,7
6096,102,36,28,21,-6.294379170221608,15
6097,91,46,16,30,-6.299398907548496,16
6098,3,37,19,21,-6.306652908739438,16
6099,8,32,78,19,-6.307058841419962,13
6100,88,51,63,32,-6.3108086639374505,19
6101,103,29,107,17,-6.31329391568841,12
6102,95,37,54,21,-6.333392985225777,16
6103,7,34,28,21,-6.339260574445828,13
6104,91,16,15,8,-6.341064031534599,8
6105,9,43,28,24,-6.342362216975378,19
6106,20,61,87,36,-6.343811823202865,25
6107,96,17,85,12,-6.345069391274803,5
6108,77,14,46,8,-6.346489877085672,6
6109,46,24,7,16,-6.3620461131037525,8
6110,37,10,56,6,-6.367440662879469,4
6111,102,15,33,9,-6.371524301983967,6
6112,27,16,28,11,-6.382931621067466,5
6113,47,32,107,19,-6.388799131361192,13
6114,96,13,33,6,-6.392035038140804,7
6115,49,12,79,8,-6.395374558799645,4
6116,103,19,43,12,-6.396904626354191,7
6117,62,18,53,11,-6.398470883121981,7
6118,37,20,80,12,-6.401050818487375,8
6119,55,21,48,13,-6.406579400537664,8
6120,72,11,6,6,-6.413604067518455,5
6121,65,38,64,22,-6.415105269042927,16
6122,62,20,7,12,-6.416308867276496,8
6123,63,33,64,19,-6.416872486726011,14
6124,23,10,61,6,-6.419517618014349,4
6125,48,28,84,17,-6.421668889523295,11
6126,98,21,108,12,-6.422836015811619,9
6127,80,23,96,14,-6.423400971659432,9
6128,57,30,69,19,-6.426659822386943,11
6129,100,21,75,11,-6.42687784088126,10
6130,87,142,16,84,-6.429838826720223,58
6131,79,12,39,8,-6.437313974618903,4
6132,112,17,104,10,-6.449220165667966,7
6133,91,20,8,12,-6.453847873736635,8
6134,10,15,11,9,-6.454288934219355,6
6135,109,36,43,23,-6.458161765145547,13
6136,54,34,100,21,-6.462414430425207,13
6137,68,11,98,7,-6.46992769597506,4
6138,109,47,11,29,-6.476747446179234,18
6139,45,17,41,11,-6.481894211723941,6
6140,97,56,86,33,-6.486588721597318,23
6141,50,35,60,19,-6.502388433089166,16
6142,100,13,20,8,-6.50325522303495,5
6143,55,29,74,17,-6.503619546467792,12
6144,65,66,55,39,-6.5120252706716855,27
6145,38,30,37,18,-6.5188975255259205,12
6146,87,84,8,50,-6.5237413470610806,34
6147,64,16,44,10,-6.52641817446092,6
6148,19,18,104,11,-6.528809563809233,7
6149,38,12,102,9,-6.529266346603467,3
6150,30,20,17,11,-6.529732326409054,9
6151,80,13,91,8,-6.531108694088667,5
6152,51,46,15,27,-6.5361142516646185,19
6153,65,29,72,17,-6.536977853075842,12
6154,15,33,29,19,-6.541368078183928,14
6155,107,12,26,7,-6.545382512387971,5
6156,23,32,106,17,-6.549055396089183,15
6157,41,28,23,17,-6.550829980754915,11
6158,7,33,100,20,-6.554112823226253,13
6159,30,15,112,10,-6.562692428407155,5
6160,63,31,75,18,-6.570041946714361,13
6161,114,26,53,15,-6.571088082289223,11
6162,8,38,34,23,-6.573808773415803,15
6163,17,41,86,23,-6.574590310379946,18
6164,51,57,76,36,-6.576315704894317,21
6165,57,28,84,15,-6.577348977317856,13
6166,101,11,27,7,-6.582303845846215,4
6167,73,29,86,16,-6.584732384148774,13
6168,30,14,74,8,-6.5938045244110794,6
6169,109,23,50,14,-6.59737646890257,9
6170,13,16,73,10,-6.598047492921338,6
6171,22,13,60,8,-6.601421861223266,5
6172,13,52,71,30,-6.60226683262218,22
6173,63,67,51,38,-6.6137098066072575,29
6174,64,49,16,30,-6.621781791045984,19
6175,5,48,25,29,-6.626414170343123,19
6176,68,26,62,15,-6.635005761261159,11
6177,65,30,4,18,-6.635600395573754,12
6178,71,16,74,9,-6.635644376222863,7
6179,60,49,23,30,-6.637846899098563,19
6180,5,26,32,16,-6.647447060451904,10
6181,37,19,71,11,-6.653996053488668,8
6182,19,71,87,44,-6.654254643173899,27
6183,71,11,83,6,-6.6562053803338666,5
6184,54,20,85,13,-6.664179187550934,7
6185,88,15,14,9,-6.66936824683007,6
6186,29,46,65,28,-6.670792875820866,18
6187,31,38,64,23,-6.680717740842573,15
6188,54,11,99,7,-6.681725927932733,4
6189,94,21,3,12,-6.6945259095116985,9
6190,51,32,108,19,-6.697498447878603,13
6191,74,15,83,8,-6.7032980304888605,7
6192,97,35,28,22,-6.716635909782018,13
6193,103,18,54,12,-6.724707925139227,6
6194,55,32,30,20,-6.725062001131896,12
6195,23,49,13,27,-6.726537007513918,22
6196,20,11,43,6,-6.726970372628883,5
6197,96,38,74,24,-6.731828732252366,14
6198,70,63,54,38,-6.740490617059239,25
6199,80,13,41,8,-6.741244434437033,5
6200,77,30,12,18,-6.742992963364651,12
6201,71,10,94,6,-6.748460655059326,4
6202,109,27,63,15,-6.749986635160675,12
6203,50,17,33,10,-6.750798742645289,7
6204,88,43,39,26,-6.751316626963761,17
6205,87,78,27,48,-6.768794455348769,30
6206,42,10,8,5,-6.780541784776636,5
6207,57,20,97,12,-6.781237277284942,8
6208,108,15,79,10,-6.783855393965386,5
6209,76,32,100,19,-6.799440423110686,13
6210,49,16,28,9,-6.801284823553006,7
6211,103,11,20,7,-6.80507831296062,4
6212,108,14,28,8,-6.806119384401873,6
6213,28,21,14,14,-6.807027415542907,7
6214,12,35,78,23,-6.8074005280423115,12
6215,102,22,50,12,-6.809919414830618,10
6216,109,11,89,7,-6.81531990803291,4
6217,4,13,56,7,-6.8162735158796925,6
6218,39,25,108,14,-6.818183477112843,11
6219,109,22,94,12,-6.819260229170755,10
6220,31,69,68,41,-6.821634358561019,28
6221,38,22,27,15,-6.8225480721889395,7
6222,37,29,30,19,-6.828235844394075,10
6223,106,25,95,16,-6.830338155584791,9
6224,114,18,76,12,-6.831521332050889,6
6225,29,15,20,9,-6.832826874702709,6
6226,87,40,108,24,-6.834140424334433,16
6227,72,28,85,18,-6.83697219501578,10
6228,109,60,16,37,-6.839893936386637,23
6229,60,62,39,36,-6.846993632230987,26
6230,4,43,60,24,-6.864343045215707,19
6231,30,36,29,23,-6.871800956301801,13
6232,99,15,106,10,-6.882359612487443,5
6233,11,32,12,19,-6.88848126291515,13
6234,35,19,27,12,-6.889601577867775,7
6235,67,13,88,9,-6.891493842154362,4
6236,50,28,95,17,-6.891870477756297,11
6237,14,16,39,9,-6.892280896151707,7
6238,3,31,41,21,-6.89461725911827,10
6239,49,81,39,51,-6.900466168563071,30
6240,68,21,58,13,-6.9046526848664955,8
6241,60,25,103,15,-6.909713022048386,10
6242,76,31,98,19,-6.914503913195636,12
6243,40,39,87,22,-6.915208460636838,17
6244,13,44,47,27,-6.918967707744426,17
6245,12,20,30,12,-6.920468129637184,8
6246,92,10,54,7,-6.935475063385283,3
6247,88,12,99,7,-6.939131232028662,5
6248,9,53,16,35,-6.946689005583058,18
6249,51,25,4,16,-6.952578906103848,9
6250,50,19,91,12,-6.959059467736709,7
6251,104,18,32,12,-6.959225086389552,6
6252,36,34,16,21,-6.9623095532486765,13
6253,97,23,18,14,-6.9651635757198616,9
6254,30,30,53,18,-6.98498975026545,12
6255,55,20,17,11,-6.987444025974708,9
6256,5,15,62,9,-6.992708759597398,6
6257,29,12,74,7,-6.99788298965225,5
6258,69,13,40,9,-7.006717860168273,4
6259,108,24,48,15,-7.01405993754928,9
6260,68,16,80,10,-7.020946425736165,6
6261,40,15,95,9,-7.026458120737084,6
6262,43,50,107,30,-7.042608164642457,20
6263,49,25,75,15,-7.046279748381457,10
6264,51,17,35,10,-7.047942210096516,7
6265,33,10,41,7,-7.0494637525151855,3
6266,69,20,104,13,-7.050658503403545,7
6267,18,25,63,16,-7.057051865944987,9
6268,36,18,99,12,-7.061516094995867,6
6269,62,14,17,8,-7.064031186672311,6
6270,25,50,37,29,-7.070541112352608,21
6271,64,19,109,10,-7.07123676744315,9
6272,63,30,98,18,-7.074142027349339,12
6273,38,23,11,14,-7.075339060309605,9
6274,53,10,85,7,-7.078145746437185,3
6275,88,137,16,85,-7.084435023872267,52
6276,94,19,69,12,-7.087672737054438,7
6277,89,17,48,12,-7.093940889199018,5
6278,102,29,100,19,-7.094058761081432,10
6279,45,10,1,6,-7.100044646871245,4
6280,55,51,40,32,-7.109300201154281,19
6281,3,32,78,18,-7.109444491661282,14
6282,103,18,88,10,-7.110825447996328,8
6283,7,33,45,20,-7.1141476412284765,13
6284,83,30,86,20,-7.11486297608935,10
6285,45,12,30,8,-7.122960634637173,4
6286,107,12,67,8,-7.124134838046413,4
6287,51,100,7,63,-7.124169403819474,37
6288,93,12,13,7,-7.127658172301537,5
6289,69,12,111,7,-7.144443379259749,5
6290,51,26,97,17,-7.145200913148903,9
6291,15,37,60,22,-7.164523611355908,15
6292,14,14,86,8,-7.166696838482465,6
6293,11,47,30,29,-7.169725660470146,18
6294,112,16,36,10,-7.175574629533444,6
6295,45,11,49,7,-7.1803155778985435,4
6296,39,18,90,10,-7.188846058446482,8
6297,43,15,112,9,-7.1893251112725824,6
6298,95,14,14,9,-7.1971223272437035,5
6299,93,14,98,8,-7.212314028509714,6
6300,108,12,72,8,-7.213712770239643,4
6301,90,15,41,9,-7.225732946536368,6
6302,90,12,3,7,-7.229183550562685,5
6303,57,12,58,7,-7.2358962284082144,5
6304,94,24,76,16,-7.2362630050315815,8
6305,40,27,114,18,-7.240772461331045,9
6306,5,14,31,9,-7.246607645789557,5
6307,8,42,13,26,-7.249552270590034,16
6308,96,12,69,8,-7.252755690648866,4
6309,18,10,61,6,-7.259552128825379,4
6310,81,19,75,12,-7.259552889264537,7
6311,70,16,110,10,-7.267896542251019,6
6312,96,84,86,52,-7.269360183001261,32
6313,68,20,55,13,-7.2739791513354835,7
6314,34,15,94,9,-7.2761384351010125,6
6315,49,14,95,9,-7.284298716033513,5
6316,54,18,2,12,-7.287492324178091,6
6317,40,31,43,18,-7.287691070183644,13
6318,68,32,23,18,-7.289923232946887,14
6319,9,23,11,14,-7.298808121542033,9
6320,98,27,5,16,-7.2988387616369135,11
6321,66,21,60,14,-7.300914124516515,7
6322,53,15,15,9,-7.3015008185893,6
6323,106,65,13,40,-7.303693924530705,25
6324,5,42,70,25,-7.323141246130925,17
6325,88,30,62,18,-7.323841783087015,12
6326,2,16,75,9,-7.332326563651876,7
6327,15,17,108,11,-7.342094547015131,6
6328,104,41,40,26,-7.342291894534158,15
6329,114,18,23,12,-7.3449426375970175,6
6330,61,11,41,7,-7.351525315520968,4
6331,87,49,78,30,-7.360452128651222,19
6332,8,33,18,22,-7.361992673527728,11
6333,114,13,78,7,-7.362319764057865,6
6334,27,21,37,13,-7.364913856955693,8
6335,33,16,25,11,-7.365926272964513,5
6336,61,10,106,7,-7.366885826585401,3
6337,80,14,31,10,-7.367135464628979,4
6338,88,12,56,7,-7.371104573008601,5
6339,71,10,73,6,-7.37323406519455,4
6340,81,19,71,12,-7.374213709282576,7
6341,51,48,64,29,-7.3869058165331,19
6342,56,22,7,13,-7.387479337914442,9
6343,28,15,10,10,-7.394064388880875,5
6344,76,14,75,8,-7.401272000460671,6
6345,91,10,77,6,-7.405339289847274,4
6346,20,30,70,19,-7.408681007686707,11
6347,109,25,68,16,-7.412111880903938,9
6348,41,34,36,18,-7.412500474371832,16
6349,5,18,73,11,-7.416873021801379,7
6350,16,24,6,13,-7.439865172191105,11
6351,43,66,13,38,-7.440342784840274,28
6352,71,12,11,7,-7.444969376445685,5
6353,77,16,74,10,-7.445248923450912,6
6354,69,18,47,11,-7.454070061027654,7
6355,80,11,27,7,-7.461746767808682,4
6356,53,12,45,7,-7.463487107897498,5
6357,36,14,70,8,-7.476080415111225,6
6358,89,23,41,15,-7.477544889027711,8
6359,68,23,20,13,-7.482872234261611,10
6360,76,15,71,8,-7.4875920550169335,7
6361,1,28,16,19,-7.488361785520795,9
6362,48,24,34,14,-7.49331551414235,10
6363,109,21,7,13,-7.49374057253885,8
6364,46,50,16,32,-7.494318856216716,18
6365,37,14,78,9,-7.496652434328358,5
6366,93,10,64,5,-7.507177747442427,5
6367,87,40,34,25,-7.517212330768041,15
6368,31,11,6,6,-7.520489323813347,5
6369,39,27,58,16,-7.5215555384091815,11
6370,55,11,6,8,-7.526848268362221,3
6371,7,16,33,9,-7.5321884826380465,7
6372,46,10,85,7,-7.538229298143683,3
6373,66,16,30,11,-7.562731538961938,5
6374,112,31,53,17,-7.574348903828082,14
6375,112,17,58,10,-7.574468513714297,7
6376,85,12,3,6,-7.5842525005471515,6
6377,43,14,47,9,-7.5847096844373425,5
6378,114,31,28,18,-7.584853881328922,13
6379,36,10,72,6,-7.585561627806541,4
6380,84,18,103,10,-7.589982363677433,8
6381,36,20,18,12,-7.594902878501233,8
6382,3,28,104,18,-7.596663267983382,10
6383,91,20,51,13,-7.599736540322733,7
6384,69,18,72,11,-7.6008233213034675,7
6385,87,45,18,27,-7.611607014750332,18
6386,49,52,107,33,-7.6187466324264985,19
6387,18,56,16,36,-7.620821442857431,20
6388,27,14,71,9,-7.620974472293361,5
6389,3,28,28,17,-7.638630473496032,11
6390,5,29,97,19,-7.6394183021151285,10
6391,96,13,15,8,-7.641753691009956,5
6392,60,11,70,7,-7.646435749026205,4
6393,31,13,33,7,-7.647223417443057,6
6394,87,53,76,34,-7.658955682459082,19
6395,13,55,30,34,-7.665552464286545,21
6396,96,24,37,14,-7.665844925696508,10
6397,77,31,41,21,-7.66915833105624,10
6398,9,38,8,21,-7.6727541362269935,17
6399,70,39,87,22,-7.68015007462121,17
6400,54,22,71,13,-7.686527692328838,9
6401,63,22,90,13,-7.686561569055609,9
6402,11,32,5,20,-7.687442157533872,12
6403,7,25,111,15,-7.690323425771979,10
6404,96,11,62,8,-7.693312023908734,3
6405,1,28,86,17,-7.696680317913665,11
6406,68,61,75,39,-7.698232004910779,22
6407,6,24,44,16,-7.699216026117287,8
6408,96,21,114,13,-7.708209589747937,8
6409,104,17,78,11,-7.72449974280056,6
6410,101,14,16,9,-7.729447625525019,5
6411,46,13,27,9,-7.7318499922390655,4
6412,57,17,108,10,-7.738005960337112,7
6413,29,18,46,9,-7.738693511487552,9
6414,84,11,44,6,-7.74146437073986,5
6415,46,11,15,7,-7.742583584977325,4
6416,68,29,28,19,-7.748993038967355,10
6417,51,19,111,12,-7.750696049131197,7
6418,73,11,53,7,-7.756297558195459,4
6419,34,16,72,10,-7.772920364347149,6
6420,114,14,92,10,-7.774797164908201,4
6421,43,18,17,11,-7.779410969380073,7
6422,111,10,47,6,-7.786638633209638,4
6423,13,25,111,14,-7.788425056310505,11
6424,31,31,107,16,-7.788469010128701,15
6425,49,32,72,20,-7.7914311211798255,12
6426,110,12,114,8,-7.800316810979699,4
6427,47,29,75,20,-7.802637218083722,9
6428,46,46,25,27,-7.8204011950255445,19
6429,108,14,54,10,-7.821734358546889,4
6430,17,22,5,15,-7.829641724195978,7
6431,93,16,70,10,-7.834949393241651,6
6432,1,20,114,13,-7.837742070296789,7
6433,60,19,94,12,-7.8405965016416,7
6434,58,21,30,13,-7.852822410978154,8
6435,92,16,16,12,-7.8586758925559135,4
6436,91,26,106,17,-7.859341034872009,9
6437,38,16,62,11,-7.859346684430754,5
6438,10,12,23,7,-7.85948423488221,5
6439,35,12,44,7,-7.859665557157527,5
6440,2,30,28,19,-7.862984699152352,11
6441,90,25,114,15,-7.8701656835045455,10
6442,40,34,54,21,-7.877426017050995,13
6443,54,11,61,7,-7.891370825375349,4
6444,87,30,80,19,-7.89956688878032,11
6445,29,16,17,9,-7.89967630532443,7
6446,90,14,53,9,-7.9010322992925905,5
6447,31,11,78,6,-7.904414780494012,5
6448,45,10,100,6,-7.910416808186414,4
6449,82,10,88,6,-7.912578083642501,4
6450,91,13,33,7,-7.919655002031917,6
6451,39,60,30,35,-7.929542337970758,25
6452,60,41,104,28,-7.929814398109316,13
6453,64,23,17,14,-7.9371107758094945,9
6454,71,19,98,12,-7.940784287039028,7
6455,83,10,98,7,-7.946776918388257,3
6456,68,70,39,42,-7.951159079684659,28
6457,30,17,114,10,-7.9585887197144976,7
6458,50,44,75,29,-7.963443352466475,15
6459,34,12,89,7,-7.976037737760561,5
6460,84,28,5,17,-7.986435375626319,11
6461,40,16,98,9,-7.993416961646093,7
6462,96,19,102,12,-7.995631160966492,7
6463,65,28,18,17,-8.006374014695181,11
6464,98,31,91,19,-8.010154956050261,12
6465,5,28,65,17,-8.01209130053563,11
6466,9,11,35,6,-8.012816785902416,5
6467,52,12,63,7,-8.01519600341839,5
6468,43,43,100,26,-8.02773331869185,17
6469,37,22,49,13,-8.028262573829636,9
6470,38,27,63,19,-8.035551882917902,8
6471,48,15,98,10,-8.040930745507076,5
6472,55,78,16,50,-8.046061626286075,28
6473,37,19,89,10,-8.048334757683454,9
6474,84,36,20,25,-8.048616703285953,11
6475,46,15,19,9,-8.056646218005667,6
6476,68,29,97,18,-8.0623155896758,11
6477,55,23,27,16,-8.063317604605786,7
6478,86,44,98,27,-8.07123889255168,17
6479,39,19,110,13,-8.071999499945951,6
6480,70,18,50,10,-8.072010588554928,8
6481,97,16,110,10,-8.077466293642962,6
6482,32,17,8,10,-8.079749532998788,7
6483,4,17,43,10,-8.083539648296876,7
6484,57,31,3,19,-8.088823479437655,12
6485,76,52,16,30,-8.092559503336215,22
6486,51,14,73,9,-8.097743889322738,5
6487,111,11,81,8,-8.120062859865858,3
6488,98,12,9,7,-8.123745049728663,5
6489,110,11,20,7,-8.125291114928709,4
6490,63,80,16,50,-8.131556117534755,30
6491,55,36,50,21,-8.131693382626928,15
6492,61,17,107,10,-8.134950583984786,7
6493,107,14,56,8,-8.14241374429404,6
6494,112,10,4,6,-8.145974306589785,4
6495,64,19,70,13,-8.153009023968611,6
6496,104,27,49,17,-8.170229238591212,10
6497,92,18,51,11,-8.176167071622316,7
6498,12,38,60,21,-8.176704391599657,17
6499,57,16,38,9,-8.179065570967875,7
6500,27,33,54,20,-8.18041909853592,13
6501,51,30,94,19,-8.188387798869616,11
6502,6,13,15,9,-8.19523827095456,4
6503,57,17,75,11,-8.19573859465214,6
6504,61,10,43,6,-8.197501979978238,4
6505,15,45,27,27,-8.204681610073106,18
6506,88,44,15,30,-8.213143448624798,14
6507,81,11,80,6,-8.214427134711952,5
6508,40,14,112,8,-8.221202026655064,6
6509,71,10,99,6,-8.224966300288866,4
6510,7,31,37,19,-8.226042864777217,12
6511,106,21,69,13,-8.230262561693126,8
6512,83,15,11,10,-8.230715708736337,5
6513,1,18,75,12,-8.241769187322507,6
6514,76,10,93,6,-8.25053412937542,4
6515,47,12,85,9,-8.252970893280143,3
6516,14,12,37,7,-8.266467835075428,5
6517,91,18,41,12,-8.276671952774398,6
6518,79,14,15,8,-8.279617988476957,6
6519,57,22,62,15,-8.282890505105964,7
6520,106,31,90,21,-8.283845461248367,10
6521,15,17,48,10,-8.294674307198187,7
6522,29,24,49,15,-8.30024160945298,9
6523,56,17,86,11,-8.300855291965847,6
6524,63,13,92,7,-8.301235837359338,6
6525,29,25,98,16,-8.302046476403797,9
6526,109,13,91,8,-8.302894097359493,5
6527,3,37,49,22,-8.305049665091294,15
6528,109,23,74,15,-8.306575916019817,8
6529,46,43,37,29,-8.306667442353499,14
6530,109,16,93,10,-8.308998271060947,6
6531,51,20,79,11,-8.309517555811905,9
6532,9,15,25,10,-8.323455878342044,5
6533,51,29,34,18,-8.33519904313484,11
6534,86,30,44,19,-8.339333779949047,11
6535,96,25,48,16,-8.343995751105185,9
6536,31,33,41,21,-8.353957395244581,12
6537,5,22,7,14,-8.357081514884822,8
6538,25,45,7,29,-8.372806618348298,16
6539,3,32,72,19,-8.389032282963832,13
6540,61,12,69,9,-8.397253145469623,3
6541,68,25,72,16,-8.400269184621727,9
6542,67,14,109,7,-8.410228891959633,7
6543,90,19,73,12,-8.42410199186246,7
6544,103,23,49,14,-8.430062008794607,9
6545,114,20,55,13,-8.432483182241098,7
6546,70,24,96,13,-8.43741799102626,11
6547,41,24,8,16,-8.446748885751395,8
6548,27,16,17,9,-8.447083930107876,7
6549,96,14,95,9,-8.450373982592186,5
6550,19,34,103,21,-8.451907756621258,13
6551,39,49,18,31,-8.45216636957102,18
6552,12,23,53,14,-8.460797624804181,9
6553,20,37,63,22,-8.464473402081476,15
6554,48,20,50,13,-8.466418162124782,7
6555,77,18,17,11,-8.46662344473387,7
6556,103,12,104,7,-8.482852346760637,5
6557,37,15,29,9,-8.491699980771868,6
6558,40,28,64,18,-8.496071624321132,10
6559,45,10,91,6,-8.504304930616431,4
6560,29,40,39,23,-8.504662903417357,17
6561,109,10,33,6,-8.506616474826913,4
6562,8,35,95,21,-8.511725721270736,14
6563,77,11,80,7,-8.51548819382583,4
6564,9,22,20,14,-8.515923532058862,8
6565,69,22,81,13,-8.51799786685539,9
6566,3,62,13,40,-8.519160791346218,22
6567,61,20,53,14,-8.524850655507475,6
6568,63,11,110,7,-8.534985747455591,4
6569,8,34,68,21,-8.545370564412986,13
6570,35,12,94,7,-8.545638882275085,5
6571,107,26,33,15,-8.550231212849106,11
6572,67,15,16,10,-8.550473387804702,5
6573,2,11,94,7,-8.550586885180524,4
6574,36,11,78,7,-8.552435160203325,4
6575,68,23,103,14,-8.554646323444773,9
6576,16,14,26,8,-8.561151203860886,6
6577,71,13,91,8,-8.567246551132914,5
6578,39,27,91,17,-8.56739283504692,10
6579,93,10,49,6,-8.572163796775678,4
6580,104,22,9,14,-8.574493523715214,8
6581,55,23,95,15,-8.575006509864881,8
6582,38,14,94,9,-8.588521468701916,5
6583,87,22,4,15,-8.590843038311565,7
6584,48,41,63,26,-8.591649372014341,15
6585,107,34,2,22,-8.596357154255273,12
6586,6,22,13,14,-8.600067561462975,8
6587,14,22,16,14,-8.606971231031414,8
6588,66,18,65,12,-8.642636100127188,6
6589,69,33,60,19,-8.651136747788069,14
6590,18,52,13,33,-8.653636499693645,19
6591,72,18,57,13,-8.656042983673217,5
6592,8,28,73,17,-8.656865963639591,11
6593,58,12,70,8,-8.66252309250944,4
6594,54,11,53,7,-8.670288326383611,4
6595,31,12,19,8,-8.676840084796208,4
6596,112,30,27,19,-8.685425209929864,11
6597,53,13,49,8,-8.69701289035937,5
6598,66,14,7,8,-8.725121734272053,6
6599,17,22,4,15,-8.727735068009611,7
6600,32,11,65,7,-8.739314169667134,4
6601,106,14,38,7,-8.745019433529976,7
6602,76,28,15,17,-8.747693902892903,11
6603,85,12,41,7,-8.754152386383815,5
6604,52,16,28,10,-8.757305556361812,6
6605,84,34,8,22,-8.76285424467774,12
6606,84,37,74,21,-8.764103490564016,16
6607,19,17,18,11,-8.772934483482583,6
6608,99,14,77,10,-8.784719144285264,4
6609,46,12,6,7,-8.79137101803374,5
6610,19,18,63,12,-8.792724982250471,6
6611,42,10,106,7,-8.802546839644405,3
6612,108,24,19,15,-8.805451324275152,9
6613,47,18,36,12,-8.810892372607714,6
6614,19,19,84,12,-8.81339664085273,7
6615,77,22,63,15,-8.819997532642512,7
6616,36,19,63,12,-8.822881427312195,7
6617,18,18,47,12,-8.827723884174087,6
6618,33,28,51,20,-8.842467587731502,8
6619,87,15,32,10,-8.844155029434871,5
6620,1,15,37,9,-8.845768047127494,6
6621,3,20,20,13,-8.846112059849585,7
6622,68,21,34,13,-8.850128344712713,8
6623,60,28,47,18,-8.854852442447157,10
6624,52,26,86,17,-8.860510586631694,9
6625,12,15,6,8,-8.87368712650089,7
6626,98,12,112,8,-8.873991556640123,4
6627,107,24,45,15,-8.882581208643296,9
6628,103,21,34,14,-8.883009589973753,7
6629,13,23,90,15,-8.883764352926047,8
6630,11,43,100,28,-8.886934672274425,15
6631,97,12,69,8,-8.888377862411462,4
6632,53,30,27,20,-8.892087302529346,10
6633,112,25,60,16,-8.892237229267325,9
6634,15,24,12,15,-8.901081094280315,9
6635,52,10,76,6,-8.902002264737622,4
6636,77,37,27,24,-8.90231785747824,13
6637,25,19,110,13,-8.91770167255822,6
6638,103,22,89,13,-8.918015663459961,9
6639,103,35,11,24,-8.918619326328127,11
6640,88,10,26,6,-8.919527282390273,4
6641,29,29,84,18,-8.921575167609983,11
6642,31,12,73,8,-8.93891957013575,4
6643,74,26,51,18,-8.938947542412071,8
6644,109,26,57,16,-8.940308236533028,10
6645,70,11,73,6,-8.941351293720283,5
6646,114,20,47,12,-8.969382880850311,8
6647,36,18,97,11,-8.970668153566258,7
6648,89,16,63,11,-8.974860507493936,5
6649,107,26,111,15,-8.980921347663005,11
6650,80,15,78,10,-8.990142670025016,5
6651,93,14,30,9,-8.997367289185709,5
6652,72,23,76,16,-8.997779491450277,7
6653,86,19,92,11,-8.99999904756414,8
6654,65,25,1,15,-9.00217902882169,10
6655,5,64,8,40,-9.002251377410767,24
6656,50,19,85,12,-9.007921978503544,7
6657,36,15,5,9,-9.008614310253616,6
6658,12,46,100,29,-9.018777204816933,17
6659,83,24,13,15,-9.019898615590664,9
6660,104,13,72,8,-9.02876607383453,5
6661,87,55,7,36,-9.031940434035896,19
6662,42,10,16,6,-9.042303853739885,4
6663,39,16,111,10,-9.04881859886048,6
6664,65,17,85,11,-9.053734140937445,6
6665,51,31,95,21,-9.0604562345489,10
6666,107,39,80,26,-9.074881524481428,13
6667,40,16,57,10,-9.07504759076948,6
6668,103,13,8,9,-9.07547283643557,4
6669,3,21,53,14,-9.076818822513886,7
6670,107,54,57,33,-9.078700261285771,21
6671,75,12,94,8,-9.08090116606965,4
6672,15,18,58,12,-9.107099163408304,6
6673,31,15,109,10,-9.113887572404181,5
6674,17,11,92,7,-9.114563540800479,4
6675,2,13,57,8,-9.119959996501732,5
6676,112,23,28,15,-9.120223564016392,8
6677,8,10,58,6,-9.142222913085966,4
6678,43,27,49,18,-9.143448784314835,9
6679,5,11,1,7,-9.143641454097294,4
6680,5,43,50,26,-9.15604936984071,17
6681,10,14,76,9,-9.15717818444399,5
6682,63,21,62,13,-9.161474645821354,8
6683,61,12,75,7,-9.169495709034498,5
6684,37,15,34,10,-9.170559355322496,5
6685,29,22,112,14,-9.17461030773198,8
6686,58,19,54,11,-9.183988111852093,8
6687,66,10,100,7,-9.189485891690612,3
6688,18,31,68,20,-9.190826393650623,11
6689,63,16,81,10,-9.193429569946275,6
6690,114,21,95,13,-9.195016624238175,8
6691,3,28,40,19,-9.202268323423779,9
6692,41,10,79,6,-9.204704069079497,4
6693,69,40,49,23,-9.212563576492524,17
6694,93,14,62,8,-9.214086704299504,6
6695,77,35,100,23,-9.21418647659614,12
6696,102,25,107,15,-9.215882737064184,10
6697,20,23,91,14,-9.233435902067155,9
6698,62,12,18,8,-9.234800982158575,4
6699,39,26,74,16,-9.23830751990649,10
6700,88,34,30,20,-9.246002926232094,14
6701,69,20,29,12,-9.248313015601624,8
6702,72,12,55,8,-9.264849417303106,4
6703,93,27,87,17,-9.265524424049662,10
6704,84,23,104,14,-9.266746412193928,9
6705,106,12,78,8,-9.274742533638902,4
6706,40,24,62,13,-9.275726600058688,11
6707,81,19,77,12,-9.279503184611325,7
6708,9,30,18,20,-9.325317307118524,10
6709,84,10,77,7,-9.326879307665173,3
6710,81,13,54,8,-9.33569894630605,5
6711,46,27,57,17,-9.344538995427152,10
6712,87,20,1,12,-9.344990956449259,8
6713,28,12,26,8,-9.352858082446945,4
6714,62,24,28,15,-9.3614354821999,9
6715,12,19,28,13,-9.36472715251189,6
6716,89,10,23,7,-9.36938210312373,3
6717,4,16,27,10,-9.378715415982098,6
6718,77,13,54,10,-9.380901529721797,3
6719,41,36,100,23,-9.381375330902392,13
6720,95,13,29,8,-9.382021477576465,5
6721,54,14,73,9,-9.382932635383147,5
6722,36,11,109,8,-9.390936468630551,3
6723,69,17,70,12,-9.40215032419605,5
6724,56,13,16,9,-9.403965360554952,4
6725,2,15,13,9,-9.422510080465477,6
6726,47,16,23,11,-9.428933500778964,5
6727,63,11,32,7,-9.44232166344675,4
6728,114,12,89,7,-9.444885030105084,5
6729,76,35,23,22,-9.453849648482663,13
6730,89,25,11,17,-9.473905386940325,8
6731,57,16,23,10,-9.474501256774843,6
6732,5,29,75,17,-9.487135559909316,12
6733,99,22,37,15,-9.502759058160704,7
6734,27,84,16,54,-9.503735028845302,30
6735,2,13,114,8,-9.509158562417845,5
6736,69,13,33,8,-9.51115802646404,5
6737,36,17,8,11,-9.51236026695053,6
6738,25,32,20,21,-9.520523686179047,11
6739,31,22,1,13,-9.525804060927038,9
6740,97,11,92,6,-9.525917165548371,5
6741,75,11,20,7,-9.527707505687728,4
6742,76,40,63,27,-9.537527582020363,13
6743,51,10,42,7,-9.543588102916445,3
6744,106,26,39,16,-9.547502317564263,10
6745,12,34,94,21,-9.548988489200944,13
6746,3,17,17,10,-9.55033737225928,7
6747,60,38,100,25,-9.561130090069941,13
6748,31,28,27,16,-9.569633624787402,12
6749,3,18,47,12,-9.572563324649543,6
6750,7,20,73,12,-9.582485903794176,8
6751,31,10,92,6,-9.586105290347549,4
6752,34,16,102,11,-9.58776658698314,5
6753,78,32,39,21,-9.589801557606744,11
6754,9,28,76,19,-9.591794162872961,9
6755,53,13,8,9,-9.596286006275319,4
6756,10,15,16,10,-9.607669865815328,5
6757,84,18,83,11,-9.609473734372155,7
6758,8,14,99,8,-9.611065592860319,6
6759,30,17,80,11,-9.61803117509945,6
6760,109,49,107,32,-9.6221501732588,17
6761,109,17,70,11,-9.623350653501724,6
6762,53,23,41,15,-9.631953807885303,8
6763,8,40,75,27,-9.637059553855455,13
6764,13,25,26,17,-9.644667177898784,8
6765,114,10,22,5,-9.649313306364826,5
6766,88,11,21,7,-9.65721273441522,4
6767,87,29,102,19,-9.659456627337187,10
6768,71,12,100,8,-9.660687520316314,4
6769,65,18,79,11,-9.675692837298339,7
6770,109,58,54,39,-9.676953395113689,19
6771,45,21,60,13,-9.677047968687356,8
6772,112,22,88,14,-9.681832903230308,8
6773,64,12,66,8,-9.686533226244313,4
6774,114,34,8,23,-9.699231858321156,11
6775,60,36,54,24,-9.707070384628162,12
6776,48,16,100,10,-9.709186246796257,6
6777,111,18,28,12,-9.712251206209237,6
6778,8,15,52,10,-9.715026692600484,5
6779,31,19,43,9,-9.72085277355369,10
6780,15,14,35,8,-9.721615421027135,6
6781,89,16,19,11,-9.73668729271828,5
6782,84,52,63,32,-9.747162233837335,20
6783,47,10,104,8,-9.753813502973621,2
6784,112,27,39,17,-9.753849767447482,10
6785,70,14,34,9,-9.755416516876583,5
6786,3,20,38,13,-9.756465034901842,7
6787,13,37,108,24,-9.76086171077813,13
6788,83,24,37,15,-9.78372636697842,9
6789,23,26,49,17,-9.783761857204425,9
6790,19,21,17,14,-9.789880941675225,7
6791,51,33,72,20,-9.790167811011377,13
6792,29,38,60,24,-9.791802980653232,14
6793,62,16,114,10,-9.799890996069497,6
6794,70,10,111,6,-9.807746966138032,4
6795,88,45,53,30,-9.809130380596871,15
6796,18,24,106,16,-9.811498602513076,8
6797,79,18,104,11,-9.811537818194267,7
6798,3,12,80,7,-9.8150650171119,5
6799,17,24,40,16,-9.815776001763272,8
6800,13,23,44,15,-9.816634162051663,8
6801,57,13,54,10,-9.824315369895022,3
6802,96,26,7,18,-9.825450759982106,8
6803,47,17,9,11,-9.833363334347133,6
6804,98,10,53,6,-9.839111782848333,4
6805,31,32,9,21,-9.853659783790295,11
6806,41,35,11,24,-9.869141213305259,11
6807,91,34,87,23,-9.869349002662767,11
6808,71,15,17,9,-9.87407872077162,6
6809,94,30,39,19,-9.877709275053965,11
6810,97,10,30,7,-9.88252203172555,3
6811,16,20,110,13,-9.893450419413215,7
6812,64,12,85,8,-9.89511233166771,4
6813,33,10,15,7,-9.911800000475989,3
6814,70,18,30,11,-9.913973705469942,7
6815,57,11,1,7,-9.916035104284749,4
6816,46,42,74,28,-9.91934754308771,14
6817,2,10,95,7,-9.920312629990494,3
6818,66,13,104,10,-9.923020394172243,3
6819,86,31,29,21,-9.92799906513859,10
6820,20,44,39,27,-9.935733230547791,17
6821,60,52,27,36,-9.950557521700254,16
6822,90,14,46,9,-9.960134782518509,5
6823,102,12,89,7,-9.960584439425153,5
6824,78,25,76,18,-9.960883913629875,7
6825,77,26,43,17,-9.97263393724616,9
6826,61,15,6,10,-9.976861344972216,5
6827,19,10,99,7,-9.983244859068366,3
6828,12,16,114,9,-9.985343546707199,7
6829,65,25,95,16,-9.987438820754926,9
6830,61,11,58,7,-9.991140661268366,4
6831,71,23,104,14,-10.004145398382484,9
6832,63,19,111,12,-10.01291034850113,7
6833,84,27,30,19,-10.023299208241367,8
6834,72,21,28,14,-10.026127135244147,7
6835,107,13,110,9,-10.034721322746929,4
6836,3,10,70,7,-10.036631807498473,3
6837,43,11,80,7,-10.040501076551806,4
6838,93,50,65,31,-10.042079956035632,19
6839,61,16,30,11,-10.045667078233517,5
6840,38,10,44,7,-10.048373138060265,3
6841,10,16,107,10,-10.056408787562024,6
6842,40,18,73,12,-10.060776256522114,6
6843,76,16,64,10,-10.071620985041546,6
6844,49,16,40,10,-10.077718304922938,6
6845,36,36,53,25,-10.114732824687984,11
6846,31,37,53,23,-10.136338371296794,14
6847,23,11,96,7,-10.143008283174428,4
6848,20,41,50,27,-10.147144974204984,14
6849,68,16,92,11,-10.147306838487292,5
6850,35,31,76,20,-10.147473531625216,11
6851,34,30,78,19,-10.167946698328937,11
6852,107,44,12,31,-10.16896739229528,13
6853,43,24,54,15,-10.170685643554325,9
6854,9,12,6,7,-10.175309866966636,5
6855,27,14,22,9,-10.193537492582191,5
6856,48,14,90,9,-10.193948361787585,5
6857,33,13,71,9,-10.195530501937558,4
6858,2,15,98,9,-10.19860338932166,6
6859,37,42,97,28,-10.199316810918765,14
6860,104,19,90,12,-10.205908373136614,7
6861,31,17,30,10,-10.214096274935347,7
6862,48,10,97,6,-10.221233545434696,4
6863,60,49,64,34,-10.225579774670623,15
6864,96,49,16,35,-10.230768867165024,14
6865,79,12,75,8,-10.235318929578343,4
6866,106,18,12,13,-10.245560433617426,5
6867,106,16,67,10,-10.25216143423421,6
6868,112,12,91,8,-10.264176950121664,4
6869,28,37,74,24,-10.332746781815512,13
6870,54,48,37,32,-10.345446907641223,16
6871,102,16,40,10,-10.346146758066931,6
6872,7,10,94,7,-10.355621654064777,3
6873,88,39,50,25,-10.36486098410092,14
6874,93,16,106,10,-10.37915501513517,6
6875,81,10,62,7,-10.381128876663766,3
6876,48,19,72,11,-10.390053523776759,8
6877,10,16,63,11,-10.390771257176635,5
6878,75,40,28,27,-10.392665070295683,13
6879,38,30,30,22,-10.41823615681849,8
6880,81,21,19,14,-10.4227612410005,7
6881,38,13,103,10,-10.428496638561523,3
6882,94,15,9,9,-10.428736566666437,6
6883,46,15,78,9,-10.43532016213296,6
6884,9,17,43,10,-10.43571876790201,7
6885,9,27,64,19,-10.495957554452962,8
6886,29,34,100,22,-10.507497913424638,12
6887,85,20,30,13,-10.510030437811338,7
6888,26,10,8,6,-10.512024852650756,4
6889,39,23,109,16,-10.513513507021568,7
6890,36,27,27,17,-10.52334959933135,10
6891,97,19,71,13,-10.523533962196904,6
6892,90,12,93,8,-10.530779388732013,4
6893,68,19,50,11,-10.535408083030939,8
6894,12,19,74,13,-10.540285470313428,6
6895,38,11,49,8,-10.545141985188478,3
6896,40,17,28,10,-10.551622113062642,7
6897,102,13,64,9,-10.555701452012437,4
6898,9,15,95,9,-10.569002592922947,6
6899,47,15,78,9,-10.571891033683887,6
6900,75,26,104,17,-10.574353916694225,9
6901,91,31,7,22,-10.609100286101581,9
6902,103,13,28,9,-10.609246701939707,4
6903,12,25,104,17,-10.646691739775022,8
6904,91,24,30,17,-10.658543869059741,7
6905,33,17,63,11,-10.66390349401416,6
6906,36,13,43,8,-10.71355202500855,5
6907,60,19,37,11,-10.713928216657274,8
6908,111,11,54,8,-10.714143810197234,3
6909,91,12,11,9,-10.737589094202365,3
6910,60,19,5,13,-10.737943337535816,6
6911,89,12,26,8,-10.74074513255954,4
6912,108,14,106,10,-10.746780907865295,4
6913,91,15,23,9,-10.74878606870166,6
6914,7,11,59,8,-10.771239818059202,3
6915,13,12,101,9,-10.774607059056445,3
6916,91,25,55,18,-10.791612827626555,7
6917,90,11,12,8,-10.792345367888727,3
6918,75,12,85,9,-10.804683773311504,3
6919,81,17,106,10,-10.816681182916206,7
6920,49,41,100,27,-10.823492275625211,14
6921,77,32,104,21,-10.833725252578546,11
6922,81,15,11,10,-10.851443298256324,5
6923,67,17,86,11,-10.856458271232293,6
6924,106,13,79,9,-10.885501834452416,4
6925,9,22,48,15,-10.894666127588817,7
6926,43,30,30,22,-10.908909228896238,8
6927,64,28,55,20,-10.91721792901183,8
6928,39,17,44,11,-10.931701642504198,6
6929,41,12,6,7,-10.932480964173765,5
6930,28,48,63,33,-10.937243385325445,15
6931,58,29,65,19,-10.961146082647755,10
6932,106,67,16,46,-10.962555092667682,21
6933,29,19,72,12,-10.964372581054949,7
6934,91,37,63,26,-10.969349538743971,11
6935,97,25,13,16,-10.985857531237668,9
6936,110,20,51,14,-11.00014817045874,6
6937,71,13,15,9,-11.00914391321025,4
6938,65,56,100,38,-11.012297063888093,18
6939,92,14,41,9,-11.016394202336146,5
6940,60,31,91,19,-11.033330949428786,12
6941,84,10,47,7,-11.043789003229907,3
6942,32,17,16,11,-11.045561391190382,6
6943,114,12,32,8,-11.045874107216173,4
6944,1,39,55,27,-11.047135752371084,12
6945,11,11,99,7,-11.04788337752713,4
6946,65,27,38,17,-11.074356765807053,10
6947,112,29,64,21,-11.096215333139426,8
6948,84,36,11,24,-11.100193468531897,12
6949,57,23,79,15,-11.100381889906581,8
6950,32,13,74,9,-11.101664191982367,4
6951,102,12,46,8,-11.102504599435605,4
6952,70,15,46,10,-11.123543654837011,5
6953,66,12,78,8,-11.131528298187064,4
6954,45,12,58,8,-11.132316744798052,4
6955,11,34,104,23,-11.141180204048963,11
6956,19,49,27,34,-11.141415326856118,15
6957,1,13,78,9,-11.156578268103178,4
6958,23,17,72,11,-11.160874339561767,6
6959,114,37,87,23,-11.160921669895089,14
6960,1,11,89,7,-11.209011069389929,4
6961,46,12,100,8,-11.210309669403339,4
6962,3,15,25,10,-11.214634960222725,5
6963,96,20,46,12,-11.223825219116964,8
6964,39,12,45,7,-11.230688824941204,5
6965,68,25,25,17,-11.235607083018877,8
6966,106,25,46,15,-11.236273437212292,10
6967,17,23,53,16,-11.244737606744525,7
6968,76,21,34,13,-11.25579697597524,8
6969,70,11,83,6,-11.265042422069474,5
6970,7,52,75,35,-11.274663385996204,17
6971,55,14,2,9,-11.27681615957405,5
6972,27,11,111,8,-11.279710088837584,3
6973,5,10,80,7,-11.295210617596888,3
6974,76,17,74,10,-11.297198648055824,7
6975,91,13,69,8,-11.30407928014614,5
6976,55,15,49,10,-11.3111037781176,5
6977,44,15,104,10,-11.332078649569059,5
6978,112,11,108,7,-11.335603356831967,4
6979,66,15,58,11,-11.346720879682533,4
6980,108,11,52,8,-11.346744817608853,3
6981,53,17,78,11,-11.357198680475333,6
6982,102,15,75,11,-11.35790237245839,4
6983,77,48,16,32,-11.38011190288672,16
6984,38,11,4,8,-11.395009854616482,3
6985,75,10,73,5,-11.395199340418813,5
6986,54,39,75,25,-11.408133317564461,14
6987,50,20,77,15,-11.423502497737049,5
6988,60,20,34,14,-11.434147211488856,6
6989,86,38,102,26,-11.442450297093961,12
6990,106,41,114,27,-11.462749893343949,14
6991,89,10,94,8,-11.466175489745245,2
6992,37,12,68,8,-11.49658369134707,4
6993,75,14,98,9,-11.49709370731316,5
6994,65,11,35,8,-11.518581403700487,3
6995,76,20,7,12,-11.52245661748586,8
6996,81,15,7,9,-11.525413070422038,6
6997,77,21,98,15,-11.52597944233578,6
6998,7,12,110,7,-11.526061320417648,5
6999,84,12,18,8,-11.52667869126048,4
7000,81,34,87,21,-11.530786241792944,13
7001,69,25,63,17,-11.548874027492651,8
7002,46,14,53,9,-11.556347535591735,5
7003,87,13,21,9,-11.56318091799384,4
7004,71,10,111,7,-11.563837134119526,3
7005,104,16,36,10,-11.564722196156032,6
7006,11,11,23,8,-11.568338446113305,3
7007,43,11,33,7,-11.582593249014051,4
7008,91,18,43,13,-11.584680594680322,5
7009,45,10,15,7,-11.602936446344312,3
7010,70,23,11,16,-11.609570033059047,7
7011,29,16,75,10,-11.609985031917772,6
7012,103,18,55,13,-11.61383361779385,5
7013,38,17,75,13,-11.628826987325251,4
7014,109,35,30,25,-11.633645492648192,10
7015,110,10,11,8,-11.637838089699006,2
7016,40,12,100,8,-11.638460148115913,4
7017,9,34,15,20,-11.64369161746246,14
7018,23,23,55,14,-11.64391055385205,9
7019,19,26,7,19,-11.65176644692338,7
7020,81,10,8,7,-11.678569579324545,3
7021,28,23,34,16,-11.682170467841415,7
7022,96,13,91,9,-11.69285419312405,4
7023,103,36,100,24,-11.698693937638303,12
7024,109,14,81,10,-11.703106695945644,4
7025,43,25,55,19,-11.714024478286158,6
7026,69,12,34,10,-11.742698738008174,2
7027,102,17,63,11,-11.747209471298389,6
7028,60,24,74,15,-11.762098333048542,9
7029,19,18,55,12,-11.76786180344628,6
7030,94,19,62,13,-11.771555517167426,6
7031,81,21,49,13,-11.780141471258917,8
7032,62,10,112,7,-11.78047192200998,3
7033,81,34,51,22,-11.790201731891964,12
7034,54,10,44,7,-11.791894285038762,3
7035,40,21,8,15,-11.79192140237277,6
7036,57,22,94,15,-11.796472246977714,7
7037,109,11,92,8,-11.825872450184745,3
7038,58,11,72,8,-11.847351060385245,3
7039,38,16,53,11,-11.864509466472805,5
7040,12,11,79,7,-11.866943529008417,4
7041,31,18,98,11,-11.908816140421925,7
7042,77,17,71,12,-11.915487518479782,5
7043,68,16,108,11,-11.92861631232352,5
7044,65,46,114,30,-11.938229846486394,16
7045,57,27,70,17,-11.940546365796532,10
7046,81,13,28,9,-11.947384191502275,4
7047,18,27,95,18,-11.951490678023534,9
7048,57,22,76,16,-11.963037229635306,6
7049,77,15,37,10,-11.967604181160285,5
7050,55,18,102,12,-11.98386619497443,6
7051,5,32,102,21,-12.011851390558958,11
7052,104,12,1,8,-12.02010829271743,4
7053,49,35,98,24,-12.027262783994834,11
7054,28,14,43,9,-12.028046594555397,5
7055,88,20,102,15,-12.040669825997002,5
7056,46,20,30,14,-12.044164698044927,6
7057,89,10,10,7,-12.05123505380701,3
7058,63,18,1,11,-12.054495717242014,7
7059,38,17,100,13,-12.063654867780361,4
7060,85,13,87,9,-12.077215618367395,4
7061,94,49,16,35,-12.097455142978449,14
7062,91,15,76,11,-12.09807191241983,4
7063,83,18,107,13,-12.107720877525319,5
7064,38,11,45,8,-12.113308453273786,3
7065,4,10,15,6,-12.124220843420797,4
7066,104,13,93,9,-12.138932518021326,4
7067,96,40,11,27,-12.14102850879166,13
7068,50,20,53,13,-12.152614797488546,7
7069,70,22,2,14,-12.153236389251049,8
7070,99,21,107,14,-12.174640608684577,7
7071,62,23,78,15,-12.176929848683924,8
7072,109,21,75,15,-12.181700739963029,6
7073,35,11,75,8,-12.188091693345983,3
7074,11,15,2,10,-12.196157085843714,5
7075,54,15,34,11,-12.19994600804293,4
7076,89,13,78,9,-12.201646848352171,4
7077,97,10,15,7,-12.205780494305644,3
7078,20,19,33,13,-12.222728464147568,6
7079,43,19,75,14,-12.224767647713703,5
7080,20,14,64,11,-12.230112840596973,3
7081,57,25,100,17,-12.24904881178982,8
7082,39,10,32,7,-12.259008757767623,3
7083,88,19,73,13,-12.262693289910837,6
7084,11,29,49,21,-12.265394797164884,8
7085,96,30,98,21,-12.27549839186978,9
7086,81,15,40,11,-12.276802562895192,4
7087,18,15,69,10,-12.281407888329312,5
7088,88,18,98,13,-12.300728896947142,5
7089,94,34,13,23,-12.315280597409899,11
7090,66,12,39,8,-12.326990757641061,4
7091,88,91,13,64,-12.345868204497037,27
7092,97,12,67,9,-12.353467827440639,3
7093,92,12,49,8,-12.374864484595681,4
7094,38,16,34,12,-12.397613710381254,4
7095,109,24,12,17,-12.4135045049996,7
7096,91,11,53,8,-12.419564767639512,3
7097,50,17,36,10,-12.423703215189777,7
7098,37,14,18,10,-12.438833593443574,4
7099,87,30,79,22,-12.466071130940083,8
7100,69,11,23,8,-12.468155133637696,3
7101,41,24,111,16,-12.478825250714587,8
7102,92,15,64,8,-12.492372460791035,7
7103,13,12,42,9,-12.522183516198908,3
7104,3,32,63,24,-12.548769683390436,8
7105,71,18,41,13,-12.557773267008857,5
7106,51,21,2,13,-12.595923969105383,8
7107,49,19,47,14,-12.600068108513415,5
7108,108,24,53,15,-12.606603502458741,9
7109,85,20,39,13,-12.618845399489867,7
7110,63,34,30,23,-12.643300278538096,11
7111,94,20,85,14,-12.645956344332362,6
7112,57,23,7,14,-12.666461617234948,9
7113,5,15,48,11,-12.675358072710559,4
7114,31,13,104,8,-12.681964820727016,5
7115,97,16,38,11,-12.68239796661763,5
7116,63,40,80,28,-12.682443988429268,12
7117,31,76,13,51,-12.705633823012965,25
7118,104,21,64,15,-12.71585067479966,6
7119,89,22,27,16,-12.719981225557996,6
7120,45,13,27,9,-12.720614115305079,4
7121,106,14,33,10,-12.736963404825655,4
7122,87,33,98,24,-12.737232267618925,9
7123,37,44,11,30,-12.738426249160876,14
7124,36,10,95,7,-12.746346244298937,3
7125,1,15,100,10,-12.750379039232417,5
7126,89,18,76,13,-12.75804553023341,5
7127,3,31,84,20,-12.781771350844402,11
7128,25,15,49,10,-12.785517383168525,5
7129,66,13,13,9,-12.789636021700206,4
7130,76,11,1,7,-12.827717897490281,4
7131,29,22,64,17,-12.835455672871143,5
7132,109,24,53,17,-12.845848364223912,7
7133,41,10,42,7,-12.856406375174817,3
7134,65,21,2,16,-12.890027578518191,5
7135,94,10,64,6,-12.918584959999516,4
7136,37,20,64,14,-12.946494518825181,6
7137,106,19,98,13,-12.95487415033694,6
7138,84,10,92,6,-12.962976398847763,4
7139,57,25,65,18,-12.982382134863352,7
7140,35,14,63,9,-12.998216518752985,5
7141,109,43,27,29,-13.017834353287023,14
7142,55,18,15,14,-13.03115867267244,4
7143,47,14,55,9,-13.036465008068175,5
7144,62,23,74,16,-13.07201740553172,7
7145,91,10,94,8,-13.125494056890847,2
7146,103,13,48,10,-13.133825600656486,3
7147,29,32,13,21,-13.136727901073609,11
7148,37,28,95,21,-13.149042342745602,7
7149,3,18,108,13,-13.149455786492924,5
7150,79,14,19,9,-13.189433599982168,5
7151,29,20,109,12,-13.210765864197791,8
7152,54,18,36,12,-13.21774479827317,6
7153,88,39,95,27,-13.236869470595257,12
7154,109,38,15,28,-13.249531706046115,10
7155,49,20,48,15,-13.272537147968347,5
7156,99,12,7,8,-13.27451726078842,4
7157,68,33,100,22,-13.287177831750679,11
7158,46,43,104,29,-13.294982678813746,14
7159,106,19,64,13,-13.295192075566398,6
7160,1,14,8,10,-13.305141225086524,4
7161,88,20,80,13,-13.305539707805673,7
7162,35,12,8,9,-13.311489751182306,3
7163,19,17,9,12,-13.318120114033066,5
7164,37,17,15,13,-13.319007709477827,4
7165,18,16,11,11,-13.321280125838722,5
7166,9,13,108,8,-13.341841222661904,5
7167,45,18,35,11,-13.348739323329763,7
7168,32,11,55,7,-13.363639630093914,4
7169,48,14,17,9,-13.364907872446567,5
7170,12,10,108,6,-13.367955655554766,4
7171,35,12,104,8,-13.369677424437173,4
7172,53,20,43,15,-13.376082278687463,5
7173,3,12,74,9,-13.385856762614393,3
7174,51,22,80,15,-13.405837899191416,7
7175,84,15,71,11,-13.41321574412034,4
7176,103,14,58,10,-13.421652899380138,4
7177,53,15,75,10,-13.423496737137015,5
7178,68,16,61,11,-13.424919545398382,5
7179,32,12,25,7,-13.427877456338669,5
7180,35,15,36,11,-13.440272285829968,4
7181,43,12,38,7,-13.441639188500288,5
7182,98,18,109,13,-13.444061011572101,5
7183,108,12,84,9,-13.488009207908556,3
7184,112,13,55,10,-13.49840576791747,3
7185,38,19,87,13,-13.505889307722844,6
7186,6,10,80,7,-13.522871173076236,3
7187,84,19,41,13,-13.556150264603872,6
7188,70,13,48,9,-13.61596473877697,4
7189,12,29,41,21,-13.623588976279663,8
7190,12,15,75,10,-13.63556285801919,5
7191,11,16,108,12,-13.647782335147589,4
7192,35,11,60,7,-13.64827931058638,4
7193,25,10,92,7,-13.698642336458672,3
7194,5,28,57,20,-13.702708831126639,8
7195,95,10,34,7,-13.704508911135058,3
7196,51,21,45,15,-13.706946532575504,6
7197,109,10,112,7,-13.71380284904661,3
7198,31,25,63,18,-13.714594813504084,7
7199,11,25,95,18,-13.725658005456244,7
7200,27,10,97,6,-13.735152835550474,4
7201,29,15,18,11,-13.759102795902571,4
7202,87,12,61,8,-13.760538340997263,4
7203,81,20,100,13,-13.764798264783213,7
7204,57,13,47,9,-13.774921234941399,4
7205,112,11,97,9,-13.794615799527316,2
7206,53,10,72,7,-13.882269785370536,3
7207,48,18,78,13,-13.897964627407005,5
7208,41,15,34,10,-13.902632667621377,5
7209,12,11,45,8,-13.905186638720524,3
7210,112,10,25,7,-13.919292260310073,3
7211,112,11,37,8,-13.937736127059292,3
7212,69,19,75,14,-13.942304484906572,5
7213,71,24,40,17,-13.948125771645662,7
7214,29,12,58,9,-13.952580214272475,3
7215,27,37,104,26,-13.967437214255792,11
7216,75,12,111,8,-13.97228180941997,4
7217,9,31,41,22,-13.990507643067815,9
7218,52,14,15,10,-14.026248257676636,4
7219,77,29,40,21,-14.048771071022594,8
7220,48,24,74,15,-14.067708006346336,9
7221,9,10,90,7,-14.073147353965513,3
7222,19,10,33,6,-14.198164828754605,4
7223,75,10,72,7,-14.207053385683185,3
7224,46,18,50,12,-14.208875687593247,6
7225,7,17,61,11,-14.217702740281519,6
7226,57,25,34,18,-14.246419359699368,7
7227,109,30,114,23,-14.263150833488547,7
7228,17,11,83,7,-14.269615650014424,4
7229,83,22,16,16,-14.27379500391039,6
7230,18,15,23,10,-14.275894417804937,5
7231,109,20,19,14,-14.305000975474687,6
7232,112,10,48,8,-14.307464286387088,2
7233,57,12,31,8,-14.310689026630854,4
7234,43,15,45,10,-14.31794966361631,5
7235,86,25,26,19,-14.322036756570215,6
7236,10,10,54,7,-14.334784055636703,3
7237,83,10,40,8,-14.347262135245899,2
7238,112,19,47,13,-14.352034788316766,6
7239,90,16,20,11,-14.40477443227544,5
7240,70,26,108,19,-14.427393649276276,7
7241,14,11,80,7,-14.43534539519452,4
7242,35,13,97,10,-14.444551731599498,3
7243,5,12,44,9,-14.447481002517359,3
7244,78,22,17,15,-14.455986406772636,7
7245,2,10,73,7,-14.457830254043131,3
7246,25,12,34,9,-14.468789684868277,3
7247,6,12,19,8,-14.46906875309814,4
7248,108,10,34,8,-14.47806718750258,2
7249,112,15,38,12,-14.502554093851142,3
7250,69,25,27,17,-14.53516647824794,8
7251,50,19,80,15,-14.554439051919097,4
7252,20,18,34,14,-14.557800978959815,4
7253,18,10,90,7,-14.572865755876734,3
7254,99,12,50,8,-14.581629542155008,4
7255,103,14,50,10,-14.598236066613515,4
7256,34,16,18,12,-14.600476247363321,4
7257,77,25,8,18,-14.612256603393076,7
7258,45,17,23,12,-14.633454544359155,5
7259,12,15,55,11,-14.659208117082446,4
7260,83,19,114,14,-14.712530964906863,5
7261,77,28,7,20,-14.72949510503469,8
7262,31,10,100,7,-14.730848989291468,3
7263,102,11,90,6,-14.739148726840867,5
7264,106,14,32,11,-14.741977351969272,3
7265,25,26,11,20,-14.778705544740388,6
7266,109,21,17,15,-14.779727195130333,6
7267,89,11,7,8,-14.785043291363074,3
7268,35,11,102,7,-14.787485364380142,4
7269,93,12,38,7,-14.887591780281296,5
7270,88,18,111,14,-14.89137809160146,4
7271,103,15,74,11,-14.973961367784039,4
7272,38,24,104,17,-14.977006233689528,7
7273,44,10,49,7,-14.992301775479174,3
7274,49,14,80,9,-14.993186389789676,5
7275,22,12,13,9,-14.994671319317483,3
7276,75,10,45,8,-15.003649946946844,2
7277,99,18,25,13,-15.014737107768294,5
7278,20,16,60,12,-15.074406318316193,4
7279,58,29,86,22,-15.095351107022623,7
7280,102,13,43,9,-15.127428175042569,4
7281,29,10,71,8,-15.143188317628589,2
7282,54,31,48,22,-15.152035020388912,9
7283,3,36,100,27,-15.17022099047744,9
7284,90,10,27,8,-15.266408205709798,2
7285,108,15,114,11,-15.270376800556948,4
7286,2,15,100,10,-15.363858490781979,5
7287,18,11,5,8,-15.389394006883379,3
7288,107,25,73,17,-15.46067272069853,8
7289,39,12,2,9,-15.473797666414953,3
7290,84,23,112,17,-15.486639525748986,6
7291,12,15,9,11,-15.494125308722385,4
7292,31,15,69,10,-15.502962092044207,5
7293,5,21,23,16,-15.554175057753401,5
7294,90,10,100,8,-15.596895375105717,2
7295,45,14,4,10,-15.600891470448106,4
7296,85,11,106,8,-15.605731963514023,3
7297,97,13,90,9,-15.621888085765935,4
7298,97,12,14,10,-15.664913845649805,2
7299,112,14,15,10,-15.700949053545523,4
7300,80,13,75,10,-15.718052052365538,3
7301,35,12,80,9,-15.72406211872363,3
7302,96,16,93,12,-15.733194627661215,4
7303,94,13,17,9,-15.746212612138288,4
7304,28,13,110,9,-15.755425369009838,4
7305,62,18,12,13,-15.771400207309306,5
7306,17,22,95,17,-15.802621580377183,5
7307,46,15,93,12,-15.866750824235567,3
7308,76,14,80,10,-15.87988367140994,4
7309,28,29,90,22,-15.880089586771646,7
7310,70,13,80,11,-15.901333417895945,2
7311,48,12,62,8,-15.963389974606171,4
7312,90,11,57,8,-15.975273202140913,3
7313,108,13,8,10,-16.00695825478633,3
7314,9,31,53,23,-16.014655893145633,8
7315,5,18,41,12,-16.050377082501452,6
7316,35,19,87,13,-16.11679485458087,6
7317,112,15,71,11,-16.116875921028463,4
7318,46,13,98,9,-16.12835125202737,4
7319,89,11,18,8,-16.194414256598467,3
7320,80,12,34,10,-16.269229317512288,2
7321,33,16,65,12,-16.286121361101067,4
7322,14,12,25,10,-16.337614979675553,2
7323,2,19,104,13,-16.352388003055772,6
7324,83,13,27,11,-16.368092522641103,2
7325,43,11,110,8,-16.376498956572302,3
7326,40,10,29,8,-16.378294184390825,2
7327,63,14,14,10,-16.386711509096077,4
7328,39,19,99,15,-16.42872930905631,4
7329,37,11,19,9,-16.4401797639671,2
7330,64,12,74,8,-16.440953543226588,4
7331,55,15,14,12,-16.464885141480416,3
7332,31,46,16,34,-16.494251500601976,12
7333,61,10,34,9,-16.513382683902012,1
7334,79,12,17,9,-16.52858758988839,3
7335,68,22,95,18,-16.55020486315604,4
7336,41,25,30,19,-16.6254000589696,6
7337,36,10,101,8,-16.627946704419486,2
7338,69,23,53,17,-16.676579450904736,6
7339,112,28,78,21,-16.67914983172849,7
7340,71,15,95,10,-16.726754189945986,5
7341,83,13,23,10,-16.74470008954982,3
7342,26,10,60,7,-16.74543091529222,3
7343,76,15,77,12,-16.756455650082987,3
7344,13,21,80,14,-16.79628268985909,7
7345,10,12,37,8,-16.87706142806293,4
7346,12,11,26,8,-16.877482698800375,3
7347,10,12,13,9,-16.892767460419815,3
7348,41,10,22,8,-16.895138763704843,2
7349,46,12,43,9,-16.90387334173946,3
7350,112,19,20,15,-16.964936240764278,4
7351,31,10,38,6,-16.97274158238423,4
7352,51,25,90,19,-16.98113610300884,6
7353,102,11,48,9,-16.984312347736424,2
7354,37,13,73,9,-17.03246334806977,4
7355,1,14,18,11,-17.058153705270215,3
7356,9,29,27,21,-17.072056537621446,8
7357,46,15,18,12,-17.114833090306377,3
7358,2,11,60,8,-17.116843000088547,3
7359,29,28,88,21,-17.15439200584212,7
7360,5,22,27,16,-17.186967099907655,6
7361,106,10,35,7,-17.31905115685177,3
7362,72,12,94,9,-17.397924000040092,3
7363,109,11,108,8,-17.40163308376229,3
7364,83,11,110,9,-17.575104905290953,2
7365,18,11,109,8,-17.59427158865158,3
7366,94,13,104,10,-17.605678687274782,3
7367,60,18,102,13,-17.60770484195146,5
7368,67,10,20,8,-17.672455088050597,2
7369,3,11,5,7,-17.694163901939536,4
7370,43,16,81,12,-17.708072706454832,4
7371,68,12,90,9,-17.719685937760907,3
7372,55,12,44,9,-17.771847163193577,3
7373,15,10,85,8,-17.788004047228643,2
7374,109,13,35,10,-17.789223446519653,3
7375,5,18,30,15,-17.810533055025342,3
7376,35,13,48,10,-17.821530991658577,3
7377,88,17,32,13,-17.824594134673823,4
7378,114,11,111,8,-17.846918134233796,3
7379,41,10,35,7,-17.84884882348167,3
7380,76,21,54,16,-18.08934803214948,5
7381,54,10,67,8,-18.121548101252504,2
7382,57,20,29,16,-18.208641397516406,4
7383,81,13,72,9,-18.287707067400422,4
7384,31,15,106,11,-18.52908676481623,4
7385,30,16,95,12,-18.59476138296642,4
7386,94,14,48,11,-18.679447719754858,3
7387,57,16,112,12,-18.74164060463068,4
7388,28,17,99,13,-18.75458480836917,4
7389,102,12,27,10,-18.772173343475483,2
7390,33,20,55,16,-18.82593244000092,4
7391,97,12,34,9,-18.83120290818016,3
7392,4,13,98,11,-18.93649850914462,2
7393,106,10,92,8,-19.04169077246869,2
7394,62,13,34,10,-19.217276142512915,3
7395,18,14,99,11,-19.290873438644518,3
7396,36,19,30,17,-19.305297671687285,2
7397,34,14,64,11,-19.39040182384417,3
7398,29,12,114,9,-19.392096732655677,3
7399,29,11,80,9,-19.670803114551138,2
7400,5,11,64,9,-19.69819687485363,2
7401,31,11,15,8,-19.73878794252568,3
7402,32,12,95,10,-19.760326388824463,2
7403,106,12,89,8,-19.849086778440608,4
7404,6,12,30,10,-19.865749004424455,2
7405,97,13,73,9,-19.966763707753138,4
7406,54,17,4,15,-19.99443539185139,2
7407,3,22,48,17,-20.04071280653289,5
7408,84,12,7,10,-20.16090095994254,2
7409,68,38,112,30,-20.16144061217486,8
7410,103,10,75,9,-20.24199150509897,1
7411,43,14,76,12,-20.24251274532342,2
7412,10,11,30,9,-20.38962047667116,2
7413,94,23,81,17,-20.517798479805748,6
7414,77,11,34,10,-20.530353874618392,1
7415,95,10,3,8,-20.57885087785416,2
7416,10,14,112,11,-21.021770709139744,3
7417,33,12,100,10,-21.028397065514312,2
7418,10,16,51,13,-21.051824036569297,3
7419,112,16,80,12,-21.108795407964617,4
7420,31,11,76,10,-21.157211826935978,1
7421,51,11,101,9,-21.226620175614496,2
7422,3,18,75,15,-21.417290354619,3
7423,4,13,25,11,-21.420042602463127,2
7424,4,15,41,10,-21.48059017391386,5
7425,31,12,62,9,-21.79094106777599,3
7426,97,12,91,10,-22.175648770183784,2
7427,1,10,3,8,-22.670516239418713,2
7428,91,18,104,17,-22.937436859705542,1
7429,8,11,4,10,-23.17790508365148,1
7430,77,19,75,16,-23.52836570307736,3
7431,53,10,74,8,-24.36471273024663,2
7432,42,11,104,10,-24.55480599508646,1
7433,57,16,26,13,-24.88112492293926,3
7434,23,14,90,12,-25.1914979759845,2
7435,38,15,55,13,-25.19286181976179,2
7436,106,10,49,9,-25.68163240192886,1
7437,81,10,98,9,-27.56322031639677,1
7438,38,10,69,9,-27.69592076147955,1
7439,61,10,98,10,-28.32332956610249,0
7440,102,18,112,16,-28.496084585485107,2
7441,90,10,109,10,-29.2714816942141,0
7442,37,11,44,11,-29.88349889925713,0
7443,81,10,17,10,-31.104140358623045,0
