,againstHero,games,hero,losses,shift,wins
0,112,17,102,1,31.59305348177514,16
1,44,11,37,0,29.88349889925713,11
2,90,13,23,1,28.362481429909806,12
3,98,10,61,0,28.323329566102494,10
4,69,10,38,1,27.695920761479556,9
5,49,10,106,1,25.681632401928862,9
6,100,11,33,1,25.460296177649866,10
7,104,11,42,1,24.55480599508646,10
8,55,13,38,2,23.805883695964802,11
9,75,19,77,3,23.52836570307736,16
10,4,11,8,1,23.177905083651485,10
11,26,14,57,3,23.006782602638854,11
12,104,17,91,1,22.905675334222092,16
13,3,10,1,2,22.670516239418717,8
14,91,12,97,2,22.175648770183784,10
15,11,15,89,2,21.994738492227253,13
16,62,12,31,3,21.790941067775986,9
17,34,12,62,2,21.778436974548594,10
18,64,11,34,2,21.53865059177988,9
19,41,15,4,5,21.48059017391386,10
20,25,13,4,2,21.420042602463127,11
21,101,11,51,2,21.226620175614492,9
22,76,11,31,1,21.157211826935978,10
23,80,16,112,4,21.108795407964617,12
24,51,16,10,3,21.051824036569297,13
25,109,10,90,1,21.034570289962243,9
26,112,14,10,3,21.021770709139737,11
27,75,17,3,3,20.89719169832094,14
28,90,11,68,2,20.787956198015937,9
29,48,18,3,4,20.77461856356065,14
30,114,13,108,3,20.76617442739275,10
31,48,12,94,2,20.576242864974443,10
32,81,23,94,6,20.517798479805748,17
33,30,11,10,2,20.38962047667116,9
34,26,10,12,2,20.379731856409943,8
35,75,10,103,1,20.24199150509897,9
36,112,38,68,8,20.161440612174868,30
37,7,12,84,2,20.160900959942538,10
38,57,10,89,2,20.153446064878874,8
39,4,17,54,2,19.994435391851386,15
40,73,13,97,4,19.966763707753138,9
41,95,12,32,2,19.760326388824467,10
42,15,11,31,3,19.738787942525676,8
43,64,11,5,2,19.698196874853622,9
44,30,11,6,2,19.605882514870544,9
45,114,11,29,3,19.42881288570476,8
46,76,10,89,2,19.405192223589758,8
47,30,19,36,2,19.305297671687292,17
48,99,14,18,3,19.290873438644518,11
49,92,10,106,2,19.04169077246869,8
50,89,11,106,4,18.95338953455918,7
51,98,13,4,2,18.93649850914462,11
52,34,12,97,3,18.831202908180163,9
53,55,20,33,4,18.82593244000092,16
54,72,14,29,3,18.821794346434427,11
55,27,12,102,2,18.772173343475483,10
56,99,17,28,4,18.75458480836917,13
57,112,16,57,4,18.741640604630682,12
58,45,10,12,2,18.653807119995122,8
59,19,14,109,3,18.610693282372278,11
60,106,15,31,4,18.52908676481623,11
61,87,17,35,5,18.4649770696095,12
62,34,12,54,2,18.362976743969607,10
63,80,20,13,6,18.335804849316265,14
64,19,11,6,3,18.335706204340323,8
65,81,12,43,3,18.327617727929393,9
66,55,14,12,3,18.17466355866916,11
67,67,10,54,2,18.121548101252504,8
68,78,17,62,4,18.093769732536956,13
69,54,21,76,5,18.08934803214948,16
70,95,15,30,4,17.919901608832795,11
71,35,10,41,3,17.84884882348167,7
72,111,11,114,3,17.846918134233793,8
73,32,17,88,4,17.824594134673823,13
74,48,13,35,3,17.821530991658573,10
75,30,18,5,3,17.81053305502534,15
76,85,10,15,2,17.788004047228643,8
77,44,12,55,3,17.77184716319358,9
78,90,23,51,5,17.7178788097309,18
79,5,11,3,4,17.694163901939536,7
80,20,10,67,2,17.672455088050597,8
81,48,12,70,3,17.608815428580364,9
82,110,11,83,2,17.575104905290953,9
83,109,18,29,6,17.571930830154646,12
84,16,39,77,9,17.459530597353453,30
85,80,10,29,2,17.457200220457587,8
86,60,10,35,3,17.41812694726481,7
87,35,10,106,3,17.31905115685177,7
88,27,22,5,6,17.18696709990766,16
89,12,15,62,4,17.172750128516864,11
90,102,17,60,5,17.171392721318526,12
91,72,13,23,3,17.14817782244226,10
92,60,11,2,3,17.116843000088547,8
93,27,29,9,8,17.072056537621442,21
94,18,14,1,3,17.058153705270215,11
95,73,13,37,4,17.032463348069772,9
96,38,10,31,4,16.97274158238423,6
97,87,14,38,4,16.9696930082377,10
98,20,19,112,4,16.964936240764278,15
99,43,12,46,3,16.90387334173946,9
100,29,18,57,4,16.901122362734938,14
101,22,10,41,2,16.895138763704843,8
102,13,12,10,3,16.89276746041981,9
103,37,12,10,4,16.877061428062927,8
104,88,27,29,7,16.85204786067182,20
105,18,14,46,3,16.84517490405338,11
106,1,10,76,3,16.815372977495873,7
107,30,20,41,5,16.767826748629854,15
108,23,13,83,3,16.74470008954982,10
109,95,15,71,5,16.726754189945982,10
110,78,28,112,7,16.67914983172849,21
111,53,23,69,6,16.676579450904736,17
112,101,10,36,2,16.627946704419482,8
113,95,22,68,4,16.55020486315604,18
114,17,12,79,3,16.528587589888392,9
115,66,10,64,2,16.52634240612363,8
116,16,46,31,12,16.494251500601973,34
117,61,10,87,3,16.482333693393578,7
118,14,15,55,3,16.46488514148042,12
119,19,11,37,2,16.4401797639671,9
120,99,19,39,4,16.42872930905631,15
121,74,13,103,3,16.409823032190317,10
122,45,13,43,4,16.39462685745925,9
123,14,14,63,4,16.386711509096077,10
124,29,10,40,2,16.378294184390825,8
125,110,11,43,3,16.376498956572302,8
126,27,13,83,2,16.3680925226411,11
127,100,22,57,6,16.352929528191847,16
128,104,19,2,6,16.35238800305577,13
129,25,12,14,2,16.337614979675553,10
130,109,17,98,4,16.30686299478245,13
131,30,18,85,5,16.304609608829036,13
132,65,16,33,4,16.286121361101067,12
133,34,12,80,2,16.26922931751229,10
134,86,25,58,6,16.268533196463114,19
135,98,13,46,4,16.128351252027375,9
136,71,15,112,4,16.11687592102847,11
137,41,18,5,6,16.050377082501452,12
138,15,14,37,3,16.033544043199246,11
139,12,17,109,4,16.02403954774549,13
140,53,31,9,8,16.014655893145633,23
141,57,11,90,3,15.975273202140915,8
142,80,11,76,3,15.945303671637879,8
143,80,13,70,2,15.901333417895945,11
144,90,29,28,7,15.88008958677165,22
145,15,12,41,3,15.833444649300676,9
146,15,14,76,4,15.823118080936442,10
147,95,22,17,5,15.802621580377183,17
148,110,13,28,4,15.75542536900984,9
149,17,13,94,4,15.746212612138288,9
150,93,16,96,4,15.733194627661216,12
151,80,12,35,3,15.724062118723628,9
152,75,13,80,3,15.718052052365538,10
153,45,20,51,5,15.703190735785379,15
154,15,14,112,4,15.700949053545523,10
155,72,23,51,7,15.686011493569213,16
156,14,12,97,2,15.664913845649805,10
157,90,13,97,4,15.621888085765939,9
158,106,11,85,3,15.605731963514026,8
159,23,10,69,2,15.603167423944381,8
160,4,14,45,4,15.60089147044811,10
161,100,10,90,2,15.59689537510572,8
162,23,21,5,5,15.554175057753397,16
163,13,12,66,3,15.520614540867863,9
164,64,20,104,5,15.515264160119216,15
165,69,15,31,5,15.502962092044207,10
166,112,23,84,6,15.486639525748984,17
167,2,12,39,3,15.473797666414951,9
168,73,25,107,8,15.46067272069853,17
169,5,11,18,3,15.389394006883377,8
170,100,15,2,5,15.36385849078198,10
171,104,12,94,3,15.27233865597326,9
172,93,14,46,3,15.251126640356858,11
173,76,13,91,3,15.216447591134663,10
174,16,44,94,11,15.208855057085275,33
175,54,11,77,1,15.154916790692539,10
176,48,31,54,9,15.15203502038891,22
177,71,10,29,2,15.143188317628589,8
178,77,19,50,4,15.082093464135092,15
179,38,10,93,4,15.046407356806787,6
180,49,18,81,6,15.043369514696264,12
181,25,18,99,5,15.014737107768298,13
182,45,10,75,2,15.00364994694684,8
183,13,12,22,3,14.994671319317483,9
184,80,14,49,5,14.99318638978968,9
185,49,10,44,3,14.992301775479177,7
186,111,18,88,4,14.891378091601458,14
187,15,19,77,5,14.819984931970572,14
188,102,11,35,4,14.787485364380144,7
189,7,11,89,3,14.785043291363074,8
190,11,26,25,6,14.778705544740387,20
191,32,14,106,3,14.741977351969275,11
192,78,15,48,4,14.736137197437774,11
193,100,10,31,3,14.730848989291468,7
194,7,28,77,8,14.729495105034692,20
195,114,19,83,5,14.712530964906861,14
196,17,19,78,6,14.709203332504174,13
197,55,16,19,5,14.687783547200517,11
198,27,34,109,11,14.672056456650022,23
199,39,10,66,3,14.612542929328729,7
200,50,12,99,4,14.581629542155012,8
201,34,18,20,4,14.557800978959818,14
202,80,19,50,4,14.554439051919097,15
203,47,15,49,3,14.53278782523131,12
204,38,15,97,4,14.531013843539451,11
205,34,12,25,3,14.468789684868279,9
206,73,10,2,3,14.457830254043134,7
207,44,12,5,3,14.447481002517359,9
208,97,13,35,3,14.444551731599496,10
209,8,24,77,7,14.435582202481532,17
210,80,11,14,4,14.435345395194517,7
211,108,26,70,7,14.427393649276278,19
212,72,15,69,4,14.413894141860307,11
213,34,22,57,6,14.396355193278234,16
214,100,15,81,5,14.3826940951582,10
215,40,10,83,2,14.347262135245902,8
216,54,10,10,3,14.334784055636703,7
217,26,25,86,6,14.322036756570213,19
218,31,12,57,4,14.310689026630854,8
219,46,11,102,3,14.307494713152066,8
220,48,10,112,2,14.307464286387091,8
221,23,15,18,5,14.275894417804937,10
222,83,11,17,4,14.269615650014424,7
223,72,13,48,5,14.226647914181537,8
224,61,17,7,6,14.217702740281522,11
225,50,18,46,6,14.208875687593249,12
226,72,10,75,3,14.207053385683185,7
227,100,32,3,9,14.177671200718626,23
228,58,13,66,3,14.08786535368442,10
229,90,10,9,3,14.073147353965513,7
230,104,22,38,7,14.071473191155546,15
231,100,31,68,10,14.067965798054423,21
232,40,29,77,8,14.0487710710226,21
233,6,11,41,4,13.99218654178206,7
234,41,31,9,9,13.990507643067811,22
235,111,12,75,4,13.972281809419972,8
236,114,29,109,7,13.96133653890183,22
237,40,24,71,7,13.948125771645659,17
238,75,19,69,5,13.942304484906572,14
239,60,14,20,4,13.939926452860888,10
240,37,11,112,3,13.937736127059289,8
241,25,10,112,3,13.919292260310073,7
242,63,31,3,7,13.905152866710317,24
243,16,21,83,6,13.895144807658395,15
244,53,19,50,6,13.883151416746278,13
245,27,18,89,5,13.875961301826154,13
246,39,18,72,5,13.872487814202465,13
247,100,30,103,9,13.84787526631238,21
248,47,12,57,4,13.842676334165546,8
249,55,17,103,4,13.826956770005326,13
250,47,18,112,6,13.820833793363406,12
251,38,14,112,3,13.819485047030156,11
252,97,11,112,2,13.794615799527316,9
253,7,19,76,7,13.7913560010183,12
254,87,11,85,3,13.78530468452242,8
255,62,17,57,4,13.757275808574349,13
256,95,37,88,11,13.752013257016605,26
257,97,10,27,4,13.735152835550473,6
258,63,25,31,7,13.714594813504087,18
259,34,10,95,3,13.704508911135058,7
260,57,28,5,8,13.702708831126637,20
261,92,10,25,3,13.698642336458672,7
262,8,12,108,3,13.645968521702336,9
263,34,18,60,5,13.644836415292458,13
264,22,13,27,4,13.578238998395374,9
265,103,18,60,5,13.575363139165225,13
266,41,19,84,6,13.556150264603875,13
267,80,10,6,3,13.522871173076231,7
268,13,27,29,9,13.513958263485302,18
269,55,13,112,3,13.49840576791747,10
270,30,32,63,10,13.49817196218878,22
271,84,12,108,3,13.488009207908556,9
272,27,24,69,8,13.483104419153626,16
273,94,24,51,7,13.451133934243908,17
274,36,15,35,4,13.440272285829971,11
275,43,19,53,5,13.43803314299166,14
276,23,15,45,4,13.436468047997263,11
277,25,12,32,5,13.427877456338669,7
278,34,13,70,4,13.426554854854936,9
279,61,16,68,5,13.424919545398383,11
280,75,15,53,5,13.423496737137011,10
281,91,11,112,3,13.423237527272498,8
282,27,10,45,3,13.421070416218555,7
283,71,15,84,4,13.41321574412034,11
284,62,11,48,4,13.383804058498162,7
285,109,14,103,5,13.379278679742843,9
286,104,12,35,4,13.369677424437175,8
287,17,14,48,5,13.364907872446567,9
288,55,11,32,4,13.363639630093912,7
289,108,13,9,5,13.341841222661904,8
290,11,16,18,5,13.321280125838719,11
291,9,17,19,5,13.31812011403307,12
292,80,20,88,7,13.305539707805673,13
293,8,14,1,4,13.305141225086524,10
294,64,19,106,6,13.295192075566392,13
295,104,43,46,14,13.294982678813746,29
296,62,16,94,5,13.279649048908027,11
297,7,12,99,4,13.27451726078842,8
298,95,23,11,6,13.263288005084235,17
299,94,19,57,6,13.247205639863786,13
300,109,15,64,6,13.229745561488967,9
301,36,18,54,6,13.217744798273168,12
302,11,43,37,13,13.2020186509975,30
303,95,28,37,7,13.149042342745599,21
304,75,15,57,4,13.125107209592635,11
305,57,13,72,2,13.071458888669092,11
306,15,26,109,6,13.04731499295951,20
307,55,14,47,5,13.036465008068177,9
308,9,14,12,4,13.029002866437166,10
309,63,14,35,5,12.998216518752985,9
310,85,17,94,5,12.991600312687378,12
311,92,10,84,4,12.962976398847768,6
312,98,19,106,6,12.954874150336938,13
313,41,11,85,4,12.952472883327006,7
314,74,16,76,6,12.943701075259918,10
315,78,14,47,5,12.914558187890036,9
316,17,19,109,6,12.911257852793483,13
317,2,21,65,5,12.890027578518191,16
318,15,11,74,3,12.87032647402204,8
319,51,30,19,8,12.868592174220957,22
320,50,13,103,4,12.862167277055054,9
321,104,35,27,11,12.83724877330016,24
322,108,14,11,4,12.798974196396992,10
323,49,15,25,5,12.785517383168523,10
324,84,31,3,11,12.7817713508444,20
325,80,21,51,7,12.779249811641694,14
326,100,15,1,5,12.750379039232417,10
327,95,10,36,3,12.746346244298936,7
328,33,14,106,4,12.736963404825657,10
329,46,24,106,9,12.725492516069494,15
330,13,76,31,25,12.705633823012963,51
331,80,40,63,12,12.682443988429267,28
332,104,13,31,5,12.68196482072701,8
333,48,15,5,4,12.675358072710559,11
334,7,23,57,9,12.666461617234948,14
335,100,13,38,3,12.638482369277124,10
336,76,20,78,5,12.633094549652565,15
337,39,20,85,7,12.618845399489865,13
338,74,20,48,8,12.617131151527765,12
339,53,24,108,9,12.606603502458741,15
340,15,12,102,3,12.597866884640942,9
341,2,21,51,8,12.59592396910538,13
342,15,32,9,13,12.592578406206988,19
343,3,12,35,4,12.563400964105028,8
344,41,18,71,5,12.557773267008855,13
345,104,33,11,10,12.522578417808795,23
346,64,15,92,7,12.492372460791035,8
347,79,30,87,8,12.466071130940087,22
348,13,88,88,26,12.460305993563065,62
349,18,14,37,4,12.438833593443572,10
350,65,27,58,9,12.431650709075077,18
351,36,17,50,7,12.423703215189775,10
352,35,10,109,3,12.407562430544194,7
353,75,14,12,5,12.356839423121738,9
354,67,12,97,3,12.353467827440639,9
355,98,32,87,9,12.34409315331202,23
356,34,14,41,5,12.338786367505541,9
357,13,34,94,11,12.315280597409904,23
358,98,29,96,9,12.301665445316491,20
359,98,18,88,5,12.300728896947142,13
360,100,30,77,9,12.29767742568246,21
361,69,15,18,5,12.281407888329316,10
362,40,15,81,4,12.276802562895192,11
363,29,12,95,4,12.273663594494513,8
364,109,21,39,6,12.264003725130951,15
365,37,18,60,7,12.263894360602317,11
366,73,19,88,6,12.262693289910839,13
367,32,10,39,3,12.259008757767624,7
368,58,11,29,3,12.250932195859463,8
369,74,22,60,8,12.23030247671151,14
370,75,19,43,5,12.224767647713705,14
371,64,19,37,6,12.216856507558594,13
372,78,11,106,3,12.210243252742742,8
373,42,11,13,3,12.203174115394766,8
374,72,15,109,4,12.199392565133763,11
375,2,15,11,5,12.196157085843712,10
376,11,35,84,11,12.189911906563855,24
377,49,10,92,4,12.189632873694913,6
378,75,11,35,3,12.188091693345983,8
379,107,21,99,7,12.174640608684578,14
380,55,21,23,8,12.170945018647474,13
381,111,23,41,8,12.165817300484488,15
382,2,22,70,8,12.153236389251047,14
383,11,40,96,13,12.141028508791658,27
384,34,14,37,4,12.135815020075322,10
385,57,19,109,6,12.12921132196382,13
386,15,10,4,4,12.124220843420797,6
387,30,23,43,6,12.093512773684786,17
388,8,11,35,3,12.093356369533678,8
389,49,22,23,7,12.076835461637527,15
390,74,22,62,7,12.061308273026555,15
391,1,18,63,7,12.054495717242016,11
392,10,10,89,3,12.05123505380701,7
393,30,20,46,6,12.044164698044929,14
394,43,14,28,5,12.028046594555397,9
395,1,12,104,4,12.02010829271743,8
396,63,15,89,4,12.017404575838292,11
397,87,29,81,11,12.015356959966109,18
398,102,32,5,11,12.011851390558954,21
399,64,16,29,4,12.010507228979474,12
400,43,25,77,8,12.004670640929955,17
401,108,22,39,8,11.99851415989162,14
402,17,17,19,5,11.997198209588895,12
403,102,18,55,6,11.983866194974429,12
404,37,15,77,5,11.967604181160285,10
405,95,27,18,9,11.951490678023532,18
406,28,13,81,4,11.947384191502273,9
407,70,27,57,10,11.940546365796532,17
408,114,46,65,16,11.938229846486395,30
409,48,19,49,5,11.919274877330185,14
410,71,17,77,5,11.915487518479784,12
411,98,18,31,7,11.908816140421921,11
412,43,11,102,4,11.887502689329436,7
413,43,12,62,4,11.874169648552916,8
414,91,30,60,11,11.8675806643859,19
415,79,11,12,4,11.866943529008417,7
416,57,48,107,16,11.855072387955328,32
417,92,17,86,6,11.833574375075663,11
418,74,10,64,4,11.828764368523547,6
419,92,11,109,3,11.825872450184745,8
420,104,31,77,10,11.812621663747164,21
421,53,10,91,3,11.811611902058752,7
422,8,21,40,6,11.791921402372768,15
423,44,10,54,3,11.791894285038762,7
424,112,10,62,3,11.780471922009976,7
425,58,10,103,3,11.772908526311582,7
426,63,17,102,6,11.747209471298389,11
427,34,12,69,2,11.742698738008174,10
428,49,17,37,6,11.725281827231868,11
429,55,25,43,6,11.714024478286158,19
430,91,13,96,4,11.692854193124049,9
431,34,23,28,7,11.682170467841413,16
432,8,10,81,3,11.678569579324542,7
433,30,21,91,6,11.67565091724384,15
434,107,17,83,5,11.64452174042024,12
435,87,32,114,12,11.643172393817506,20
436,100,12,40,4,11.638460148115916,8
437,11,10,110,2,11.637838089699006,8
438,75,17,38,4,11.628826987325251,13
439,11,23,70,7,11.609570033059047,16
440,90,15,39,5,11.577976501423594,10
441,93,12,104,4,11.577012913737342,8
442,36,16,104,6,11.564722196156035,10
443,111,10,71,3,11.563837134119524,7
444,21,13,87,4,11.56318091799384,9
445,108,13,3,4,11.562059375800656,9
446,53,14,46,5,11.556347535591735,9
447,100,30,41,10,11.550572113391238,20
448,49,19,43,6,11.54116590657209,13
449,18,12,84,4,11.526678691260484,8
450,110,12,7,5,11.526061320417648,7
451,7,15,81,6,11.525413070422038,9
452,35,11,65,3,11.518581403700487,8
453,108,10,18,3,11.50838861651189,7
454,19,12,89,4,11.497390115995614,8
455,98,14,75,5,11.497093707313164,9
456,68,12,37,4,11.496583691347068,8
457,18,14,34,4,11.482941012320621,10
458,48,14,15,5,11.48279141653066,9
459,114,41,106,14,11.462749893343949,27
460,100,35,49,12,11.456244824909797,23
461,41,26,12,8,11.414617123719317,18
462,47,17,18,5,11.411676107822023,12
463,75,39,54,14,11.408133317564468,25
464,73,10,75,5,11.395199340418811,5
465,4,11,38,3,11.395009854616482,8
466,65,22,57,7,11.382534230045803,15
467,43,17,91,5,11.378756439291882,12
468,39,28,78,9,11.374922957505095,19
469,75,15,102,4,11.357902372458392,11
470,108,11,112,4,11.335603356831966,7
471,104,15,44,5,11.332078649569057,10
472,64,12,20,3,11.331308462604776,9
473,69,13,91,5,11.30407928014614,8
474,7,25,96,7,11.300422106484016,18
475,80,10,5,3,11.295210617596885,7
476,75,10,61,4,11.28385436329936,6
477,111,11,27,3,11.279710088837586,8
478,2,14,55,5,11.276816159574052,9
479,100,50,65,16,11.275226832418385,34
480,75,52,7,17,11.2746633859962,35
481,83,11,70,5,11.265042422069474,6
482,25,25,68,8,11.235607083018879,17
483,45,12,39,5,11.230688824941206,7
484,46,20,96,8,11.223825219116968,12
485,25,15,3,5,11.214634960222725,10
486,100,12,46,4,11.210309669403342,8
487,89,11,1,4,11.209011069389932,7
488,78,13,1,4,11.156578268103182,9
489,46,15,70,5,11.123543654837006,10
490,48,11,102,3,11.116814719382416,8
491,74,13,32,4,11.10166419198237,9
492,79,23,57,8,11.10038188990658,15
493,72,23,19,7,11.09841396569939,16
494,78,11,66,4,11.09651688512087,7
495,41,21,89,6,11.096465892840714,15
496,99,11,11,4,11.04788337752713,7
497,55,39,1,12,11.047135752371082,27
498,32,12,114,4,11.045874107216173,8
499,16,17,32,6,11.045561391190379,11
500,47,10,84,3,11.043789003229906,7
501,49,25,104,8,11.041712547533377,17
502,7,13,66,5,11.034566799554367,8
503,41,14,92,5,11.016394202336146,9
504,15,13,71,4,11.00914391321025,9
505,51,20,110,6,11.00014817045874,14
506,13,25,97,9,10.985857531237667,16
507,50,40,20,13,10.968930608298047,27
508,29,28,86,9,10.944229389007265,19
509,63,48,28,15,10.937243385325443,33
510,48,22,9,7,10.894666127588817,15
511,79,13,106,4,10.885501834452416,9
512,51,33,81,12,10.882761671799567,21
513,86,17,67,6,10.856458271232293,11
514,44,22,13,7,10.85202026233818,15
515,38,26,65,10,10.83463870682701,16
516,106,17,81,7,10.816681182916202,10
517,85,12,75,3,10.8046837733115,9
518,55,25,91,7,10.79161282762655,18
519,7,25,19,7,10.77597719817787,18
520,27,45,19,14,10.771280367688261,31
521,59,11,7,3,10.7712398180592,8
522,106,14,108,4,10.746780907865295,10
523,5,19,60,6,10.737943337535818,13
524,11,12,91,3,10.737589094202368,9
525,23,10,11,3,10.736120462067522,7
526,53,22,17,7,10.723383781136485,15
527,54,11,111,3,10.714143810197234,8
528,43,13,36,5,10.713552025008552,8
529,98,20,77,6,10.67353135151257,14
530,63,17,33,6,10.663903494014164,11
531,26,11,16,4,10.641463660095841,7
532,80,10,3,4,10.612199935723586,6
533,48,11,103,3,10.609852030111929,8
534,28,13,103,4,10.609246701939709,9
535,7,31,91,9,10.609100286101583,22
536,104,26,75,9,10.574353916694225,17
537,95,15,9,6,10.569002592922947,9
538,20,11,12,4,10.562633058497603,7
539,28,17,40,7,10.551622113062646,10
540,19,13,79,5,10.549815768045507,8
541,50,19,68,8,10.535408083030939,11
542,71,19,97,6,10.523533962196902,13
543,27,27,36,10,10.52334959933135,17
544,53,44,88,14,10.519286458480718,30
545,64,27,9,8,10.495957554452962,19
546,94,14,49,4,10.474432971630804,10
547,64,28,112,8,10.456743108722605,20
548,43,17,9,7,10.435718767902006,10
549,78,15,46,6,10.435320162132959,9
550,44,16,39,6,10.434810009571388,10
551,60,35,29,13,10.42089747006503,22
552,16,66,106,21,10.396735673348633,45
553,18,16,19,5,10.389246220506259,11
554,106,16,93,6,10.37915501513517,10
555,108,14,68,5,10.37834742902957,9
556,15,16,55,4,10.370537288257989,12
557,63,36,91,11,10.368824470659426,25
558,63,24,69,8,10.366973166191585,16
559,13,49,18,17,10.366295029596339,32
560,50,39,88,14,10.364860984100918,25
561,104,24,12,8,10.358875950961007,16
562,94,10,7,3,10.355621654064775,7
563,17,15,27,6,10.354549099588292,9
564,40,16,102,6,10.346146758066931,10
565,37,48,54,16,10.345446907641227,32
566,37,13,1,5,10.342164269053162,8
567,74,37,28,13,10.332746781815512,24
568,101,11,13,3,10.296727071239353,8
569,63,39,76,12,10.294441268951951,27
570,45,23,107,8,10.289536165233185,15
571,60,24,112,8,10.282975838759189,16
572,72,22,68,7,10.275897741373278,15
573,47,16,3,5,10.263621577333433,11
574,23,33,76,12,10.25965129445218,21
575,67,16,106,6,10.252161434234207,10
576,75,12,79,4,10.235318929578343,8
577,30,17,31,7,10.214096274935345,10
578,107,42,109,14,10.207364620313752,28
579,90,19,104,7,10.205908373136616,12
580,97,42,37,14,10.199316810918761,28
581,98,15,2,6,10.198603389321663,9
582,41,23,49,8,10.197367127109924,15
583,71,13,33,4,10.195530501937558,9
584,90,14,48,5,10.193948361787585,9
585,6,12,9,5,10.175309866966638,7
586,92,16,68,5,10.147306838487294,11
587,96,11,23,4,10.143008283174428,7
588,53,37,31,14,10.136338371296794,23
589,78,12,114,5,10.123963867745244,7
590,74,11,29,4,10.117149758840515,7
591,53,36,36,11,10.114732824687982,25
592,71,21,54,8,10.113144202991709,13
593,43,47,87,16,10.081696034391205,31
594,40,16,49,6,10.077718304922936,10
595,49,37,69,15,10.076509248182436,22
596,13,23,83,8,10.067954696106945,15
597,73,18,40,6,10.060776256522114,12
598,107,16,10,6,10.056408787562026,10
599,44,10,38,3,10.048373138060263,7
600,34,21,19,7,10.046525413696887,14
601,87,14,66,5,10.045799735479148,9
602,80,15,30,5,10.04303538527198,10
603,70,10,3,3,10.036631807498475,7
604,110,13,107,4,10.034721322746927,9
605,28,21,72,7,10.026127135244147,14
606,30,27,84,8,10.023299208241372,19
607,89,16,37,7,10.02210147471719,9
608,28,39,75,13,10.021801272184058,26
609,76,19,57,6,10.02019313359368,13
610,111,19,63,7,10.01291034850113,12
611,104,23,71,9,10.004145398382484,14
612,95,25,65,9,9.98743882075493,16
613,114,16,12,7,9.985343546707197,9
614,6,15,61,5,9.976861344972216,10
615,91,12,109,4,9.971568873148838,8
616,46,14,90,5,9.960134782518509,9
617,29,14,102,4,9.929141879190585,10
618,30,12,93,4,9.924014583109775,8
619,75,15,29,6,9.923300198268768,9
620,95,10,2,3,9.920312629990494,7
621,1,11,57,4,9.916035104284747,7
622,30,18,70,7,9.91397370546994,11
623,54,34,60,11,9.913747967452041,23
624,103,21,68,8,9.904114100948451,13
625,13,58,3,19,9.90267481421411,39
626,11,14,83,4,9.896151919094924,10
627,110,20,16,7,9.893450419413218,13
628,17,15,71,6,9.87407872077162,9
629,9,32,31,11,9.853659783790295,21
630,51,26,33,7,9.853114112635913,19
631,74,10,3,3,9.841517466916368,7
632,53,10,98,4,9.839111782848335,6
633,9,17,47,6,9.833363334347133,11
634,75,19,109,6,9.83076635543319,13
635,47,17,69,6,9.824856595944091,11
636,54,13,57,3,9.824315369895022,10
637,81,12,109,4,9.819741316945185,8
638,11,40,109,13,9.818197495918092,27
639,40,24,17,8,9.815776001763272,16
640,63,40,48,14,9.811551158222233,26
641,104,18,79,7,9.811537818194267,11
642,106,24,18,8,9.811498602513073,16
643,111,10,70,4,9.807746966138032,6
644,53,21,109,7,9.80472277411344,14
645,114,16,62,6,9.799890996069497,10
646,39,27,94,10,9.799678470541032,17
647,62,10,93,4,9.798162399200413,6
648,76,27,35,10,9.787487717233065,17
649,37,24,83,9,9.783726366978422,15
650,95,30,51,9,9.77001175442697,21
651,65,46,93,18,9.761587206731543,28
652,15,14,53,5,9.75938988218119,9
653,49,10,38,3,9.749746841362613,7
654,63,52,84,20,9.74716223383734,32
655,102,38,86,13,9.743964141517802,25
656,100,32,60,11,9.74032342180746,21
657,108,35,13,12,9.737626185873808,23
658,43,19,31,10,9.72085277355369,9
659,48,13,89,3,9.72016162500569,10
660,78,12,37,4,9.719307443467278,8
661,52,15,8,5,9.715026692600484,10
662,28,18,111,6,9.712251206209237,12
663,2,10,48,3,9.702269151070572,7
664,8,34,114,11,9.699231858321156,23
665,103,20,57,7,9.6845510516246,13
666,88,22,112,8,9.681832903230312,14
667,79,18,65,7,9.67569283729834,11
668,64,47,60,15,9.661747726131631,32
669,100,12,71,4,9.660687520316314,8
670,21,11,88,4,9.657212734415223,7
671,74,41,46,14,9.651769490532574,27
672,22,10,114,5,9.649313306364824,5
673,75,40,8,13,9.637059553855455,27
674,41,23,53,8,9.631953807885305,15
675,70,17,109,6,9.623350653501722,11
676,30,32,77,11,9.6218312337316,21
677,43,26,15,9,9.619130376922648,17
678,99,14,8,6,9.611065592860317,8
679,83,18,84,7,9.609473734372155,11
680,72,11,104,4,9.607945163400757,7
681,16,15,10,5,9.607669865815327,10
682,8,13,53,4,9.596286006275319,9
683,48,19,108,6,9.58641061639515,13
684,92,10,31,4,9.586105290347549,6
685,54,21,43,8,9.585604342831404,13
686,73,20,7,8,9.582485903794176,12
687,27,28,31,12,9.569633624787398,16
688,26,23,13,7,9.562123129591575,16
689,16,51,18,17,9.55830153014691,34
690,17,17,3,7,9.550337372259282,10
691,33,25,107,10,9.539564483245075,15
692,9,14,94,6,9.535806051453793,8
693,20,11,75,4,9.527707505687728,7
694,92,11,97,5,9.525917165548373,6
695,1,22,31,9,9.525804060927042,13
696,20,32,25,11,9.520523686179047,21
697,62,14,64,6,9.51528432405094,8
698,8,17,36,6,9.512360266950532,11
699,33,13,69,5,9.51115802646404,8
700,114,13,2,5,9.509158562417845,8
701,15,35,51,13,9.50362708455373,22
702,37,22,99,7,9.502759058160704,15
703,75,29,5,12,9.487135559909316,17
704,13,22,98,7,9.474726692398676,15
705,23,16,57,6,9.474501256774843,10
706,16,47,96,14,9.462953828826514,33
707,11,22,9,8,9.452997859790166,14
708,32,11,63,4,9.44232166344675,7
709,13,15,2,6,9.422510080465475,9
710,103,11,38,3,9.411620771765369,8
711,16,13,56,4,9.403965360554954,9
712,27,16,38,5,9.401601002215303,11
713,49,15,58,6,9.39673364981589,9
714,109,11,36,3,9.390936468630548,8
715,107,26,103,9,9.38527765474234,17
716,81,25,16,9,9.384174025613891,16
717,73,14,54,5,9.38293263538315,9
718,27,16,4,6,9.378715415982096,10
719,60,34,12,15,9.373381073655496,19
720,100,23,76,9,9.372708881255944,14
721,28,19,12,6,9.364727152511893,13
722,26,12,28,4,9.352858082446945,8
723,1,20,87,8,9.344990956449255,12
724,54,13,81,5,9.33569894630605,8
725,77,10,84,3,9.326879307665175,7
726,18,30,9,10,9.325317307118523,20
727,45,10,38,3,9.31109379184883,7
728,49,10,74,4,9.302425288754323,6
729,12,11,17,4,9.294611804735958,7
730,62,24,40,11,9.275726600058688,13
731,47,26,60,9,9.272798561110866,17
732,54,30,27,11,9.269071237772646,19
733,89,10,15,4,9.268075265281285,6
734,114,17,94,7,9.267018335328505,10
735,104,23,84,9,9.26674641219393,14
736,87,27,93,10,9.26552442404966,17
737,20,16,90,6,9.256704804618028,10
738,78,15,53,6,9.245467105519946,9
739,18,12,62,4,9.234800982158571,8
740,91,23,20,9,9.233435902067155,14
741,70,16,69,5,9.227346228401577,11
742,68,22,109,7,9.205767765094537,15
743,93,11,90,4,9.204947446014167,7
744,79,10,41,4,9.204704069079494,6
745,95,21,114,8,9.195016624238175,13
746,81,16,63,6,9.193429569946275,10
747,68,31,18,11,9.190826393650621,20
748,23,14,91,6,9.188824217195526,8
749,72,23,3,9,9.187493129539424,14
750,54,19,58,8,9.183988111852093,11
751,53,14,38,5,9.17946873124013,9
752,112,22,29,8,9.174610307731976,14
753,63,14,72,4,9.168022793278993,10
754,16,36,64,12,9.166098638825636,24
755,62,21,63,8,9.161474645821357,13
756,76,14,10,5,9.157178184443993,9
757,50,43,5,17,9.15604936984071,26
758,39,25,106,10,9.15596937875274,15
759,1,11,5,4,9.143641454097294,7
760,28,23,112,8,9.12022356401639,15
761,57,13,2,5,9.119959996501729,8
762,92,11,17,4,9.114563540800479,7
763,109,15,31,5,9.11388757240418,10
764,58,11,45,4,9.091525705777382,7
765,94,12,75,4,9.080901166069646,8
766,95,34,8,13,9.07920947405897,21
767,53,21,3,7,9.076818822513886,14
768,57,16,40,6,9.075047590769481,10
769,80,39,107,13,9.074881524481428,26
770,49,14,55,5,9.07453979611351,9
771,44,29,86,10,9.073857704921485,19
772,35,16,45,7,9.040031591861496,9
773,91,25,39,9,9.014113578195186,16
774,5,15,36,6,9.008614310253613,9
775,30,30,88,12,9.008031571554385,18
776,85,19,50,7,9.007921978503543,12
777,8,64,5,24,9.002251377410767,40
778,1,25,65,10,9.00217902882169,15
779,38,10,72,4,8.999506480702252,6
780,78,15,80,5,8.990142670025016,10
781,48,10,81,3,8.9896961045111,7
782,97,18,36,7,8.970668153566256,11
783,34,19,103,6,8.970243702574694,13
784,47,20,114,8,8.969382880850313,12
785,27,27,53,9,8.968048711845617,18
786,11,14,81,5,8.967824856070829,9
787,11,34,41,11,8.953991407123153,23
788,18,45,39,16,8.95168677836069,29
789,87,33,91,11,8.944507965742199,22
790,73,11,70,5,8.94135129372028,6
791,51,26,74,8,8.938947542412071,18
792,73,12,31,4,8.93891957013575,8
793,27,49,60,16,8.928785554550483,33
794,3,15,98,7,8.926309600802396,8
795,84,29,29,11,8.921575167609982,18
796,26,10,88,4,8.919527282390272,6
797,110,19,25,6,8.91770167255822,13
798,100,38,43,15,8.917383841964035,23
799,63,15,10,5,8.910939208335906,10
800,94,32,12,13,8.900231530265584,19
801,16,77,27,28,8.892060221661595,49
802,69,12,97,4,8.888377862411463,8
803,90,23,13,8,8.883764352926049,15
804,49,11,53,4,8.87692828941625,7
805,112,12,98,4,8.873991556640124,8
806,6,15,12,7,8.87368712650089,8
807,35,16,51,6,8.849945437990394,10
808,32,15,87,5,8.844155029434871,10
809,100,31,29,12,8.841937017793759,19
810,49,21,29,8,8.838275929133859,13
811,12,40,107,13,8.83024040628561,27
812,76,26,9,9,8.8289260170713,17
813,49,19,11,7,8.825733499359641,12
814,63,19,36,7,8.822881427312195,12
815,63,22,77,7,8.819997532642512,15
816,84,19,19,7,8.813396640852732,12
817,36,18,47,6,8.810892372607718,12
818,106,10,42,3,8.802546839644403,7
819,11,19,38,7,8.80025539192087,12
820,11,21,47,7,8.793803106813352,14
821,63,18,19,6,8.792724982250471,12
822,6,12,46,5,8.791371018033741,7
823,26,11,107,4,8.789963547813729,7
824,77,14,99,4,8.784719144285264,10
825,16,27,1,8,8.777340054296332,19
826,15,42,88,13,8.764269632154086,29
827,74,37,84,16,8.764103490564013,21
828,8,34,84,12,8.76285424467774,22
829,28,16,52,6,8.75730555636181,10
830,30,53,39,21,8.747392409319959,32
831,38,14,106,7,8.745019433529976,7
832,65,11,32,4,8.739314169667136,7
833,57,26,46,10,8.738900979302741,16
834,4,22,17,7,8.727735068009611,15
835,40,27,3,9,8.719928293728287,18
836,45,15,86,6,8.710518828201984,9
837,98,28,49,10,8.706969661782532,18
838,28,23,62,9,8.703867920620008,14
839,38,16,3,6,8.700552917920668,10
840,46,13,77,5,8.692557302357292,8
841,78,29,12,9,8.684165205333196,20
842,39,41,20,17,8.683414479878406,24
843,39,67,68,26,8.67961042805456,41
844,19,12,31,4,8.67684008479621,8
845,53,11,54,4,8.67028832638361,7
846,70,12,58,4,8.66252309250944,8
847,73,28,8,11,8.656865963639591,17
848,58,10,15,3,8.609651553934281,7
849,13,22,6,8,8.600067561462977,14
850,44,23,6,7,8.597523681350719,16
851,2,34,107,12,8.596357154255273,22
852,53,18,77,7,8.576780251337041,11
853,95,23,55,8,8.57500650986488,15
854,9,22,104,8,8.574493523715214,14
855,49,10,93,4,8.57216379677568,6
856,111,25,107,11,8.570266784296765,14
857,91,13,71,5,8.567246551132914,8
858,78,11,36,4,8.552435160203324,7
859,27,64,87,24,8.551512306551714,40
860,94,11,2,4,8.550586885180525,7
861,16,15,67,5,8.550473387804702,10
862,94,12,35,5,8.545638882275084,7
863,91,13,65,5,8.541931736396267,8
864,110,11,63,4,8.534985747455591,7
865,53,20,61,6,8.524850655507475,14
866,81,22,69,9,8.517997866855394,13
867,20,22,9,8,8.515923532058864,14
868,50,11,52,5,8.515472572504802,6
869,55,25,64,8,8.51293322653446,17
870,91,10,45,4,8.504304930616431,6
871,64,28,40,10,8.496071624321134,18
872,104,19,69,6,8.491359963005367,13
873,16,27,58,10,8.488429747726556,17
874,15,11,70,5,8.48414311669357,6
875,55,14,85,5,8.476039600481302,9
876,30,11,66,3,8.470012652510327,8
877,34,24,51,9,8.4699102284808,15
878,103,28,19,11,8.469047877005721,17
879,50,20,48,7,8.466418162124782,13
880,39,26,112,10,8.464674026518864,16
881,63,37,20,15,8.464473402081477,22
882,12,16,106,5,8.461406597257815,11
883,53,23,12,9,8.46079762480418,14
884,76,22,94,7,8.458632259785002,15
885,95,14,96,5,8.450373982592184,9
886,8,24,41,8,8.446748885751393,16
887,96,24,70,11,8.437417991026258,13
888,55,20,114,7,8.432483182241096,13
889,88,15,103,6,8.430464226549896,9
890,73,19,90,7,8.424101991862461,12
891,41,12,102,4,8.421036787338002,8
892,13,23,103,7,8.418538595487911,16
893,109,14,67,7,8.410228891959635,7
894,29,21,34,9,8.399162943605287,12
895,62,25,68,10,8.382615098007266,15
896,58,29,13,9,8.381428024864276,20
897,7,45,25,16,8.3728066183483,29
898,7,22,5,8,8.357081514884822,14
899,41,33,31,12,8.353957395244583,21
900,65,32,102,11,8.353467426988884,21
901,48,25,96,9,8.343995751105185,16
902,54,54,109,19,8.336552490351869,35
903,76,14,108,5,8.33452707348594,9
904,25,15,9,5,8.323455878342038,10
905,79,20,51,9,8.309517555811908,11
906,37,43,46,14,8.306667442353499,29
907,92,13,63,6,8.301235837359338,7
908,86,17,56,6,8.300855291965847,11
909,109,10,58,4,8.291034573977958,6
910,49,16,103,7,8.289554117063618,9
911,90,31,106,10,8.283845461248369,21
912,15,14,79,6,8.279617988476957,8
913,41,18,91,6,8.2766719527744,12
914,60,20,45,8,8.270932074255704,12
915,37,12,14,5,8.26646783507543,7
916,8,29,15,12,8.254756555500954,17
917,93,10,76,4,8.25053412937542,6
918,75,18,1,6,8.241769187322511,12
919,69,21,106,8,8.230262561693127,13
920,99,10,71,4,8.224966300288866,6
921,87,35,70,15,8.222879447071525,20
922,29,10,89,4,8.22283637871362,6
923,112,14,40,6,8.221202026655064,8
924,64,42,51,16,8.201880887276834,26
925,74,25,39,10,8.195535087876934,15
926,92,16,40,6,8.191919233506125,10
927,7,53,87,19,8.186933222272419,34
928,72,19,49,7,8.165643444811542,12
929,33,17,20,6,8.157924685534638,11
930,68,31,8,12,8.152272734975396,19
931,12,18,38,7,8.148426278473252,11
932,4,10,112,4,8.145974306589784,6
933,56,14,107,6,8.142413744294041,8
934,50,36,55,15,8.131693382626922,21
935,107,43,43,16,8.125440552299429,27
936,20,11,110,4,8.125291114928707,7
937,9,12,98,5,8.123745049728663,7
938,81,11,111,3,8.120062859865856,8
939,17,17,77,7,8.106011789729994,10
940,73,14,51,5,8.09774388932274,9
941,95,11,49,3,8.095998639719062,8
942,86,57,76,22,8.0850118495849,35
943,43,17,4,7,8.083539648296874,10
944,8,17,32,7,8.079749532998788,10
945,87,43,9,17,8.078706607204952,26
946,110,16,97,6,8.077466293642962,10
947,50,18,70,8,8.072010588554928,10
948,19,15,46,6,8.056646218005667,9
949,30,15,12,5,8.054443061149305,10
950,16,45,69,16,8.054291070790875,29
951,20,36,84,11,8.048616703285955,25
952,98,15,48,5,8.040930745507078,10
953,100,18,18,8,8.035989461751754,10
954,63,12,52,5,8.01519600341839,7
955,35,11,9,5,8.012816785902414,6
956,65,28,5,11,8.012091300535628,17
957,91,31,98,12,8.010154956050263,19
958,41,18,81,6,8.009042710590085,12
959,102,19,96,7,7.995631160966492,12
960,98,16,40,7,7.993416961646092,9
961,20,19,3,7,7.987586080022351,12
962,5,28,84,11,7.986435375626316,17
963,27,35,94,13,7.986020548938503,22
964,34,20,68,8,7.978044783319159,12
965,100,69,86,28,7.971641299719461,41
966,58,10,61,4,7.964357976226594,6
967,75,44,50,15,7.963443352466475,29
968,23,21,39,8,7.963088024258928,13
969,102,15,34,5,7.962391346680716,10
970,98,19,71,7,7.940784287039028,12
971,27,48,78,16,7.93006833114994,32
972,78,16,103,4,7.929047988565182,12
973,30,48,13,18,7.92615309985384,30
974,30,13,33,4,7.91339518812487,9
975,108,20,98,8,7.913100401728397,12
976,88,10,82,4,7.912578083642501,6
977,71,13,38,4,7.906029048659731,9
978,78,11,31,5,7.904414780494012,6
979,29,30,30,11,7.902898306652615,19
980,53,14,90,5,7.9010322992925905,9
981,17,16,29,7,7.899676305324428,9
982,3,18,94,7,7.8995884826671166,11
983,54,34,40,13,7.877426017050995,21
984,27,35,77,13,7.8745216976485,22
985,114,25,90,10,7.870165683504547,15
986,28,30,2,11,7.862984699152351,19
987,44,12,35,5,7.859665557157527,7
988,106,26,91,9,7.859341034872011,17
989,11,13,66,6,7.856337586346077,7
990,114,20,1,7,7.837742070296789,13
991,16,50,9,17,7.836196702611142,33
992,70,16,93,6,7.834949393241649,10
993,13,58,43,25,7.834617919431734,33
994,5,22,17,7,7.829641724195981,15
995,15,10,52,4,7.828284164082511,6
996,54,14,108,4,7.821734358546891,10
997,25,46,46,19,7.820401195025543,27
998,114,12,110,4,7.800316810979699,8
999,108,11,78,4,7.797957113003343,7
1000,107,31,31,15,7.788469010128701,16
1001,47,10,111,4,7.786638633209638,6
1002,16,40,76,18,7.786506155237847,22
1003,114,18,81,8,7.77743951670038,10
1004,92,14,114,4,7.774797164908201,10
1005,53,11,73,4,7.756297558195458,7
1006,98,12,30,5,7.75360326573728,7
1007,100,38,11,14,7.7524005573637345,24
1008,111,19,51,7,7.750696049131197,12
1009,28,29,68,10,7.748993038967358,19
1010,30,10,111,3,7.74442175449077,7
1011,44,11,84,5,7.741464370739859,6
1012,46,18,29,9,7.738693511487552,9
1013,76,12,72,4,7.731997605583369,8
1014,16,14,101,5,7.729447625525021,9
1015,11,37,57,16,7.727829388644561,21
1016,78,17,104,6,7.72449974280056,11
1017,16,98,39,38,7.7202369961493345,60
1018,72,29,27,12,7.712316498929215,17
1019,114,21,96,8,7.708209589747937,13
1020,98,42,86,17,7.705613124334454,25
1021,75,61,68,22,7.69823200491078,39
1022,86,28,1,11,7.696680317913666,17
1023,111,25,7,10,7.690323425771979,15
1024,76,39,68,12,7.690297930054157,27
1025,5,32,11,12,7.687442157533873,20
1026,8,38,9,17,7.672754136226992,21
1027,37,29,38,11,7.668156637885104,18
1028,37,24,96,10,7.665844925696507,14
1029,72,14,60,5,7.664629407768883,9
1030,27,29,112,11,7.661494705671576,18
1031,104,11,66,3,7.658809119364057,8
1032,104,39,60,12,7.65596663244094,27
1033,33,13,31,6,7.647223417443057,7
1034,70,11,60,4,7.646435749026204,7
1035,97,29,5,10,7.639418302115126,19
1036,28,28,3,11,7.638630473496032,17
1037,69,11,61,3,7.633216471104308,8
1038,71,14,27,5,7.6209744722933594,9
1039,60,32,69,14,7.6138451240077565,18
1040,41,27,77,9,7.599547839905652,18
1041,37,30,7,12,7.59861653018427,18
1042,18,20,36,8,7.594902878501233,12
1043,103,18,84,8,7.589982363677433,10
1044,72,10,36,4,7.585561627806544,6
1045,28,31,114,13,7.584853881328921,18
1046,3,12,85,6,7.584252500547151,6
1047,12,25,77,10,7.576465102864336,15
1048,53,31,112,14,7.574348903828081,17
1049,100,37,12,15,7.573615059890711,22
1050,75,23,49,9,7.565086245339052,14
1051,34,18,76,8,7.561119825945015,10
1052,39,20,103,8,7.555167426699789,12
1053,16,74,55,27,7.540678563620176,47
1054,85,10,46,3,7.538229298143683,7
1055,34,22,55,9,7.534603126846269,13
1056,33,16,7,7,7.5321884826380465,9
1057,41,24,19,8,7.531111873359516,16
1058,6,11,55,3,7.526848268362221,8
1059,41,17,17,6,7.526219064648913,11
1060,6,11,31,5,7.520489323813347,6
1061,65,17,66,6,7.515278237298981,11
1062,86,39,17,17,7.514722263451873,22
1063,85,11,47,3,7.51471835956732,8
1064,108,14,15,5,7.510530648484562,9
1065,107,16,61,7,7.509321940652872,9
1066,64,10,93,5,7.507177747442428,5
1067,7,21,109,8,7.493740572538848,13
1068,71,15,76,7,7.4875920550169335,8
1069,34,19,74,6,7.4794382394263454,13
1070,70,14,36,6,7.476080415111225,8
1071,18,25,65,10,7.467319094675642,15
1072,110,18,39,6,7.464111416570432,12
1073,45,12,53,5,7.463487107897499,7
1074,27,11,80,4,7.4617467678086795,7
1075,100,12,70,5,7.458777129644962,7
1076,11,12,71,5,7.444969376445687,7
1077,34,22,49,9,7.4445926572295,13
1078,6,24,16,11,7.439865172191104,13
1079,73,18,5,7,7.416873021801379,11
1080,36,34,41,16,7.412500474371831,18
1081,70,30,20,11,7.408681007686706,19
1082,20,11,94,4,7.40491165274963,7
1083,100,60,87,25,7.404280823590364,35
1084,43,45,86,17,7.4016094223364775,28
1085,75,14,76,6,7.401272000460674,8
1086,39,71,49,26,7.39496585590305,45
1087,10,15,28,5,7.394064388880875,10
1088,7,22,56,9,7.387479337914444,13
1089,16,15,92,4,7.376894869640722,11
1090,71,19,81,7,7.374213709282574,12
1091,13,48,23,21,7.373546879981892,27
1092,73,10,71,4,7.373234065194549,6
1093,56,12,88,5,7.371104573008601,7
1094,31,14,80,4,7.367135464628979,10
1095,25,16,33,5,7.365926272964513,11
1096,62,17,104,5,7.356292241509542,12
1097,109,45,8,19,7.345721442245663,26
1098,23,18,114,6,7.3449426375970175,12
1099,40,41,104,15,7.3422918945341555,26
1100,75,19,11,8,7.336654356306241,11
1101,78,24,34,10,7.336336560215486,14
1102,75,16,2,7,7.332326563651876,9
1103,78,38,87,15,7.33030021328082,23
1104,62,30,88,12,7.323841783087015,18
1105,70,42,5,17,7.323141246130925,25
1106,107,23,66,9,7.314401309911109,14
1107,78,28,3,12,7.304787220480845,16
1108,5,27,98,11,7.298838761636912,16
1109,43,31,40,13,7.287691070183644,18
1110,2,18,54,6,7.287492324178089,12
1111,23,18,17,7,7.286484354574564,11
1112,107,45,49,17,7.2846764816960015,28
1113,49,34,60,13,7.283728608313214,21
1114,30,24,38,8,7.275284679509272,16
1115,55,20,68,7,7.273979151335484,13
1116,107,34,62,15,7.2691324595311855,19
1117,62,10,96,3,7.268496266352457,7
1118,110,16,70,6,7.267896542251018,10
1119,20,17,98,6,7.267496359610289,11
1120,16,29,38,9,7.2658873126989665,20
1121,100,14,48,6,7.263809625362946,8
1122,75,19,81,7,7.259552889264536,12
1123,69,12,96,4,7.2527556906488675,8
1124,13,42,8,16,7.249552270590032,26
1125,19,32,3,13,7.248295900826971,19
1126,31,14,5,5,7.246607645789558,9
1127,34,29,87,11,7.243810943600305,18
1128,48,40,107,16,7.241941399148153,24
1129,114,27,40,9,7.240772461331045,18
1130,114,16,30,7,7.22328003108775,9
1131,16,49,46,18,7.215241172016058,31
1132,16,129,88,49,7.2150722340321485,80
1133,30,15,90,6,7.21256730381331,9
1134,98,14,93,6,7.212314028509714,8
1135,12,17,15,7,7.2052521825534805,10
1136,14,14,95,5,7.1971223272437035,9
1137,112,15,43,6,7.1893251112725824,9
1138,63,50,88,18,7.181466866993264,32
1139,98,24,29,9,7.180316216962127,15
1140,36,16,112,6,7.175574629533444,10
1141,30,13,61,5,7.169715355965248,8
1142,114,19,57,7,7.168179779176467,12
1143,17,23,60,9,7.159951280063795,14
1144,69,13,48,6,7.158814996268277,7
1145,19,18,108,7,7.157387609947201,11
1146,114,25,3,9,7.152889180930058,16
1147,27,29,103,11,7.148363895164129,18
1148,29,14,37,6,7.147246302868525,8
1149,97,26,51,9,7.145200913148905,17
1150,111,12,69,5,7.144443379259749,7
1151,33,13,78,5,7.142209395263028,8
1152,97,28,68,11,7.141635420047944,17
1153,27,39,15,17,7.136849333340005,22
1154,30,14,58,5,7.134101849433167,9
1155,62,11,38,4,7.131662703916968,7
1156,16,77,63,30,7.1283657008650145,47
1157,13,12,93,5,7.127658172301537,7
1158,72,21,77,9,7.125122343869388,12
1159,67,12,107,4,7.124134838046416,8
1160,57,10,35,3,7.121001943594234,7
1161,86,30,83,10,7.114862976089353,20
1162,45,33,7,13,7.114147641228474,20
1163,13,64,106,25,7.112707704477979,39
1164,40,51,55,19,7.109300201154281,32
1165,100,32,54,12,7.106265052685026,20
1166,1,10,45,4,7.100044646871245,6
1167,27,21,55,7,7.087211713998168,14
1168,104,27,3,10,7.0862804085077595,17
1169,63,15,12,7,7.082818499870268,8
1170,85,10,53,3,7.078145746437185,7
1171,72,17,103,7,7.076236466749699,10
1172,37,50,25,21,7.070541112352608,29
1173,99,18,36,6,7.061516094995866,12
1174,3,26,57,10,7.046184284491371,16
1175,72,11,114,5,7.039741382461145,6
1176,94,18,60,7,7.0351599724686675,11
1177,37,19,27,7,7.034792767414978,12
1178,80,10,43,4,7.031005677454651,6
1179,95,15,40,6,7.026458120737086,9
1180,87,27,53,12,7.022639512769474,15
1181,51,16,92,7,7.0168491500307955,9
1182,63,25,38,8,7.013791456544737,17
1183,100,26,102,9,7.010528546414991,17
1184,40,13,69,4,7.006717860168273,9
1185,30,26,37,9,6.995271622141733,17
1186,4,21,87,7,6.993636995986404,14
1187,62,15,5,6,6.992708759597396,9
1188,111,24,13,11,6.988942249892514,13
1189,17,20,55,9,6.987444025974706,11
1190,53,30,30,12,6.984989750265449,18
1191,15,12,6,4,6.9844847610743175,8
1192,57,22,43,7,6.979538883847618,15
1193,18,23,97,9,6.9651635757198616,14
1194,16,34,36,13,6.962309553248682,21
1195,102,22,87,8,6.961827622477074,14
1196,111,15,39,6,6.960860011711803,9
1197,32,18,104,6,6.9592250863895515,12
1198,91,19,50,7,6.959059467736711,12
1199,90,20,63,8,6.95733483322537,12
1200,109,30,55,14,6.952801077513015,16
1201,4,25,51,9,6.952578906103851,16
1202,58,20,88,8,6.951724289335951,12
1203,60,33,50,15,6.944865376684978,18
1204,99,12,88,5,6.93913123202866,7
1205,87,39,40,17,6.915208460636839,22
1206,58,21,68,8,6.904652684866492,13
1207,39,16,14,7,6.8922808961517115,9
1208,88,13,67,4,6.891493842154361,9
1209,18,17,112,6,6.887267609994756,11
1210,106,15,99,5,6.882359612487443,10
1211,16,43,91,15,6.876030290903075,28
1212,30,29,109,10,6.872627903843029,19
1213,34,12,38,4,6.871444823359393,8
1214,29,19,69,8,6.870269758663409,11
1215,60,43,4,19,6.864343045215706,24
1216,11,36,68,15,6.855439241001142,21
1217,7,99,51,37,6.849475435937798,62
1218,87,53,19,20,6.843160030750407,33
1219,75,28,47,9,6.839491111976113,19
1220,20,15,29,6,6.832826874702712,9
1221,95,25,106,9,6.830338155584791,16
1222,68,69,31,28,6.821634358561019,41
1223,49,14,18,5,6.821290318156634,9
1224,56,13,4,6,6.816273515879686,7
1225,50,22,102,10,6.809919414830619,12
1226,14,21,28,7,6.807027415542909,14
1227,28,14,108,6,6.806119384401875,8
1228,28,16,49,7,6.801284823553006,9
1229,2,14,38,6,6.792448237787319,8
1230,80,29,87,11,6.787984537789177,18
1231,79,15,108,5,6.783855393965387,10
1232,97,20,57,8,6.78123727728494,12
1233,8,10,42,5,6.780541784776636,5
1234,17,15,30,7,6.7793579151449554,8
1235,103,18,17,6,6.777134032154198,12
1236,65,43,29,17,6.767708276680646,26
1237,86,82,96,32,6.75704159555934,50
1238,51,64,63,28,6.753726451822532,36
1239,39,43,88,17,6.751316626963761,26
1240,33,17,50,7,6.750798742645289,10
1241,63,27,109,12,6.749986635160673,15
1242,94,10,71,4,6.748460655059323,6
1243,45,13,68,5,6.747691137383074,8
1244,100,23,74,9,6.742923050259366,14
1245,104,16,19,6,6.742171792497148,10
1246,41,13,80,5,6.741244434437033,8
1247,15,20,69,7,6.736896270525394,13
1248,74,38,96,14,6.7318287322523656,24
1249,30,32,55,12,6.725062001131899,20
1250,103,13,94,6,6.717236128190117,7
1251,28,35,97,13,6.716635909782017,22
1252,86,115,51,49,6.705427698133431,66
1253,83,15,74,7,6.703298030488861,8
1254,63,25,23,9,6.701335055503619,16
1255,64,38,31,15,6.680717740842574,23
1256,30,35,3,12,6.678994379061112,23
1257,23,31,68,14,6.6769594800553715,17
1258,34,34,86,14,6.6743605007457365,20
1259,14,15,88,6,6.669368246830069,9
1260,85,20,54,7,6.664179187550934,13
1261,19,13,80,5,6.657036501175089,8
1262,83,11,71,5,6.6562053803338666,6
1263,71,19,37,8,6.653996053488666,11
1264,32,26,5,10,6.647447060451906,16
1265,76,51,51,19,6.64314149833777,32
1266,102,19,88,6,6.636908554010762,13
1267,74,16,71,7,6.635644376222863,9
1268,4,30,65,12,6.635600395573753,18
1269,68,61,87,24,6.632496531982399,37
1270,39,22,37,9,6.6321566948630455,13
1271,47,43,13,17,6.6302542913878515,26
1272,98,29,63,12,6.629039814212708,17
1273,39,102,51,41,6.628453471772387,61
1274,25,48,5,19,6.626414170343125,29
1275,102,12,77,5,6.618078815941925,7
1276,70,18,64,6,6.6150540525041945,12
1277,70,15,29,7,6.61208942766715,8
1278,11,25,35,10,6.609898653259957,15
1279,71,52,13,22,6.6022668326221785,30
1280,73,16,13,6,6.598047492921335,10
1281,41,14,90,6,6.596764805214359,8
1282,49,33,3,14,6.592008597219497,19
1283,86,29,73,13,6.584732384148775,16
1284,27,11,101,4,6.582303845846215,7
1285,84,28,57,13,6.577348977317855,15
1286,53,26,114,11,6.571088082289225,15
1287,78,29,69,12,6.570244276121929,17
1288,75,31,63,13,6.570041946714362,18
1289,74,15,91,6,6.5630560139016625,9
1290,112,15,30,5,6.562692428407154,10
1291,64,22,19,7,6.560999233342087,15
1292,55,26,97,10,6.55988722490137,16
1293,85,15,65,6,6.556919781757104,9
1294,106,32,23,15,6.549055396089183,17
1295,58,16,112,7,6.5464579572728105,9
1296,39,30,77,13,6.543255167179636,17
1297,81,48,13,18,6.534046463710123,30
1298,87,63,37,25,6.532950417511036,38
1299,94,14,34,6,6.531647534575397,8
1300,91,13,80,5,6.531108694088667,8
1301,102,12,38,3,6.529266346603467,9
1302,44,16,64,6,6.52641817446092,10
1303,13,84,87,32,6.521909690525375,52
1304,98,16,12,6,6.5172917110234705,10
1305,60,20,66,7,6.5151715619171755,13
1306,55,66,65,27,6.5120252706716855,39
1307,74,29,55,12,6.5036195464677915,17
1308,13,25,76,10,6.503302760367724,15
1309,90,11,102,6,6.502237322589013,5
1310,112,28,76,12,6.4984423567384235,16
1311,80,10,77,4,6.4777469157069785,6
1312,98,11,68,4,6.469927695975062,7
1313,35,12,15,6,6.467296765301501,6
1314,11,15,10,6,6.454288934219358,9
1315,8,20,91,8,6.453847873736635,12
1316,93,28,54,10,6.453790444084362,18
1317,68,16,33,6,6.451134609706935,10
1318,29,29,15,12,6.442607839265635,17
1319,69,18,94,7,6.432434124144731,11
1320,89,15,74,6,6.429670108852098,9
1321,75,21,100,10,6.42687784088126,11
1322,96,23,80,9,6.423400971659434,14
1323,84,28,48,11,6.421668889523295,17
1324,41,48,86,18,6.421498587390495,30
1325,61,10,23,4,6.419517618014351,6
1326,29,23,68,9,6.416741070326833,14
1327,7,20,62,8,6.416308867276496,12
1328,64,38,65,16,6.415105269042925,22
1329,91,18,54,8,6.414686940093471,10
1330,48,21,55,8,6.406579400537662,13
1331,80,20,37,8,6.401050818487377,12
1332,79,12,49,4,6.395374558799645,8
1333,54,62,70,25,6.393751574298834,37
1334,86,38,48,15,6.392497095701149,23
1335,33,13,96,7,6.392035038140804,6
1336,28,16,27,5,6.382931621067466,11
1337,16,115,87,46,6.382226249967047,69
1338,70,20,98,7,6.375551069484688,13
1339,72,18,17,7,6.374145428769875,11
1340,33,15,102,6,6.371524301983967,9
1341,56,10,37,4,6.3674406628794715,6
1342,7,24,46,8,6.3620461131037525,16
1343,64,19,43,8,6.359617177052285,11
1344,30,16,62,7,6.3590034015997015,9
1345,92,13,27,6,6.356396578041118,7
1346,85,17,96,5,6.345069391274805,12
1347,15,15,75,5,6.343731652265016,10
1348,28,43,9,19,6.342362216975373,24
1349,28,34,7,13,6.33926057444583,21
1350,89,12,55,5,6.335775873531133,7
1351,77,37,51,16,6.3237027482982455,21
1352,86,23,52,9,6.314494525069316,14
1353,62,16,15,7,6.313402159690988,9
1354,3,19,50,8,6.302491398681792,11
1355,107,48,53,19,6.300738049492767,29
1356,43,16,8,7,6.297331254782461,9
1357,86,55,97,23,6.295568946747489,32
1358,28,36,102,15,6.294379170221607,21
1359,87,38,49,17,6.29306277034463,21
1360,100,18,84,6,6.292769168431847,12
1361,40,68,68,26,6.288399173895761,42
1362,12,15,4,5,6.2855790295334035,10
1363,29,14,93,6,6.281843189307094,8
1364,86,21,4,8,6.279484499549702,13
1365,55,24,70,10,6.272647161931926,14
1366,20,45,5,17,6.2703736334427855,28
1367,15,12,95,5,6.265255655621168,7
1368,107,65,55,27,6.2629651896189,38
1369,48,10,46,4,6.2577441282220505,6
1370,38,15,57,7,6.244977724558426,8
1371,37,49,63,19,6.239339617220506,30
1372,114,48,5,20,6.2376335334787205,28
1373,95,10,94,5,6.229015093991729,5
1374,28,37,70,15,6.2149266559981875,22
1375,114,24,70,9,6.214622620602992,15
1376,35,15,84,6,6.209299301194259,9
1377,108,26,88,10,6.206778138596414,16
1378,50,30,71,13,6.204695227712774,17
1379,74,28,70,13,6.203999405338759,15
1380,63,28,2,12,6.2000184918514885,16
1381,13,73,40,31,6.184837754544506,42
1382,47,17,28,7,6.182374184386464,10
1383,80,10,93,5,6.175234905241023,5
1384,13,47,36,18,6.167141158071527,29
1385,104,58,28,24,6.161167829833448,34
1386,23,25,100,10,6.160200190912252,15
1387,50,11,81,5,6.158903696641053,6
1388,100,32,7,13,6.153012622391108,19
1389,114,48,68,20,6.151577271829131,28
1390,73,24,74,9,6.15033234594065,15
1391,76,17,48,6,6.130488708954145,11
1392,63,18,66,7,6.119936177330313,11
1393,81,13,31,4,6.1171597913254,9
1394,10,13,48,5,6.110914502877383,8
1395,90,12,7,5,6.108519045195328,7
1396,98,30,76,12,6.108080609901331,18
1397,84,12,15,5,6.098921486728436,7
1398,62,16,69,7,6.098141811871047,9
1399,11,25,103,9,6.096644925623905,16
1400,54,11,47,5,6.095812400128515,6
1401,96,14,108,6,6.092516088942797,8
1402,49,32,51,13,6.089422332353599,19
1403,9,26,84,11,6.089357364465301,15
1404,60,33,15,14,6.08275874538289,19
1405,23,13,102,6,6.080684731147933,7
1406,3,11,90,5,6.078153120016463,6
1407,55,22,77,9,6.0702404998734645,13
1408,23,27,41,11,6.068042449918643,16
1409,98,22,84,8,6.0610062755899206,14
1410,41,22,28,9,6.053005216366935,13
1411,20,22,68,10,6.05097914081471,12
1412,63,24,18,9,6.046455003215185,15
1413,62,30,51,12,6.046321991251018,18
1414,8,62,63,27,6.040704829296191,35
1415,104,41,55,17,6.036207114699971,24
1416,7,24,98,9,6.033686003781979,15
1417,26,10,68,4,6.030745942778483,6
1418,29,15,48,6,6.020141509256065,9
1419,27,18,35,7,6.016767935838183,11
1420,16,37,53,14,6.0109581007292086,23
1421,107,69,104,28,6.010771127855349,41
1422,65,51,9,20,6.006217714596818,31
1423,106,47,5,18,6.005839560090041,29
1424,57,26,63,12,6.001123193099421,14
1425,94,21,54,9,6.000772945562414,12
1426,28,18,29,8,5.991947603875371,10
1427,114,25,31,11,5.991876520395493,14
1428,27,57,86,23,5.9916581904627915,34
1429,87,28,97,10,5.983886061129735,18
1430,94,17,37,7,5.9815536162143665,10
1431,30,15,72,6,5.981031131976352,9
1432,71,13,109,5,5.977466642753509,8
1433,16,52,3,20,5.976983247695229,32
1434,64,20,18,8,5.974775055211903,12
1435,78,30,8,12,5.971195592839112,18
1436,47,16,81,6,5.96783503011096,10
1437,97,18,40,7,5.96691841614039,11
1438,39,34,29,16,5.9660900499545715,18
1439,104,46,50,18,5.958647190439788,28
1440,97,12,10,6,5.950831581917697,6
1441,27,56,65,22,5.9505220277082325,34
1442,28,15,53,6,5.945744364633269,9
1443,16,48,17,17,5.940232340982307,31
1444,53,26,104,11,5.936620222245529,15
1445,73,20,114,8,5.924435121305104,12
1446,61,18,60,8,5.922750219418491,10
1447,78,23,7,11,5.919551023484508,12
1448,54,84,88,34,5.915269494128592,50
1449,90,15,80,5,5.915216102688404,10
1450,37,22,110,10,5.913666685850416,12
1451,16,131,107,50,5.902027392860027,81
1452,54,18,3,8,5.900167075724968,10
1453,38,10,98,4,5.899897776783364,6
1454,75,45,9,18,5.89399328159944,27
1455,101,15,68,5,5.891939886749792,10
1456,65,52,40,22,5.89106233992842,30
1457,37,11,3,5,5.8897383384754045,6
1458,17,16,43,7,5.8888013330711,9
1459,10,15,57,5,5.8872808270615,10
1460,75,17,108,7,5.88550634585497,10
1461,46,12,36,5,5.882094180819337,7
1462,28,12,31,5,5.876337878232255,7
1463,51,19,91,7,5.873980399232273,12
1464,55,18,98,7,5.870446924304782,11
1465,54,36,95,16,5.865979569344116,20
1466,18,31,8,11,5.865710785121709,20
1467,34,17,7,7,5.86350495140184,10
1468,7,21,112,8,5.863389950487476,13
1469,104,52,51,19,5.856995324327739,33
1470,75,16,93,7,5.854064268882733,9
1471,80,12,79,6,5.851472407179259,6
1472,65,17,14,8,5.850273562995321,9
1473,13,40,69,16,5.843363292908417,24
1474,16,23,93,11,5.842811946264205,12
1475,54,29,49,12,5.8414712309316155,17
1476,88,13,66,5,5.838752373213262,8
1477,8,34,57,13,5.837314748465126,21
1478,63,40,13,17,5.836981602703613,23
1479,30,49,60,17,5.831314754464257,32
1480,13,49,25,22,5.827601447712149,27
1481,8,37,93,16,5.8241714732303524,21
1482,86,32,103,12,5.822946833329548,20
1483,86,56,75,25,5.819454003755878,31
1484,79,13,20,5,5.810117746469002,8
1485,73,20,109,8,5.807578339260896,12
1486,8,19,98,7,5.806615359942182,12
1487,10,11,106,3,5.803672894932928,8
1488,91,19,31,7,5.801858258461762,12
1489,11,21,17,9,5.800640520347571,12
1490,48,13,19,6,5.7924314405882,7
1491,62,19,11,8,5.789369247630062,11
1492,34,21,48,9,5.788285695597517,12
1493,17,21,9,9,5.788074839959892,12
1494,104,16,81,8,5.786821230718973,8
1495,47,20,15,9,5.776315263541678,11
1496,15,18,50,7,5.776077652807674,11
1497,23,45,60,18,5.772794691627653,27
1498,61,10,54,4,5.763750710129661,6
1499,49,30,77,11,5.759883489906799,19
1500,80,15,68,6,5.759836210772856,9
1501,64,32,63,14,5.757572899301187,18
1502,58,13,53,7,5.7565593826386765,6
1503,11,34,19,13,5.756316664639484,21
1504,23,13,47,5,5.755142063292812,8
1505,36,12,77,5,5.751140829309577,7
1506,50,25,18,11,5.745370532916838,14
1507,100,25,114,10,5.743860264273013,15
1508,25,42,106,16,5.737688222420903,26
1509,13,50,64,23,5.733384315133941,27
1510,107,31,47,13,5.730039668040248,18
1511,55,40,54,18,5.729162102948165,22
1512,45,14,9,5,5.727853500458992,9
1513,25,26,51,11,5.726135112848954,15
1514,93,11,9,4,5.723540166631908,7
1515,69,16,12,8,5.715951067980107,8
1516,54,23,72,9,5.711828677342122,14
1517,53,17,62,7,5.701449545318571,10
1518,70,10,32,5,5.692479372096221,5
1519,35,21,40,8,5.68914021357686,13
1520,76,17,114,6,5.686109810518634,11
1521,102,10,95,4,5.685319962340827,6
1522,94,10,25,5,5.671887186214522,5
1523,16,31,99,13,5.665818337043016,18
1524,54,11,82,4,5.664278302313932,7
1525,16,37,84,15,5.660913981238355,22
1526,25,36,88,13,5.660869431868405,23
1527,8,74,87,31,5.658285597120998,43
1528,30,13,2,6,5.655225265692614,7
1529,46,31,75,13,5.65470539949331,18
1530,20,44,16,16,5.653886889078915,28
1531,4,10,97,4,5.649870700339142,6
1532,39,13,97,5,5.649731064357224,8
1533,29,37,19,14,5.646461013632089,23
1534,108,13,38,5,5.644414418783651,8
1535,78,47,51,22,5.638766096914629,25
1536,109,16,46,7,5.636528034552761,9
1537,64,43,86,18,5.632716173751325,25
1538,78,16,20,7,5.629467930549495,9
1539,19,10,5,4,5.623378775596124,6
1540,95,26,50,11,5.619957219349118,15
1541,68,26,91,12,5.619466372772095,14
1542,102,16,98,7,5.616900846312717,9
1543,65,29,76,10,5.61682780221381,19
1544,23,11,10,5,5.611414438981723,6
1545,72,15,12,5,5.594419997217227,10
1546,80,17,64,8,5.593698551425533,9
1547,20,38,96,15,5.591064360306498,23
1548,69,38,86,16,5.577802432439769,22
1549,20,22,44,9,5.576158683247873,13
1550,7,23,38,10,5.575438881033765,13
1551,72,11,9,5,5.567587328744071,6
1552,86,98,88,41,5.562390170991595,57
1553,107,63,20,27,5.562332766197248,36
1554,31,10,95,4,5.558189159340279,6
1555,13,30,95,13,5.5569838085167085,17
1556,46,11,4,5,5.5562218746456535,6
1557,104,86,65,37,5.554661796165203,49
1558,8,44,46,20,5.5530537260963095,24
1559,69,16,54,7,5.552096999235809,9
1560,8,41,25,16,5.550067480025429,25
1561,36,53,31,23,5.5485644604686595,30
1562,25,18,84,7,5.546687618128964,11
1563,18,42,75,18,5.546579166688547,24
1564,44,11,70,5,5.543204446478317,6
1565,64,21,23,9,5.53887757595366,12
1566,8,11,85,4,5.538404103047142,7
1567,16,22,14,9,5.533520092369791,13
1568,64,11,102,4,5.525256448935211,7
1569,74,15,77,6,5.523098396212754,9
1570,89,10,84,5,5.518590211576737,5
1571,45,23,65,11,5.510611418282089,12
1572,95,19,83,7,5.510188596504651,12
1573,80,10,81,5,5.509744831821596,5
1574,39,32,38,13,5.50941856941641,19
1575,32,13,109,6,5.508051897308613,7
1576,2,13,40,5,5.504797437287725,8
1577,5,10,111,4,5.501968622126493,6
1578,58,28,69,13,5.500786187625181,15
1579,67,10,102,4,5.497246561771851,6
1580,15,19,78,9,5.495634846653291,10
1581,111,27,55,11,5.492663797248297,16
1582,51,14,89,6,5.490983680492761,8
1583,13,46,54,19,5.47948770363916,27
1584,16,99,8,40,5.477498125379748,59
1585,100,22,25,10,5.476003695191374,12
1586,57,14,98,6,5.474149624282838,8
1587,28,31,17,13,5.468605078583842,18
1588,31,13,74,5,5.468299370651388,8
1589,57,13,50,5,5.46070428512311,8
1590,8,19,38,8,5.45571555055501,11
1591,13,38,37,16,5.444485826742332,22
1592,107,24,102,11,5.4429592421544415,13
1593,65,50,20,19,5.436416455030899,31
1594,71,29,68,11,5.435653336862239,18
1595,42,13,69,6,5.432900919803655,7
1596,104,38,25,17,5.42238345531962,21
1597,2,26,106,11,5.4140126266560475,15
1598,4,11,58,4,5.405037105567138,7
1599,8,20,33,8,5.397787705463006,12
1600,6,14,106,6,5.390411966564587,8
1601,54,38,68,15,5.382447112107091,23
1602,100,22,109,8,5.379853421224188,14
1603,65,16,103,6,5.377768524309904,10
1604,76,20,29,10,5.371211242445575,10
1605,15,25,18,10,5.370261713586336,15
1606,84,36,39,16,5.369674486814979,20
1607,7,35,97,16,5.356987360153854,19
1608,15,12,96,5,5.353611172107388,7
1609,17,31,49,15,5.3513656262489135,16
1610,13,22,48,9,5.345621103460163,13
1611,78,18,50,7,5.342630350789609,11
1612,68,53,53,22,5.342360173932808,31
1613,97,14,102,5,5.335160623731833,9
1614,5,33,51,12,5.328986421528186,21
1615,54,36,90,15,5.316089112252218,21
1616,7,40,3,16,5.315954351050264,24
1617,12,21,34,9,5.31592171902971,12
1618,38,19,19,6,5.315551758815005,13
1619,86,15,61,6,5.314125600249345,9
1620,41,28,3,9,5.308183069174525,19
1621,58,13,47,5,5.305481766967035,8
1622,73,19,87,6,5.303982369774461,13
1623,77,14,81,6,5.303602497121728,8
1624,57,13,53,6,5.2956689882177095,7
1625,99,21,86,8,5.291638236148403,13
1626,100,50,27,22,5.287624363758572,28
1627,28,12,92,4,5.284547759707862,8
1628,62,13,109,7,5.284405260681897,6
1629,13,23,62,10,5.279557581763115,13
1630,88,20,6,8,5.272285617199486,12
1631,11,26,102,12,5.269694308768165,14
1632,34,11,1,3,5.259854618241466,8
1633,107,29,35,11,5.259758635892075,18
1634,35,11,31,5,5.255104723881268,6
1635,72,21,65,9,5.2525708680547405,12
1636,25,26,40,11,5.242222631716464,15
1637,52,14,16,6,5.238731564661998,8
1638,78,23,77,10,5.238454313487661,13
1639,91,21,25,9,5.236778929543698,12
1640,75,60,107,21,5.231874163862643,39
1641,35,11,5,5,5.226534281744125,6
1642,92,23,39,11,5.223931097826436,12
1643,108,28,87,12,5.223904520923723,16
1644,54,54,106,25,5.222938310920245,29
1645,7,101,88,43,5.220134457500585,58
1646,10,20,86,9,5.219152465496855,11
1647,19,17,81,7,5.218113087589113,10
1648,33,12,91,6,5.213867650447784,6
1649,16,79,100,32,5.211034078416436,47
1650,50,22,109,9,5.207842202449346,13
1651,63,21,43,9,5.207688448634705,12
1652,15,15,91,8,5.198642780775296,7
1653,78,27,49,12,5.198224201350136,15
1654,46,25,39,13,5.196853389468726,12
1655,57,11,77,5,5.195556204271688,6
1656,104,18,80,8,5.194103195079235,10
1657,40,13,113,5,5.1937263926866155,8
1658,6,10,71,4,5.19369227829273,6
1659,23,14,43,6,5.189120753246306,8
1660,75,17,97,7,5.1834390154874335,10
1661,91,12,48,6,5.179665478095687,6
1662,11,19,32,9,5.1696009211826786,10
1663,31,11,54,5,5.168002033532433,6
1664,65,29,96,13,5.165027076154164,16
1665,67,12,5,5,5.159840528973079,7
1666,35,16,28,8,5.153123660542294,8
1667,39,57,60,25,5.152802282703843,32
1668,106,24,9,10,5.150083731218856,14
1669,11,13,97,6,5.149154391162877,7
1670,13,17,70,7,5.142156998200086,10
1671,27,48,49,20,5.142147981794254,28
1672,70,15,71,7,5.1409333575718525,8
1673,72,17,8,8,5.137819960649828,9
1674,36,21,3,8,5.136055944816984,13
1675,107,25,77,11,5.133888332698846,14
1676,40,30,58,14,5.133397385337806,16
1677,64,14,33,5,5.132334361355241,9
1678,103,20,12,10,5.129139372345028,10
1679,64,10,76,5,5.126258276838511,5
1680,30,10,1,4,5.107240382060615,6
1681,49,14,33,5,5.095253781724572,9
1682,34,24,30,10,5.093231704876005,14
1683,34,15,5,5,5.091205514677904,10
1684,15,28,30,12,5.0836642167601935,16
1685,32,10,20,3,5.082163415292113,7
1686,3,23,64,10,5.0798483629114175,13
1687,104,38,100,16,5.07592182790552,22
1688,41,10,61,4,5.060781095904457,6
1689,7,16,10,7,5.0604070656519635,9
1690,100,27,55,13,5.057275002393836,14
1691,16,23,35,9,5.053981282073499,14
1692,95,20,75,8,5.05026015248493,12
1693,20,23,2,10,5.048117889239678,13
1694,34,34,8,14,5.045872609442448,20
1695,30,18,108,7,5.041583987630236,11
1696,40,16,91,7,5.034652795604085,9
1697,74,26,93,12,5.031462008142043,14
1698,112,12,34,5,5.029259987635679,7
1699,94,36,87,16,5.028702412089726,20
1700,47,25,86,10,5.026594655071246,15
1701,108,30,51,13,5.016985241457158,17
1702,55,19,18,9,5.012210431301632,10
1703,93,12,63,5,5.011120266810436,7
1704,112,17,94,6,5.010192110959227,11
1705,12,16,43,6,5.010092621024881,10
1706,39,35,43,16,5.006459842543767,19
1707,85,24,72,9,5.005644721261361,15
1708,102,13,83,5,5.00532757458449,8
1709,93,26,5,10,5.00446052682132,16
1710,100,25,34,12,5.004456878240623,13
1711,7,41,106,20,5.003800212982274,21
1712,51,23,96,10,5.001175453325252,13
1713,3,26,77,12,4.9989738181650925,14
1714,50,23,31,10,4.99199978599778,13
1715,63,19,94,8,4.988953899876627,11
1716,80,34,55,16,4.987967529735274,18
1717,37,73,86,32,4.980857284592114,41
1718,80,10,44,5,4.973541413806906,5
1719,98,11,23,5,4.9699651611390046,6
1720,27,21,114,9,4.967571693509975,12
1721,96,23,90,9,4.963939687748074,14
1722,85,10,64,4,4.96270118497494,6
1723,64,33,41,13,4.951397157092098,20
1724,20,12,100,5,4.948684351907279,7
1725,56,19,68,9,4.948132166753329,10
1726,80,29,106,12,4.946009667025369,17
1727,39,23,81,9,4.943832581007462,14
1728,40,15,78,5,4.942465399220725,10
1729,28,14,32,6,4.94214857785708,8
1730,49,11,71,5,4.940945789460408,6
1731,98,26,37,11,4.940519420053038,15
1732,100,72,51,34,4.9400020259394655,38
1733,63,17,85,8,4.93137224468223,9
1734,104,10,103,5,4.929333969571576,5
1735,86,40,36,17,4.92743325124,23
1736,100,77,107,36,4.925676488158577,41
1737,108,17,63,7,4.925158043652065,10
1738,74,56,106,24,4.924754963776783,32
1739,34,13,15,5,4.917498933434509,8
1740,47,14,100,6,4.9093021147864135,8
1741,18,11,29,4,4.907291190161112,7
1742,38,12,28,6,4.907164394244709,6
1743,13,43,77,18,4.906794574928387,25
1744,95,39,87,17,4.900981782159267,22
1745,23,16,77,7,4.892331871891687,9
1746,39,10,101,4,4.88974127810336,6
1747,27,11,46,4,4.887638683251713,7
1748,12,10,57,4,4.8872175245265135,6
1749,20,12,72,5,4.886775559464283,7
1750,94,12,18,5,4.884425557504234,7
1751,69,11,95,4,4.882909765417967,7
1752,63,20,79,8,4.882182316485546,12
1753,88,26,57,12,4.870812248870149,14
1754,11,88,86,38,4.868403647954056,50
1755,29,11,1,4,4.866934575588788,7
1756,5,10,89,3,4.862465640901744,7
1757,81,24,3,10,4.860040341211914,14
1758,100,31,112,14,4.858414274039207,17
1759,58,38,107,15,4.857008495705358,23
1760,23,46,88,18,4.856004139813016,28
1761,77,11,114,5,4.854209160918305,6
1762,97,12,32,5,4.8514593495768255,7
1763,78,34,60,15,4.85034428415885,19
1764,30,31,94,14,4.848071493453302,17
1765,39,17,83,7,4.8453860426526845,10
1766,83,20,64,9,4.840996077098241,11
1767,94,17,109,8,4.837565167214331,9
1768,8,15,67,6,4.831909846155588,9
1769,90,25,65,12,4.825235861891514,13
1770,31,19,25,9,4.8238393010997695,10
1771,14,15,54,5,4.820525855929134,10
1772,16,112,65,48,4.817496389223386,64
1773,74,11,85,5,4.812388004493801,6
1774,13,23,79,9,4.81127521378253,14
1775,104,34,63,15,4.811269466320185,19
1776,30,75,16,30,4.810756321281799,45
1777,89,14,68,6,4.806077051288233,8
1778,1,16,12,7,4.804302234326604,9
1779,75,22,96,7,4.801381492311929,15
1780,41,22,97,10,4.799957538599524,12
1781,34,14,88,6,4.799596567728279,8
1782,111,11,25,5,4.797175922879401,6
1783,52,13,20,5,4.795236183864799,8
1784,26,10,89,4,4.793448655016913,6
1785,5,12,10,6,4.788462999241516,6
1786,15,25,81,11,4.783657780343265,14
1787,50,28,30,12,4.780811288699288,16
1788,34,10,98,5,4.779193341125504,5
1789,9,12,5,5,4.777710715122406,7
1790,33,14,23,6,4.772846471482117,8
1791,90,13,70,6,4.771084444295363,7
1792,12,15,31,7,4.7706324645211815,8
1793,18,15,98,8,4.768289045671959,7
1794,55,16,94,7,4.767452995148847,9
1795,58,24,87,10,4.764267958873134,14
1796,13,28,84,11,4.762106527456084,17
1797,106,14,62,6,4.759729251582843,8
1798,18,40,87,17,4.756693590622039,23
1799,7,23,50,10,4.754905099968973,13
1800,25,16,77,7,4.745845616411634,9
1801,16,107,7,47,4.744562074788691,60
1802,76,46,107,17,4.736244325803578,29
1803,25,13,108,5,4.7274242554223145,8
1804,41,34,104,16,4.726865305600903,18
1805,75,32,31,15,4.721982750346428,17
1806,20,23,46,8,4.7087130702664775,15
1807,41,22,37,9,4.708031554461574,13
1808,111,13,106,4,4.703726078810505,9
1809,65,73,88,29,4.702916833614272,44
1810,43,16,103,6,4.701447170954387,10
1811,57,52,15,23,4.700638792267927,29
1812,88,27,38,10,4.6957798952347884,17
1813,40,51,39,21,4.685059105758992,30
1814,75,10,92,4,4.670779177266828,6
1815,109,19,38,7,4.6680162036882455,12
1816,11,26,98,12,4.667493378770945,14
1817,48,40,87,16,4.659491148242347,24
1818,25,15,47,7,4.65539023183265,8
1819,27,13,79,6,4.651583262533679,7
1820,15,16,1,6,4.649350840919032,10
1821,63,39,96,15,4.649023449526141,24
1822,80,11,69,5,4.638884395252672,6
1823,60,22,25,10,4.636282806493919,12
1824,106,15,110,7,4.633960085739291,8
1825,102,16,91,7,4.632859199025978,9
1826,65,13,89,6,4.632113459581725,7
1827,100,37,88,15,4.625717286575204,22
1828,51,44,109,16,4.624306959512695,28
1829,72,10,40,4,4.616108231770902,6
1830,85,20,68,7,4.615895850726344,13
1831,74,11,57,5,4.613445177041246,6
1832,75,40,37,15,4.608119905928104,25
1833,13,21,96,9,4.6080585972764805,12
1834,38,15,18,7,4.607415756411174,8
1835,108,19,60,8,4.601423271346147,11
1836,80,18,39,8,4.600479594629686,10
1837,27,11,58,5,4.599497662673681,6
1838,13,45,78,19,4.597389344309831,26
1839,50,32,96,14,4.592653394244439,18
1840,78,26,54,11,4.592600537057525,15
1841,9,15,37,7,4.590013554185222,8
1842,99,16,65,7,4.579704538683154,9
1843,7,23,58,11,4.575034525669341,12
1844,99,14,95,6,4.572737764013049,8
1845,99,16,104,8,4.5627492392393005,8
1846,74,23,109,9,4.56252527772352,14
1847,43,18,5,8,4.559277543830878,10
1848,70,15,23,7,4.554568026577774,8
1849,83,15,46,7,4.551826612706294,8
1850,99,18,15,7,4.5514613106187225,11
1851,93,29,28,11,4.540056078542574,18
1852,106,23,75,11,4.532198108241351,12
1853,52,10,55,4,4.531437489197339,6
1854,55,44,28,18,4.526943972884062,26
1855,74,23,50,10,4.520207268757788,13
1856,49,18,112,8,4.517911222226071,10
1857,63,64,54,27,4.513765725874224,37
1858,23,41,87,17,4.512300706037801,24
1859,64,28,8,11,4.503057942170461,17
1860,13,68,46,28,4.497540419141798,40
1861,55,47,60,21,4.496007919155317,26
1862,58,21,39,9,4.494576390875354,12
1863,87,43,41,19,4.493818686537543,24
1864,75,44,71,17,4.485645835804012,27
1865,7,46,64,21,4.481240056988839,25
1866,96,31,25,14,4.472832877552797,17
1867,37,18,32,8,4.466542082918524,10
1868,79,15,54,6,4.462814449138745,9
1869,19,14,85,6,4.456802611003388,8
1870,77,11,97,4,4.454901155383994,7
1871,95,44,16,20,4.4533785755833835,24
1872,50,14,19,6,4.445333605009822,8
1873,95,15,109,6,4.444131433700791,9
1874,37,39,70,16,4.433263990915909,23
1875,65,35,3,14,4.429509708162627,21
1876,23,14,20,6,4.427778675436007,8
1877,99,30,13,13,4.4209668288342625,17
1878,29,17,23,8,4.418393467914161,9
1879,84,30,70,13,4.416286467774103,17
1880,7,64,53,28,4.4162137369106675,36
1881,50,24,64,11,4.415510499418937,13
1882,86,118,5,51,4.415256493878053,67
1883,16,55,50,23,4.4137196395395515,32
1884,86,36,81,13,4.41370209716057,23
1885,51,46,11,19,4.412998244261856,27
1886,71,14,108,6,4.402422140240555,8
1887,20,53,28,23,4.401187083369335,30
1888,76,35,5,15,4.400670357773005,20
1889,99,10,54,4,4.379722874612374,6
1890,87,33,25,15,4.379098196808539,18
1891,50,17,72,7,4.375655689739112,10
1892,55,13,58,6,4.369004483506257,7
1893,40,23,23,10,4.3684233268033035,13
1894,74,15,9,6,4.367415226980933,9
1895,27,60,3,26,4.3667900702206,34
1896,49,17,70,8,4.364791676107706,9
1897,95,20,23,9,4.361896262769256,11
1898,64,31,71,12,4.3594731378011655,19
1899,19,11,83,5,4.359398192701059,6
1900,65,16,6,7,4.346168811124805,9
1901,70,29,65,11,4.343984179663613,18
1902,12,10,76,5,4.3418913384635776,5
1903,12,40,13,14,4.341371143569527,26
1904,62,25,19,10,4.338973871662798,15
1905,11,29,3,12,4.3360878284927775,17
1906,60,12,22,5,4.334241842742773,7
1907,95,19,41,8,4.332143979792181,11
1908,112,15,77,5,4.331879954372317,10
1909,72,25,87,12,4.328734545134901,13
1910,72,23,15,11,4.320242867974792,12
1911,4,22,40,10,4.316643149060887,12
1912,11,53,88,22,4.31528891426651,31
1913,97,23,17,10,4.313428551304965,13
1914,100,29,78,12,4.306504123439816,17
1915,106,27,53,13,4.3023196001359025,14
1916,37,45,55,21,4.3010010805888355,24
1917,30,15,52,6,4.285939641259887,9
1918,114,20,15,9,4.283176268910454,11
1919,91,30,107,12,4.264126621091651,18
1920,50,20,49,9,4.263153819097887,11
1921,100,32,63,15,4.262978075872103,17
1922,37,55,106,26,4.262507559544696,29
1923,8,57,51,25,4.2524567035694645,32
1924,86,62,104,27,4.250245918123389,35
1925,6,10,72,5,4.2485701532137155,5
1926,106,14,34,7,4.243674039664676,7
1927,16,44,71,18,4.24180487871631,26
1928,71,31,87,14,4.240167636343153,17
1929,12,14,58,6,4.239755277925304,8
1930,49,32,65,14,4.23543755941813,18
1931,29,11,104,5,4.232469176091443,6
1932,41,59,107,23,4.232356930880344,36
1933,17,12,62,5,4.230180767198623,7
1934,9,21,38,9,4.22415659668818,12
1935,71,11,44,5,4.2235243488394545,6
1936,62,18,102,8,4.223468853406059,10
1937,97,37,16,17,4.222715093786662,20
1938,28,29,100,12,4.22112967447295,17
1939,4,19,18,8,4.220670692754495,11
1940,17,20,63,9,4.21709530073227,11
1941,43,19,84,9,4.214619850887415,10
1942,52,10,48,4,4.211289472665269,6
1943,65,56,36,24,4.205692860728478,32
1944,103,18,3,9,4.204198112236471,9
1945,51,26,29,12,4.200611882951566,14
1946,112,12,103,5,4.192929666832575,7
1947,13,36,1,14,4.187998461115461,22
1948,23,27,25,12,4.182190113226041,15
1949,18,13,103,5,4.1752141807255745,8
1950,51,51,46,22,4.174462162624302,29
1951,107,53,23,24,4.172486813229879,29
1952,60,24,96,8,4.164982345638217,16
1953,83,40,5,19,4.163709904424498,21
1954,49,50,86,24,4.160999894397798,26
1955,19,10,2,5,4.15617878328422,5
1956,27,24,84,11,4.15605922191636,13
1957,87,119,107,52,4.155244492016435,67
1958,62,23,8,9,4.155008709022655,14
1959,99,12,17,5,4.148375833376951,7
1960,15,17,103,8,4.148119256013827,9
1961,50,77,28,33,4.143924434349459,44
1962,100,12,95,6,4.142851413596654,6
1963,23,49,65,23,4.142109485382538,26
1964,53,47,71,20,4.141303557057989,27
1965,30,28,64,12,4.139822872969585,16
1966,71,11,20,4,4.1364305573939655,7
1967,74,13,30,6,4.132114674773076,7
1968,83,15,50,8,4.131296712002355,7
1969,18,57,53,26,4.124925801617175,31
1970,60,35,41,17,4.124791635334078,18
1971,7,12,2,5,4.115660194227726,7
1972,16,65,49,27,4.115079751730522,38
1973,100,46,19,20,4.112454947141806,26
1974,97,30,63,13,4.107378727934814,17
1975,75,48,51,22,4.10605342104463,26
1976,93,14,109,6,4.10355895326709,8
1977,83,20,93,9,4.100880722204595,11
1978,20,24,35,10,4.098728722002916,14
1979,111,15,8,7,4.091375789332372,8
1980,86,27,93,12,4.090249999306011,15
1981,17,51,51,24,4.088673144397254,27
1982,36,11,19,5,4.088590218421681,6
1983,39,40,19,15,4.086515444510748,25
1984,78,17,98,8,4.084899624702052,9
1985,91,21,75,13,4.084376386784757,8
1986,16,48,109,20,4.074520158198362,28
1987,95,21,46,9,4.071848693893571,12
1988,7,68,31,30,4.069172309295859,38
1989,65,19,73,8,4.067312461469672,11
1990,20,12,38,4,4.067291998076448,8
1991,43,10,95,4,4.063398320607962,6
1992,56,11,39,6,4.061429150921742,5
1993,14,10,20,4,4.051966837258039,6
1994,32,10,40,5,4.050021677419865,5
1995,84,12,69,5,4.046782427990891,7
1996,1,10,43,5,4.0389767157587135,5
1997,63,41,114,15,4.037972989054357,26
1998,60,42,114,22,4.029174933224299,20
1999,16,154,86,64,4.027183016832997,90
2000,7,31,47,13,4.025431088719286,18
2001,28,25,19,10,4.019180575644085,15
2002,39,21,96,8,4.016816457185767,13
2003,34,17,67,9,4.015594495513433,8
2004,8,20,110,8,4.013172679497399,12
2005,5,18,77,8,4.010067732208506,10
2006,107,42,64,19,4.007940956634881,23
2007,31,16,112,6,4.001730552260444,10
2008,76,24,60,9,4.000770681345,15
2009,9,18,100,7,3.9953268600169216,11
2010,104,16,112,7,3.9943402412730644,9
2011,112,12,14,6,3.993235963114864,6
2012,51,85,65,37,3.990986526211724,48
2013,50,15,29,7,3.9901096227477506,8
2014,45,16,87,7,3.9869877249578156,9
2015,106,12,3,5,3.9869286680549902,7
2016,41,29,69,11,3.9797729258891983,18
2017,60,18,97,9,3.9792005525226397,9
2018,83,10,76,4,3.9791717561004964,6
2019,96,58,54,28,3.976827697325717,30
2020,96,12,14,5,3.975747798085741,7
2021,8,60,65,27,3.971547797186142,33
2022,84,11,94,5,3.968156665744439,6
2023,78,15,96,6,3.961613354196052,9
2024,10,21,84,9,3.9602546020658425,12
2025,40,23,37,11,3.9558411724945226,12
2026,9,15,91,7,3.9508212932565088,8
2027,67,11,104,5,3.95056976239549,6
2028,16,23,2,10,3.948584482321736,13
2029,35,19,43,9,3.946831407739411,10
2030,6,11,40,5,3.9442678680230885,6
2031,9,31,54,14,3.942845641758712,17
2032,84,22,76,10,3.938973343504664,12
2033,18,15,20,6,3.930360704025332,9
2034,5,28,2,12,3.9232778253201652,16
2035,16,51,62,20,3.918066009623022,31
2036,83,24,87,11,3.916710407315815,13
2037,75,29,64,13,3.9160007140392388,16
2038,55,30,63,14,3.9003771949656936,16
2039,107,44,3,21,3.8998073957748334,23
2040,77,13,58,6,3.8981506835692445,7
2041,1,25,54,11,3.8929886538978153,14
2042,40,17,5,8,3.8914877974226934,9
2043,3,22,112,11,3.881829625852149,11
2044,65,86,41,35,3.8730812369047185,51
2045,41,21,29,9,3.868637237264429,12
2046,43,27,109,11,3.867241547838042,16
2047,57,16,48,7,3.8589473829739176,9
2048,86,33,62,15,3.8579815466758753,18
2049,40,50,107,20,3.8570605527160113,30
2050,85,17,17,7,3.8507511089593,10
2051,28,39,76,18,3.848512689408892,21
2052,41,22,50,9,3.845767300582984,13
2053,18,23,31,11,3.8430258307678673,12
2054,47,11,12,5,3.8390154161535532,6
2055,65,22,34,9,3.8388096634466446,13
2056,3,22,18,9,3.8346712095468676,13
2057,38,13,46,5,3.8338597693432206,8
2058,11,45,54,20,3.830761670343523,25
2059,74,84,86,39,3.830438067887497,45
2060,98,33,107,15,3.8262612451674287,18
2061,4,11,3,5,3.8250463920918434,6
2062,48,12,75,5,3.823943527087417,7
2063,5,28,91,11,3.8146250930665184,17
2064,110,16,5,7,3.8138584796050914,9
2065,28,27,71,11,3.8126316435493948,16
2066,17,13,80,5,3.803939831522535,8
2067,89,14,53,7,3.799040779312777,7
2068,6,11,39,5,3.7966207547038127,6
2069,90,25,50,11,3.7900343777578605,14
2070,25,29,54,13,3.788520356553666,16
2071,108,20,27,8,3.788484389259807,12
2072,57,24,37,11,3.7883373383566465,13
2073,78,39,19,16,3.7879382183310883,23
2074,106,52,51,23,3.7850976424308236,29
2075,104,28,98,15,3.783243181516933,13
2076,29,39,87,16,3.78222935471684,23
2077,7,10,93,5,3.780231549016956,5
2078,114,47,13,24,3.775914918731173,23
2079,87,21,17,9,3.7733166042192914,12
2080,55,27,9,11,3.772633679119087,16
2081,88,87,51,42,3.772351956328509,45
2082,18,29,30,13,3.771793322983948,16
2083,102,14,17,6,3.765627490194506,8
2084,87,39,57,17,3.761962304644709,22
2085,52,13,107,5,3.753558475982526,8
2086,53,42,40,19,3.7429391558119973,23
2087,28,58,54,25,3.7427833536169195,33
2088,51,55,84,24,3.742451182902999,31
2089,15,31,7,16,3.741081293807919,15
2090,1,13,4,5,3.736039087851971,8
2091,13,84,55,37,3.7352248820559995,47
2092,60,59,40,26,3.735016412978284,33
2093,90,31,5,13,3.729228130116929,18
2094,15,13,40,6,3.725578311667862,7
2095,87,52,20,24,3.725119508640054,28
2096,20,25,41,12,3.722699653504378,13
2097,15,21,5,8,3.7147342263498166,13
2098,1,21,64,10,3.714096825641645,11
2099,112,10,35,5,3.7046440124812365,5
2100,16,62,5,25,3.7016615680953477,37
2101,23,19,28,9,3.6970356039584327,10
2102,80,16,38,8,3.695780114212427,8
2103,72,24,78,12,3.687490807799237,12
2104,65,23,109,12,3.6820630235649334,11
2105,38,21,84,10,3.669980206703245,11
2106,107,38,38,16,3.6695942987189007,22
2107,60,55,86,24,3.6676135242361485,31
2108,28,20,85,9,3.6675135147560156,11
2109,39,24,31,10,3.6610558433956144,14
2110,90,10,71,5,3.6561036030201173,5
2111,107,21,32,10,3.6546977761524615,11
2112,62,11,20,5,3.6532443670061325,6
2113,97,17,29,7,3.6527966127132636,10
2114,17,11,18,6,3.651905683853184,5
2115,74,50,65,23,3.6492230502429246,27
2116,9,13,23,6,3.6475995665029006,7
2117,14,10,70,5,3.647042134114854,5
2118,34,18,43,8,3.6439583345872713,10
2119,3,32,29,14,3.640968061507456,18
2120,6,15,86,6,3.637615954610379,9
2121,72,22,100,9,3.629040135098469,13
2122,55,51,5,22,3.6280461911141377,29
2123,39,55,27,23,3.6279610211789914,32
2124,43,19,18,10,3.6267699505365094,9
2125,80,26,28,12,3.6230809501897743,14
2126,112,15,79,7,3.621796379179409,8
2127,13,21,61,8,3.6146533376867587,13
2128,1,36,88,17,3.612486249864132,19
2129,69,17,39,8,3.602481693913607,9
2130,86,24,32,11,3.600337352350485,13
2131,34,23,79,9,3.5987779482770503,14
2132,75,57,16,26,3.5952902080350215,31
2133,106,14,57,7,3.593618983726931,7
2134,104,61,5,28,3.5931408944870395,33
2135,7,22,11,9,3.5909071733141316,13
2136,97,10,95,4,3.589432471334791,6
2137,14,18,11,7,3.5868100547047623,11
2138,88,62,5,29,3.583030843412137,33
2139,102,22,51,10,3.5799509862134142,12
2140,91,38,86,17,3.5760441594388466,21
2141,14,22,87,9,3.574657228905804,13
2142,25,19,43,7,3.573077352948072,12
2143,62,13,84,6,3.5672380956620375,7
2144,6,28,7,15,3.5631855242339134,13
2145,30,62,65,27,3.561917600098948,35
2146,60,12,79,5,3.555370933230572,7
2147,28,19,36,9,3.554999615354129,10
2148,34,17,104,7,3.5506468783547804,10
2149,63,94,86,39,3.5494783654033975,55
2150,41,28,109,11,3.5487793479544,17
2151,114,17,49,9,3.548728211191125,8
2152,40,16,19,6,3.5456118713031146,10
2153,33,11,70,5,3.5452850377562246,6
2154,13,31,19,13,3.5440871663273827,18
2155,47,29,27,13,3.543966431934925,16
2156,40,65,36,28,3.54008292473436,37
2157,28,32,30,15,3.539926425473853,17
2158,44,15,7,7,3.5352660207554565,8
2159,85,26,84,10,3.5349178606931724,16
2160,6,10,62,4,3.534555615892036,6
2161,93,17,25,8,3.5300397889756283,9
2162,37,55,50,26,3.5287986061002155,29
2163,76,37,87,16,3.5264683108233306,21
2164,17,11,57,4,3.5231240907929307,7
2165,27,19,98,9,3.521955911173927,10
2166,28,17,15,8,3.521005718300717,9
2167,53,14,100,6,3.5195197890566727,8
2168,8,32,27,15,3.515211617722362,17
2169,74,16,23,7,3.505315761927062,9
2170,25,27,109,12,3.5041369262347244,15
2171,73,17,98,8,3.503959852428817,9
2172,37,19,109,8,3.503844054679794,11
2173,39,14,102,6,3.5024293607442263,8
2174,38,15,54,7,3.502268170966973,8
2175,37,13,108,6,3.5019197237718505,7
2176,23,22,15,10,3.5001626021093504,12
2177,114,39,51,19,3.4973322349486455,20
2178,97,36,114,16,3.494809729950692,20
2179,20,26,109,10,3.4929177397438647,16
2180,6,10,54,5,3.4921987314309866,5
2181,14,16,5,6,3.490369625649153,10
2182,62,13,36,6,3.4895283270523723,7
2183,36,30,51,14,3.487460022502504,16
2184,41,16,45,6,3.485066668867455,10
2185,25,20,70,9,3.4845181159437417,11
2186,74,60,5,28,3.4699961467083478,32
2187,43,40,60,18,3.455693016886847,22
2188,33,23,5,11,3.4543275091771948,12
2189,37,21,23,10,3.4530437057487378,11
2190,112,14,114,7,3.4529529803290564,7
2191,7,94,86,40,3.4487912180291196,54
2192,86,63,46,26,3.447367416883425,37
2193,11,35,60,15,3.4471724802633115,20
2194,81,17,65,7,3.4470499311553464,10
2195,16,30,12,13,3.4325288291725853,17
2196,78,11,81,6,3.4320246992935286,5
2197,7,52,27,24,3.4308990471010516,28
2198,54,69,51,31,3.4308531323018583,38
2199,87,57,50,27,3.427638697835965,30
2200,108,10,69,6,3.4269138907252197,4
2201,4,12,37,5,3.4218717037755013,7
2202,28,18,78,9,3.417711658801108,9
2203,17,11,36,6,3.417273645156761,5
2204,79,22,11,9,3.411899322441769,13
2205,43,35,7,14,3.4056925239293445,21
2206,49,44,19,20,3.3946963082952384,24
2207,4,13,28,6,3.394082491248691,7
2208,73,10,104,4,3.3914910994647243,6
2209,88,82,107,35,3.388308151629917,47
2210,36,28,55,13,3.3833365772573503,15
2211,39,48,3,23,3.380759841466555,25
2212,70,20,75,10,3.379349863200628,10
2213,64,40,39,18,3.377216491809084,22
2214,13,78,60,33,3.3770875938219187,45
2215,72,23,11,11,3.3761818275237743,12
2216,73,18,96,8,3.3726024221333364,10
2217,37,22,100,9,3.3718369789109697,13
2218,13,56,28,26,3.3671896375902834,30
2219,69,27,57,11,3.367166221655226,16
2220,40,17,20,7,3.3649339637959685,10
2221,54,25,97,12,3.3648153427656786,13
2222,14,23,8,10,3.3634201583462153,13
2223,9,14,61,6,3.362078776884604,8
2224,14,17,106,7,3.360059412826618,10
2225,83,10,20,5,3.3478898251644154,5
2226,94,20,65,10,3.3472699488499056,10
2227,15,19,20,8,3.345564249700581,11
2228,13,42,11,18,3.34278030791396,24
2229,54,20,98,9,3.341408257498299,11
2230,68,13,5,6,3.3380294056441113,7
2231,80,17,48,7,3.3356230533911297,10
2232,60,23,38,11,3.3201484252433606,12
2233,98,14,97,7,3.3185319117606134,7
2234,97,16,84,6,3.3164282058099306,10
2235,60,31,75,14,3.313915862803686,17
2236,86,66,25,31,3.3097455853588773,35
2237,41,14,96,5,3.3088942892360294,9
2238,19,41,107,17,3.307359072836679,24
2239,114,21,64,9,3.3046667254482807,12
2240,47,13,61,6,3.3043540506366393,7
2241,76,17,79,7,3.2930359935936755,10
2242,34,45,107,19,3.2909922405162497,26
2243,55,15,35,7,3.2899027901624844,8
2244,68,31,78,14,3.285372327961684,17
2245,8,25,3,13,3.2773896333319046,12
2246,39,50,53,22,3.2771617260881887,28
2247,114,13,67,6,3.2746706512348394,7
2248,7,24,74,9,3.2574931437928867,15
2249,29,11,108,5,3.254331422994316,6
2250,114,47,25,20,3.2540864225169726,27
2251,100,38,15,17,3.252832450403916,21
2252,64,10,96,4,3.2470341038418864,6
2253,60,83,16,38,3.2452233159929404,45
2254,23,12,81,5,3.2407035870769985,7
2255,30,46,49,20,3.2399113520088854,26
2256,99,25,60,11,3.238194459102711,14
2257,107,49,36,23,3.2348387046482587,26
2258,3,14,97,7,3.230803945654674,7
2259,23,55,7,25,3.2229283053761706,30
2260,19,21,12,11,3.2219445095429298,10
2261,100,10,80,4,3.221630002984554,6
2262,17,16,74,7,3.211770551027834,9
2263,50,19,97,8,3.210625734622635,11
2264,60,47,31,24,3.209470727487928,23
2265,56,12,97,6,3.2085312435870676,6
2266,106,28,17,11,3.2039846830051175,17
2267,23,15,30,7,3.2022910560317883,8
2268,36,41,39,18,3.1998605067578247,23
2269,52,11,13,5,3.198313935058208,6
2270,16,57,37,26,3.194936337032898,31
2271,69,15,8,7,3.191300471105285,8
2272,17,22,90,9,3.1908484224220683,13
2273,11,10,58,4,3.1884299720547125,6
2274,54,31,114,15,3.18479213160143,16
2275,100,21,50,9,3.182484639829969,12
2276,103,16,69,8,3.178595710406121,8
2277,87,11,26,5,3.178365822043256,6
2278,16,34,47,15,3.1778605747552726,19
2279,106,25,60,10,3.1712615038081853,15
2280,74,17,12,7,3.170371170202151,10
2281,86,15,113,6,3.169695932976229,9
2282,75,19,4,8,3.1591429263358246,11
2283,86,21,82,9,3.158656091984634,12
2284,104,51,7,23,3.158219418007501,28
2285,3,18,76,8,3.150422222688238,10
2286,75,23,23,12,3.1487336010920157,11
2287,100,65,13,30,3.1478251869099063,35
2288,112,12,45,6,3.146093665017745,6
2289,114,23,9,8,3.1400252375404265,15
2290,15,36,11,16,3.1372782014701857,20
2291,76,15,2,6,3.135016863493124,9
2292,6,11,28,5,3.131247568187587,6
2293,30,55,19,24,3.125484844850005,31
2294,51,15,61,5,3.123205657151163,10
2295,34,26,11,11,3.1224893996672733,15
2296,76,26,27,11,3.1223771632911816,15
2297,23,36,8,16,3.1207627844807817,20
2298,28,36,48,16,3.118969087107223,20
2299,36,11,80,5,3.1158574211756562,6
2300,25,25,17,11,3.1106502600539123,14
2301,50,24,4,12,3.1105592371369686,12
2302,104,37,109,17,3.106483867605531,20
2303,111,21,86,9,3.1037611827633476,12
2304,86,38,77,17,3.1019167430803836,21
2305,92,15,60,6,3.101629065738577,9
2306,99,14,68,6,3.1001036150844774,8
2307,88,16,74,6,3.1000151762465453,10
2308,64,10,91,4,3.099347902087069,6
2309,104,34,54,16,3.0987784259955395,18
2310,6,20,87,9,3.097245674861366,11
2311,85,10,109,3,3.0954068823106935,7
2312,6,17,27,8,3.0947871865212933,9
2313,93,17,50,7,3.089216846430406,10
2314,107,59,37,27,3.087858660035621,32
2315,16,55,23,25,3.083500884703225,30
2316,66,12,28,6,3.0826665795427424,6
2317,55,16,62,7,3.0797392954165557,9
2318,97,23,104,11,3.078979141926911,12
2319,19,29,60,14,3.0741844930514635,15
2320,75,30,25,13,3.0695517335408993,17
2321,71,18,25,8,3.0644100067848137,10
2322,57,41,51,19,3.0641529465856614,22
2323,6,11,57,5,3.0567504666964656,6
2324,7,45,55,19,3.054761469393279,26
2325,29,26,78,11,3.0480277295430134,15
2326,12,40,3,17,3.043232035591344,23
2327,38,13,96,6,3.0422152322461717,7
2328,68,30,12,14,3.041358769608477,16
2329,30,22,79,9,3.0387025691085756,13
2330,25,39,65,16,3.0368934823131166,23
2331,86,43,78,20,3.034722772832767,23
2332,76,23,19,10,3.03373893891917,13
2333,39,13,98,5,3.0332323169773585,8
2334,89,10,114,5,3.026921822427984,5
2335,76,26,39,10,3.022675040857641,16
2336,40,17,33,6,3.0217035797006977,11
2337,86,131,87,63,3.020951600132488,68
2338,47,29,88,14,3.0208806441241447,15
2339,9,43,39,21,3.0121485145406113,22
2340,74,42,63,20,3.0096162132471513,22
2341,50,20,108,10,3.0061866874624097,10
2342,96,14,34,6,3.001763014782561,8
2343,4,11,69,5,2.99948417666171,6
2344,86,47,90,20,2.997206734082276,27
2345,114,11,34,6,2.988482941118176,5
2346,85,23,13,9,2.985985548040522,14
2347,89,19,107,8,2.97929477413752,11
2348,46,13,1,7,2.9771068452784517,6
2349,84,36,106,18,2.975473960825013,18
2350,36,32,4,13,2.9739066740354216,19
2351,114,64,88,30,2.9736929918128037,34
2352,2,21,37,10,2.96975801126945,11
2353,73,16,63,8,2.966556049159884,8
2354,103,17,76,9,2.965533878997632,8
2355,25,18,57,8,2.9649349505538733,10
2356,91,27,13,13,2.96394682527563,14
2357,16,143,51,67,2.9638324922735335,76
2358,114,23,46,10,2.963143531607224,13
2359,13,106,51,51,2.9562967878148285,55
2360,15,33,3,15,2.9522579457276636,18
2361,54,19,29,8,2.949914447875304,11
2362,52,15,12,7,2.9481231325534893,8
2363,71,18,46,9,2.9448527741935377,9
2364,60,39,8,19,2.9438347563437417,20
2365,9,18,1,10,2.9438107743951836,8
2366,83,27,65,13,2.938404758323202,14
2367,68,27,49,12,2.9363199373933013,15
2368,36,20,87,8,2.93557325089767,12
2369,66,16,86,7,2.9349279516020905,9
2370,78,20,94,9,2.934032764236852,11
2371,33,21,28,11,2.934003356051797,10
2372,12,18,40,9,2.93028970370934,9
2373,3,10,33,4,2.927658221464771,6
2374,1,14,62,7,2.921521583990398,7
2375,102,19,106,10,2.9207255392565106,9
2376,109,17,9,9,2.91854195196147,8
2377,55,11,31,5,2.9183781753906346,6
2378,37,10,33,4,2.9157377490462264,6
2379,47,22,41,11,2.9126189727076195,11
2380,60,23,58,11,2.9117712245785903,12
2381,80,36,54,18,2.9116630961094714,18
2382,104,12,10,6,2.9113530030237116,6
2383,62,19,9,9,2.9069158954391607,10
2384,16,33,79,14,2.9049583801159358,19
2385,30,34,71,16,2.8915964337712703,18
2386,27,58,88,28,2.8900429056834263,30
2387,17,25,46,11,2.875672610475698,14
2388,106,14,77,7,2.875589368126161,7
2389,69,26,43,12,2.874624697498018,14
2390,75,21,30,10,2.874328227945732,11
2391,108,10,2,4,2.873465048153021,6
2392,112,14,1,5,2.872325056767921,9
2393,88,69,68,31,2.8695211003313754,38
2394,88,10,17,6,2.869337502995369,4
2395,46,23,63,12,2.8672418698963504,11
2396,28,70,84,31,2.8670003890442093,39
2397,72,14,88,6,2.8660882603566407,8
2398,55,50,11,21,2.8656348858368936,29
2399,69,25,28,12,2.861912956405139,13
2400,88,15,94,8,2.8588031686479485,7
2401,74,13,112,6,2.8550316834984484,7
2402,16,96,28,43,2.854985092700266,53
2403,97,13,33,6,2.848649622206162,7
2404,30,10,45,4,2.841712664869655,6
2405,95,33,39,15,2.8414955259541013,18
2406,4,25,16,13,2.8411046840521457,12
2407,107,51,106,24,2.8408623146416336,27
2408,104,73,16,33,2.8388907836839916,40
2409,86,104,28,46,2.8374089851944673,58
2410,39,11,35,5,2.8361547619317555,6
2411,30,18,102,9,2.835829624332191,9
2412,53,23,81,10,2.8322690458402344,13
2413,114,61,86,29,2.8307983943039834,32
2414,15,39,107,15,2.8291612991129442,24
2415,75,21,112,9,2.8242194050340816,12
2416,54,18,62,8,2.824080555827825,10
2417,18,13,71,6,2.821320109059585,7
2418,68,14,48,7,2.8206443314688054,7
2419,97,26,76,12,2.8180456861896697,14
2420,9,48,40,21,2.81743847104381,27
2421,1,32,36,16,2.809530345293069,16
2422,99,15,41,7,2.8081672918617295,8
2423,65,42,71,18,2.8056942435602363,24
2424,106,14,112,7,2.805082024542774,7
2425,12,42,27,18,2.8046964318602283,24
2426,87,90,65,41,2.799200858225144,49
2427,20,66,54,33,2.798936654496461,33
2428,83,32,8,16,2.795775595052069,16
2429,68,14,44,7,2.7953277213928227,7
2430,7,26,1,12,2.793205495238505,14
2431,100,13,36,6,2.7923934619121074,7
2432,18,10,57,4,2.7910504415885566,6
2433,70,12,102,7,2.7906887378625385,5
2434,85,14,112,6,2.788857070839814,8
2435,51,58,41,27,2.7880359032469952,31
2436,17,36,107,17,2.78728948647837,19
2437,18,30,40,12,2.780722164544755,18
2438,10,17,87,8,2.7770692343126595,9
2439,30,61,107,27,2.7739070687901175,34
2440,16,36,80,15,2.7654656327688585,21
2441,38,14,78,6,2.7648802096570626,8
2442,1,17,94,9,2.7623810098011936,8
2443,88,23,35,11,2.7598010038488723,12
2444,97,34,96,17,2.7556888339056833,17
2445,70,14,43,6,2.753352748891413,8
2446,43,36,65,18,2.7525986025329385,18
2447,30,31,104,15,2.7504108450647493,16
2448,71,26,51,12,2.748484052918404,14
2449,69,31,68,14,2.743936079051882,17
2450,43,44,94,20,2.738284089480833,24
2451,99,12,63,6,2.737725340993938,6
2452,39,30,62,13,2.7367319129051215,17
2453,15,25,54,13,2.735147263925594,12
2454,60,26,46,12,2.733085524905183,14
2455,49,11,5,5,2.7256599500520577,6
2456,44,16,88,8,2.7255415222047095,8
2457,37,30,84,14,2.7240272709777176,16
2458,58,17,51,8,2.7220403540386506,9
2459,63,20,4,9,2.7170319642618375,11
2460,88,61,49,27,2.7144625519502794,34
2461,86,89,84,44,2.7122592129849856,45
2462,90,14,33,6,2.708622984963186,8
2463,2,46,50,21,2.7076882491876733,25
2464,39,11,79,4,2.703936570933463,7
2465,20,27,7,13,2.7023319306021247,14
2466,47,27,68,12,2.7008094429751055,15
2467,8,63,11,29,2.698721990639596,34
2468,39,22,48,9,2.697481925191404,13
2469,10,11,65,5,2.691616036034299,6
2470,87,23,31,11,2.6915087275033063,12
2471,7,21,30,11,2.691476247459028,10
2472,11,29,43,14,2.690595886408949,15
2473,13,20,102,8,2.68911865765018,12
2474,74,13,43,7,2.6848796666350316,6
2475,43,14,58,6,2.6806335210315986,8
2476,39,25,5,12,2.6791322172692817,13
2477,39,74,107,35,2.677072560868394,39
2478,54,79,16,37,2.6768906219105006,42
2479,48,10,12,4,2.675775448389384,6
2480,25,17,44,8,2.67353547628176,9
2481,13,118,7,55,2.6708973171944725,63
2482,37,67,104,30,2.6697156594454787,37
2483,71,17,5,8,2.668348512437488,9
2484,51,62,60,25,2.6680912544453945,37
2485,107,54,9,27,2.659934690345264,27
2486,11,33,20,14,2.658025854837765,19
2487,76,18,95,9,2.6576501695432873,9
2488,40,24,27,13,2.6563176029466624,11
2489,19,32,68,14,2.6559298105207456,18
2490,20,14,73,6,2.6543798385197754,8
2491,57,13,36,5,2.6531160901053727,8
2492,19,20,20,10,2.646933293157403,10
2493,100,24,69,11,2.641711217702835,13
2494,110,13,54,6,2.635884902993451,7
2495,51,12,22,5,2.6349206585516356,7
2496,95,34,107,16,2.633836762476072,18
2497,27,70,107,31,2.6286062134104733,39
2498,39,51,54,24,2.6240157360627983,27
2499,39,42,28,20,2.6233394077803616,22
2500,39,10,89,4,2.6189716831037595,6
2501,9,20,34,9,2.6185115894413817,11
2502,94,33,107,13,2.6133702151384584,20
2503,40,29,1,13,2.6081027273161883,16
2504,36,23,91,10,2.600483205457642,13
2505,20,10,89,5,2.5989355295603778,5
2506,65,32,80,15,2.5986356922004026,17
2507,13,94,107,44,2.5978950195498487,50
2508,20,48,37,23,2.5936827651590773,25
2509,102,27,37,12,2.5931875377695404,15
2510,1,10,109,5,2.5929606771402334,5
2511,19,35,94,17,2.5924300471605743,18
2512,28,71,65,31,2.5907378992374,40
2513,33,15,88,6,2.581178022844097,9
2514,63,16,45,7,2.5799907481308075,9
2515,50,22,112,9,2.578275791966451,13
2516,81,14,108,7,2.5758573743146345,7
2517,1,29,51,14,2.574119304918465,15
2518,48,14,25,7,2.5710538086168517,7
2519,86,14,14,7,2.5565201304900285,7
2520,16,75,68,33,2.555368429487557,42
2521,73,19,1,8,2.5534291003907317,11
2522,47,12,30,7,2.551854085041669,5
2523,71,14,47,7,2.5504632262813383,7
2524,44,14,76,6,2.5504141931433417,8
2525,7,74,36,34,2.54935875079736,40
2526,77,14,95,7,2.541033558735234,7
2527,97,35,65,16,2.539739428020559,19
2528,70,22,9,9,2.5390649499197586,13
2529,54,34,102,16,2.5372297090094844,18
2530,43,14,72,7,2.536394554509492,7
2531,90,29,87,13,2.533544175082614,16
2532,40,60,88,27,2.532837544735202,33
2533,7,29,17,13,2.532089441361393,16
2534,44,15,107,7,2.530544567099409,8
2535,99,19,30,8,2.530388293684778,11
2536,36,33,9,15,2.527924078037464,18
2537,39,18,4,8,2.5267698999647306,10
2538,68,27,46,12,2.520930145642669,15
2539,12,15,36,7,2.516319942513756,8
2540,29,35,27,15,2.5139766493292597,20
2541,50,54,107,26,2.5099686972292012,28
2542,87,15,92,7,2.5078466479835897,8
2543,84,13,67,7,2.500709874534178,6
2544,65,38,111,16,2.4964278491140734,22
2545,64,21,11,8,2.4904938630540925,13
2546,27,34,43,16,2.4874868991786303,18
2547,71,27,9,12,2.485839871550415,15
2548,28,25,79,12,2.485405030035431,13
2549,88,45,109,19,2.4817016474099605,26
2550,87,58,28,28,2.477822962643624,30
2551,17,20,20,9,2.4759550702480673,11
2552,30,17,103,7,2.4703689712282224,10
2553,4,17,81,7,2.4678124777063224,10
2554,74,17,69,9,2.466497282082459,8
2555,103,10,37,6,2.4659405881754024,4
2556,41,23,76,12,2.4646493381228964,11
2557,13,31,34,15,2.4629355156987685,16
2558,17,17,1,8,2.462761073509875,9
2559,102,32,25,15,2.460889696925051,17
2560,110,17,86,8,2.459712460283758,9
2561,40,10,84,5,2.4542210673969374,5
2562,63,15,61,6,2.445410080263457,9
2563,32,10,50,6,2.4440541907162885,4
2564,64,15,47,6,2.441201731533324,9
2565,109,24,102,11,2.4374588964673856,13
2566,14,19,51,7,2.433844123091522,12
2567,3,17,96,8,2.432078371197565,9
2568,93,17,37,7,2.4227477033995664,10
2569,103,25,51,12,2.422501148647578,13
2570,109,28,34,13,2.4224825666242897,15
2571,109,11,99,5,2.4195174025010506,6
2572,28,19,94,8,2.4149604753175544,11
2573,107,24,81,11,2.4141594134658915,13
2574,34,23,50,11,2.4065274329929407,12
2575,88,57,104,25,2.406185933878753,32
2576,22,14,34,7,2.405197781979372,7
2577,86,21,33,9,2.4046138870938174,12
2578,20,26,80,12,2.4033351571638515,14
2579,100,27,94,10,2.400243221659601,17
2580,114,15,98,7,2.3992721750256822,8
2581,46,38,28,16,2.3990178798165616,22
2582,97,21,109,10,2.398141101921517,11
2583,16,43,48,21,2.3975104970965586,22
2584,53,50,65,24,2.397002822057666,26
2585,16,22,45,9,2.3925466679441394,13
2586,23,13,48,6,2.3894452247322233,7
2587,104,40,95,18,2.3890342183876068,22
2588,4,21,71,8,2.387175011736595,13
2589,96,25,104,11,2.386641983915838,14
2590,87,50,60,25,2.385121345746396,25
2591,75,13,56,5,2.3840139649043484,8
2592,8,14,112,6,2.3798297239108375,8
2593,71,40,107,17,2.376060967609246,23
2594,49,29,12,17,2.3757535970577646,12
2595,39,44,104,20,2.3751154073426797,24
2596,90,19,84,9,2.374748457023267,10
2597,53,31,55,14,2.3720895326624136,17
2598,25,32,63,16,2.3688265373602633,16
2599,40,24,50,10,2.367144047455048,14
2600,49,13,97,5,2.366826181424206,8
2601,22,10,87,6,2.365823638651169,4
2602,99,23,5,11,2.36162190226428,12
2603,70,34,76,16,2.358420872168424,18
2604,76,35,49,16,2.3583999407791754,19
2605,100,14,97,6,2.358325970901081,8
2606,53,44,64,20,2.3578163734178164,24
2607,96,14,109,6,2.3566759619593634,8
2608,8,27,17,13,2.354578898260205,14
2609,99,12,33,5,2.354570382478152,7
2610,4,36,31,15,2.353535596679466,21
2611,79,10,96,5,2.351992111457352,5
2612,16,50,43,22,2.3507433165143277,28
2613,11,18,33,7,2.349854916623711,11
2614,29,24,11,11,2.3496813327430064,13
2615,76,29,109,12,2.3483387187433786,17
2616,78,10,45,5,2.343791897433706,5
2617,16,38,90,19,2.341213398493082,19
2618,108,36,107,17,2.33769066632224,19
2619,25,28,53,14,2.3301510854690863,14
2620,109,51,5,25,2.3285813949081624,26
2621,72,10,42,4,2.3285230567907247,6
2622,84,35,50,17,2.3257021134383256,18
2623,8,10,103,4,2.3245085117289825,6
2624,104,21,102,11,2.3206272974702777,10
2625,111,18,87,8,2.316389144833365,10
2626,88,32,91,15,2.315767764685106,17
2627,8,58,96,27,2.313991189820113,31
2628,71,31,63,14,2.311262987331468,17
2629,63,28,70,13,2.309911464577443,15
2630,76,13,69,5,2.308555624427584,8
2631,35,13,70,7,2.3047047876076423,6
2632,60,26,95,12,2.300035058084818,14
2633,50,34,76,18,2.298946803227753,16
2634,80,20,7,9,2.2986689861273377,11
2635,63,42,50,19,2.2950983829965117,23
2636,100,24,5,11,2.293242743404467,13
2637,106,13,4,7,2.287883468044358,6
2638,8,76,28,35,2.28759259007733,41
2639,73,16,16,8,2.286947763730408,8
2640,81,26,88,12,2.2857834835265316,14
2641,107,36,112,18,2.28568932916869,18
2642,38,10,81,5,2.2819621266449914,5
2643,77,12,69,6,2.2797993708458937,6
2644,11,60,46,28,2.27863758150919,32
2645,65,14,92,7,2.2769844774151653,7
2646,50,47,11,22,2.276023953743783,25
2647,40,14,74,6,2.2751378053719047,8
2648,7,108,68,50,2.2702884441480418,58
2649,61,10,31,5,2.2696136748473625,5
2650,28,66,96,31,2.2674069446039304,35
2651,85,12,7,5,2.267272935114745,7
2652,87,11,42,5,2.267067713255764,6
2653,109,23,3,11,2.262800410189064,12
2654,87,62,106,30,2.262204101784011,32
2655,98,16,17,8,2.2572460925395315,8
2656,74,13,41,7,2.2545650248033358,6
2657,95,30,25,14,2.253973143655666,16
2658,63,11,83,4,2.2518527555221,7
2659,8,17,19,8,2.250211187456416,9
2660,16,52,70,23,2.2486906290153845,29
2661,87,36,69,15,2.246850810864761,21
2662,70,10,27,5,2.2432632584575636,5
2663,104,65,13,30,2.242803874148522,35
2664,64,21,49,9,2.241601060238613,12
2665,68,61,107,30,2.239285821874588,31
2666,77,13,103,6,2.2366700053173294,7
2667,108,11,65,6,2.2352573569912666,5
2668,27,17,48,7,2.23496412717063,10
2669,4,26,114,13,2.2345648368573663,13
2670,46,18,65,7,2.232998478058108,11
2671,12,26,11,13,2.231267105865383,13
2672,62,29,71,14,2.2274966883750613,15
2673,90,16,25,7,2.2261576936837093,9
2674,15,50,86,23,2.2250860482481816,27
2675,112,11,12,6,2.2247336886150633,5
2676,98,13,99,7,2.2212581677933705,6
2677,17,32,50,16,2.2211240849487943,16
2678,8,53,39,26,2.2208284702166408,27
2679,75,23,84,11,2.2186834285684545,12
2680,5,50,96,22,2.21142719225076,28
2681,89,17,60,9,2.2059312682885306,8
2682,13,32,72,16,2.2040070476145748,16
2683,75,27,27,12,2.2036511265370837,15
2684,96,10,49,5,2.2013596017058807,5
2685,17,14,91,6,2.2013317711286335,8
2686,91,12,56,6,2.199268647174773,6
2687,7,75,40,33,2.195752128306479,42
2688,68,35,106,16,2.193685806982791,19
2689,34,36,27,17,2.186049556860647,19
2690,52,10,100,4,2.1822522154052884,6
2691,41,46,68,22,2.171804807510055,24
2692,60,67,88,30,2.1715375199885685,37
2693,23,13,53,6,2.1639220781507693,7
2694,89,11,49,5,2.155221325127321,6
2695,62,27,3,12,2.154788303981498,15
2696,10,21,8,9,2.147315002146761,12
2697,55,11,69,5,2.141856565606561,6
2698,71,39,39,18,2.1402119009407667,21
2699,102,22,74,10,2.1384304011801003,12
2700,81,17,68,8,2.1370452313390325,9
2701,3,64,51,32,2.1369691563906206,32
2702,66,13,31,6,2.1367157981218847,7
2703,8,26,102,13,2.1358165667375633,13
2704,11,30,74,14,2.1347610080309,16
2705,2,12,61,5,2.133108515807604,7
2706,54,77,8,33,2.1325516335637458,44
2707,98,10,43,4,2.1302778964437667,6
2708,102,32,114,14,2.1240842876015136,18
2709,7,62,9,31,2.12190310948229,31
2710,49,24,63,12,2.1212323385530256,12
2711,53,11,70,5,2.1174802085363624,6
2712,7,17,72,8,2.1143024060967663,9
2713,69,11,25,5,2.112059751085251,6
2714,57,38,13,19,2.1070868819342965,19
2715,68,28,94,13,2.106511062546953,15
2716,112,19,23,8,2.101852765262114,11
2717,76,30,55,13,2.1010477361103184,17
2718,65,91,107,43,2.09901727929986,48
2719,83,34,55,17,2.0962093979720247,17
2720,97,22,8,11,2.094799206270942,11
2721,108,30,86,13,2.0910937309013526,17
2722,40,18,11,9,2.0894421004610075,9
2723,64,43,68,18,2.0864244028015833,25
2724,66,14,72,6,2.0852128177023035,8
2725,44,14,51,5,2.0848742289559725,9
2726,57,22,30,11,2.0742110648973373,11
2727,27,20,23,10,2.0722628371370155,10
2728,94,12,50,5,2.067325915186851,7
2729,84,30,34,14,2.067010635537676,16
2730,107,44,70,22,2.066718062800076,22
2731,76,22,88,11,2.06206527213327,11
2732,62,20,60,10,2.0597588787986405,10
2733,9,19,57,9,2.058380213538902,10
2734,48,25,65,13,2.057937129130549,12
2735,12,14,7,7,2.0405365521973633,7
2736,43,44,19,20,2.0399608862566416,24
2737,11,18,93,10,2.0391902780828315,8
2738,80,16,60,8,2.038549414490356,8
2739,33,25,13,12,2.031483396821486,13
2740,91,14,114,7,2.031242634143403,7
2741,32,11,13,5,2.0261815070275424,6
2742,28,52,51,26,2.025017303726126,26
2743,90,26,60,11,2.0244178494313427,15
2744,114,27,17,11,2.021159075364864,16
2745,8,37,90,16,2.0194647820717773,21
2746,111,10,10,4,2.0194606727691027,6
2747,93,11,60,4,2.018629631632228,7
2748,69,14,37,7,2.0155128499001473,7
2749,41,46,27,20,2.0152493875384563,26
2750,68,29,70,14,2.015118158104632,15
2751,39,35,12,16,2.011891168245126,19
2752,23,47,86,22,2.011686001208666,25
2753,62,20,37,8,2.01074071282815,12
2754,60,73,77,35,2.0085290730636887,38
2755,83,22,97,12,2.0076368732075736,10
2756,8,39,50,17,1.9997739229036222,22
2757,66,11,27,5,1.999266452067432,6
2758,114,26,74,13,1.9975972531686852,13
2759,8,92,55,46,1.9945813817420799,46
2760,53,19,4,9,1.9876947928926743,10
2761,100,12,79,5,1.9822381822120898,7
2762,95,28,53,11,1.9769373995573165,17
2763,88,32,70,15,1.9762934359596307,17
2764,55,31,84,15,1.9725581442910776,16
2765,54,10,35,4,1.970607603878345,6
2766,23,22,3,10,1.9704853033748797,12
2767,19,31,65,15,1.9655134440486957,16
2768,28,33,91,15,1.9649527402335243,18
2769,41,24,112,11,1.9642201479007209,13
2770,80,11,97,5,1.9631828964682283,6
2771,39,14,33,7,1.960095595226131,7
2772,50,11,35,5,1.9581460146246819,6
2773,19,30,86,15,1.9572349198961296,15
2774,27,34,57,17,1.9534766566361856,17
2775,36,34,64,17,1.9485056781764578,17
2776,25,20,55,9,1.9429576796619987,11
2777,23,14,31,6,1.9392936999416412,8
2778,110,13,104,5,1.938847445081051,8
2779,71,49,7,25,1.9387153694352726,24
2780,32,10,98,5,1.938005226383161,5
2781,23,14,97,7,1.9330528734436583,7
2782,30,33,11,15,1.9323653860964833,18
2783,65,30,84,14,1.928864673268391,16
2784,70,19,40,8,1.9276789997691242,11
2785,17,28,54,14,1.925973647351252,14
2786,107,19,72,9,1.924084169340613,10
2787,114,21,18,10,1.9235772497574426,11
2788,99,11,76,6,1.9173589523208294,5
2789,97,32,106,16,1.9159665785715103,16
2790,110,11,17,5,1.9155371371930712,6
2791,8,65,74,29,1.9128656065638743,36
2792,68,38,1,18,1.9099752765436635,20
2793,65,51,106,24,1.9069424806899138,27
2794,55,27,99,12,1.895072402151854,15
2795,85,12,98,5,1.892963761582925,7
2796,51,54,37,23,1.892799917988142,31
2797,20,35,106,16,1.8905905914286998,19
2798,71,44,86,22,1.8883807510456327,22
2799,27,14,18,7,1.8878641320648082,7
2800,25,23,64,11,1.8857238852847764,12
2801,96,16,30,7,1.8850748786904798,9
2802,68,108,13,51,1.8849483625328212,57
2803,2,41,8,20,1.8848654476169666,21
2804,87,66,54,30,1.8710926114506883,36
2805,60,19,48,9,1.868377497336707,10
2806,53,13,47,6,1.867452050486345,7
2807,60,13,33,5,1.8644268792007332,8
2808,93,21,97,10,1.8583722279909525,11
2809,53,22,97,10,1.8492466822191047,12
2810,19,25,88,13,1.8450287055712755,12
2811,50,13,73,5,1.8439270323254195,8
2812,12,18,85,9,1.8411131730635333,9
2813,114,30,20,14,1.8395405662544684,16
2814,8,41,100,19,1.838178294028023,22
2815,87,63,3,29,1.8371646184656238,34
2816,92,30,88,14,1.8365360092779848,16
2817,84,38,96,19,1.8356486827006806,19
2818,88,23,90,10,1.8344778390431964,13
2819,74,29,13,14,1.8278354237299024,15
2820,11,15,114,8,1.8276036019184327,7
2821,44,13,114,6,1.8263733365516688,7
2822,13,44,75,20,1.82625422828726,24
2823,86,37,79,17,1.8233812794868036,20
2824,102,13,99,6,1.821289341303691,7
2825,40,18,111,9,1.8104998545748747,9
2826,36,22,25,11,1.807144013826855,11
2827,70,57,86,26,1.80463722039498,31
2828,51,34,31,14,1.8036645224364263,20
2829,112,50,16,24,1.7995643538534876,26
2830,63,10,103,4,1.7993918081481381,6
2831,8,40,30,20,1.7986527143277458,20
2832,114,35,39,18,1.7909993968165154,17
2833,20,19,48,8,1.7888857426975104,11
2834,97,27,46,13,1.7888516310767923,14
2835,65,27,77,12,1.7824305156446967,15
2836,29,20,8,8,1.781826812153748,12
2837,37,25,90,12,1.7816453937181727,13
2838,15,39,68,17,1.7799026131571731,22
2839,50,21,69,11,1.7758250016074677,10
2840,9,19,30,8,1.7725720850396782,11
2841,103,39,16,20,1.765131463561878,19
2842,88,11,110,6,1.764222812142971,5
2843,64,47,88,21,1.7611807290570651,26
2844,37,98,5,47,1.7580752219846099,51
2845,88,37,18,18,1.7539193639392456,19
2846,104,21,43,9,1.750605109142025,12
2847,79,23,107,10,1.7474071801332398,13
2848,60,33,36,16,1.7416473627060738,17
2849,18,11,6,5,1.7414584600944842,6
2850,65,41,17,17,1.7406554308740467,24
2851,36,37,88,16,1.7392851936744356,21
2852,51,14,66,7,1.7380363030144774,7
2853,9,23,112,10,1.7370284161007252,13
2854,86,20,89,8,1.7356386018874979,12
2855,111,16,9,7,1.7347101097492736,9
2856,16,27,44,12,1.7334648777380284,15
2857,106,38,96,17,1.7318320126651967,21
2858,32,13,68,5,1.7311662598089266,8
2859,109,20,77,10,1.727976391358886,10
2860,77,10,28,5,1.7274479044716262,5
2861,49,29,15,15,1.7216503112217902,14
2862,77,19,11,9,1.7198753848877157,10
2863,104,24,83,10,1.7171480590838881,14
2864,5,51,54,23,1.7127518345022985,28
2865,88,62,28,29,1.7102908597256317,33
2866,50,34,51,17,1.7082975555891384,17
2867,86,67,55,31,1.7078571022769586,36
2868,107,123,86,58,1.7068811504984986,65
2869,85,15,57,7,1.703449553409084,8
2870,20,16,102,8,1.6989391239814888,8
2871,36,15,23,9,1.697287527418564,6
2872,73,20,28,10,1.687006788072292,10
2873,55,40,106,18,1.6835382667235024,22
2874,39,75,13,35,1.6833252409730617,40
2875,55,25,20,12,1.682789944223458,13
2876,8,83,88,40,1.6811669912632214,43
2877,65,31,50,15,1.6801621867417356,16
2878,17,18,64,8,1.6742261514283467,10
2879,23,14,50,5,1.673947609647618,9
2880,63,45,7,18,1.673573876629926,27
2881,48,14,104,6,1.673511883025235,8
2882,87,45,84,20,1.6712785926609632,25
2883,68,46,3,23,1.6711554440218455,23
2884,45,28,31,13,1.6710870406691025,15
2885,17,17,112,8,1.670998049379022,9
2886,54,19,33,8,1.6683853925492595,11
2887,3,31,43,14,1.6651254167664868,17
2888,8,95,107,48,1.6636951263902326,47
2889,37,47,74,23,1.66281633297112,24
2890,63,24,47,10,1.6623324282821739,14
2891,41,30,1,13,1.6558361653082903,17
2892,36,23,68,11,1.651168634820273,12
2893,12,33,87,15,1.6402422664324783,18
2894,30,41,68,20,1.6397998764136308,21
2895,41,60,88,27,1.6397874376242172,33
2896,102,10,49,4,1.6394569107680652,6
2897,104,26,18,11,1.6361581237581893,15
2898,6,18,68,10,1.6346986227731617,8
2899,35,28,86,12,1.630292710908606,16
2900,18,37,51,19,1.6280086279913597,18
2901,64,12,84,7,1.6272082249846804,5
2902,106,46,88,20,1.6248459493396556,26
2903,44,17,87,8,1.6239279411647956,9
2904,38,32,13,17,1.614314899085529,15
2905,30,29,69,14,1.6139022710932394,15
2906,76,17,18,8,1.601109520179619,9
2907,14,11,75,5,1.594721022285634,6
2908,34,43,16,19,1.5938069518093538,24
2909,57,38,39,19,1.5884848488756722,19
2910,49,23,62,10,1.5851399264471664,13
2911,2,15,25,8,1.5845186001024,7
2912,88,20,61,8,1.5819478875432638,12
2913,58,12,100,6,1.5819008855655083,6
2914,2,34,97,16,1.581483466739766,18
2915,55,22,90,12,1.578656952498875,10
2916,86,30,72,14,1.5774210896268557,16
2917,96,34,88,17,1.5755489762598094,17
2918,30,27,78,13,1.5696074585617392,14
2919,4,61,13,28,1.56876063127331,33
2920,80,20,11,10,1.5532652275466894,10
2921,109,13,47,6,1.549168689951247,7
2922,57,25,102,12,1.5483760769806807,13
2923,63,30,27,13,1.5482939869847638,17
2924,60,32,9,14,1.541763907829675,18
2925,22,10,86,5,1.5381482899799122,5
2926,94,21,11,11,1.5369194320927209,10
2927,98,13,79,6,1.5335435073226167,7
2928,29,13,53,5,1.53176700286447,8
2929,64,15,81,7,1.5315551836921608,8
2930,114,20,84,9,1.5282826629009736,11
2931,13,66,27,32,1.5277775268373557,34
2932,76,14,90,6,1.5239560719394636,8
2933,35,14,37,7,1.523131742310598,7
2934,3,22,61,8,1.5200379980927694,14
2935,46,12,55,5,1.514859018089967,7
2936,64,29,27,14,1.506656484827703,15
2937,27,25,50,10,1.5040884605682736,15
2938,54,10,89,4,1.503765809030216,6
2939,63,22,15,10,1.4989595234613098,12
2940,19,15,102,6,1.4975662366291813,9
2941,46,52,5,24,1.4974094901037533,28
2942,107,47,25,23,1.4967278623744338,24
2943,112,16,11,8,1.4950492246382474,8
2944,2,23,74,10,1.4920197761473226,13
2945,49,33,7,15,1.4907855360930005,18
2946,60,74,71,35,1.4843115108657066,39
2947,37,38,17,16,1.479924510472103,22
2948,68,10,84,4,1.4788993773509214,6
2949,109,20,69,10,1.476902335560545,10
2950,103,17,79,8,1.4762996181953671,9
2951,106,50,11,21,1.4751786277994416,29
2952,35,24,7,12,1.4676220715119486,12
2953,6,13,69,7,1.4672562795661197,6
2954,71,24,3,11,1.4668209780059522,13
2955,40,64,51,31,1.4624658901194083,33
2956,31,21,47,10,1.4606130980712677,11
2957,25,23,83,10,1.459720188055504,13
2958,62,28,65,14,1.4496341901836953,14
2959,106,55,63,27,1.448556681809942,28
2960,75,44,39,23,1.4473715172929777,21
2961,65,33,69,16,1.4425642416495112,17
2962,20,21,97,11,1.4395279608818752,10
2963,50,28,25,14,1.4391705454909005,14
2964,34,21,39,10,1.4278801146393896,11
2965,36,35,45,19,1.423273124508118,16
2966,1,11,53,5,1.4196819324858239,6
2967,80,36,86,17,1.4162310289001794,19
2968,15,41,65,19,1.4119875326523994,22
2969,100,29,62,15,1.4095954922785325,14
2970,12,20,71,10,1.4059148964814137,10
2971,46,25,9,13,1.4052752923291445,12
2972,70,17,95,9,1.4011695857654891,8
2973,74,12,98,6,1.394136813126094,6
2974,63,44,41,21,1.393059609593735,23
2975,95,12,80,6,1.3888115326852126,6
2976,86,87,8,45,1.3887471294184057,42
2977,12,13,64,6,1.3883647817413076,7
2978,36,11,29,6,1.3837445576600509,5
2979,87,68,30,33,1.382113059381005,35
2980,102,18,3,8,1.3811952404449805,10
2981,106,30,41,15,1.3806292559177726,15
2982,39,52,41,27,1.3725005678823738,25
2983,16,64,19,28,1.3677297158037256,36
2984,25,26,30,14,1.363384718034573,12
2985,41,35,40,18,1.358626645359705,17
2986,104,33,70,16,1.3582302540990812,17
2987,47,33,87,15,1.3571633976213282,18
2988,29,40,107,16,1.3557283794699355,24
2989,30,14,81,7,1.3508923221630391,7
2990,97,37,88,18,1.3490743629309014,19
2991,108,17,40,9,1.3479697301696891,8
2992,52,19,87,8,1.3439420173712888,11
2993,8,44,104,21,1.3410693202324964,23
2994,6,10,23,5,1.3385415186806267,5
2995,77,12,94,5,1.3353290162205556,7
2996,50,20,98,9,1.335287430553141,11
2997,30,83,86,38,1.3293231443644227,45
2998,30,21,48,9,1.3239953886043165,12
2999,84,36,54,17,1.3202943615638323,19
3000,74,18,80,9,1.319966132866856,9
3001,65,111,63,53,1.3193232513653719,58
3002,55,57,88,25,1.3163784693707288,32
3003,54,21,23,10,1.3133138976413523,11
3004,94,11,40,5,1.3131730085845268,6
3005,112,32,65,16,1.3122977163439495,16
3006,68,52,9,25,1.3104638696206712,27
3007,9,28,58,13,1.310268135821897,15
3008,32,14,51,7,1.3093866254236395,7
3009,41,28,114,14,1.307338108043566,14
3010,38,16,17,8,1.3036206431746913,8
3011,5,44,13,21,1.3023509853743034,23
3012,78,16,109,8,1.3015742746802685,8
3013,7,22,8,10,1.2952715014492373,12
3014,88,39,4,19,1.294921220761057,20
3015,41,19,78,8,1.2892335099283343,11
3016,51,19,99,10,1.2892082407104484,9
3017,89,17,88,9,1.288899774963521,8
3018,93,10,43,5,1.2815568757500557,5
3019,96,59,107,27,1.2779661064945878,32
3020,46,57,54,28,1.2778066019254952,29
3021,34,10,91,5,1.2767116469837227,5
3022,87,64,11,29,1.2748219037157655,35
3023,71,11,1,6,1.2732152302328021,5
3024,60,29,28,16,1.272111001147211,13
3025,62,11,47,5,1.265526998129847,6
3026,52,15,65,8,1.262826215370322,7
3027,92,12,107,5,1.2625916923530776,7
3028,57,24,55,13,1.2620925157379805,11
3029,81,20,18,10,1.2612198373935404,10
3030,93,10,79,5,1.2606355667564615,5
3031,86,39,112,18,1.2594712193458382,21
3032,9,37,63,18,1.2589023707877973,19
3033,17,42,13,21,1.2570532505054286,21
3034,41,74,13,36,1.251763682954913,38
3035,13,61,9,28,1.2504419702657084,33
3036,16,38,29,19,1.244834998200107,19
3037,108,16,55,7,1.2425126869095378,9
3038,91,20,37,10,1.2413018923540677,10
3039,70,32,51,16,1.2403340780472845,16
3040,71,25,31,12,1.2380158081615484,13
3041,63,16,95,8,1.2339697301933765,8
3042,28,39,25,17,1.2338977751460145,22
3043,51,88,107,38,1.233524626679821,50
3044,64,18,108,9,1.231630129497269,9
3045,55,17,41,8,1.220974525083998,9
3046,71,37,88,16,1.218508421155273,21
3047,54,25,18,12,1.2139969956731949,13
3048,17,35,34,18,1.212836226783514,17
3049,58,16,63,9,1.2116740819179406,7
3050,57,59,86,29,1.2114369577488064,30
3051,25,33,97,16,1.2112097532933517,17
3052,47,12,76,8,1.2091645579998245,4
3053,3,15,46,8,1.2064770707138577,7
3054,28,65,5,32,1.2040234196998174,33
3055,20,20,76,11,1.195513412586339,9
3056,25,67,16,32,1.1932865297100734,35
3057,68,18,74,7,1.1930607364890244,11
3058,98,15,60,7,1.188577253485572,8
3059,87,16,110,7,1.1878037867151132,9
3060,76,31,96,14,1.1853039288193863,17
3061,48,27,11,13,1.1812388789745782,14
3062,89,16,104,8,1.1768798083300285,8
3063,33,12,77,6,1.1756675735500741,6
3064,63,51,11,22,1.1727104947557743,29
3065,44,13,75,7,1.169380882277211,6
3066,108,19,74,8,1.1664859423669782,11
3067,16,56,41,26,1.164409244395375,30
3068,16,33,108,15,1.163747925816394,18
3069,86,36,18,16,1.16255605324444,20
3070,77,30,18,13,1.157226861340675,17
3071,111,32,16,16,1.1556733242940576,16
3072,79,17,7,8,1.150116600366683,9
3073,107,42,97,20,1.1486858251368084,22
3074,17,10,33,5,1.1464162819529016,5
3075,64,20,45,9,1.1431500338693177,11
3076,8,14,56,7,1.138262181129431,7
3077,13,57,53,26,1.137975375986167,31
3078,107,43,18,23,1.1371611267925203,20
3079,36,26,106,13,1.1307287364062795,13
3080,3,26,31,14,1.1304098830558913,12
3081,79,17,88,8,1.1249704502892566,9
3082,69,28,19,13,1.12274464710603,15
3083,28,25,57,12,1.1208866402447313,13
3084,50,69,54,34,1.1176760529666152,35
3085,29,19,7,7,1.117067463392933,12
3086,100,14,61,7,1.1138239851805005,7
3087,40,16,109,7,1.112646763896167,9
3088,73,13,55,6,1.1082443575059628,7
3089,87,38,64,19,1.1074901549231737,19
3090,91,12,47,6,1.1047106963660323,6
3091,40,19,45,9,1.104353122593122,10
3092,96,18,2,9,1.1039761816908875,9
3093,70,39,106,20,1.1024614638047314,19
3094,77,26,87,12,1.1017637064574404,14
3095,18,35,41,18,1.098384167284529,17
3096,87,70,39,33,1.0982945815388099,37
3097,54,41,19,18,1.0951937907986231,23
3098,87,35,75,17,1.0859483979409972,18
3099,15,15,17,8,1.0855800690980384,7
3100,60,31,81,15,1.0765050885349574,16
3101,19,30,57,15,1.0764867469339017,15
3102,75,27,74,12,1.0761366724331511,15
3103,64,19,97,9,1.0748997556853976,10
3104,28,61,109,28,1.0738097371372834,33
3105,9,16,97,9,1.0715415510849877,7
3106,67,20,37,9,1.070770052763525,11
3107,58,14,71,7,1.0679524363994424,7
3108,104,14,92,8,1.0650896272942483,6
3109,88,32,3,15,1.0621797128272272,17
3110,100,14,44,7,1.0590413147864144,7
3111,13,16,89,7,1.0581999047075505,9
3112,71,18,45,10,1.0500246166344471,8
3113,107,73,63,39,1.0499479505653528,34
3114,104,16,33,7,1.0375486456158094,9
3115,45,14,3,7,1.0349134798027042,7
3116,104,38,74,17,1.0321539192468763,21
3117,78,45,107,21,1.0299764540806504,24
3118,48,18,51,10,1.0238446488089576,8
3119,63,20,44,9,1.0233184771026445,11
3120,64,12,90,6,1.0226762518657313,6
3121,79,13,9,7,1.0203716742776936,6
3122,86,72,3,35,1.0184654674384126,37
3123,20,17,85,8,1.0120202947249686,9
3124,91,20,18,9,1.0069076377111847,11
3125,45,12,88,5,1.005819520359159,7
3126,114,11,93,6,1.0049906589581667,5
3127,57,34,41,17,1.00006887405222,17
3128,68,29,38,13,0.9956485324900232,16
3129,43,33,88,15,0.9947945347929822,18
3130,3,42,60,20,0.9913631554114472,22
3131,20,13,27,6,0.9871413726704082,7
3132,69,32,107,15,0.9867318989974718,17
3133,54,19,112,9,0.9843355592348286,10
3134,16,125,13,58,0.9826353825245314,67
3135,7,81,41,40,0.9794700083084562,41
3136,93,19,84,8,0.9776365381665071,11
3137,68,15,102,7,0.9774478191416416,8
3138,87,76,88,39,0.9771805164055242,37
3139,107,65,5,32,0.9748363761521168,33
3140,70,10,62,5,0.9747108971050832,5
3141,78,12,9,6,0.9745877106891233,6
3142,63,52,87,24,0.9694664805604988,28
3143,64,15,57,7,0.9686108755747885,8
3144,41,21,94,9,0.9669375303013759,12
3145,71,34,8,17,0.9628252268322728,17
3146,104,38,106,19,0.9604760273979267,19
3147,106,11,103,6,0.9583580547252463,5
3148,60,78,7,38,0.9515995280010714,40
3149,63,23,53,11,0.9461903574639025,12
3150,18,34,60,17,0.9344074833355396,17
3151,16,40,72,20,0.9283059904790143,20
3152,3,30,9,15,0.9265694640511716,15
3153,55,24,4,12,0.9256101911535765,12
3154,95,32,7,15,0.9236786450564196,17
3155,29,17,9,9,0.919777650807688,8
3156,29,16,43,8,0.9196986818795099,8
3157,75,27,114,13,0.9181862737012535,14
3158,51,68,87,33,0.9168856041700201,35
3159,39,14,1,5,0.9120351629887123,9
3160,64,17,46,8,0.9119833053856681,9
3161,34,20,3,9,0.9113037225897234,11
3162,36,35,75,19,0.9076169876586814,16
3163,76,28,102,13,0.9068567870201522,15
3164,29,12,12,6,0.9066091071417807,6
3165,6,14,50,7,0.9048960894988062,7
3166,60,12,111,7,0.901998030050083,5
3167,62,14,50,6,0.9017457082495477,8
3168,78,17,55,9,0.9002458878614119,8
3169,30,52,27,26,0.8997232050548485,26
3170,107,91,28,43,0.8970764795683025,48
3171,39,24,70,11,0.8958543413772162,13
3172,106,71,28,34,0.8945808420172994,37
3173,39,54,55,25,0.8915312651875593,29
3174,27,63,51,30,0.888138361606474,33
3175,9,19,69,9,0.8879210172039291,10
3176,27,48,11,23,0.8856386812161117,25
3177,93,13,3,5,0.8808947328421434,8
3178,83,21,88,11,0.8798897555023121,10
3179,13,47,15,24,0.8757286594591273,23
3180,41,15,48,7,0.8735829617761527,8
3181,27,15,1,6,0.8721383199452204,9
3182,57,22,68,10,0.871674240734193,12
3183,60,17,84,10,0.8716143564890761,7
3184,46,34,87,15,0.8711353256142379,19
3185,8,67,37,33,0.870008429807156,34
3186,11,83,16,36,0.8689296192195455,47
3187,54,111,65,54,0.8660420311677451,57
3188,58,19,3,8,0.865079685560992,11
3189,41,25,43,12,0.864027427303756,13
3190,68,85,51,39,0.8636071760652753,46
3191,68,19,43,10,0.8623513819268345,9
3192,10,10,114,4,0.8617397018011357,6
3193,77,14,64,8,0.855042195937581,6
3194,41,12,38,5,0.8514389884122157,7
3195,33,15,95,7,0.8491128905949068,8
3196,79,23,84,11,0.8428978656974995,12
3197,19,24,77,12,0.8379851134542081,12
3198,2,16,46,8,0.8285194662826778,8
3199,29,12,106,6,0.8264692442725412,6
3200,84,15,95,7,0.8218033746912392,8
3201,114,19,45,9,0.820568913201756,10
3202,57,18,20,9,0.8178941572060074,9
3203,86,38,12,18,0.8156441062566462,20
3204,56,14,40,7,0.8062835825274118,7
3205,30,26,40,13,0.8045580871786273,13
3206,86,85,20,41,0.8016884889387337,44
3207,98,11,62,5,0.7995773049352709,6
3208,15,55,16,28,0.7958588072945487,27
3209,2,22,88,11,0.7956469041111253,11
3210,1,36,107,18,0.792741418555241,18
3211,28,16,89,7,0.7901986413516666,9
3212,75,14,33,6,0.7900898585820573,8
3213,41,21,46,11,0.7882087764921283,10
3214,4,18,104,10,0.7872554057904755,8
3215,48,20,109,9,0.7860713609857853,11
3216,87,22,99,10,0.7762165713325079,12
3217,88,32,69,15,0.7753807063240763,17
3218,58,15,50,8,0.7660630045931233,7
3219,57,14,91,6,0.7523919124216624,8
3220,14,15,13,6,0.751185424264851,9
3221,98,22,100,10,0.7471432837189802,12
3222,46,24,84,11,0.7446057703540031,13
3223,36,13,74,5,0.7437175733038418,8
3224,15,51,39,23,0.7431576274831314,28
3225,109,27,106,14,0.7430675694349274,13
3226,38,22,64,11,0.7416758999099181,11
3227,94,24,86,12,0.7404864736135068,12
3228,7,12,108,5,0.7404080910313966,7
3229,25,24,15,13,0.7394428200536313,11
3230,88,24,77,11,0.7378048830896938,13
3231,40,77,86,36,0.735275767181436,41
3232,28,57,11,27,0.733863128330741,30
3233,95,41,5,21,0.7316066534315495,20
3234,33,13,27,6,0.7289108112107268,7
3235,27,13,99,7,0.7284055341482011,6
3236,71,10,96,5,0.7278695572627853,5
3237,57,10,4,4,0.7276499847388465,6
3238,49,20,109,10,0.7270267076148561,10
3239,81,19,27,9,0.7248890061971007,10
3240,51,38,43,20,0.7192859319153487,18
3241,37,51,28,24,0.7168710662114339,27
3242,61,18,40,9,0.715489570683085,9
3243,8,72,106,37,0.7133251026811394,35
3244,43,18,71,10,0.7122285277146779,8
3245,51,37,12,18,0.7101916786560039,19
3246,106,18,27,7,0.7074485049679642,11
3247,68,71,86,36,0.7070864651977483,35
3248,41,20,54,10,0.7052079558025968,10
3249,91,10,49,5,0.7029955830398265,5
3250,38,11,91,5,0.700382291127082,6
3251,61,11,39,6,0.6964131355147368,5
3252,90,15,74,6,0.6948431634826372,9
3253,7,90,65,47,0.6945220468207863,43
3254,50,29,9,14,0.6932669196756267,15
3255,100,19,85,9,0.692145009111035,10
3256,69,27,11,14,0.6919460086860773,13
3257,88,17,48,7,0.6890250559346728,10
3258,51,23,98,11,0.6875823408827684,12
3259,68,75,27,36,0.6873238062883651,39
3260,78,29,84,15,0.6870815538251351,14
3261,18,19,25,10,0.6816652439852796,9
3262,109,14,23,7,0.6795387556597839,7
3263,79,16,3,9,0.6788187325928862,7
3264,66,15,9,7,0.6778609704226946,8
3265,88,26,78,12,0.6778357578813761,14
3266,29,13,79,5,0.6757838864896741,8
3267,50,10,38,4,0.6752935140977933,6
3268,23,23,12,11,0.6683929234960068,12
3269,71,24,55,13,0.6670673084821276,11
3270,87,44,74,21,0.6669497609047663,23
3271,39,65,65,34,0.6541315550544965,31
3272,63,32,78,15,0.6511427448806575,17
3273,75,50,88,24,0.6490595256191717,26
3274,2,10,109,5,0.6444253237530845,5
3275,72,12,62,6,0.6413947117031077,6
3276,85,15,69,7,0.6408165415497196,8
3277,25,25,41,14,0.6394054706376694,11
3278,16,64,57,30,0.6392313574802793,34
3279,49,28,8,13,0.6383864691812153,15
3280,6,18,51,10,0.6381605805799537,8
3281,111,17,36,8,0.6365354853619519,9
3282,43,11,48,6,0.6335452834733725,5
3283,33,29,16,16,0.6325119131101442,13
3284,13,34,20,16,0.6324978295967632,18
3285,4,28,64,13,0.6316212138641669,15
3286,60,23,1,11,0.6297573562891117,12
3287,38,20,29,10,0.6286324723530292,10
3288,109,30,84,14,0.6283430275726476,16
3289,36,33,71,17,0.6241330409639588,16
3290,9,17,81,8,0.6212818094890723,9
3291,40,12,38,5,0.617907919478443,7
3292,31,22,58,11,0.616855370373501,11
3293,78,48,57,23,0.6156333715871791,25
3294,86,35,38,17,0.6102764909095695,18
3295,51,42,69,20,0.6101979768399988,22
3296,91,16,70,7,0.6063303701253766,9
3297,30,51,100,26,0.6041121088815675,25
3298,86,56,9,29,0.6017557404930524,27
3299,63,15,34,7,0.6010869874219991,8
3300,71,32,106,15,0.6009609652453838,17
3301,111,10,12,6,0.6003907747378712,4
3302,71,10,23,4,0.6000287508458293,6
3303,69,32,3,14,0.597861262529489,18
3304,65,25,78,11,0.5972758077920031,14
3305,79,22,8,10,0.596047638444006,12
3306,55,24,3,12,0.5910345457593124,12
3307,87,25,112,13,0.5908646302689579,12
3308,76,13,36,4,0.5885035889042637,9
3309,68,35,77,16,0.5847877126510238,19
3310,63,28,112,14,0.5834223269951258,14
3311,47,30,51,16,0.5820326521668331,14
3312,28,26,98,11,0.5775231479620817,15
3313,88,60,9,29,0.5756732724314684,31
3314,41,32,75,17,0.57538170131953,15
3315,114,40,7,19,0.5741553045041325,21
3316,69,15,71,8,0.5724150990318982,7
3317,71,13,78,6,0.56619632387446,7
3318,37,16,43,7,0.5623554718266413,9
3319,60,27,109,13,0.5608097746742312,14
3320,83,10,2,5,0.5594397265150789,5
3321,68,74,65,37,0.550600184176375,37
3322,92,17,7,7,0.5480230211986085,10
3323,23,32,51,16,0.547309759048545,16
3324,64,29,54,15,0.5456745481805175,14
3325,35,14,13,7,0.5410242166059803,7
3326,106,10,1,5,0.5396528610114324,5
3327,6,22,107,11,0.5355439544398269,11
3328,65,26,47,13,0.5332277519864393,13
3329,41,18,103,8,0.5269053363965305,10
3330,4,24,77,12,0.5234491201479384,12
3331,74,14,27,8,0.5219215520059601,6
3332,60,51,65,28,0.5216529175374925,23
3333,60,18,83,9,0.5212906629660267,9
3334,30,22,106,11,0.5189588569615469,11
3335,112,10,66,4,0.5146742754382652,6
3336,112,20,51,10,0.5141422831615046,10
3337,4,18,9,9,0.5118055197130298,9
3338,54,41,7,20,0.5072416292031929,21
3339,111,51,68,26,0.5032623987049997,25
3340,90,13,91,6,0.5003235284827334,7
3341,88,35,31,18,0.4999807976090581,17
3342,74,22,18,12,0.4929022250899433,10
3343,39,46,47,22,0.492304337936158,24
3344,38,13,114,6,0.49067913419821746,7
3345,62,12,97,6,0.490051403125013,6
3346,19,16,58,8,0.4895753929310045,8
3347,84,80,107,39,0.48662393295564865,41
3348,88,40,20,21,0.4827222531499379,19
3349,109,46,13,22,0.482033722868293,24
3350,7,19,48,10,0.48075396413828586,9
3351,95,28,74,13,0.4784255086028103,15
3352,76,18,62,9,0.4784217833711707,9
3353,25,51,39,26,0.47594650511842773,25
3354,7,60,18,31,0.4748651156903118,29
3355,63,42,5,18,0.4718441296207792,24
3356,65,54,31,26,0.4691388746969232,28
3357,5,10,78,6,0.46671252280804226,4
3358,12,18,50,7,0.46586470667488683,11
3359,106,101,86,50,0.4658315283344795,51
3360,86,81,54,41,0.46582318117547167,40
3361,104,38,76,20,0.4636043507636282,18
3362,65,58,12,30,0.46281952828017164,28
3363,65,11,21,6,0.46273082007848293,5
3364,107,36,46,19,0.458246310756249,17
3365,106,45,50,21,0.450853387486715,24
3366,87,36,15,17,0.44867974155253937,19
3367,13,33,112,17,0.44654566712440297,16
3368,30,37,54,18,0.4460275388884087,19
3369,7,78,39,40,0.44566273518626937,38
3370,80,11,9,7,0.4439834453330443,4
3371,90,15,11,7,0.4409004522210786,8
3372,107,67,60,34,0.4399094716611669,33
3373,109,76,86,38,0.4382040730178596,38
3374,40,49,63,25,0.43519783962840436,24
3375,40,43,31,22,0.4296271974626762,21
3376,107,32,85,16,0.42684494255397554,16
3377,106,21,43,11,0.42530171348423335,10
3378,27,15,61,8,0.4250644477983035,7
3379,95,13,57,8,0.42117305158203777,5
3380,112,18,69,10,0.4198013383725023,8
3381,5,14,38,7,0.41683785462955975,7
3382,20,16,69,8,0.4110151707783516,8
3383,31,33,86,17,0.41076921803924654,16
3384,96,39,55,20,0.40999901205957556,19
3385,50,18,79,9,0.40910464935228613,9
3386,74,55,16,28,0.4074421879861471,27
3387,16,45,114,21,0.4068130302568868,24
3388,17,11,26,5,0.4065653808604262,6
3389,35,16,30,8,0.40164153194297303,8
3390,37,41,65,19,0.3990326963086119,22
3391,104,15,20,8,0.39743988488785525,7
3392,20,21,95,10,0.3956021347010563,11
3393,61,16,65,9,0.3950505274193439,7
3394,13,88,49,39,0.39370050097638604,49
3395,102,14,84,7,0.3912018744364834,7
3396,8,13,44,6,0.3904420875790021,7
3397,16,53,78,26,0.38978294593785207,27
3398,50,19,89,9,0.3889433495588358,10
3399,64,20,15,11,0.38691464929245284,9
3400,69,30,36,15,0.38598798110098687,15
3401,79,12,78,6,0.38583207842589995,6
3402,11,65,107,31,0.3805355395730365,34
3403,114,28,71,14,0.3795577437704564,14
3404,37,13,48,6,0.3793970201456422,7
3405,70,22,97,12,0.3783758219642569,10
3406,14,18,84,8,0.3778390349649412,10
3407,63,27,60,13,0.37326617266532824,14
3408,103,14,54,8,0.3711572343700788,6
3409,51,40,30,20,0.3690727556562843,20
3410,40,21,75,10,0.3686371386700514,11
3411,95,26,28,12,0.36814720179538235,14
3412,8,32,76,15,0.36631050299304696,17
3413,54,83,107,42,0.3655524627632432,41
3414,92,18,13,7,0.36521745881562023,11
3415,43,11,90,5,0.3643101985935386,6
3416,28,14,44,8,0.3571298728778931,6
3417,34,13,75,6,0.35287672494659683,7
3418,63,11,82,5,0.34593533956848593,6
3419,53,41,51,21,0.34398118429468505,20
3420,94,16,33,8,0.34380946136701285,8
3421,111,12,18,6,0.34349474631160665,6
3422,106,14,66,6,0.34287379392296863,8
3423,17,12,69,6,0.3399205773020941,6
3424,84,19,91,9,0.338597737579075,10
3425,109,13,4,6,0.33809070228925237,7
3426,5,61,87,30,0.3370261398348081,31
3427,39,40,50,20,0.3358837847035394,20
3428,55,65,51,32,0.3317862409811213,33
3429,83,20,106,11,0.3316445649094074,9
3430,8,57,70,28,0.32660941887077904,29
3431,87,26,2,13,0.32619162405938884,13
3432,80,17,71,9,0.3237123360021252,8
3433,18,46,28,22,0.32313224084926334,24
3434,27,27,62,14,0.32158321443949933,13
3435,83,25,28,14,0.31931308670237557,11
3436,50,46,13,23,0.3183740832997801,23
3437,114,22,69,10,0.3170624988990175,12
3438,107,39,90,20,0.3131139201836661,19
3439,16,41,40,20,0.3129456302783174,21
3440,60,48,53,25,0.3118269913878406,23
3441,64,12,28,6,0.3078927557568371,6
3442,23,19,111,11,0.30722018824926817,8
3443,51,17,38,8,0.30308488501942854,9
3444,85,34,86,16,0.30043079848706666,18
3445,57,18,60,9,0.29997989841242795,9
3446,88,16,85,8,0.29964355304249035,8
3447,87,45,104,24,0.2989430528005182,21
3448,46,28,76,14,0.2977453961949545,14
3449,95,54,86,25,0.2936051982256425,29
3450,98,16,19,7,0.29311592538168885,9
3451,27,17,25,9,0.2912949474117434,8
3452,49,13,57,7,0.28995346102881403,6
3453,87,18,33,9,0.28990718970381224,9
3454,68,63,60,33,0.2853879784305839,30
3455,90,10,98,5,0.2818861887378333,5
3456,87,43,109,20,0.2816619596342483,23
3457,67,12,25,6,0.2816428039469052,6
3458,96,12,67,7,0.2799650125910983,5
3459,7,20,70,8,0.27895885562123496,12
3460,94,24,29,12,0.2789341126845451,12
3461,87,28,103,15,0.2785521950229916,13
3462,53,18,5,8,0.2778213329671466,10
3463,12,21,8,10,0.2751918616544977,11
3464,51,54,9,26,0.2700079238709996,28
3465,36,11,38,4,0.2667921507986764,7
3466,22,16,109,8,0.26617483465115477,8
3467,43,22,114,12,0.26405625020379975,10
3468,37,22,76,12,0.2606095394442805,10
3469,104,22,17,11,0.2597220823510658,11
3470,16,20,85,11,0.25737423659678205,9
3471,4,32,68,16,0.2573095525279982,16
3472,4,16,30,8,0.2549680926160687,8
3473,17,11,108,5,0.25064673927891207,6
3474,39,51,63,29,0.2485762976887582,22
3475,40,25,47,14,0.24655985846699083,11
3476,39,11,93,6,0.24650819188031292,5
3477,88,25,93,14,0.2346836303137904,11
3478,93,13,51,7,0.23291171077771639,6
3479,65,10,101,5,0.22906131925900258,5
3480,11,67,39,34,0.22695665476450774,33
3481,87,50,96,24,0.2238030562399532,26
3482,79,31,48,16,0.22311337916674606,15
3483,50,61,86,32,0.2216523965537408,29
3484,12,29,18,14,0.2214557983313134,15
3485,86,79,39,41,0.22073155107485032,38
3486,82,15,28,8,0.2205286984952181,7
3487,37,38,88,19,0.21837047991817124,19
3488,17,21,84,10,0.21599839278237065,11
3489,7,99,107,54,0.2137364856426741,45
3490,53,21,44,9,0.21221133134211373,12
3491,2,37,86,17,0.21062883056177345,20
3492,6,11,100,6,0.20965402679156367,5
3493,43,21,50,9,0.20889556585366265,12
3494,33,13,74,6,0.2046546758624042,7
3495,106,20,48,10,0.20449983406695527,10
3496,107,61,74,29,0.19420996588142067,32
3497,112,18,72,9,0.19365171750841212,9
3498,19,21,112,11,0.19051106403814208,10
3499,104,17,23,10,0.18692044107224143,7
3500,44,15,65,6,0.18351226600641293,9
3501,51,40,20,18,0.18130039081952756,22
3502,50,25,114,12,0.18060110833647136,13
3503,70,23,41,13,0.17939581625615586,10
3504,78,33,11,15,0.17686665327079393,18
3505,20,48,8,24,0.17245365752257427,24
3506,15,10,66,5,0.1703541022119147,5
3507,76,28,30,15,0.16826557910019804,13
3508,106,28,100,13,0.1677556244233467,15
3509,107,31,4,16,0.16653385204254045,15
3510,13,80,86,38,0.16497427756503827,42
3511,75,57,65,29,0.16394853878537058,28
3512,17,29,68,15,0.16206629975870687,14
3513,7,51,4,26,0.16136746029798288,25
3514,7,16,83,7,0.15765677447455673,9
3515,79,14,55,7,0.15414527044248416,7
3516,68,51,63,25,0.14938742389458298,26
3517,68,41,104,21,0.14920589858094652,20
3518,51,17,85,8,0.1485089203425515,9
3519,55,17,29,9,0.14628936106624899,8
3520,37,41,114,19,0.14487606275647452,22
3521,100,51,39,26,0.1436082500357994,25
3522,49,27,9,15,0.1403485015412945,12
3523,86,95,65,50,0.1328835867340733,45
3524,73,10,25,5,0.13287312364388484,5
3525,33,16,114,9,0.1306594611288726,7
3526,69,25,7,13,0.12779683769017072,12
3527,88,65,46,31,0.12160552196414671,34
3528,80,23,84,12,0.11286096846693006,11
3529,68,10,79,4,0.11002938828097016,6
3530,17,34,39,16,0.10903300833788604,18
3531,103,22,29,12,0.10854405086209162,10
3532,54,15,12,8,0.10677371542804602,7
3533,97,10,94,6,0.10576953599255426,4
3534,11,10,73,5,0.1054273387277771,5
3535,64,24,100,11,0.1053276394727547,13
3536,2,18,84,9,0.10504403066305122,9
3537,87,59,55,30,0.10393392000771386,29
3538,15,26,104,13,0.10344391765702249,13
3539,100,19,17,8,0.1033034771886362,11
3540,13,24,45,12,0.09910833731151314,12
3541,86,30,53,13,0.09593092236921533,17
3542,74,39,25,20,0.09563368284675952,19
3543,114,29,36,13,0.0921312858778607,16
3544,15,46,19,23,0.09190535153055165,23
3545,114,48,104,25,0.08363522002227851,23
3546,84,37,88,17,0.08333477514829642,20
3547,47,14,19,7,0.08237732780024944,7
3548,16,29,98,15,0.08177859450323165,14
3549,62,10,95,5,0.0814782186148065,5
3550,97,36,74,17,0.07931920932357457,19
3551,74,43,54,21,0.07806324953233126,22
3552,11,41,76,21,0.07237636421867902,20
3553,106,21,40,10,0.0680825308022658,11
3554,107,71,114,36,0.06336114924955752,35
3555,57,15,104,6,0.0631456146283403,9
3556,16,24,89,12,0.06095933834713444,12
3557,75,46,55,21,0.06023477871620806,25
3558,73,16,106,8,0.047003862193632395,8
3559,8,29,48,14,0.046300725486206125,15
3560,83,17,51,10,0.04607341431682118,7
3561,31,11,97,5,0.04256244744109594,6
3562,9,10,73,5,0.04170228259349536,5
3563,72,17,47,10,0.03554514182185788,7
3564,87,37,62,18,0.03446645815962748,19
3565,31,11,8,5,0.02937900525924807,6
3566,77,25,29,12,0.024466029711668325,13
3567,65,39,11,20,0.02225019372157458,19
3568,13,111,65,54,0.01458893693313318,57
3569,80,18,8,10,0.01264063172158774,8
3570,43,24,78,12,0.012286794783632113,12
3571,109,17,83,7,0.009729329647016893,10
3572,85,15,11,7,0.009683215318296827,8
3573,106,47,76,26,-0.009505075346388465,21
3574,11,15,85,8,-0.009683215318296353,7
3575,83,17,109,10,-0.009729329647015561,7
3576,78,24,43,12,-0.012286794783631668,12
3577,8,18,80,8,-0.012640631721588136,10
3578,65,111,13,57,-0.014588936933132663,54
3579,11,39,65,19,-0.022250193721574954,20
3580,29,25,77,13,-0.02446602971166854,12
3581,8,11,31,6,-0.02937900525924678,5
3582,62,37,87,19,-0.03446645815962768,18
3583,47,17,72,7,-0.035545141821858924,10
3584,73,10,9,5,-0.04170228259349358,5
3585,97,11,31,6,-0.04256244744109594,5
3586,51,17,83,7,-0.04607341431682181,10
3587,48,29,8,15,-0.04630072548620637,14
3588,106,16,73,8,-0.04700386219363217,8
3589,55,46,75,25,-0.060234778716207416,21
3590,89,24,16,12,-0.06095933834713563,12
3591,104,15,57,9,-0.06314561462833927,6
3592,114,71,107,35,-0.06336114924955756,36
3593,40,21,106,11,-0.06808253080226648,10
3594,54,43,74,22,-0.0780632495323316,21
3595,74,36,97,19,-0.07931920932357497,17
3596,95,10,62,5,-0.08147821861480545,5
3597,98,29,16,14,-0.08177859450323123,15
3598,19,14,47,7,-0.08237732780024842,7
3599,88,37,84,20,-0.08333477514829642,17
3600,104,48,114,23,-0.08363522002227874,25
3601,19,46,15,23,-0.09190535153055271,23
3602,36,29,114,16,-0.09213128587785951,13
3603,25,39,74,19,-0.09563368284675924,20
3604,53,30,86,17,-0.09593092236921522,13
3605,45,24,13,12,-0.09910833731151285,12
3606,17,19,100,11,-0.10330347718863582,8
3607,104,26,15,13,-0.1034439176570201,13
3608,55,59,87,29,-0.10393392000771247,30
3609,84,18,2,9,-0.10504403066305122,9
3610,100,24,64,13,-0.10532763947275307,11
3611,73,10,11,5,-0.10542733872777674,5
3612,94,10,97,4,-0.10576953599255319,6
3613,12,15,54,7,-0.10677371542804602,8
3614,29,22,103,10,-0.10854405086209194,12
3615,39,34,17,18,-0.10903300833788687,16
3616,79,10,68,6,-0.11002938828097086,4
3617,84,23,80,11,-0.11286096846693021,12
3618,46,65,88,34,-0.12160552196414537,31
3619,7,25,69,12,-0.12779683769017072,13
3620,114,16,33,7,-0.13065946112887206,9
3621,25,10,73,5,-0.13287312364388448,5
3622,65,95,86,45,-0.1328835867340757,50
3623,9,27,49,12,-0.1403485015412958,15
3624,39,51,100,25,-0.1436082500357988,26
3625,114,41,37,22,-0.14487606275647522,19
3626,29,17,55,8,-0.14628936106624899,9
3627,85,17,51,9,-0.14850892034255025,8
3628,104,41,68,20,-0.14920589858094577,21
3629,63,51,68,26,-0.14938742389458398,25
3630,55,14,79,7,-0.1541452704424852,7
3631,83,16,7,9,-0.15765677447455717,7
3632,4,51,7,25,-0.16136746029798252,26
3633,68,29,17,14,-0.16206629975870612,15
3634,65,57,75,28,-0.16394853878537097,29
3635,86,80,13,42,-0.16497427756503852,38
3636,4,31,107,15,-0.1665338520425416,16
3637,100,28,106,15,-0.1677556244233485,13
3638,30,28,76,13,-0.16826557910019702,15
3639,66,10,15,5,-0.1703541022119154,5
3640,8,48,20,24,-0.17245365752257383,24
3641,11,33,78,18,-0.17686665327079298,15
3642,41,23,70,10,-0.17939581625615697,13
3643,114,25,50,13,-0.18060110833647136,12
3644,20,40,51,22,-0.18130039081952506,18
3645,65,15,44,9,-0.18351226600641318,6
3646,23,17,104,7,-0.186920441072241,10
3647,112,21,19,10,-0.19051106403814258,11
3648,72,18,112,9,-0.1936517175084127,9
3649,74,13,33,7,-0.2046546758624053,6
3650,50,21,43,12,-0.20889556585365976,9
3651,100,11,6,5,-0.20965402679156336,6
3652,86,37,2,20,-0.21062883056177364,17
3653,44,21,53,12,-0.2122113313421144,9
3654,107,99,7,45,-0.21373648564267406,54
3655,84,21,17,11,-0.21599839278237148,10
3656,88,38,37,19,-0.21837047991817116,19
3657,28,15,82,7,-0.2205286984952181,8
3658,39,79,86,38,-0.22073155107485068,41
3659,18,29,12,15,-0.22145579833131304,14
3660,86,61,50,29,-0.22165239655374097,32
3661,48,31,79,15,-0.22311337916674676,16
3662,96,50,87,26,-0.22380305623995242,24
3663,39,67,11,33,-0.22695665476450658,34
3664,101,10,65,5,-0.22906131925900355,5
3665,51,13,93,6,-0.2329117107777153,7
3666,93,25,88,11,-0.23468363031378975,14
3667,93,11,39,5,-0.24650819188031328,6
3668,47,25,40,11,-0.2465598584669911,14
3669,63,51,39,22,-0.2485762976887572,29
3670,108,11,17,6,-0.2506467392789125,5
3671,30,16,4,8,-0.25496809261606845,8
3672,68,32,4,16,-0.25730955252800053,16
3673,85,20,16,9,-0.25737423659678205,11
3674,17,22,104,11,-0.2597220823510663,11
3675,76,22,37,10,-0.2606095394442805,12
3676,114,22,43,10,-0.2640562502037996,12
3677,109,16,22,8,-0.2661748346511539,8
3678,38,11,36,7,-0.26679215079867674,4
3679,9,54,51,28,-0.2700079238710004,26
3680,8,21,12,11,-0.27519186165449905,10
3681,5,18,53,10,-0.27782133296714684,8
3682,103,28,87,13,-0.2785521950229926,15
3683,29,24,94,12,-0.2789341126845448,12
3684,70,20,7,12,-0.2789588556212364,8
3685,67,12,96,5,-0.2799650125910977,7
3686,25,12,67,6,-0.2816428039469052,6
3687,109,43,87,23,-0.28166195963424945,20
3688,98,10,90,5,-0.2818861887378329,5
3689,60,63,68,30,-0.2853879784305837,33
3690,33,18,87,9,-0.28990718970381263,9
3691,57,13,49,6,-0.28995346102881514,7
3692,25,17,27,8,-0.29129494741174317,9
3693,19,16,98,9,-0.29311592538168973,7
3694,86,54,95,29,-0.2936051982256425,25
3695,76,28,46,14,-0.297745396194955,14
3696,104,45,87,21,-0.2989430528005174,24
3697,85,16,88,8,-0.2996435530424907,8
3698,60,18,57,9,-0.29997989841242956,9
3699,86,34,85,18,-0.30043079848706633,16
3700,38,17,51,9,-0.303084885019429,8
3701,111,19,23,8,-0.3072201882492683,11
3702,28,12,64,6,-0.3078927557568362,6
3703,53,48,60,23,-0.3118269913878415,25
3704,40,41,16,21,-0.3129456302783173,20
3705,69,22,114,12,-0.3170624988990179,10
3706,13,46,50,23,-0.31837408329978034,23
3707,28,25,83,11,-0.31931308670237585,14
3708,62,27,27,13,-0.32158321443949917,14
3709,28,46,18,24,-0.3231322408492643,22
3710,71,17,80,8,-0.32371233600212634,9
3711,2,26,87,13,-0.326191624059389,13
3712,70,57,8,29,-0.32660941887077916,28
3713,106,20,83,9,-0.33164456490940797,11
3714,51,65,55,33,-0.3317862409811193,32
3715,50,40,39,20,-0.3358837847035414,20
3716,87,61,5,31,-0.3370261398348085,30
3717,4,13,109,7,-0.33809070228925137,6
3718,91,19,84,10,-0.33859773757907446,9
3719,69,12,17,6,-0.3399205773020955,6
3720,66,14,106,8,-0.34287379392296813,6
3721,18,12,111,6,-0.3434947463116063,6
3722,33,16,94,8,-0.3438094613670113,8
3723,51,41,53,20,-0.34398118429468527,21
3724,82,11,63,6,-0.3459353395684866,5
3725,75,13,34,7,-0.35287672494659683,6
3726,44,14,28,6,-0.35712987287789527,8
3727,90,11,43,6,-0.3643101985935379,5
3728,13,18,92,11,-0.3652174588156216,7
3729,107,83,54,41,-0.36555246276324344,42
3730,76,32,8,17,-0.3663105029930477,15
3731,28,26,95,14,-0.3681472017953835,12
3732,75,21,40,11,-0.36863713867005155,10
3733,30,40,51,20,-0.369072755656284,20
3734,54,14,103,6,-0.37115723437007936,8
3735,60,27,63,14,-0.3732661726653274,13
3736,84,18,14,10,-0.37783903496494214,8
3737,16,29,102,15,-0.37795834144692964,14
3738,97,22,70,10,-0.37837582196425723,12
3739,48,13,37,7,-0.3793970201456411,6
3740,71,28,114,14,-0.3795577437704577,14
3741,78,12,79,6,-0.3858320784259002,6
3742,36,30,69,15,-0.38598798110098714,15
3743,15,20,64,9,-0.3869146492924528,11
3744,89,19,50,10,-0.3889433495588358,9
3745,78,53,16,27,-0.3897829459378538,26
3746,44,13,8,7,-0.39044208757900134,6
3747,84,14,102,7,-0.39120187443648163,7
3748,49,88,13,49,-0.3937005009763855,39
3749,65,16,61,7,-0.3950505274193441,9
3750,95,21,20,11,-0.39560213470105715,10
3751,20,15,104,7,-0.3974398848878548,8
3752,65,41,37,22,-0.3990326963086111,19
3753,30,16,35,8,-0.401641531942974,8
3754,26,11,17,6,-0.4065653808604267,5
3755,114,45,16,24,-0.4068130302568868,21
3756,16,55,74,27,-0.40744218798614557,28
3757,79,18,50,9,-0.40910464935228674,9
3758,55,39,96,19,-0.4099990120595754,20
3759,86,33,31,16,-0.4107692180392456,17
3760,69,16,20,8,-0.4110151707783507,8
3761,38,14,5,7,-0.41683785462955825,7
3762,69,18,112,8,-0.4198013383725037,10
3763,57,13,95,5,-0.4211730515820383,8
3764,61,15,27,7,-0.42506444779830493,8
3765,43,21,106,10,-0.4253017134842326,11
3766,85,32,107,16,-0.4268449425539753,16
3767,31,43,40,21,-0.4296271974626759,22
3768,63,49,40,24,-0.4351978396284048,25
3769,86,76,109,38,-0.4382040730178593,38
3770,60,67,107,33,-0.4399094716611665,34
3771,11,15,90,8,-0.4409004522210788,7
3772,9,11,80,4,-0.4439834453330441,7
3773,39,78,7,38,-0.44566273518626787,40
3774,54,37,30,19,-0.44602753888841007,18
3775,112,33,13,16,-0.44654566712440186,17
3776,15,36,87,19,-0.44867974155253976,17
3777,50,45,106,24,-0.45085338748671533,21
3778,46,36,107,17,-0.4582463107562494,19
3779,21,11,65,5,-0.4627308200784832,6
3780,12,58,65,28,-0.46281952828017253,30
3781,76,38,104,18,-0.46360435076362777,20
3782,54,81,86,40,-0.46582318117547183,41
3783,50,18,12,11,-0.46586470667488794,7
3784,78,10,5,4,-0.466712522808043,6
3785,31,54,65,28,-0.46913887469692556,26
3786,5,42,63,24,-0.4718441296207794,18
3787,18,60,7,29,-0.47486511569031375,31
3788,39,51,25,25,-0.47594650511842646,26
3789,20,23,30,12,-0.47661390204255377,11
3790,62,18,76,9,-0.47842178337117147,9
3791,74,28,95,15,-0.47842550860281247,13
3792,48,19,7,9,-0.48075396413828564,10
3793,13,46,109,24,-0.48203372286829366,22
3794,107,80,84,41,-0.4866239329556469,39
3795,58,16,19,8,-0.4895753929310065,8
3796,97,12,62,6,-0.490051403125013,6
3797,114,13,38,7,-0.4906791341982179,6
3798,47,46,39,24,-0.49230433793615863,22
3799,18,22,74,10,-0.4929022250899433,12
3800,31,35,88,17,-0.49998079760905945,18
3801,91,13,90,7,-0.500323528482734,6
3802,68,51,111,25,-0.5032623987049999,26
3803,7,41,54,21,-0.507241629203192,20
3804,9,18,4,9,-0.5118055197130301,9
3805,51,20,112,10,-0.5141422831615037,10
3806,66,10,112,6,-0.514674275438265,4
3807,106,22,30,11,-0.5189588569615463,11
3808,83,18,60,9,-0.521290662966027,9
3809,65,51,60,23,-0.5216529175374923,28
3810,27,14,74,6,-0.5219215520059618,8
3811,77,24,4,12,-0.5234491201479363,12
3812,103,18,41,10,-0.5269053363965305,8
3813,47,26,65,13,-0.5332277519864402,13
3814,107,22,6,11,-0.5355439544398289,11
3815,1,10,106,5,-0.5396528610114331,5
3816,13,14,35,7,-0.5410242166059793,7
3817,54,29,64,14,-0.545674548180516,15
3818,51,32,23,16,-0.5473097590485455,16
3819,7,17,92,10,-0.5480230211986078,7
3820,65,74,68,37,-0.5506001841763752,37
3821,2,10,83,5,-0.5594397265150782,5
3822,109,27,60,14,-0.5608097746742303,13
3823,43,16,37,9,-0.562355471826641,7
3824,78,13,71,7,-0.5661963238744604,6
3825,71,15,69,7,-0.5724150990318982,8
3826,7,40,114,21,-0.5741553045041332,19
3827,75,32,41,15,-0.57538170131953,17
3828,9,60,88,31,-0.575673272431468,29
3829,98,26,28,15,-0.5775231479620817,11
3830,51,30,47,14,-0.5820326521668323,16
3831,112,28,63,14,-0.5834223269951251,14
3832,77,35,68,19,-0.5847877126510233,16
3833,20,29,74,14,-0.5870486229107592,15
3834,36,13,76,9,-0.5885035889042627,4
3835,112,25,87,12,-0.5908646302689567,13
3836,3,24,55,12,-0.5910345457593116,12
3837,8,22,79,12,-0.5960476384440053,10
3838,78,25,65,14,-0.5972758077920025,11
3839,3,32,69,18,-0.5978612625294901,14
3840,23,10,71,6,-0.6000287508458285,4
3841,12,10,111,4,-0.6003907747378694,6
3842,106,32,71,17,-0.6009609652453864,15
3843,34,15,63,8,-0.6010869874220004,7
3844,9,56,86,27,-0.6017557404930514,29
3845,100,51,30,25,-0.604112108881567,26
3846,70,16,91,9,-0.6063303701253768,7
3847,69,42,51,22,-0.6101979768399989,20
3848,38,35,86,18,-0.6102764909095699,17
3849,57,48,78,25,-0.6156333715871796,23
3850,58,22,31,11,-0.6168553703734997,11
3851,38,12,40,7,-0.6179079194784425,5
3852,81,17,9,9,-0.6212818094890713,8
3853,71,33,36,16,-0.6241330409639583,17
3854,84,30,109,16,-0.6283430275726473,14
3855,29,20,38,10,-0.6286324723530287,10
3856,1,23,60,12,-0.6297573562891136,11
3857,64,28,4,15,-0.6316212138641667,13
3858,20,34,13,18,-0.6324978295967627,16
3859,16,29,33,13,-0.6325119131101443,16
3860,20,16,93,9,-0.6327174645108355,7
3861,48,11,43,5,-0.6335452834733725,6
3862,36,17,111,9,-0.6365354853619519,8
3863,51,18,6,8,-0.6381605805799541,10
3864,8,28,49,15,-0.6383864691812163,13
3865,57,64,16,34,-0.6392313574802775,30
3866,41,25,25,11,-0.6394054706376703,14
3867,69,15,85,8,-0.6408165415497192,7
3868,62,12,72,6,-0.6413947117031077,6
3869,109,10,2,5,-0.6444253237530845,5
3870,88,50,75,26,-0.6490595256191716,24
3871,78,32,63,17,-0.6511427448806584,15
3872,65,65,39,31,-0.654131555054497,34
3873,74,44,87,23,-0.6669497609047667,21
3874,55,24,71,11,-0.6670673084821287,13
3875,12,23,23,12,-0.6683929234960083,11
3876,38,10,50,6,-0.6752935140977925,4
3877,79,13,29,8,-0.6757838864896738,5
3878,78,26,88,14,-0.677835757881376,12
3879,9,15,66,8,-0.6778609704226952,7
3880,3,16,79,7,-0.6788187325928865,9
3881,23,14,109,7,-0.6795387556597839,7
3882,25,19,18,9,-0.6816652439852798,10
3883,84,29,78,14,-0.6870815538251354,15
3884,27,75,68,39,-0.6873238062883658,36
3885,98,23,51,12,-0.6875823408827685,11
3886,48,17,88,10,-0.6890250559346737,7
3887,11,27,69,13,-0.6919460086860769,14
3888,85,19,100,10,-0.6921450091110348,9
3889,9,29,50,15,-0.6932669196756251,14
3890,65,90,7,43,-0.6945220468207879,47
3891,74,15,90,9,-0.6948431634826367,6
3892,39,11,61,5,-0.6964131355147355,6
3893,91,11,38,6,-0.7003822911270813,5
3894,49,10,91,5,-0.7029955830398261,5
3895,54,20,41,10,-0.7052079558025973,10
3896,86,71,68,35,-0.7070864651977475,36
3897,27,18,106,11,-0.7074485049679631,7
3898,12,37,51,19,-0.7101916786560047,18
3899,71,18,43,8,-0.7122285277146747,10
3900,106,72,8,35,-0.7133251026811389,37
3901,40,18,61,9,-0.7154895706830842,9
3902,28,51,37,27,-0.7168710662114356,24
3903,43,38,51,18,-0.7192859319153498,20
3904,27,19,81,10,-0.724889006197101,9
3905,109,20,49,10,-0.7270267076148553,10
3906,4,10,57,6,-0.7276499847388429,4
3907,96,10,71,5,-0.7278695572627853,5
3908,99,13,27,6,-0.7284055341482,7
3909,27,13,33,7,-0.7289108112107292,6
3910,5,41,95,20,-0.7316066534315485,21
3911,11,57,28,30,-0.7338631283307411,27
3912,86,77,40,41,-0.7352757671814358,36
3913,77,24,88,13,-0.7378048830896929,11
3914,15,24,25,11,-0.7394428200536325,13
3915,108,12,7,7,-0.7404080910313966,5
3916,86,24,94,12,-0.7404864736135073,12
3917,64,22,38,11,-0.7416758999099166,11
3918,106,27,109,13,-0.7430675694349284,14
3919,39,51,15,28,-0.7431576274831306,23
3920,74,13,36,8,-0.743717573303843,5
3921,84,24,46,13,-0.7446057703540044,11
3922,100,22,98,12,-0.7471432837189799,10
3923,13,15,14,9,-0.7511854242648529,6
3924,91,14,57,8,-0.7523919124216641,6
3925,50,15,58,7,-0.7660630045931237,8
3926,69,32,88,17,-0.7753807063240763,15
3927,99,22,87,12,-0.7762165713325068,10
3928,109,20,48,11,-0.7860713609857849,9
3929,104,18,4,8,-0.7872554057904768,10
3930,46,21,41,10,-0.7882087764921283,11
3931,33,14,75,8,-0.7900898585820583,6
3932,89,16,28,9,-0.790198641351668,7
3933,107,36,1,18,-0.7927414185552435,18
3934,88,22,2,11,-0.7956469041111253,11
3935,16,55,15,27,-0.7958588072945474,28
3936,62,11,98,6,-0.7995773049352699,5
3937,20,85,86,44,-0.801688488938734,41
3938,40,26,30,13,-0.804558087178627,13
3939,40,14,56,7,-0.8062835825274137,7
3940,12,38,86,20,-0.8156441062566451,18
3941,20,18,57,9,-0.8178941572060072,9
3942,45,19,114,10,-0.8205689132017555,9
3943,95,15,84,8,-0.8218033746912397,7
3944,106,12,29,6,-0.8264692442725412,6
3945,46,16,2,8,-0.8285194662826783,8
3946,77,24,19,12,-0.837985113454208,12
3947,84,23,79,12,-0.8428978656974985,11
3948,95,15,33,8,-0.8491128905949085,7
3949,38,12,41,7,-0.851438988412215,5
3950,64,14,77,6,-0.855042195937583,8
3951,114,10,10,6,-0.8617397018011352,4
3952,43,19,68,9,-0.8623513819268356,10
3953,51,85,68,46,-0.8636071760652753,39
3954,43,25,41,13,-0.8640274273037558,12
3955,3,19,58,11,-0.8650796855609917,8
3956,65,111,54,57,-0.8660420311677455,54
3957,37,67,8,34,-0.870008429807157,33
3958,87,34,46,19,-0.8711353256142382,15
3959,84,17,60,7,-0.8716143564890748,10
3960,68,22,57,12,-0.8716742407341933,10
3961,1,15,27,9,-0.87213831994522,6
3962,48,15,41,8,-0.8735829617761531,7
3963,15,47,13,23,-0.8757286594591266,24
3964,88,21,83,10,-0.8798897555023121,11
3965,3,13,93,8,-0.8808947328421445,5
3966,11,48,27,25,-0.8856386812161113,23
3967,69,19,9,10,-0.887921017203931,9
3968,51,63,27,33,-0.8881383616064742,30
3969,55,54,39,29,-0.89153126518756,25
3970,28,71,106,37,-0.8945808420172991,34
3971,70,24,39,13,-0.8958543413772138,11
3972,28,91,107,48,-0.897076479568304,43
3973,27,52,30,26,-0.8997232050548477,26
3974,55,17,78,8,-0.9002458878614126,9
3975,50,14,62,8,-0.9017457082495483,6
3976,111,12,60,5,-0.9019980300500823,7
3977,50,14,6,7,-0.9048960894988056,7
3978,12,12,29,6,-0.9066091071417803,6
3979,75,35,36,16,-0.9076169876586808,19
3980,3,20,34,11,-0.9113037225897213,9
3981,46,17,64,9,-0.9119833053856672,8
3982,1,14,39,9,-0.9120351629887133,5
3983,87,68,51,35,-0.9168856041700204,33
3984,114,27,75,14,-0.9181862737012525,13
3985,43,16,29,8,-0.9196986818795114,8
3986,9,17,29,8,-0.9197776508076894,9
3987,7,32,95,17,-0.9236786450564201,15
3988,4,24,55,12,-0.9256101911535772,12
3989,9,30,3,15,-0.9265694640511721,15
3990,72,40,16,20,-0.9283059904790143,20
3991,60,34,18,17,-0.934407483335539,17
3992,53,23,63,12,-0.9461903574639031,11
3993,7,78,60,40,-0.9515995280010718,38
3994,103,11,106,5,-0.9583580547252478,6
3995,106,38,104,19,-0.960476027397927,19
3996,8,34,71,17,-0.9628252268322751,17
3997,94,21,41,12,-0.9669375303013764,9
3998,57,15,64,8,-0.96861087557479,7
3999,87,52,63,28,-0.9694664805604988,24
4000,9,12,78,6,-0.9745877106891233,6
4001,62,10,70,5,-0.9747108971050835,5
4002,5,65,107,33,-0.9748363761521173,32
4003,88,76,87,37,-0.9771805164055255,39
4004,102,15,68,8,-0.9774478191416431,7
4005,84,19,93,11,-0.9776365381665065,8
4006,41,81,7,41,-0.9794700083084553,40
4007,13,125,16,67,-0.9826353825245314,58
4008,112,19,54,10,-0.9843355592348288,9
4009,107,32,69,17,-0.9867318989974727,15
4010,27,13,20,7,-0.9871413726704095,6
4011,60,42,3,22,-0.9913631554114459,20
4012,88,33,43,18,-0.9947945347929819,15
4013,38,29,68,16,-0.9956485324900239,13
4014,41,34,57,17,-1.00006887405222,17
4015,93,11,114,5,-1.0049906589581687,6
4016,88,12,45,7,-1.0058195203591593,5
4017,18,20,91,11,-1.0069076377111847,9
4018,85,17,20,9,-1.0120202947249695,8
4019,3,72,86,37,-1.0184654674384122,35
4020,9,13,79,6,-1.0203716742776934,7
4021,90,12,64,6,-1.0226762518657317,6
4022,44,20,63,11,-1.023318477102645,9
4023,51,18,48,8,-1.0238446488089568,10
4024,107,45,78,24,-1.029976454080651,21
4025,74,38,104,21,-1.0321539192468763,17
4026,3,14,45,7,-1.0349134798027042,7
4027,33,16,104,9,-1.0375486456158098,7
4028,63,73,107,34,-1.0499479505653528,39
4029,45,18,71,8,-1.050024616634447,10
4030,89,16,13,9,-1.05819990470755,7
4031,44,14,100,7,-1.0590413147864146,7
4032,3,32,88,17,-1.062179712827227,15
4033,92,14,104,6,-1.0650896272942478,8
4034,71,14,58,7,-1.0679524363994422,7
4035,37,20,67,11,-1.0707700527635227,9
4036,97,16,9,7,-1.0715415510849884,9
4037,109,61,28,33,-1.0738097371372815,28
4038,97,19,64,10,-1.0748997556853979,9
4039,74,27,75,15,-1.0761366724331527,12
4040,57,30,19,15,-1.0764867469339023,15
4041,81,31,60,16,-1.0765050885349574,15
4042,17,15,15,7,-1.085580069098038,8
4043,75,35,87,18,-1.0859483979409976,17
4044,19,41,54,23,-1.095193790798622,18
4045,39,70,87,37,-1.0982945815388088,33
4046,41,35,18,17,-1.0983841672845305,18
4047,87,26,77,14,-1.1017637064574393,12
4048,106,39,70,19,-1.1024614638047314,20
4049,2,18,96,9,-1.1039761816908868,9
4050,45,19,40,10,-1.1043531225931211,9
4051,47,12,91,6,-1.1047106963660316,6
4052,64,38,87,19,-1.107490154923174,19
4053,55,13,73,7,-1.1082443575059626,6
4054,86,101,106,52,-1.11125626745342,49
4055,109,16,40,9,-1.1126467638961661,7
4056,61,14,100,7,-1.113823985180499,7
4057,7,19,29,12,-1.1170674633929336,7
4058,54,69,50,35,-1.117676052966614,34
4059,57,25,28,13,-1.1208866402447324,12
4060,19,28,69,15,-1.1227446471060296,13
4061,88,17,79,9,-1.1249704502892561,8
4062,31,26,3,12,-1.130409883055891,14
4063,106,26,36,13,-1.1307287364062797,13
4064,18,43,107,20,-1.13716112679252,23
4065,53,57,13,31,-1.1379753759861668,26
4066,56,14,8,7,-1.138262181129433,7
4067,45,20,64,11,-1.143150033869317,9
4068,33,10,17,5,-1.1464162819529,5
4069,97,42,107,22,-1.1486858251368084,20
4070,7,17,79,9,-1.1501166003666843,8
4071,16,32,111,16,-1.1556733242940573,16
4072,18,30,77,17,-1.157226861340676,13
4073,18,36,86,20,-1.1625560532444394,16
4074,108,33,16,18,-1.163747925816395,15
4075,41,56,16,30,-1.164409244395375,26
4076,74,19,108,11,-1.1664859423669791,8
4077,75,13,44,6,-1.169380882277211,7
4078,11,51,63,29,-1.1727104947557743,22
4079,77,12,33,6,-1.1756675735500741,6
4080,104,16,89,8,-1.1768798083300274,8
4081,96,31,76,17,-1.185303928819388,14
4082,110,16,87,9,-1.1878037867151126,7
4083,60,15,98,8,-1.1885772534855719,7
4084,74,18,68,11,-1.1930607364890227,7
4085,16,67,25,35,-1.1932865297100739,32
4086,76,20,20,9,-1.195513412586338,11
4087,5,65,28,33,-1.204023419699817,32
4088,46,15,3,7,-1.2064770707138572,8
4089,76,12,47,4,-1.209164557999826,8
4090,97,33,25,17,-1.2112097532933537,16
4091,86,59,57,30,-1.2114369577488067,29
4092,63,16,58,7,-1.2116740819179412,9
4093,34,35,17,17,-1.2128362267835149,18
4094,18,25,54,13,-1.2139969956731949,12
4095,88,37,71,21,-1.2185084211552721,16
4096,41,17,55,9,-1.2209745250839978,8
4097,108,18,64,9,-1.2316301294972696,9
4098,107,88,51,50,-1.2335246266798214,38
4099,25,39,28,22,-1.2338977751460154,17
4100,95,16,63,8,-1.2339697301933763,8
4101,93,21,107,10,-1.2375139728583175,11
4102,31,25,71,13,-1.2380158081615487,12
4103,51,32,70,16,-1.2403340780472845,16
4104,37,20,91,10,-1.2413018923540673,10
4105,55,16,108,9,-1.242512686909538,7
4106,29,38,16,19,-1.2448349982001063,19
4107,9,61,13,33,-1.2504419702657081,28
4108,13,74,41,38,-1.251763682954914,36
4109,13,42,17,21,-1.2570532505054302,21
4110,63,37,9,19,-1.258902370787797,18
4111,112,39,86,21,-1.2594712193458395,18
4112,79,10,93,5,-1.2606355667564606,5
4113,18,20,81,10,-1.2612198373935393,10
4114,55,24,57,11,-1.2620925157379828,13
4115,14,15,107,7,-1.2621804963006722,8
4116,107,12,92,7,-1.2625916923530782,5
4117,65,15,52,7,-1.2628262153703227,8
4118,47,11,62,6,-1.2655269981298467,5
4119,28,29,60,13,-1.2721110011472117,16
4120,1,11,71,5,-1.2732152302328026,6
4121,11,64,87,35,-1.2748219037157664,29
4122,91,10,34,5,-1.2767116469837234,5
4123,54,57,46,29,-1.2778066019254957,28
4124,107,59,96,32,-1.2779661064945875,27
4125,43,10,93,5,-1.2815568757500564,5
4126,88,17,89,8,-1.2888997749635214,9
4127,99,19,51,9,-1.289208240710447,10
4128,78,19,41,11,-1.2892335099283336,8
4129,4,39,88,20,-1.2949212207610556,19
4130,8,22,7,12,-1.2952715014492375,10
4131,109,16,78,8,-1.301574274680268,8
4132,13,44,5,23,-1.3023509853743045,21
4133,17,16,38,8,-1.3036206431746913,8
4134,114,28,41,14,-1.3073381080435666,14
4135,51,14,32,7,-1.3093866254236384,7
4136,58,28,9,15,-1.3102681358218982,13
4137,9,52,68,27,-1.3104638696206719,25
4138,65,32,112,16,-1.312297716343949,16
4139,40,11,94,6,-1.3131730085845275,5
4140,23,21,54,11,-1.3133138976413512,10
4141,88,57,55,32,-1.3163784693707288,25
4142,63,111,65,58,-1.3193232513653719,53
4143,80,18,74,9,-1.3199661328668553,9
4144,54,36,84,19,-1.3202943615638323,17
4145,48,21,30,12,-1.323995388604317,9
4146,86,83,30,45,-1.3293231443644218,38
4147,98,20,50,11,-1.3352874305531426,9
4148,94,12,77,7,-1.3353290162205556,5
4149,23,10,6,5,-1.3385415186806273,5
4150,104,44,8,23,-1.3410693202324977,21
4151,87,19,52,11,-1.3439420173712868,8
4152,40,17,108,8,-1.3479697301696891,9
4153,88,37,97,19,-1.3490743629309023,18
4154,81,14,30,7,-1.3508923221630396,7
4155,107,40,29,24,-1.3557283794699353,16
4156,87,33,47,18,-1.3571633976213282,15
4157,70,33,104,17,-1.3582302540990816,16
4158,40,35,41,17,-1.3586266453597045,18
4159,30,26,25,12,-1.3633847180345748,14
4160,76,47,106,22,-1.3637390504385927,25
4161,19,64,16,36,-1.3677297158037247,28
4162,41,52,39,25,-1.3725005678823738,27
4163,41,30,106,15,-1.3806292559177735,15
4164,3,18,102,10,-1.3811952404449805,8
4165,30,68,87,35,-1.3821130593810047,33
4166,29,11,36,5,-1.3837445576600507,6
4167,64,13,12,7,-1.3883647817413072,6
4168,8,87,86,42,-1.3887471294184068,45
4169,80,12,95,6,-1.3888115326852122,6
4170,107,65,11,35,-1.389011694446381,30
4171,41,44,63,23,-1.393059609593735,21
4172,98,12,74,6,-1.3941368131260956,6
4173,95,17,70,8,-1.4011695857654893,9
4174,9,25,46,12,-1.4052752923291463,13
4175,71,20,12,10,-1.4059148964814134,10
4176,62,29,100,14,-1.409595492278533,15
4177,65,41,15,22,-1.4119875326523994,19
4178,86,36,80,19,-1.4162310289001792,17
4179,53,11,1,6,-1.4196819324858234,5
4180,45,35,36,16,-1.423273124508117,19
4181,39,21,34,11,-1.4278801146393896,10
4182,25,28,50,14,-1.4391705454909005,14
4183,97,21,20,10,-1.439527960881876,11
4184,69,33,65,17,-1.4425642416495132,16
4185,39,44,75,21,-1.4473715172929773,23
4186,63,55,106,28,-1.448556681809941,27
4187,65,28,62,14,-1.4496341901836953,14
4188,83,23,25,13,-1.459720188055503,10
4189,47,21,31,11,-1.460613098071267,10
4190,51,64,40,33,-1.462465890119408,31
4191,3,24,71,13,-1.466820978005952,11
4192,69,13,6,6,-1.467256279566122,7
4193,7,24,35,12,-1.4676220715119488,12
4194,11,50,106,29,-1.475178627799442,21
4195,79,17,103,9,-1.476299618195366,8
4196,69,20,109,10,-1.4769023355605444,10
4197,84,10,68,6,-1.4788993773509216,4
4198,17,38,37,22,-1.4799245104721017,16
4199,71,74,60,39,-1.4843115108657063,35
4200,7,33,49,18,-1.490785536092999,15
4201,74,23,2,13,-1.4920197761473217,10
4202,11,16,112,8,-1.4950492246382474,8
4203,25,47,107,24,-1.4967278623744342,23
4204,5,52,46,28,-1.4974094901037531,24
4205,102,15,19,9,-1.4975662366291813,6
4206,15,22,63,12,-1.4989595234613105,10
4207,89,10,54,6,-1.5037658090302162,4
4208,50,25,27,15,-1.504088460568275,10
4209,27,29,64,15,-1.506656484827703,14
4210,55,12,46,7,-1.5148590180899666,5
4211,61,22,3,14,-1.5200379980927687,8
4212,37,14,35,7,-1.5231317423105963,7
4213,90,14,76,8,-1.5239560719394625,6
4214,27,66,13,34,-1.5277775268373563,32
4215,84,20,114,11,-1.5282826629009745,9
4216,81,15,64,8,-1.5315551836921608,7
4217,53,13,29,8,-1.5317670028644699,5
4218,79,13,98,7,-1.5335435073226167,6
4219,11,21,94,10,-1.5369194320927215,11
4220,86,10,22,5,-1.5381482899799122,5
4221,9,32,60,18,-1.5417639078296765,14
4222,74,61,107,33,-1.5445233108407403,28
4223,27,30,63,17,-1.548293986984764,13
4224,102,25,57,13,-1.5483760769806825,12
4225,47,13,109,7,-1.5491686899512471,6
4226,11,20,80,10,-1.5532652275466878,10
4227,13,61,4,33,-1.5687606312733104,28
4228,78,27,30,14,-1.56960745856174,13
4229,88,34,96,17,-1.5755489762598094,17
4230,72,30,86,16,-1.5774210896268577,14
4231,90,22,55,10,-1.5786569524988743,12
4232,97,34,2,18,-1.581483466739766,16
4233,100,12,58,6,-1.581900885565509,6
4234,61,20,88,12,-1.5819478875432638,8
4235,25,15,2,7,-1.5845186001024003,8
4236,62,23,49,13,-1.5851399264471664,10
4237,39,38,57,19,-1.5884848488756724,19
4238,16,43,34,24,-1.5938069518093543,19
4239,75,11,14,6,-1.594721022285634,5
4240,18,17,76,9,-1.6011095201796195,8
4241,69,29,30,15,-1.6139022710932387,14
4242,13,32,38,15,-1.6143148990855287,17
4243,87,17,44,9,-1.623927941164795,8
4244,88,46,106,26,-1.6248459493396543,20
4245,84,12,64,5,-1.627208224984681,7
4246,51,37,18,18,-1.6280086279913606,19
4247,86,28,35,16,-1.6302927109086052,12
4248,68,18,6,8,-1.6346986227731621,10
4249,18,26,104,15,-1.6361581237581888,11
4250,49,10,102,6,-1.6394569107680652,4
4251,88,60,41,33,-1.6397874376242183,27
4252,68,41,30,21,-1.6397998764136303,20
4253,87,33,12,18,-1.6402422664324792,15
4254,76,41,11,21,-1.6465830449965855,20
4255,68,23,36,12,-1.6511686348202723,11
4256,1,30,41,17,-1.6558361653082898,13
4257,47,24,63,14,-1.6623324282821748,10
4258,74,47,37,24,-1.6628163329711194,23
4259,107,95,8,47,-1.6636951263902342,48
4260,43,31,3,17,-1.6651254167664868,14
4261,16,83,11,48,-1.6657502847984842,35
4262,33,19,54,11,-1.6683853925492602,8
4263,112,17,17,9,-1.6709980493790215,8
4264,31,28,45,15,-1.671087040669103,13
4265,3,46,68,23,-1.671155444021846,23
4266,84,45,87,25,-1.6712785926609635,20
4267,104,14,48,8,-1.6735118830252353,6
4268,7,45,63,27,-1.6735738766299257,18
4269,50,14,23,9,-1.6739476096476191,5
4270,64,18,17,10,-1.6742261514283465,8
4271,50,31,65,16,-1.6801621867417365,15
4272,88,83,8,43,-1.6811669912632214,40
4273,20,25,55,13,-1.682789944223457,12
4274,13,75,39,40,-1.6833252409730635,35
4275,106,40,55,22,-1.6835382667235006,18
4276,28,20,73,10,-1.687006788072292,10
4277,23,15,36,6,-1.697287527418564,9
4278,102,16,20,8,-1.698939123981487,8
4279,57,15,85,8,-1.7034495534090837,7
4280,86,123,107,65,-1.706881150498499,58
4281,55,67,86,36,-1.7078571022769593,31
4282,51,34,50,17,-1.708297555589138,17
4283,28,62,88,33,-1.710290859725632,29
4284,54,51,5,28,-1.712751834502299,23
4285,83,24,104,14,-1.7171480590838877,10
4286,11,19,77,10,-1.7198753848877157,9
4287,15,29,49,14,-1.7216503112217891,15
4288,28,10,77,5,-1.7274479044716256,5
4289,77,20,109,10,-1.7279763913588855,10
4290,68,13,32,8,-1.7311662598089272,5
4291,96,38,106,21,-1.7318320126651956,17
4292,44,27,16,15,-1.7334648777380282,12
4293,9,16,111,9,-1.7347101097492725,7
4294,89,20,86,12,-1.7356386018874979,8
4295,112,23,9,13,-1.7370284161007248,10
4296,66,14,51,7,-1.7380363030144785,7
4297,88,37,36,21,-1.7392851936744365,16
4298,17,41,65,24,-1.7406554308740465,17
4299,6,11,18,6,-1.741458460094483,5
4300,36,33,60,17,-1.7416473627060736,16
4301,107,23,79,13,-1.7474071801332414,10
4302,43,21,104,12,-1.7506051091420238,9
4303,18,37,88,19,-1.753919363939246,18
4304,5,98,37,51,-1.758075221984611,47
4305,88,47,64,26,-1.7611807290570662,21
4306,110,11,88,5,-1.7642228121429715,6
4307,16,39,103,19,-1.7651314635618787,20
4308,30,19,9,11,-1.7725720850396791,8
4309,69,21,50,10,-1.7758250016074677,11
4310,68,39,15,22,-1.779902613157172,17
4311,90,25,37,13,-1.7816453937181718,12
4312,8,20,29,12,-1.7818268121537475,8
4313,77,27,65,15,-1.7824305156446971,12
4314,46,27,97,14,-1.7888516310767928,13
4315,48,19,20,11,-1.788885742697511,8
4316,39,35,114,17,-1.7909993968165168,18
4317,30,40,8,20,-1.7986527143277458,20
4318,103,10,63,6,-1.7993918081481381,4
4319,16,50,112,26,-1.7995643538534876,24
4320,31,34,51,20,-1.8036645224364254,14
4321,86,57,70,31,-1.8046372203949796,26
4322,25,22,36,11,-1.807144013826857,11
4323,111,18,40,9,-1.8104998545748772,9
4324,99,13,102,7,-1.8212893413036917,6
4325,79,37,86,20,-1.8233812794868027,17
4326,75,44,13,24,-1.82625422828726,20
4327,114,13,44,7,-1.8263733365516681,6
4328,114,15,11,7,-1.8276036019184336,8
4329,13,29,74,15,-1.8278354237299026,14
4330,90,23,88,13,-1.8344778390431953,10
4331,96,38,84,19,-1.8356486827006808,19
4332,88,30,92,16,-1.8365360092779854,14
4333,3,63,87,34,-1.837164618465623,29
4334,100,41,8,22,-1.8381782940280218,19
4335,20,30,114,16,-1.839540566254469,14
4336,85,18,12,9,-1.8411131730635322,9
4337,73,13,50,8,-1.8439270323254189,5
4338,88,25,19,12,-1.8450287055712744,13
4339,97,22,53,12,-1.8492466822191038,10
4340,97,21,93,11,-1.8583722279909514,10
4341,33,13,60,8,-1.8644268792007352,5
4342,47,13,53,7,-1.867452050486345,6
4343,48,19,60,10,-1.8683774973367067,9
4344,54,66,87,36,-1.8710926114506878,30
4345,8,41,2,21,-1.884865447616968,20
4346,13,108,68,57,-1.8849483625328207,51
4347,30,16,96,9,-1.885074878690478,7
4348,64,23,25,12,-1.885723885284777,11
4349,18,14,27,7,-1.887864132064807,7
4350,86,44,71,22,-1.8883807510456327,22
4351,106,35,20,19,-1.8905905914286998,16
4352,37,54,51,31,-1.8927999179881416,23
4353,98,12,85,7,-1.8929637615829242,5
4354,99,27,55,15,-1.895072402151854,12
4355,106,51,65,27,-1.9069424806899136,24
4356,88,21,12,11,-1.9079727374799846,10
4357,1,38,68,20,-1.9099752765436626,18
4358,74,65,8,36,-1.912865606563874,29
4359,17,11,110,6,-1.9155371371930692,5
4360,106,32,97,16,-1.9159665785715099,16
4361,76,11,99,5,-1.9173589523208294,6
4362,18,21,114,11,-1.9235772497574435,10
4363,72,19,107,10,-1.9240841693406125,9
4364,54,28,17,14,-1.9259736473512512,14
4365,40,19,70,11,-1.9276789997691235,8
4366,84,30,65,16,-1.9288646732683914,14
4367,11,33,30,18,-1.932365386096484,15
4368,97,14,23,7,-1.933052873443659,7
4369,98,10,32,5,-1.938005226383161,5
4370,7,49,71,24,-1.9387153694352721,25
4371,104,13,110,8,-1.938847445081051,5
4372,31,14,23,8,-1.9392936999416412,6
4373,55,20,25,11,-1.9429576796619983,9
4374,64,34,36,17,-1.9485056781764574,17
4375,57,34,27,17,-1.9534766566361852,17
4376,86,30,19,15,-1.9572349198961299,15
4377,35,11,50,6,-1.9581460146246799,5
4378,33,14,39,7,-1.9600955952261323,7
4379,97,11,80,6,-1.9631828964682283,5
4380,112,24,41,13,-1.9642201479007202,11
4381,91,33,28,18,-1.9649527402335243,15
4382,65,31,19,16,-1.9655134440486957,15
4383,3,22,23,12,-1.9704853033748797,10
4384,35,10,54,6,-1.970607603878344,4
4385,84,31,55,16,-1.972558144291078,15
4386,70,32,88,17,-1.97629343595963,15
4387,53,28,95,17,-1.9769373995573174,11
4388,79,12,100,7,-1.9822381822120907,5
4389,4,19,53,10,-1.9876947928926731,9
4390,55,92,8,46,-1.9945813817420808,46
4391,74,26,114,13,-1.9975972531686852,13
4392,27,11,66,6,-1.9992664520674324,5
4393,50,39,8,22,-1.9997739229036215,17
4394,97,22,83,10,-2.0076368732075736,12
4395,77,73,60,38,-2.0085290730636896,35
4396,37,20,62,12,-2.0107407128281514,8
4397,86,47,23,25,-2.0116860012086644,22
4398,12,35,39,19,-2.011891168245126,16
4399,102,29,16,15,-2.01250365528989,14
4400,12,21,88,11,-2.014366026449469,10
4401,70,29,68,15,-2.0151181581046322,14
4402,27,46,41,26,-2.0152493875384563,20
4403,37,14,69,7,-2.0155128499001447,7
4404,60,11,93,7,-2.0186296316322276,4
4405,10,10,111,6,-2.019460672769103,4
4406,90,37,8,21,-2.019464782071777,16
4407,17,27,114,16,-2.0211590753648663,11
4408,60,26,90,15,-2.0244178494313423,11
4409,51,52,28,26,-2.0250173037261257,26
4410,13,11,32,6,-2.0261815070275415,5
4411,114,14,91,7,-2.031242634143404,7
4412,13,25,33,13,-2.0314833968214865,12
4413,60,16,80,8,-2.0385494144903564,8
4414,93,18,11,8,-2.03919027808283,10
4415,19,44,43,24,-2.03996088625664,20
4416,7,14,12,7,-2.0405365521973633,7
4417,65,25,48,12,-2.0579371291305484,13
4418,57,19,9,10,-2.058380213538902,9
4419,60,20,62,10,-2.0597588787986405,10
4420,88,22,76,11,-2.0620652721332697,11
4421,70,44,107,22,-2.066718062800075,22
4422,34,30,84,16,-2.067010635537675,14
4423,50,12,94,7,-2.0673259151868515,5
4424,23,20,27,10,-2.072262837137015,10
4425,30,22,57,11,-2.074211064897338,11
4426,51,14,44,9,-2.084874228955974,5
4427,72,14,66,8,-2.0852128177023075,6
4428,68,43,64,25,-2.086424402801581,18
4429,11,18,40,9,-2.0894421004610075,9
4430,86,30,108,17,-2.0910937309013535,13
4431,8,22,97,11,-2.094799206270942,11
4432,55,34,83,17,-2.0962093979720233,17
4433,107,91,65,48,-2.099017279299859,43
4434,55,30,76,17,-2.101047736110318,13
4435,23,19,112,11,-2.1018527652621146,8
4436,94,28,68,15,-2.106511062546954,13
4437,13,38,57,19,-2.1070868819342947,19
4438,25,11,69,6,-2.1120597510852503,5
4439,72,17,7,9,-2.1143024060967655,8
4440,70,11,53,6,-2.117480208536361,5
4441,63,24,49,12,-2.1212323385530256,12
4442,9,62,7,31,-2.12190310948229,31
4443,114,32,102,18,-2.1240842876015145,14
4444,43,10,98,6,-2.130277896443765,4
4445,8,77,54,44,-2.1325516335637458,33
4446,61,12,2,7,-2.1331085158076037,5
4447,74,30,11,16,-2.1347610080308996,14
4448,102,26,8,13,-2.1358165667375646,13
4449,31,13,66,7,-2.1367157981218847,6
4450,51,64,3,32,-2.136969156390622,32
4451,68,17,81,9,-2.1370452313390325,8
4452,39,39,71,21,-2.1402119009407663,18
4453,69,11,55,6,-2.141856565606561,5
4454,8,21,10,12,-2.1473150021467613,9
4455,3,27,62,15,-2.154788303981497,12
4456,49,11,89,6,-2.1552213251273202,5
4457,53,13,23,7,-2.1639220781507684,6
4458,88,67,60,37,-2.1715375199885694,30
4459,68,46,41,24,-2.1718048075100542,22
4460,100,10,52,6,-2.1822522154052875,4
4461,27,36,34,19,-2.1860495568606466,17
4462,106,35,68,19,-2.1936858069827916,16
4463,40,75,7,42,-2.1957521283064794,33
4464,56,12,91,6,-2.1992686471747738,6
4465,91,14,17,8,-2.2013317711286327,6
4466,49,10,96,5,-2.2013596017058816,5
4467,27,27,75,15,-2.203651126537083,12
4468,72,32,13,16,-2.2040070476145734,16
4469,60,17,89,8,-2.2059312682885284,9
4470,96,50,5,28,-2.21142719225076,22
4471,84,23,75,12,-2.2186834285684554,11
4472,39,53,8,27,-2.2208284702166408,26
4473,50,32,17,16,-2.221124084948795,16
4474,99,13,98,6,-2.221258167793369,7
4475,12,11,112,5,-2.2247336886150633,6
4476,86,50,15,27,-2.2250860482481825,23
4477,25,16,90,9,-2.2261576936837106,7
4478,71,29,62,15,-2.2274966883750613,14
4479,11,26,12,13,-2.231267105865384,13
4480,65,18,46,11,-2.2329984780581085,7
4481,114,26,4,13,-2.2345648368573663,13
4482,48,17,27,10,-2.234964127170627,7
4483,65,11,108,5,-2.235257356991268,6
4484,103,13,77,7,-2.236670005317329,6
4485,107,61,68,31,-2.2392858218745877,30
4486,49,21,64,12,-2.2416010602386134,9
4487,13,65,104,35,-2.2428038741485223,30
4488,27,10,70,5,-2.2432632584575636,5
4489,69,36,87,21,-2.24685081086476,15
4490,70,52,16,29,-2.248690629015385,23
4491,19,17,8,9,-2.2502111874564155,8
4492,83,11,63,7,-2.2518527555220995,4
4493,74,29,20,16,-2.2532656544174667,13
4494,25,30,95,16,-2.253973143655665,14
4495,41,13,74,6,-2.2545650248033335,7
4496,17,16,98,8,-2.257246092539532,8
4497,106,62,87,32,-2.2622041017840124,30
4498,3,23,109,12,-2.262800410189064,11
4499,42,11,87,6,-2.2670677132557637,5
4500,7,12,85,7,-2.267272935114745,5
4501,96,66,28,35,-2.2674069446039304,31
4502,31,10,61,5,-2.2696136748473643,5
4503,68,108,7,58,-2.2702884441480418,50
4504,74,14,40,8,-2.2751378053719047,6
4505,11,47,50,25,-2.276023953743783,22
4506,92,14,65,7,-2.2769844774151675,7
4507,46,60,11,32,-2.27863758150919,28
4508,69,12,77,6,-2.279799370845894,6
4509,81,10,38,5,-2.281962126644993,5
4510,112,36,107,18,-2.2856893291686897,18
4511,88,26,81,14,-2.2857834835265307,12
4512,16,16,73,8,-2.2869477637304083,8
4513,28,76,8,41,-2.287592590077328,35
4514,4,13,106,6,-2.2878834680443574,7
4515,5,24,100,13,-2.293242743404464,11
4516,50,42,63,23,-2.295098382996511,19
4517,7,20,80,11,-2.2986689861273364,9
4518,76,34,50,16,-2.298946803227752,18
4519,95,26,60,14,-2.300035058084819,12
4520,70,13,35,6,-2.304704787607643,7
4521,69,13,76,8,-2.308555624427584,5
4522,70,28,63,15,-2.309911464577443,13
4523,63,31,71,17,-2.3112629873314674,14
4524,96,58,8,31,-2.313991189820115,27
4525,91,32,88,17,-2.315767764685104,15
4526,87,18,111,10,-2.3163891448333644,8
4527,102,21,104,10,-2.3206272974702777,11
4528,103,10,8,6,-2.3245085117289825,4
4529,50,35,84,18,-2.3257021134383264,17
4530,42,10,72,6,-2.328523056790725,4
4531,5,51,109,26,-2.3285813949081633,25
4532,53,28,25,14,-2.330151085469087,14
4533,107,36,108,19,-2.3376906663222394,17
4534,90,38,16,19,-2.3412133984930836,19
4535,45,10,78,5,-2.343791897433706,5
4536,109,29,76,17,-2.348338718743378,12
4537,11,24,29,13,-2.349681332743006,11
4538,33,18,11,11,-2.3498549166237113,7
4539,43,50,16,28,-2.3507433165143286,22
4540,96,10,79,5,-2.3519921114573528,5
4541,31,36,4,21,-2.353535596679466,15
4542,33,12,99,7,-2.354570382478151,5
4543,17,27,8,14,-2.3545788982602027,13
4544,109,14,96,8,-2.3566759619593642,6
4545,64,44,53,24,-2.357816373417817,20
4546,97,14,100,8,-2.358325970901079,6
4547,49,35,76,19,-2.3583999407791745,16
4548,76,34,70,18,-2.358420872168422,16
4549,5,23,99,12,-2.361621902264283,11
4550,87,10,22,4,-2.3658236386511695,6
4551,97,13,49,8,-2.3668261814242055,5
4552,50,24,40,14,-2.3671440474550494,10
4553,63,32,25,16,-2.3688265373602633,16
4554,55,31,53,17,-2.372089532662414,14
4555,84,19,90,10,-2.374748457023267,9
4556,104,44,39,24,-2.3751154073426806,20
4557,12,29,49,12,-2.3757535970577637,17
4558,107,40,71,23,-2.3760609676092463,17
4559,112,14,8,8,-2.379829723910838,6
4560,56,13,75,8,-2.3840139649043497,5
4561,60,50,87,25,-2.3851213457463967,25
4562,104,25,96,14,-2.3866419839158373,11
4563,71,21,4,13,-2.387175011736595,8
4564,95,40,104,22,-2.389034218387607,18
4565,48,13,23,7,-2.389445224732223,6
4566,45,22,16,13,-2.3925466679441394,9
4567,65,50,53,26,-2.3970028220576673,24
4568,48,43,16,22,-2.3975104970965577,21
4569,109,21,97,11,-2.3981411019215164,10
4570,28,38,46,22,-2.399017879816561,16
4571,98,15,114,8,-2.3992721750256814,7
4572,94,27,100,17,-2.4002432216595997,10
4573,80,26,20,14,-2.403335157163852,12
4574,33,21,86,12,-2.404613887093818,9
4575,34,14,22,7,-2.405197781979372,7
4576,104,57,88,32,-2.406185933878752,25
4577,50,23,34,12,-2.4065274329929416,11
4578,81,24,107,13,-2.414159413465892,11
4579,94,19,28,11,-2.4149604753175535,8
4580,99,11,109,6,-2.419517402501051,5
4581,34,28,109,15,-2.42248256662429,13
4582,51,25,103,13,-2.4225011486475783,12
4583,37,17,93,10,-2.422747703399567,7
4584,90,39,107,20,-2.4251424853764503,19
4585,96,17,3,9,-2.4320783711975644,8
4586,51,19,14,12,-2.433844123091522,7
4587,102,24,109,13,-2.437458896467386,11
4588,47,15,64,9,-2.441201731533323,6
4589,50,10,32,4,-2.4440541907162885,6
4590,61,15,63,9,-2.445410080263457,6
4591,84,10,40,5,-2.454221067396937,5
4592,86,17,110,9,-2.4597124602837575,8
4593,25,32,102,17,-2.460889696925049,15
4594,1,17,17,9,-2.462761073509874,8
4595,34,31,13,16,-2.4629355156987685,15
4596,76,23,41,11,-2.4646493381228964,12
4597,37,10,103,4,-2.465940588175403,6
4598,69,17,74,8,-2.466497282082459,9
4599,81,17,4,10,-2.467812477706321,7
4600,103,17,30,10,-2.4703689712282237,7
4601,20,20,17,11,-2.4759550702480677,9
4602,28,58,87,30,-2.4778229626436263,28
4603,79,25,28,13,-2.4854050300354316,12
4604,9,27,71,15,-2.485839871550414,12
4605,43,34,27,18,-2.487486899178629,16
4606,11,21,64,13,-2.490493863054092,8
4607,111,38,65,22,-2.4964278491140734,16
4608,67,13,84,6,-2.500709874534178,7
4609,92,15,87,8,-2.5078466479835875,7
4610,107,54,50,28,-2.5099686972292012,26
4611,27,35,29,20,-2.5139766493292606,15
4612,36,15,12,8,-2.516319942513754,7
4613,46,27,68,15,-2.520930145642669,12
4614,4,18,39,10,-2.5267698999647306,8
4615,9,33,36,18,-2.527924078037464,15
4616,30,19,99,11,-2.530388293684777,8
4617,107,15,44,8,-2.5305445670994096,7
4618,17,29,7,16,-2.532089441361392,13
4619,88,60,40,33,-2.532837544735202,27
4620,87,29,90,16,-2.533544175082615,13
4621,72,14,43,7,-2.536394554509492,7
4622,102,34,54,18,-2.537229709009487,16
4623,9,22,70,13,-2.539064949919759,9
4624,65,35,97,19,-2.5397394280205594,16
4625,95,14,77,7,-2.5410335587352355,7
4626,20,40,88,20,-2.541950104212901,20
4627,36,74,7,40,-2.5493587507973596,34
4628,76,14,44,8,-2.5504141931433426,6
4629,47,14,71,7,-2.550463226281338,7
4630,30,12,47,5,-2.551854085041669,7
4631,1,19,73,11,-2.5534291003907312,8
4632,68,75,16,42,-2.5553684294875567,33
4633,25,14,48,7,-2.5710538086168517,7
4634,51,29,1,15,-2.5741193049184647,14
4635,108,14,81,7,-2.575857374314636,7
4636,112,22,50,13,-2.578275791966451,9
4637,45,16,63,9,-2.579990748130807,7
4638,88,15,33,9,-2.581178022844097,6
4639,65,71,28,40,-2.5907378992374013,31
4640,94,35,19,18,-2.592430047160573,17
4641,109,10,1,5,-2.5929606771402347,5
4642,37,27,102,15,-2.5931875377695413,12
4643,37,48,20,25,-2.593682765159078,23
4644,107,94,13,50,-2.59789501954985,44
4645,80,32,65,17,-2.5986356922004035,15
4646,89,10,20,5,-2.5989355295603778,5
4647,91,23,36,13,-2.6004832054576417,10
4648,1,29,40,16,-2.6081027273161874,13
4649,107,33,94,20,-2.6133702151384592,13
4650,34,20,9,11,-2.6185115894413826,9
4651,89,10,39,6,-2.6189716831037595,4
4652,28,42,39,22,-2.6233394077803625,20
4653,54,51,39,27,-2.6240157360627983,24
4654,107,70,27,39,-2.628606213410472,31
4655,107,34,95,18,-2.633836762476073,16
4656,22,12,51,7,-2.634920658551637,5
4657,54,13,110,7,-2.6358849029934506,6
4658,69,24,100,13,-2.641711217702835,11
4659,20,20,19,10,-2.646933293157403,10
4660,36,13,57,8,-2.65311609010537,5
4661,73,14,20,8,-2.6543798385197737,6
4662,68,32,19,18,-2.6559298105207456,14
4663,27,24,40,11,-2.6563176029466633,13
4664,95,18,76,9,-2.6576501695432877,9
4665,20,33,11,19,-2.6580258548377644,14
4666,9,54,107,27,-2.6599346903452616,27
4667,60,62,51,37,-2.668091254445394,25
4668,5,17,71,9,-2.668348512437487,8
4669,104,67,37,37,-2.6697156594454787,30
4670,7,118,13,63,-2.670897317194471,55
4671,44,17,25,9,-2.67353547628176,8
4672,12,10,48,6,-2.6757754483893836,4
4673,16,79,54,42,-2.676890621910499,37
4674,107,74,39,39,-2.6770725608683947,35
4675,5,25,39,13,-2.679132217269281,12
4676,58,14,43,8,-2.6806335210315995,6
4677,107,21,93,12,-2.6848247910711347,9
4678,43,13,74,6,-2.6848796666350307,7
4679,102,20,13,12,-2.6891186576501824,8
4680,43,29,11,15,-2.690595886408949,14
4681,30,21,7,10,-2.691476247459028,11
4682,31,23,87,12,-2.691508727503307,11
4683,65,11,10,6,-2.6916160360342993,5
4684,48,22,39,13,-2.697481925191404,9
4685,11,63,8,34,-2.698721990639595,29
4686,68,27,47,15,-2.700809442975105,12
4687,7,27,20,14,-2.7023319306021247,13
4688,79,11,39,7,-2.7039365709334606,4
4689,50,46,2,25,-2.7076882491876737,21
4690,33,14,90,8,-2.7086229849631858,6
4691,84,89,86,45,-2.7122592129849847,44
4692,49,61,88,34,-2.7144625519502794,27
4693,4,20,63,11,-2.717031964261838,9
4694,51,17,58,9,-2.7220403540386506,8
4695,84,30,37,16,-2.724027270977717,14
4696,88,16,44,8,-2.725541522204711,8
4697,5,11,49,6,-2.7256599500520573,5
4698,46,26,60,14,-2.733085524905184,12
4699,54,25,15,12,-2.735147263925594,13
4700,62,30,39,17,-2.7367319129051215,13
4701,63,12,99,6,-2.7377253409939395,6
4702,94,44,43,24,-2.7382840894808322,20
4703,68,31,69,17,-2.743936079051881,14
4704,51,26,71,14,-2.7484840529184043,12
4705,104,31,30,16,-2.7504108450647484,15
4706,65,36,43,18,-2.7525986025329394,18
4707,43,14,70,8,-2.753352748891412,6
4708,96,34,97,17,-2.7556888339056824,17
4709,35,23,88,12,-2.7598010038488736,11
4710,94,17,1,8,-2.7623810098011927,9
4711,78,14,38,8,-2.764880209657064,6
4712,80,36,16,21,-2.76546563276886,15
4713,87,17,10,9,-2.7770692343126613,8
4714,40,30,18,18,-2.780722164544755,12
4715,107,36,17,19,-2.7872894864783673,17
4716,41,58,51,31,-2.788035903246999,27
4717,112,14,85,8,-2.7888570708398155,6
4718,102,12,70,5,-2.7906887378625385,7
4719,57,10,18,6,-2.791050441588557,4
4720,36,13,100,7,-2.7923934619121082,6
4721,1,26,7,14,-2.7932054952385057,12
4722,44,14,68,7,-2.795327721392822,7
4723,8,32,83,16,-2.795775595052068,16
4724,54,66,20,33,-2.7989366544964605,33
4725,65,90,87,49,-2.7992008582251438,41
4726,27,42,12,24,-2.8046964318602283,18
4727,112,14,106,7,-2.805082024542775,7
4728,71,42,65,24,-2.8056942435602354,18
4729,41,15,99,8,-2.808167291861728,7
4730,36,32,1,16,-2.8095303452930676,16
4731,40,48,9,27,-2.81743847104381,21
4732,76,26,97,14,-2.8180456861896683,12
4733,48,14,68,7,-2.8206443314688054,7
4734,71,13,18,7,-2.821320109059585,6
4735,62,18,54,10,-2.824080555827825,8
4736,112,21,75,12,-2.824219405034082,9
4737,107,39,15,24,-2.8291612991129433,15
4738,86,61,114,32,-2.83079839430398,29
4739,81,23,53,13,-2.832269045840236,10
4740,35,11,39,6,-2.836154761931755,5
4741,28,104,86,58,-2.8374089851944664,46
4742,16,73,104,40,-2.838890783683991,33
4743,16,25,4,12,-2.8411046840521466,13
4744,39,33,95,18,-2.841495525954101,15
4745,45,10,30,6,-2.841712664869655,4
4746,33,13,97,7,-2.8486496222061612,6
4747,28,96,16,53,-2.854985092700266,43
4748,112,13,74,7,-2.8550316834984466,6
4749,94,15,88,7,-2.858803168647949,8
4750,28,25,69,13,-2.8619129564051375,12
4751,11,50,55,29,-2.865634885836894,21
4752,88,14,72,8,-2.866088260356641,6
4753,84,70,28,39,-2.8670003890442084,31
4754,63,23,46,11,-2.86724186989635,12
4755,17,10,88,4,-2.869337502995369,6
4756,68,69,88,38,-2.8695211003313763,31
4757,1,14,112,9,-2.8723250567679224,5
4758,2,10,108,6,-2.87346504815302,4
4759,30,21,75,11,-2.8743282279457314,10
4760,43,26,69,14,-2.874624697498018,12
4761,77,14,106,7,-2.8755893681261617,7
4762,46,25,17,14,-2.875672610475698,11
4763,88,58,27,30,-2.8900429056834263,28
4764,71,34,30,18,-2.8915964337712703,16
4765,79,33,16,19,-2.9049583801159375,14
4766,9,19,62,10,-2.9069158954391585,9
4767,10,12,104,6,-2.911353003023708,6
4768,54,36,80,18,-2.91166309610947,18
4769,58,23,60,12,-2.91177122457859,11
4770,41,22,47,11,-2.9126189727076204,11
4771,33,10,37,6,-2.9157377490462273,4
4772,31,11,55,6,-2.9183781753906346,5
4773,9,17,109,8,-2.91854195196147,9
4774,106,19,102,9,-2.920725539256512,10
4775,62,14,1,7,-2.9215215839903967,7
4776,33,10,3,6,-2.927658221464772,4
4777,40,18,12,9,-2.9302897037093416,9
4778,28,21,33,10,-2.934003356051797,11
4779,94,20,78,11,-2.934032764236852,9
4780,86,16,66,9,-2.9349279516020914,7
4781,87,20,36,12,-2.935573250897671,8
4782,49,27,68,15,-2.9363199373933018,12
4783,65,27,83,14,-2.938404758323202,13
4784,1,18,9,8,-2.9438107743951827,10
4785,8,39,60,20,-2.9438347563437417,19
4786,46,18,71,9,-2.9448527741935377,9
4787,12,15,52,8,-2.948123132553489,7
4788,29,19,54,11,-2.9499144478753045,8
4789,3,33,15,18,-2.9522579457276623,15
4790,51,106,13,55,-2.956296787814829,51
4791,46,23,114,13,-2.963143531607223,10
4792,51,143,16,76,-2.9638324922735344,67
4793,13,27,91,14,-2.9639468252756305,13
4794,57,18,25,10,-2.9649349505538742,8
4795,76,17,103,8,-2.9655338789976318,9
4796,63,16,73,8,-2.966556049159883,8
4797,37,21,2,11,-2.969758011269449,10
4798,88,64,114,34,-2.9736929918128054,30
4799,4,32,36,19,-2.973906674035423,13
4800,106,36,84,18,-2.975473960825012,18
4801,1,13,46,6,-2.9771068452784513,7
4802,107,19,89,11,-2.9792947741375198,8
4803,13,23,85,14,-2.985985548040523,9
4804,34,11,114,5,-2.9884829411181757,6
4805,90,47,86,27,-2.997206734082277,20
4806,69,11,4,6,-2.9994841766617113,5
4807,34,14,96,8,-3.001763014782561,6
4808,108,20,50,10,-3.006186687462408,10
4809,63,42,74,22,-3.0096162132471513,20
4810,39,43,9,22,-3.01214851454061,21
4811,88,29,47,15,-3.0208806441241465,14
4812,33,17,40,11,-3.0217035797006964,6
4813,39,26,76,16,-3.022675040857639,10
4814,114,10,89,5,-3.0269218224279837,5
4815,98,13,39,8,-3.033232316977357,5
4816,19,23,76,13,-3.0337389389191696,10
4817,78,43,86,23,-3.034722772832767,20
4818,65,39,25,23,-3.0368934823131153,16
4819,79,22,30,13,-3.038702569108576,9
4820,12,30,68,16,-3.041358769608476,14
4821,96,13,38,7,-3.042215232246171,6
4822,3,40,12,23,-3.0432320355913456,17
4823,78,26,29,15,-3.048027729543013,11
4824,55,45,7,26,-3.0547614693932803,19
4825,57,11,6,6,-3.056750466696465,5
4826,51,41,57,22,-3.0641529465856623,19
4827,25,18,71,10,-3.0644100067848146,8
4828,25,30,75,17,-3.0695517335408993,13
4829,60,29,19,15,-3.0741844930514644,14
4830,104,23,97,12,-3.0789791419269115,11
4831,62,16,55,9,-3.0797392954165557,7
4832,28,12,66,6,-3.0826665795427424,6
4833,23,55,16,30,-3.0835008847032244,25
4834,37,59,107,32,-3.087858660035623,27
4835,50,17,93,10,-3.0892168464304066,7
4836,27,17,6,9,-3.094787186521295,8
4837,109,10,85,7,-3.095406882310694,3
4838,87,20,6,11,-3.0972456748613655,9
4839,54,34,104,18,-3.0987784259955413,16
4840,91,10,64,6,-3.099347902087069,4
4841,74,16,88,10,-3.1000151762465453,6
4842,68,14,99,8,-3.100103615084475,6
4843,60,15,92,9,-3.1016290657385786,6
4844,77,38,86,21,-3.1019167430803822,17
4845,86,21,111,12,-3.1037611827633467,9
4846,30,23,20,12,-3.1046519258930347,11
4847,109,37,104,20,-3.106483867605531,17
4848,4,24,50,12,-3.110559237136967,12
4849,17,25,25,14,-3.1106502600539123,11
4850,80,11,36,6,-3.115857421175655,5
4851,48,36,28,20,-3.1189690871072235,16
4852,8,36,23,20,-3.120762784480779,16
4853,27,26,76,15,-3.122377163291182,11
4854,11,26,34,15,-3.122489399667274,11
4855,61,15,51,10,-3.1232056571511624,5
4856,19,55,30,31,-3.1254848448500048,24
4857,28,11,6,6,-3.131247568187587,5
4858,2,15,76,9,-3.1350168634931235,6
4859,11,36,15,20,-3.1372782014701865,16
4860,9,23,114,15,-3.140025237540426,8
4861,45,12,112,6,-3.1460936650177436,6
4862,13,65,100,35,-3.1478251869099063,30
4863,23,23,75,11,-3.148733601092015,12
4864,76,18,3,10,-3.150422222688239,8
4865,7,51,104,28,-3.1582194180075027,23
4866,82,21,86,12,-3.1586560919846343,9
4867,4,19,75,11,-3.1591429263358264,8
4868,113,15,86,9,-3.16969593297623,6
4869,60,25,106,15,-3.171261503808185,10
4870,47,34,16,19,-3.1778605747552735,15
4871,26,11,87,6,-3.178365822043256,5
4872,69,16,103,8,-3.1785957104061207,8
4873,50,21,100,12,-3.1824846398299695,9
4874,114,31,54,16,-3.1847921316014287,15
4875,58,10,11,6,-3.1884299720547142,4
4876,90,22,17,13,-3.190848422422067,9
4877,8,15,69,8,-3.1913004711052855,7
4878,37,57,16,31,-3.1949363370328974,26
4879,13,11,52,6,-3.198313935058208,5
4880,39,41,36,23,-3.1998605067578247,18
4881,30,15,23,8,-3.2022910560317883,7
4882,17,28,106,17,-3.2039846830051175,11
4883,97,12,56,6,-3.20853124358707,6
4884,31,47,60,23,-3.209470727487928,24
4885,97,19,50,11,-3.210625734622635,8
4886,74,16,17,9,-3.211770551027836,7
4887,102,28,76,16,-3.211945141016371,12
4888,80,10,100,6,-3.221630002984554,4
4889,12,21,19,10,-3.2219445095429284,11
4890,7,55,23,30,-3.22292830537617,25
4891,97,14,3,7,-3.230803945654675,7
4892,36,49,107,26,-3.2348387046482574,23
4893,60,25,99,14,-3.23819445910271,11
4894,49,46,30,26,-3.239911352008885,20
4895,81,12,23,7,-3.240703587077,5
4896,16,83,60,45,-3.245223315992939,38
4897,96,10,64,6,-3.2470341038418864,4
4898,15,38,100,21,-3.2528324504039166,17
4899,25,47,114,27,-3.2540864225169717,20
4900,108,11,29,6,-3.254331422994316,5
4901,74,24,7,15,-3.2574931437928867,9
4902,67,13,114,7,-3.2746706512348394,6
4903,53,50,39,28,-3.2771617260881896,22
4904,3,25,8,12,-3.277389633331906,13
4905,78,31,68,17,-3.285372327961684,14
4906,35,15,55,8,-3.2899027901624853,7
4907,107,45,34,26,-3.2909922405162497,19
4908,79,17,76,10,-3.2930359935936764,7
4909,61,13,47,7,-3.3043540506366402,6
4910,64,21,114,12,-3.3046667254482798,9
4911,107,41,19,24,-3.3073590728366797,17
4912,96,14,41,9,-3.3088942892360294,5
4913,25,66,86,35,-3.3097455853588764,31
4914,75,31,60,17,-3.313915862803686,14
4915,84,16,97,10,-3.3164282058099315,6
4916,97,14,98,7,-3.3185319117606134,7
4917,38,23,60,12,-3.3201484252433597,11
4918,48,17,80,10,-3.335623053391129,7
4919,5,13,68,7,-3.3380294056441095,6
4920,98,20,54,11,-3.341408257498297,9
4921,11,42,13,24,-3.34278030791396,18
4922,20,19,15,11,-3.3455642497005824,8
4923,65,20,94,10,-3.3472699488499047,10
4924,20,10,83,5,-3.3478898251644154,5
4925,107,15,14,9,-3.3479962116917648,6
4926,106,17,14,10,-3.3600594128266157,7
4927,61,14,9,8,-3.362078776884604,6
4928,8,23,14,13,-3.3634201583462144,10
4929,97,25,54,13,-3.3648153427656795,12
4930,20,17,40,10,-3.3649339637959677,7
4931,57,27,69,16,-3.367166221655227,11
4932,28,56,13,30,-3.367189637590283,26
4933,100,22,37,13,-3.3718369789109683,9
4934,96,18,73,10,-3.3726024221333355,8
4935,11,23,72,12,-3.3761818275237743,11
4936,60,78,13,45,-3.3770875938219196,33
4937,39,40,64,22,-3.3772164918090852,18
4938,75,20,70,10,-3.3793498632006282,10
4939,3,48,39,25,-3.3807598414665545,23
4940,55,28,36,15,-3.38333657725735,13
4941,104,10,73,6,-3.3914910994647247,4
4942,28,13,4,7,-3.394082491248691,6
4943,19,44,49,24,-3.394696308295238,20
4944,7,35,43,21,-3.405692523929345,14
4945,11,22,79,13,-3.411899322441765,9
4946,36,11,17,5,-3.4172736451567602,6
4947,78,18,28,9,-3.4177116588011063,9
4948,37,12,4,7,-3.4218717037755013,5
4949,69,10,108,4,-3.4269138907252206,6
4950,50,57,87,30,-3.4276386978359663,27
4951,51,69,54,38,-3.4308531323018583,31
4952,27,52,7,28,-3.4308990471010476,24
4953,48,20,106,11,-3.4316235296616595,9
4954,81,11,78,5,-3.4320246992935277,6
4955,12,30,16,17,-3.4325288291725844,13
4956,65,17,81,10,-3.4470499311553464,7
4957,60,35,11,20,-3.4471724802633115,15
4958,46,63,86,37,-3.4473674168834245,26
4959,86,94,7,54,-3.44879121802912,40
4960,114,14,112,7,-3.452952980329055,7
4961,23,21,37,11,-3.4530437057487378,10
4962,5,23,33,12,-3.4543275091771934,11
4963,60,40,43,22,-3.4556930168868454,18
4964,5,60,74,32,-3.4699961467083478,28
4965,70,20,25,11,-3.484518115943742,9
4966,45,16,41,10,-3.485066668867454,6
4967,51,30,36,16,-3.4874600225025043,14
4968,36,13,62,7,-3.4895283270523745,6
4969,5,16,14,10,-3.4903696256491523,6
4970,54,10,6,5,-3.4921987314309866,5
4971,109,26,20,16,-3.4929177397438647,10
4972,114,36,97,20,-3.4948097299506924,16
4973,51,39,114,20,-3.4973322349486473,19
4974,15,22,23,12,-3.5001626021093504,10
4975,108,13,37,7,-3.5019197237718496,6
4976,54,15,38,8,-3.502268170966973,7
4977,102,14,39,8,-3.5024293607442267,6
4978,109,19,37,11,-3.5038440546797935,8
4979,98,17,73,9,-3.5039598524288147,8
4980,109,27,25,15,-3.504136926234722,12
4981,23,16,74,9,-3.505315761927062,7
4982,27,32,8,17,-3.5152116177223616,15
4983,100,14,53,8,-3.519519789056672,6
4984,15,17,28,9,-3.5210057183007173,8
4985,87,131,86,69,-3.5212808552634485,62
4986,98,19,27,10,-3.521955911173927,9
4987,57,11,17,7,-3.5231240907929307,4
4988,50,55,37,29,-3.5287986061002137,26
4989,25,17,93,9,-3.53003978897563,8
4990,62,10,6,6,-3.5345556158920366,4
4991,84,26,85,16,-3.5349178606931724,10
4992,7,15,44,8,-3.535266020755458,7
4993,30,32,28,17,-3.5399264254738525,15
4994,36,65,40,37,-3.5400829247343593,28
4995,27,29,47,16,-3.543966431934924,13
4996,19,31,13,18,-3.544087166327382,13
4997,70,11,33,6,-3.545285037756224,5
4998,19,16,40,10,-3.545611871303118,6
4999,49,17,114,8,-3.548728211191125,9
5000,109,28,41,17,-3.548779347954399,11
5001,86,94,63,55,-3.549478365403399,39
5002,104,17,34,10,-3.55064687835478,7
5003,36,19,28,10,-3.554999615354129,9
5004,79,12,60,7,-3.555370933230573,5
5005,65,62,30,35,-3.5619176000989485,27
5006,7,28,6,13,-3.563185524233912,15
5007,84,13,62,7,-3.5672380956620353,6
5008,11,27,48,15,-3.571700875711397,12
5009,43,19,25,12,-3.5730773529480713,7
5010,87,22,14,13,-3.5746572289058025,9
5011,86,38,91,21,-3.5760441594388466,17
5012,51,22,102,12,-3.5799509862134142,10
5013,5,62,88,33,-3.583030843412139,29
5014,11,18,14,11,-3.5868100547047623,7
5015,95,10,97,6,-3.5894324713347885,4
5016,11,22,7,13,-3.590907173314133,9
5017,5,61,104,33,-3.5931408944870395,28
5018,57,14,106,7,-3.59361898372693,7
5019,16,57,75,31,-3.59529020803502,26
5020,79,23,34,14,-3.5987779482770503,9
5021,32,24,86,13,-3.600337352350486,11
5022,39,17,69,9,-3.6024816939136075,8
5023,88,36,1,19,-3.6124862498641357,17
5024,61,21,13,13,-3.6146533376867587,8
5025,79,15,112,8,-3.621796379179409,7
5026,28,26,80,14,-3.6230809501897747,12
5027,18,19,43,9,-3.6267699505365094,10
5028,27,55,39,32,-3.6279610211789914,23
5029,5,51,55,29,-3.628046191114139,22
5030,100,22,72,13,-3.6290401350984696,9
5031,86,15,6,9,-3.637615954610378,6
5032,29,32,3,18,-3.640968061507456,14
5033,43,18,34,10,-3.6439583345872704,8
5034,70,10,14,5,-3.647042134114855,5
5035,23,13,9,7,-3.6475995665029,6
5036,65,50,74,27,-3.6492230502429246,23
5037,18,11,17,5,-3.651905683853183,6
5038,29,17,97,10,-3.6527966127132636,7
5039,20,11,62,6,-3.653244367006134,5
5040,32,21,107,11,-3.65469777615246,10
5041,71,10,90,5,-3.6561036030201173,5
5042,31,24,39,14,-3.6610558433956157,10
5043,85,20,28,11,-3.6675135147560156,9
5044,86,55,60,31,-3.667613524236148,24
5045,38,38,107,22,-3.669594298718901,16
5046,84,21,38,11,-3.6699802067032445,10
5047,109,23,65,11,-3.6820630235649325,12
5048,78,24,72,12,-3.687490807799237,12
5049,38,16,80,8,-3.6957801142124267,8
5050,28,19,23,10,-3.6970356039584327,9
5051,5,62,16,37,-3.7016615680953464,25
5052,35,10,112,5,-3.704644012481239,5
5053,64,21,1,11,-3.7140968256416436,10
5054,5,21,15,13,-3.7147342263498166,8
5055,41,25,20,13,-3.722699653504377,12
5056,20,52,87,28,-3.7251195086400495,24
5057,40,13,15,7,-3.72557831166786,6
5058,5,31,90,18,-3.72922813011693,13
5059,40,59,60,33,-3.7350164129782835,26
5060,55,84,13,47,-3.735224882055998,37
5061,4,13,1,8,-3.7360390878519705,5
5062,7,31,15,15,-3.741081293807919,16
5063,84,55,51,31,-3.742451182903001,24
5064,54,58,28,33,-3.742783353616919,25
5065,40,42,53,23,-3.7429391558119973,19
5066,107,13,52,8,-3.7535584759825276,5
5067,57,39,87,22,-3.761962304644709,17
5068,17,14,102,8,-3.765627490194505,6
5069,30,29,18,16,-3.7717933229839495,13
5070,51,87,88,45,-3.772351956328506,42
5071,9,27,55,16,-3.772633679119087,11
5072,17,21,87,12,-3.7733166042192905,9
5073,13,47,114,23,-3.7759149187311722,24
5074,93,10,7,5,-3.7802315490169547,5
5075,87,39,29,23,-3.782229354716841,16
5076,98,28,104,13,-3.783243181516934,15
5077,51,52,106,29,-3.7850976424308227,23
5078,19,39,78,23,-3.787938218331087,16
5079,37,24,57,13,-3.7883373383566443,11
5080,27,20,108,12,-3.7884843892598083,8
5081,54,29,25,16,-3.7885203565536667,13
5082,50,25,90,14,-3.7900343777578587,11
5083,39,11,6,6,-3.796620754703812,5
5084,53,14,89,7,-3.799040779312777,7
5085,80,13,17,8,-3.803939831522535,5
5086,71,27,28,16,-3.8126316435493957,11
5087,5,16,110,9,-3.8138584796050905,7
5088,91,28,5,17,-3.814625093066518,11
5089,75,12,48,7,-3.8239435270874167,5
5090,3,11,4,6,-3.8250463920918425,5
5091,107,33,98,18,-3.826261245167428,15
5092,86,84,74,45,-3.8304380678874983,39
5093,54,45,11,25,-3.830761670343524,20
5094,46,13,38,8,-3.8338597693432206,5
5095,18,22,3,13,-3.8346712095468676,9
5096,34,22,65,13,-3.838809663446646,9
5097,12,11,47,6,-3.839015416153552,5
5098,31,23,18,12,-3.8430258307678686,11
5099,50,22,41,13,-3.845767300582984,9
5100,76,39,28,21,-3.8485126894088935,18
5101,17,17,85,10,-3.8507511089593,7
5102,107,50,40,30,-3.8570605527160122,20
5103,62,33,86,18,-3.857981546675875,15
5104,48,16,57,9,-3.858947382973919,7
5105,109,27,43,16,-3.867241547838043,11
5106,29,21,41,12,-3.868637237264429,9
5107,41,86,65,51,-3.8730812369047185,35
5108,112,22,3,11,-3.881829625852149,11
5109,5,17,40,9,-3.8914877974226956,8
5110,54,25,1,14,-3.8929886538978145,11
5111,58,13,77,7,-3.8981506835692445,6
5112,3,44,107,23,-3.899807395774833,21
5113,63,30,55,16,-3.900377194965691,14
5114,64,29,75,16,-3.916000714039239,13
5115,87,24,83,13,-3.916710407315815,11
5116,62,51,16,31,-3.918066009623021,20
5117,2,28,5,16,-3.923277825320164,12
5118,20,15,18,9,-3.9303607040253326,6
5119,76,22,84,12,-3.9389733435046645,10
5120,54,31,9,17,-3.942845641758714,14
5121,40,11,6,6,-3.944267868023087,5
5122,43,19,35,10,-3.946831407739412,9
5123,2,23,16,13,-3.9485844823217353,10
5124,104,11,67,6,-3.9505697623954874,5
5125,91,15,9,8,-3.9508212932565088,7
5126,37,23,40,12,-3.9558411724945217,11
5127,84,21,10,12,-3.960254602065843,9
5128,96,15,78,9,-3.9616133541960523,6
5129,94,11,84,6,-3.9681566657444405,5
5130,65,60,8,33,-3.9715477971861413,27
5131,14,12,96,7,-3.975747798085742,5
5132,54,58,96,30,-3.9768276973257124,28
5133,76,10,83,6,-3.979171756100496,4
5134,97,18,60,9,-3.9792005525226384,9
5135,69,29,41,18,-3.9797729258891974,11
5136,3,12,106,7,-3.9869286680549885,5
5137,87,16,45,9,-3.9869877249578156,7
5138,29,15,50,8,-3.9901096227477506,7
5139,65,85,51,48,-3.9909865262117235,37
5140,14,12,112,6,-3.9932359631148633,6
5141,112,16,104,9,-3.994340241273064,7
5142,100,18,9,11,-3.9953268600169216,7
5143,60,24,76,15,-4.000770681345001,9
5144,112,16,31,10,-4.001730552260444,6
5145,64,42,107,23,-4.007940956634882,19
5146,77,18,5,10,-4.010067732208504,8
5147,110,20,8,12,-4.013172679497397,8
5148,67,17,34,8,-4.015594495513434,9
5149,96,21,39,13,-4.016816457185767,8
5150,19,25,28,15,-4.019180575644085,10
5151,47,31,7,18,-4.025431088719286,13
5152,86,154,16,90,-4.027183016832997,64
5153,114,42,60,20,-4.029174933224297,22
5154,114,41,63,26,-4.0379729890543565,15
5155,43,10,1,5,-4.038976715758714,5
5156,69,12,84,7,-4.046782427990892,5
5157,40,10,32,5,-4.050021677419865,5
5158,20,10,14,6,-4.05196683725804,4
5159,39,11,56,5,-4.061429150921741,6
5160,95,10,43,6,-4.063398320607962,4
5161,38,12,20,8,-4.067291998076448,4
5162,73,19,65,11,-4.067312461469671,8
5163,31,68,7,38,-4.069172309295861,30
5164,46,21,95,12,-4.071848693893571,9
5165,109,48,16,28,-4.0745201581983626,20
5166,75,21,91,8,-4.084376386784757,13
5167,98,17,78,9,-4.084899624702052,8
5168,19,40,39,25,-4.0865154445107486,15
5169,19,11,36,6,-4.08859021842168,5
5170,51,51,17,27,-4.088673144397256,24
5171,93,27,86,15,-4.0902499993060095,12
5172,8,15,111,8,-4.091375789332371,7
5173,35,24,20,14,-4.0987287220029165,10
5174,93,20,83,11,-4.100880722204596,9
5175,51,48,75,26,-4.10605342104463,22
5176,63,30,97,17,-4.107378727934816,13
5177,19,46,100,26,-4.112454947141808,20
5178,49,65,16,38,-4.115079751730523,27
5179,2,12,7,7,-4.115660194227728,5
5180,41,35,60,18,-4.124791635334076,17
5181,53,57,18,31,-4.124925801617173,26
5182,50,15,83,7,-4.131296712002355,8
5183,106,51,107,28,-4.131711792879515,23
5184,30,13,74,7,-4.132114674773073,6
5185,20,11,71,7,-4.1364305573939655,4
5186,64,28,30,16,-4.139822872969586,12
5187,71,47,53,27,-4.141303557057989,20
5188,65,49,23,26,-4.142109485382539,23
5189,95,12,100,6,-4.142851413596654,6
5190,28,77,50,44,-4.143924434349461,33
5191,107,61,30,35,-4.146725636165426,26
5192,103,17,15,9,-4.148119256013829,8
5193,17,12,99,7,-4.148375833376952,5
5194,8,23,62,14,-4.155008709022655,9
5195,84,24,27,13,-4.156059221916358,11
5196,2,10,19,5,-4.15617878328422,5
5197,86,50,49,26,-4.160999894397799,24
5198,5,40,83,21,-4.163709904424498,19
5199,96,24,60,16,-4.164982345638217,8
5200,23,53,107,29,-4.172486813229878,24
5201,46,51,51,29,-4.174462162624302,22
5202,103,13,18,8,-4.1752141807255745,5
5203,25,27,23,15,-4.182190113226042,12
5204,1,36,13,22,-4.187998461115461,14
5205,103,12,112,7,-4.192929666832575,5
5206,29,26,51,14,-4.200611882951566,12
5207,3,18,103,9,-4.204198112236472,9
5208,36,56,65,32,-4.205692860728478,24
5209,48,10,52,6,-4.211289472665269,4
5210,84,19,43,10,-4.2146198508874155,9
5211,63,20,17,11,-4.217095300732271,9
5212,18,19,4,11,-4.220670692754496,8
5213,100,29,28,17,-4.221129674472951,12
5214,16,37,97,20,-4.222715093786662,17
5215,102,18,62,10,-4.2234688534060565,8
5216,44,11,71,6,-4.223524348839454,5
5217,38,21,9,12,-4.2241565966881796,9
5218,62,12,17,7,-4.2301807671986245,5
5219,107,59,41,36,-4.232356930880344,23
5220,104,11,29,6,-4.232469176091443,5
5221,65,32,49,18,-4.235437559418131,14
5222,58,14,12,8,-4.239755277925306,6
5223,87,31,71,17,-4.240167636343153,14
5224,71,44,16,26,-4.24180487871631,18
5225,34,14,106,7,-4.243674039664677,7
5226,72,10,6,5,-4.248570153213717,5
5227,104,62,86,35,-4.25024591812339,27
5228,51,57,8,32,-4.252456703569465,25
5229,106,55,37,29,-4.262507559544696,26
5230,63,32,100,17,-4.262978075872104,15
5231,49,20,50,11,-4.263153819097887,9
5232,107,30,91,18,-4.264126621091653,12
5233,15,20,114,11,-4.283176268910454,9
5234,52,15,30,9,-4.285939641259885,6
5235,55,45,37,24,-4.301001080588835,21
5236,53,27,106,14,-4.302319600135904,13
5237,78,29,100,17,-4.306504123439815,12
5238,109,45,88,27,-4.312126403910374,18
5239,17,23,97,13,-4.313428551304964,10
5240,88,53,11,31,-4.315288914266511,22
5241,40,22,4,12,-4.316643149060886,10
5242,15,23,72,12,-4.320242867974791,11
5243,87,25,72,13,-4.3287345451349015,12
5244,77,15,112,10,-4.331879954372317,5
5245,41,19,95,11,-4.33214397979218,8
5246,22,12,60,7,-4.334241842742773,5
5247,3,29,11,17,-4.336087828492777,12
5248,19,25,62,15,-4.338973871662797,10
5249,13,40,12,26,-4.341371143569527,14
5250,76,10,12,5,-4.341891338463575,5
5251,65,29,70,18,-4.343984179663611,11
5252,6,16,65,9,-4.346168811124804,7
5253,83,11,19,6,-4.35939819270106,5
5254,71,31,64,19,-4.3594731378011655,12
5255,23,20,95,11,-4.361896262769259,9
5256,70,17,49,9,-4.364791676107705,8
5257,3,60,27,34,-4.366790070220602,26
5258,9,15,74,9,-4.367415226980933,6
5259,23,23,40,13,-4.368423326803304,10
5260,58,13,55,7,-4.3690044835062585,6
5261,72,17,50,10,-4.375655689739112,7
5262,25,33,87,18,-4.379098196808539,15
5263,54,10,99,6,-4.379722874612374,4
5264,5,35,76,20,-4.4006703577730075,15
5265,28,53,20,30,-4.401187083369335,23
5266,108,14,71,8,-4.402422140240555,6
5267,11,46,51,27,-4.412998244261856,19
5268,81,36,86,23,-4.413702097160574,13
5269,50,55,16,32,-4.41371963953955,23
5270,5,118,86,67,-4.4152564938780525,51
5271,64,24,50,13,-4.415510499418937,11
5272,53,64,7,36,-4.416213736910667,28
5273,70,30,84,17,-4.416286467774103,13
5274,107,82,88,48,-4.417922077161399,34
5275,23,17,29,9,-4.418393467914162,8
5276,13,30,99,17,-4.4209668288342625,13
5277,20,14,23,8,-4.427778675436007,6
5278,3,35,65,21,-4.429509708162627,14
5279,70,39,37,23,-4.433263990915908,16
5280,109,15,95,9,-4.44413143370079,6
5281,19,14,50,8,-4.445333605009821,6
5282,16,44,95,24,-4.453378575583382,20
5283,97,11,77,7,-4.454901155383995,4
5284,85,14,19,8,-4.456802611003387,6
5285,54,15,79,9,-4.4628144491387465,6
5286,32,18,37,10,-4.466542082918523,8
5287,25,31,96,17,-4.472832877552796,14
5288,64,46,7,25,-4.481240056988838,21
5289,71,44,75,27,-4.485645835804011,17
5290,41,43,87,24,-4.49381868653754,19
5291,39,21,58,12,-4.494576390875354,9
5292,60,47,55,26,-4.496007919155315,21
5293,46,68,13,40,-4.497540419141799,28
5294,8,28,64,17,-4.503057942170459,11
5295,87,41,23,24,-4.512300706037801,17
5296,54,64,63,37,-4.513765725874225,27
5297,93,16,20,8,-4.515352163146574,8
5298,112,18,49,10,-4.51791122222607,8
5299,50,23,74,13,-4.520207268757789,10
5300,28,44,55,26,-4.526943972884062,18
5301,55,10,52,6,-4.531437489197341,4
5302,75,23,106,12,-4.532198108241352,11
5303,28,29,93,18,-4.540056078542574,11
5304,15,18,99,11,-4.551461310618722,7
5305,46,15,83,8,-4.551826612706295,7
5306,23,15,70,8,-4.554568026577774,7
5307,5,18,43,10,-4.559277543830877,8
5308,104,16,99,8,-4.5627492392393005,8
5309,95,14,99,8,-4.572737764013049,6
5310,58,23,7,12,-4.5750345256693405,11
5311,65,16,99,9,-4.579704538683155,7
5312,37,15,9,8,-4.590013554185221,7
5313,54,26,78,15,-4.592600537057526,11
5314,96,32,50,18,-4.592653394244438,14
5315,78,45,13,26,-4.597389344309831,19
5316,58,11,27,6,-4.599497662673681,5
5317,39,18,80,10,-4.600479594629686,8
5318,60,19,108,11,-4.601423271346146,8
5319,18,15,38,8,-4.607415756411177,7
5320,96,21,13,12,-4.608058597276484,9
5321,37,40,75,25,-4.608119905928107,15
5322,57,11,74,6,-4.613445177041247,5
5323,68,20,85,13,-4.615895850726343,7
5324,40,10,72,6,-4.616108231770903,4
5325,109,44,51,28,-4.624306959512696,16
5326,88,37,100,22,-4.625717286575204,15
5327,89,13,65,7,-4.632113459581723,6
5328,91,16,102,9,-4.632859199025976,7
5329,110,15,106,8,-4.633960085739292,7
5330,25,22,60,12,-4.63628280649392,10
5331,69,11,80,6,-4.638884395252672,5
5332,96,39,63,24,-4.649023449526143,15
5333,1,16,15,10,-4.649350840919031,6
5334,79,13,27,7,-4.651583262533679,6
5335,47,15,25,8,-4.655390231832651,7
5336,98,26,11,14,-4.667493378770945,12
5337,38,19,109,12,-4.668016203688246,7
5338,92,10,75,6,-4.670779177266829,4
5339,39,51,40,30,-4.685059105758994,21
5340,38,27,88,17,-4.695779895234789,10
5341,15,52,57,29,-4.700638792267926,23
5342,103,16,43,10,-4.701447170954387,6
5343,107,119,87,68,-4.702214609913845,51
5344,88,73,65,44,-4.702916833614272,29
5345,106,13,111,9,-4.703726078810505,4
5346,37,22,41,13,-4.708031554461573,9
5347,46,23,20,15,-4.708713070266477,8
5348,31,32,75,17,-4.72198275034643,15
5349,104,34,41,18,-4.7268653056009,16
5350,108,13,25,8,-4.727424255422313,5
5351,107,46,76,29,-4.736244325803577,17
5352,7,107,16,60,-4.744562074788692,47
5353,77,16,25,9,-4.745845616411634,7
5354,50,23,7,13,-4.754905099968972,10
5355,87,40,18,23,-4.75669359062204,17
5356,62,14,106,8,-4.759729251582842,6
5357,84,28,13,17,-4.762106527456084,11
5358,87,24,58,14,-4.764267958873133,10
5359,94,16,55,9,-4.767452995148849,7
5360,98,15,18,7,-4.76828904567196,8
5361,31,15,12,8,-4.7706324645211815,7
5362,70,13,90,7,-4.771084444295364,6
5363,23,14,33,8,-4.772846471482117,6
5364,5,12,9,7,-4.777710715122406,5
5365,98,10,34,5,-4.779193341125504,5
5366,30,28,50,16,-4.780811288699289,12
5367,81,25,15,14,-4.7836577803432645,11
5368,10,12,5,6,-4.788462999241516,6
5369,89,10,26,6,-4.7934486550169115,4
5370,20,13,52,8,-4.795236183864798,5
5371,25,11,111,6,-4.797175922879401,5
5372,88,14,34,8,-4.799596567728281,6
5373,97,22,41,12,-4.799957538599525,10
5374,96,22,75,15,-4.801381492311929,7
5375,12,16,1,9,-4.804302234326604,7
5376,68,14,89,8,-4.8060770512882325,6
5377,16,75,30,45,-4.810756321281797,30
5378,63,34,104,19,-4.811269466320188,15
5379,79,23,13,14,-4.81127521378253,9
5380,85,11,74,6,-4.8123880044938,5
5381,65,112,16,64,-4.817496389223385,48
5382,54,15,14,10,-4.820525855929134,5
5383,25,19,31,10,-4.823839301099769,9
5384,65,25,90,13,-4.825235861891515,12
5385,67,15,8,9,-4.831909846155587,6
5386,109,17,94,9,-4.837565167214328,8
5387,64,20,83,11,-4.840996077098241,9
5388,83,17,39,10,-4.845386042652685,7
5389,94,31,30,17,-4.848071493453302,14
5390,60,34,78,19,-4.850344284158851,15
5391,32,12,97,7,-4.851459349576825,5
5392,114,11,77,6,-4.854209160918305,5
5393,88,46,23,28,-4.856004139813015,18
5394,107,38,58,23,-4.857008495705356,15
5395,112,31,100,17,-4.858414274039207,14
5396,3,24,81,14,-4.860040341211916,10
5397,89,10,5,7,-4.8624656409017435,3
5398,1,11,29,7,-4.866934575588786,4
5399,57,26,88,14,-4.87081224887015,12
5400,79,20,63,12,-4.882182316485546,8
5401,95,11,69,7,-4.882909765417964,4
5402,18,12,94,7,-4.884425557504233,5
5403,72,12,20,7,-4.886775559464282,5
5404,57,10,12,6,-4.8872175245265135,4
5405,46,11,27,7,-4.887638683251712,4
5406,101,10,39,6,-4.889741278103361,4
5407,77,16,23,9,-4.892331871891688,7
5408,87,39,95,22,-4.900981782159267,17
5409,77,43,13,25,-4.906794574928388,18
5410,28,12,38,6,-4.907164394244709,6
5411,29,11,18,7,-4.9072911901611125,4
5412,100,14,47,8,-4.909302114786415,6
5413,15,13,34,8,-4.917498933434509,5
5414,106,56,74,32,-4.924754963776781,24
5415,63,17,108,10,-4.925158043652064,7
5416,107,77,100,41,-4.925676488158578,36
5417,36,40,86,23,-4.92743325124,17
5418,103,10,104,5,-4.929333969571576,5
5419,85,17,63,9,-4.93137224468223,8
5420,51,72,100,38,-4.940002025939465,34
5421,37,26,98,15,-4.940519420053042,11
5422,71,11,49,6,-4.9409457894604065,5
5423,32,14,28,8,-4.942148577857081,6
5424,78,15,40,10,-4.942465399220725,5
5425,81,23,39,14,-4.943832581007462,9
5426,106,29,80,17,-4.946009667025367,12
5427,68,19,56,10,-4.94813216675333,9
5428,100,12,20,7,-4.94868435190728,5
5429,41,33,64,20,-4.951397157092097,13
5430,64,10,85,6,-4.962701184974941,4
5431,90,23,96,14,-4.963939687748074,9
5432,114,21,27,12,-4.967571693509976,9
5433,23,11,98,6,-4.969965161139004,5
5434,44,10,80,5,-4.973541413806903,5
5435,86,73,37,41,-4.980857284592115,32
5436,55,34,80,18,-4.9879675297352755,16
5437,94,19,63,11,-4.988953899876627,8
5438,31,23,50,13,-4.991999785997779,10
5439,77,26,3,14,-4.9989738181650925,12
5440,96,23,51,13,-5.001175453325252,10
5441,106,41,7,21,-5.003800212982271,20
5442,34,25,100,13,-5.004456878240623,12
5443,5,26,93,16,-5.004460526821323,10
5444,83,13,102,8,-5.005327574584489,5
5445,72,24,85,15,-5.005644721261359,9
5446,43,35,39,19,-5.006459842543771,16
5447,43,16,12,10,-5.010092621024883,6
5448,94,17,112,11,-5.010192110959226,6
5449,63,12,93,7,-5.011120266810433,5
5450,18,19,55,10,-5.012210431301632,9
5451,51,30,108,17,-5.016985241457157,13
5452,86,25,47,15,-5.026594655071246,10
5453,87,36,94,20,-5.028702412089726,16
5454,34,12,112,7,-5.029259987635679,5
5455,93,26,74,14,-5.031462008142044,12
5456,91,16,40,9,-5.034652795604084,7
5457,108,18,30,11,-5.041583987630236,7
5458,8,34,34,20,-5.045872609442448,14
5459,2,23,20,13,-5.04811788923968,10
5460,75,20,95,12,-5.050260152484929,8
5461,35,23,16,14,-5.053981282073501,9
5462,55,27,100,14,-5.057275002393836,13
5463,10,16,7,9,-5.060407065651965,7
5464,61,10,41,6,-5.060781095904458,4
5465,100,38,104,22,-5.075921827905519,16
5466,64,23,3,13,-5.079848362911417,10
5467,20,10,32,7,-5.082163415292113,3
5468,30,28,15,16,-5.083664216760197,12
5469,5,15,34,10,-5.091205514677906,5
5470,30,24,34,14,-5.093231704876005,10
5471,33,14,49,9,-5.095253781724573,5
5472,1,10,30,6,-5.107240382060614,4
5473,76,10,64,5,-5.126258276838511,5
5474,12,20,103,10,-5.129139372345028,10
5475,33,14,64,9,-5.132334361355243,5
5476,58,30,40,16,-5.133397385337805,14
5477,77,25,107,14,-5.133888332698847,11
5478,3,21,36,13,-5.136055944816982,8
5479,8,17,72,9,-5.1378199606498285,8
5480,71,15,70,8,-5.140933357571855,7
5481,49,48,27,28,-5.1421479817942535,20
5482,70,17,13,10,-5.142156998200086,7
5483,97,13,11,7,-5.1491543911628765,6
5484,9,24,106,14,-5.150083731218857,10
5485,60,57,39,32,-5.152802282703841,25
5486,28,16,35,8,-5.153123660542294,8
5487,5,12,67,7,-5.159840528973079,5
5488,96,29,65,16,-5.165027076154164,13
5489,54,11,31,6,-5.168002033532433,5
5490,32,19,11,10,-5.169600921182679,9
5491,48,12,91,6,-5.179665478095682,6
5492,97,17,75,10,-5.1834390154874335,7
5493,43,14,23,8,-5.189120753246306,6
5494,71,10,6,6,-5.193692278292731,4
5495,113,13,40,8,-5.1937263926866155,5
5496,80,18,104,10,-5.194103195079235,8
5497,77,11,57,6,-5.195556204271688,5
5498,39,25,46,12,-5.196853389468726,13
5499,49,27,78,15,-5.198224201350137,12
5500,91,15,15,7,-5.198642780775296,8
5501,43,21,63,12,-5.207688448634705,9
5502,109,22,50,13,-5.207842202449347,9
5503,100,79,16,47,-5.211034078416436,32
5504,91,12,33,6,-5.213867650447786,6
5505,81,17,19,10,-5.2181130875891135,7
5506,86,20,10,11,-5.2191524654968555,9
5507,88,101,7,58,-5.220134457500585,43
5508,106,54,54,29,-5.222938310920246,25
5509,87,28,108,16,-5.22390452092372,12
5510,39,23,92,12,-5.223931097826435,11
5511,5,11,35,6,-5.226534281744123,5
5512,107,60,75,39,-5.231874163862644,21
5513,25,21,91,12,-5.236778929543696,9
5514,77,23,78,13,-5.23845431348766,10
5515,16,14,52,8,-5.2387315646619985,6
5516,40,26,25,15,-5.242222631716464,11
5517,65,21,72,12,-5.2525708680547405,9
5518,31,11,35,6,-5.255104723881266,5
5519,35,29,107,18,-5.259758635892076,11
5520,1,11,34,8,-5.259854618241466,3
5521,102,26,11,14,-5.269694308768166,12
5522,87,37,76,22,-5.270859497631277,15
5523,6,20,88,12,-5.272285617199486,8
5524,62,23,13,13,-5.279557581763116,10
5525,109,13,62,6,-5.284405260681897,7
5526,92,12,28,8,-5.284547759707863,4
5527,27,50,100,28,-5.287624363758572,22
5528,86,21,99,13,-5.291638236148404,8
5529,53,13,57,7,-5.295668988217709,6
5530,81,14,77,8,-5.30360249712173,6
5531,87,19,73,13,-5.303982369774458,6
5532,47,13,58,8,-5.305481766967035,5
5533,3,28,41,19,-5.308183069174525,9
5534,61,15,86,9,-5.314125600249347,6
5535,19,19,38,13,-5.315551758815004,6
5536,34,21,12,12,-5.315921719029712,9
5537,3,40,7,24,-5.315954351050264,16
5538,90,36,54,21,-5.31608911225222,15
5539,51,33,5,21,-5.328986421528186,12
5540,102,14,97,9,-5.335160623731833,5
5541,53,53,68,31,-5.342360173932807,22
5542,50,18,78,11,-5.342630350789609,7
5543,48,22,13,13,-5.345621103460161,9
5544,49,31,17,16,-5.351365626248913,15
5545,96,12,15,7,-5.353611172107386,5
5546,97,35,7,19,-5.356987360153852,16
5547,39,36,84,20,-5.36967448681498,16
5548,18,25,15,15,-5.370261713586335,10
5549,29,20,76,10,-5.371211242445575,10
5550,103,16,65,10,-5.377768524309902,6
5551,109,22,100,14,-5.379853421224187,8
5552,68,38,54,23,-5.382447112107092,15
5553,106,14,6,8,-5.390411966564588,6
5554,33,20,8,12,-5.397787705463005,8
5555,58,11,4,7,-5.405037105567137,4
5556,106,26,2,15,-5.41401262665605,11
5557,25,38,104,21,-5.422383455319622,17
5558,69,13,42,7,-5.432900919803655,6
5559,68,29,71,18,-5.43565333686224,11
5560,20,50,65,31,-5.436416455030898,19
5561,37,38,13,22,-5.4444858267423255,16
5562,38,19,8,11,-5.455715550555012,8
5563,50,13,57,8,-5.460704285123109,5
5564,74,13,31,8,-5.4682993706513905,5
5565,17,31,28,18,-5.468605078583842,13
5566,98,14,57,8,-5.474149624282838,6
5567,25,22,100,12,-5.476003695191376,10
5568,8,99,16,59,-5.477498125379747,40
5569,54,46,13,27,-5.479487703639157,19
5570,89,14,51,8,-5.490983680492759,6
5571,55,27,111,16,-5.492663797248299,11
5572,78,19,15,10,-5.495634846653292,9
5573,102,10,67,6,-5.497246561771854,4
5574,69,28,58,15,-5.500786187625181,13
5575,111,10,5,6,-5.501968622126494,4
5576,40,13,2,8,-5.504797437287728,5
5577,109,13,32,7,-5.508051897308614,6
5578,38,32,39,19,-5.509418569416409,13
5579,81,10,80,5,-5.509744831821594,5
5580,83,19,95,12,-5.510188596504651,7
5581,65,23,45,12,-5.510611418282088,11
5582,84,10,89,5,-5.518590211576736,5
5583,77,15,74,9,-5.523098396212754,6
5584,102,11,64,7,-5.525256448935211,4
5585,85,11,8,7,-5.538404103047143,4
5586,23,21,64,12,-5.53887757595366,9
5587,70,11,44,6,-5.543204446478318,5
5588,75,42,18,24,-5.546579166688548,18
5589,84,18,25,11,-5.546687618128967,7
5590,31,53,36,30,-5.548564460468655,23
5591,25,41,8,25,-5.550067480025429,16
5592,54,16,69,9,-5.552096999235808,7
5593,46,44,8,24,-5.55305372609631,20
5594,65,86,104,49,-5.554661796165203,37
5595,4,11,46,6,-5.556221874645653,5
5596,95,30,13,17,-5.5569838085167085,13
5597,95,10,31,6,-5.5581891593402775,4
5598,20,63,107,36,-5.562332766197244,27
5599,88,98,86,57,-5.562390170991595,41
5600,9,11,72,6,-5.567587328744072,5
5601,38,23,7,13,-5.5754388810337625,10
5602,44,22,20,13,-5.576158683247873,9
5603,86,38,69,22,-5.5778024324397695,16
5604,96,38,20,23,-5.591064360306497,15
5605,64,17,80,9,-5.593698551425533,8
5606,12,15,72,10,-5.594419997217227,5
5607,86,88,11,51,-5.601840851498305,37
5608,10,11,23,6,-5.611414438981724,5
5609,76,29,65,19,-5.616827802213812,10
5610,98,16,102,9,-5.616900846312716,7
5611,91,26,68,14,-5.619466372772095,12
5612,50,26,95,15,-5.619957219349119,11
5613,5,10,19,6,-5.623378775596125,4
5614,20,16,78,9,-5.629467930549494,7
5615,86,43,64,25,-5.632716173751322,18
5616,46,16,109,9,-5.636528034552761,7
5617,51,47,78,25,-5.638766096914631,22
5618,38,13,108,8,-5.644414418783651,5
5619,19,37,29,23,-5.646461013632089,14
5620,97,13,39,8,-5.649731064357224,5
5621,97,10,4,6,-5.649870700339141,4
5622,16,44,20,28,-5.6538868890789145,16
5623,75,31,46,18,-5.654705399493309,13
5624,2,13,30,7,-5.655225265692612,6
5625,87,74,8,43,-5.658285597120998,31
5626,88,36,25,23,-5.660869431868404,13
5627,84,37,16,22,-5.660913981238356,15
5628,82,11,54,7,-5.664278302313933,4
5629,99,31,16,18,-5.665818337043018,13
5630,25,10,94,5,-5.671887186214522,5
5631,95,10,102,6,-5.685319962340827,4
5632,114,17,76,11,-5.686109810518632,6
5633,40,21,35,13,-5.68914021357686,8
5634,32,10,70,5,-5.69247937209622,5
5635,62,17,53,10,-5.701449545318571,7
5636,72,23,54,14,-5.711828677342122,9
5637,12,16,69,8,-5.715951067980106,8
5638,9,11,93,7,-5.723540166631908,4
5639,51,26,25,15,-5.726135112848953,11
5640,9,14,45,9,-5.7278535004589894,5
5641,54,40,55,22,-5.729162102948166,18
5642,47,31,107,18,-5.730039668040248,13
5643,64,50,13,27,-5.733384315133941,23
5644,106,42,25,26,-5.737688222420903,16
5645,114,25,100,15,-5.743860264273012,10
5646,18,25,50,14,-5.74537053291684,11
5647,77,12,36,7,-5.751140829309575,5
5648,47,13,23,8,-5.75514206329281,5
5649,19,34,11,21,-5.756316664639485,13
5650,53,13,58,6,-5.756559382638675,7
5651,63,32,64,18,-5.757572899301189,14
5652,68,15,80,9,-5.759836210772854,6
5653,77,30,49,19,-5.759883489906796,11
5654,54,10,61,6,-5.763750710129662,4
5655,60,45,23,27,-5.772794691627651,18
5656,50,18,15,11,-5.776077652807675,7
5657,15,20,47,11,-5.776315263541679,9
5658,81,16,104,8,-5.786821230718971,8
5659,9,21,17,12,-5.788074839959892,9
5660,48,21,34,12,-5.788285695597516,9
5661,11,19,62,11,-5.78936924763006,8
5662,19,13,48,7,-5.792431440588203,6
5663,17,21,11,12,-5.800640520347569,9
5664,31,19,91,12,-5.801858258461764,7
5665,106,11,10,8,-5.803672894932926,3
5666,98,19,8,12,-5.806615359942181,7
5667,109,20,73,12,-5.807578339260897,8
5668,20,13,79,8,-5.810117746469003,5
5669,75,56,86,31,-5.819454003755878,25
5670,103,32,86,20,-5.822946833329546,12
5671,93,37,8,21,-5.824171473230354,16
5672,25,49,13,27,-5.82760144771215,22
5673,60,49,30,32,-5.831314754464255,17
5674,13,40,63,23,-5.83698160270361,17
5675,57,34,8,21,-5.8373147484651255,13
5676,66,13,88,8,-5.8387523732132625,5
5677,49,29,54,17,-5.8414712309316155,12
5678,93,23,16,12,-5.842811946264205,11
5679,69,40,13,24,-5.843363292908417,16
5680,14,17,65,9,-5.850273562995321,8
5681,79,12,80,6,-5.851472407179259,6
5682,93,16,75,9,-5.854064268882732,7
5683,51,52,104,33,-5.856995324327739,19
5684,112,21,7,13,-5.863389950487477,8
5685,7,17,34,10,-5.863504951401842,7
5686,8,31,18,20,-5.865710785121708,11
5687,95,36,54,20,-5.865979569344116,16
5688,98,18,55,11,-5.870446924304781,7
5689,91,19,51,12,-5.873980399232273,7
5690,31,12,28,7,-5.876337878232255,5
5691,36,12,46,7,-5.882094180819337,5
5692,74,22,102,13,-5.882481039476397,9
5693,108,17,75,10,-5.885506345854971,7
5694,57,15,10,10,-5.887280827061498,5
5695,43,16,17,9,-5.888801333071097,7
5696,3,11,37,6,-5.889738338475403,5
5697,40,52,65,30,-5.891062339928423,22
5698,68,15,101,10,-5.891939886749792,5
5699,9,45,75,27,-5.89399328159944,18
5700,98,10,38,6,-5.899897776783364,4
5701,3,18,54,10,-5.900167075724966,8
5702,107,131,16,81,-5.9020273928600275,50
5703,110,22,37,12,-5.913666685850415,10
5704,80,15,90,10,-5.9152161026884,5
5705,88,84,54,50,-5.915269494128592,34
5706,7,23,78,12,-5.919551023484507,11
5707,60,18,61,10,-5.9227502194184884,8
5708,114,20,73,12,-5.924435121305102,8
5709,104,26,53,15,-5.936620222245529,11
5710,17,48,16,31,-5.94023234098231,17
5711,53,15,28,9,-5.94574436463327,6
5712,65,56,27,34,-5.9505220277082325,22
5713,10,12,97,6,-5.9508315819177,6
5714,50,46,104,28,-5.958647190439791,18
5715,29,34,39,18,-5.9660900499545715,16
5716,40,18,97,11,-5.9669184161403885,7
5717,81,16,47,10,-5.967835030110961,6
5718,8,30,78,18,-5.971195592839113,12
5719,18,20,64,12,-5.974775055211903,8
5720,3,52,16,32,-5.976983247695231,20
5721,109,13,71,8,-5.977466642753509,5
5722,72,15,30,9,-5.981031131976351,6
5723,37,17,94,10,-5.9815536162143665,7
5724,97,28,87,18,-5.983886061129735,10
5725,86,57,27,34,-5.991658190462793,23
5726,31,25,114,14,-5.991876520395491,11
5727,29,18,28,10,-5.99194760387537,8
5728,54,21,94,12,-6.000772945562414,9
5729,63,26,57,14,-6.001123193099421,12
5730,5,47,106,29,-6.005839560090041,18
5731,9,51,65,31,-6.006217714596816,20
5732,104,69,107,41,-6.010771127855346,28
5733,53,37,16,23,-6.0109581007292086,14
5734,35,18,27,11,-6.016767935838181,7
5735,48,15,29,9,-6.020141509256064,6
5736,68,10,26,6,-6.030745942778485,4
5737,98,24,7,15,-6.033686003781979,9
5738,55,41,104,24,-6.036207114699969,17
5739,63,62,8,35,-6.040704829296192,27
5740,51,30,62,18,-6.046321991251016,12
5741,18,24,63,15,-6.046455003215185,9
5742,68,22,20,12,-6.050979140814712,10
5743,28,22,41,13,-6.053005216366935,9
5744,84,22,98,14,-6.061006275589921,8
5745,41,27,23,16,-6.068042449918644,11
5746,77,22,55,13,-6.070240499873465,9
5747,90,11,3,6,-6.078153120016463,5
5748,102,13,23,7,-6.080684731147932,6
5749,15,33,60,19,-6.08275874538289,14
5750,84,26,9,15,-6.089357364465301,11
5751,51,32,49,19,-6.089422332353599,13
5752,108,14,96,8,-6.092516088942799,6
5753,47,11,54,6,-6.095812400128515,5
5754,103,25,11,16,-6.096644925623905,9
5755,69,16,62,9,-6.098141811871047,7
5756,15,12,84,7,-6.098921486728437,5
5757,76,30,98,18,-6.108080609901334,12
5758,7,12,90,7,-6.108519045195328,5
5759,48,13,10,8,-6.11091450287738,5
5760,31,13,81,9,-6.117159791325402,4
5761,66,18,63,11,-6.119936177330313,7
5762,48,17,76,11,-6.130488708954145,6
5763,74,24,73,15,-6.15033234594065,9
5764,68,48,114,28,-6.151577271829131,20
5765,7,32,100,19,-6.153012622391108,13
5766,81,11,50,6,-6.158903696641054,5
5767,100,25,23,15,-6.1602001909122555,10
5768,28,58,104,34,-6.1611678298334525,24
5769,36,47,13,29,-6.167141158071527,18
5770,93,10,80,5,-6.175234905241022,5
5771,28,17,47,10,-6.182374184386464,7
5772,40,73,13,42,-6.184837754544506,31
5773,2,28,63,16,-6.200018491851488,12
5774,70,28,74,15,-6.203999405338757,13
5775,71,30,50,17,-6.204695227712774,13
5776,88,26,108,16,-6.206778138596414,10
5777,84,15,35,9,-6.209299301194261,6
5778,70,24,114,15,-6.214622620602995,9
5779,70,37,28,22,-6.2149266559981875,15
5780,94,10,95,5,-6.229015093991729,5
5781,5,48,114,28,-6.237633533478719,20
5782,63,49,37,30,-6.239339617220504,19
5783,57,15,38,8,-6.244977724558426,7
5784,46,10,48,6,-6.2577441282220505,4
5785,55,65,107,38,-6.262965189618901,27
5786,95,12,15,7,-6.265255655621165,5
5787,5,45,20,28,-6.270373633442779,17
5788,70,24,55,14,-6.2726471619319275,10
5789,87,40,48,25,-6.2730529960397,15
5790,4,21,86,13,-6.279484499549702,8
5791,93,14,29,8,-6.281843189307092,6
5792,4,15,12,10,-6.285579029533404,5
5793,68,68,40,42,-6.288399173895761,26
5794,84,18,100,12,-6.292769168431846,6
5795,49,38,87,21,-6.293062770344628,17
5796,102,36,28,21,-6.294379170221608,15
5797,97,55,86,32,-6.29556894674749,23
5798,8,16,43,9,-6.29733125478246,7
5799,53,48,107,29,-6.300738049492765,19
5800,50,19,3,11,-6.302491398681792,8
5801,15,16,62,9,-6.313402159690988,7
5802,52,23,86,14,-6.314494525069316,9
5803,51,37,77,21,-6.3237027482982455,16
5804,55,12,89,7,-6.33577587353113,5
5805,7,34,28,21,-6.339260574445828,13
5806,9,43,28,24,-6.342362216975378,19
5807,75,15,15,10,-6.343731652265016,5
5808,96,17,85,12,-6.345069391274803,5
5809,27,13,92,7,-6.356396578041118,6
5810,62,16,30,9,-6.359003401599702,7
5811,43,19,64,11,-6.359617177052284,8
5812,46,24,7,16,-6.3620461131037525,8
5813,37,10,56,6,-6.367440662879469,4
5814,102,15,33,9,-6.371524301983967,6
5815,17,18,72,11,-6.374145428769874,7
5816,98,20,70,13,-6.375551069484688,7
5817,27,16,28,11,-6.382931621067466,5
5818,96,13,33,6,-6.392035038140804,7
5819,48,38,86,23,-6.392497095701154,15
5820,70,62,54,37,-6.3937515742988325,25
5821,49,12,79,8,-6.395374558799645,4
5822,37,20,80,12,-6.401050818487375,8
5823,55,21,48,13,-6.406579400537664,8
5824,54,18,91,10,-6.414686940093469,8
5825,65,38,64,22,-6.415105269042927,16
5826,62,20,7,12,-6.416308867276496,8
5827,68,23,29,14,-6.416741070326833,9
5828,23,10,61,6,-6.419517618014349,4
5829,86,48,41,30,-6.421498587390495,18
5830,48,28,84,17,-6.421668889523295,11
5831,80,23,96,14,-6.423400971659432,9
5832,100,21,75,11,-6.42687784088126,10
5833,74,15,89,9,-6.429670108852098,6
5834,94,18,69,11,-6.4324341241447325,7
5835,15,29,29,17,-6.442607839265635,12
5836,33,16,68,10,-6.451134609706935,6
5837,54,28,93,18,-6.453790444084363,10
5838,91,20,8,12,-6.453847873736635,8
5839,10,15,11,9,-6.454288934219355,6
5840,15,12,35,6,-6.4672967653015005,6
5841,68,11,98,7,-6.46992769597506,4
5842,77,10,80,6,-6.477746915706978,4
5843,76,28,112,16,-6.4984423567384235,12
5844,76,25,13,15,-6.503302760367722,10
5845,55,29,74,17,-6.503619546467792,12
5846,65,66,55,39,-6.5120252706716855,27
5847,66,20,60,13,-6.515171561917174,7
5848,12,16,98,10,-6.517291711023471,6
5849,87,84,13,52,-6.521909690525374,32
5850,64,16,44,10,-6.52641817446092,6
5851,38,12,102,9,-6.529266346603467,3
5852,80,13,91,8,-6.531108694088667,5
5853,34,14,94,8,-6.531647534575399,6
5854,37,63,87,38,-6.5329504175110396,25
5855,13,48,81,30,-6.534046463710119,18
5856,77,30,39,17,-6.543255167179637,13
5857,112,16,58,9,-6.5464579572728105,7
5858,23,32,106,17,-6.549055396089183,15
5859,65,15,85,9,-6.556919781757102,6
5860,97,26,55,16,-6.559887224901373,10
5861,19,22,64,15,-6.560999233342088,7
5862,30,15,112,10,-6.562692428407155,5
5863,91,15,74,9,-6.5630560139016625,6
5864,63,31,75,18,-6.570041946714361,13
5865,69,29,78,17,-6.570244276121928,12
5866,114,26,53,15,-6.571088082289223,11
5867,57,28,84,15,-6.577348977317856,13
5868,101,11,27,7,-6.582303845846215,4
5869,73,29,86,16,-6.584732384148774,13
5870,3,33,49,19,-6.592008597219499,14
5871,90,14,41,8,-6.596764805214359,6
5872,13,16,73,10,-6.598047492921338,6
5873,13,52,71,30,-6.60226683262218,22
5874,35,25,11,15,-6.6098986532599575,10
5875,29,15,70,8,-6.61208942766715,7
5876,64,18,70,12,-6.615054052504195,6
5877,77,12,102,7,-6.618078815941925,5
5878,5,48,25,29,-6.626414170343123,19
5879,51,102,39,61,-6.628453471772385,41
5880,63,29,98,17,-6.629039814212707,12
5881,13,43,47,26,-6.6302542913878515,17
5882,37,22,39,13,-6.6321566948630455,9
5883,87,61,68,37,-6.632496531982402,24
5884,65,30,4,18,-6.635600395573754,12
5885,71,16,74,9,-6.635644376222863,7
5886,51,51,76,32,-6.6431414983377675,19
5887,5,26,32,16,-6.647447060451904,10
5888,37,19,71,11,-6.653996053488668,8
5889,71,11,83,6,-6.6562053803338666,5
5890,80,13,19,8,-6.657036501175087,5
5891,54,20,85,13,-6.664179187550934,7
5892,88,15,14,9,-6.66936824683007,6
5893,86,34,34,20,-6.674360500745735,14
5894,68,31,23,17,-6.676959480055372,14
5895,3,35,30,23,-6.678994379061112,12
5896,31,38,64,23,-6.680717740842573,15
5897,23,25,63,16,-6.701335055503617,9
5898,74,15,83,8,-6.7032980304888605,7
5899,51,115,86,66,-6.7054276981334295,49
5900,97,35,28,22,-6.716635909782018,13
5901,94,13,103,7,-6.717236128190118,6
5902,55,32,30,20,-6.725062001131896,12
5903,96,38,74,24,-6.731828732252366,14
5904,69,20,15,13,-6.736896270525394,7
5905,80,13,41,8,-6.741244434437033,5
5906,19,16,104,10,-6.74217179249715,6
5907,74,23,100,14,-6.742923050259366,9
5908,68,13,45,8,-6.747691137383074,5
5909,71,10,94,6,-6.748460655059326,4
5910,109,27,63,15,-6.749986635160675,12
5911,50,17,33,10,-6.750798742645289,7
5912,88,43,39,26,-6.751316626963761,17
5913,63,64,51,36,-6.75372645182253,28
5914,96,82,86,50,-6.757041595559339,32
5915,29,43,65,26,-6.767708276680646,17
5916,17,18,103,12,-6.777134032154199,6
5917,30,15,17,8,-6.779357915144956,7
5918,42,10,8,5,-6.780541784776636,5
5919,57,20,97,12,-6.781237277284942,8
5920,108,15,79,10,-6.783855393965386,5
5921,87,29,80,18,-6.78798453778918,11
5922,38,14,2,8,-6.79244823778732,6
5923,49,16,28,9,-6.801284823553006,7
5924,108,14,28,8,-6.806119384401873,6
5925,28,21,14,14,-6.807027415542907,7
5926,102,22,50,12,-6.809919414830618,10
5927,4,13,56,7,-6.8162735158796925,6
5928,18,14,49,9,-6.821290318156632,5
5929,31,69,68,41,-6.821634358561019,28
5930,106,25,95,16,-6.830338155584791,9
5931,29,15,20,9,-6.832826874702709,6
5932,47,28,75,19,-6.839491111976111,9
5933,19,53,87,33,-6.843160030750405,20
5934,51,99,7,62,-6.849475435937795,37
5935,68,36,11,21,-6.855439241001142,15
5936,4,43,60,24,-6.864343045215707,19
5937,69,19,29,11,-6.870269758663408,8
5938,38,12,34,8,-6.871444823359393,4
5939,91,43,16,28,-6.876030290903078,15
5940,99,15,106,10,-6.882359612487443,5
5941,112,17,18,11,-6.8872676099947565,6
5942,67,13,88,9,-6.891493842154362,4
5943,14,16,39,9,-6.892280896151707,7
5944,68,21,58,13,-6.9046526848664955,8
5945,40,39,87,22,-6.915208460636838,17
5946,88,12,99,7,-6.939131232028662,5
5947,87,115,16,70,-6.943465153548736,45
5948,50,33,60,18,-6.944865376684981,15
5949,88,20,58,12,-6.951724289335951,8
5950,51,25,4,16,-6.952578906103848,9
5951,55,30,109,16,-6.952801077513015,14
5952,63,20,90,12,-6.95733483322537,8
5953,50,19,91,12,-6.959059467736709,7
5954,104,18,32,12,-6.959225086389552,6
5955,39,15,111,9,-6.9608600117118025,6
5956,87,22,102,14,-6.961827622477074,8
5957,36,34,16,21,-6.9623095532486765,13
5958,97,23,18,14,-6.9651635757198616,9
5959,43,22,57,15,-6.979538883847616,7
5960,6,12,15,8,-6.9844847610743175,4
5961,30,30,53,18,-6.98498975026545,12
5962,55,20,17,11,-6.987444025974708,9
5963,13,24,111,13,-6.9889422498925144,11
5964,5,15,62,9,-6.992708759597398,6
5965,87,21,4,14,-6.993636995986404,7
5966,37,26,30,17,-6.9952716221417335,9
5967,69,13,40,9,-7.006717860168273,4
5968,102,26,100,17,-7.010528546414988,9
5969,38,25,63,17,-7.013791456544735,8
5970,92,16,51,9,-7.0168491500307955,7
5971,53,27,87,15,-7.022639512769472,12
5972,40,15,95,9,-7.026458120737084,6
5973,43,10,80,6,-7.031005677454653,4
5974,27,19,37,12,-7.034792767414977,7
5975,60,18,94,11,-7.0351599724686675,7
5976,114,11,72,6,-7.039741382461145,5
5977,57,26,3,16,-7.046184284491375,10
5978,36,18,99,12,-7.061516094995867,6
5979,25,50,37,29,-7.070541112352608,21
5980,103,17,72,10,-7.076236466749702,7
5981,53,10,85,7,-7.078145746437185,3
5982,12,15,63,8,-7.082818499870269,7
5983,3,27,104,17,-7.08628040850776,10
5984,55,21,27,14,-7.087211713998168,7
5985,45,10,1,6,-7.100044646871245,4
5986,54,32,100,20,-7.1062650526850275,12
5987,55,51,40,32,-7.109300201154281,19
5988,106,64,13,39,-7.112707704477981,25
5989,7,33,45,20,-7.1141476412284765,13
5990,83,30,86,20,-7.11486297608935,10
5991,35,10,57,7,-7.121001943594234,3
5992,107,12,67,8,-7.124134838046413,4
5993,77,21,72,12,-7.125122343869388,9
5994,93,12,13,7,-7.127658172301537,5
5995,63,77,16,47,-7.128365700865015,30
5996,38,11,62,7,-7.131662703916967,4
5997,58,14,30,9,-7.134101849433167,5
5998,15,39,27,22,-7.136849333340006,17
5999,68,28,97,17,-7.141635420047944,11
6000,78,13,33,8,-7.142209395263028,5
6001,69,12,111,7,-7.144443379259749,5
6002,51,26,97,17,-7.145200913148903,9
6003,37,14,29,8,-7.147246302868524,6
6004,103,29,27,18,-7.1483638951641275,11
6005,3,25,114,16,-7.152889180930057,9
6006,108,18,19,11,-7.157387609947199,7
6007,48,13,69,7,-7.158814996268279,6
6008,60,23,17,14,-7.159951280063793,9
6009,14,14,86,8,-7.166696838482465,6
6010,57,19,114,12,-7.1681797791764685,7
6011,61,13,30,8,-7.169715355965246,5
6012,112,16,36,10,-7.175574629533444,6
6013,29,24,98,15,-7.180316216962129,9
6014,88,50,63,32,-7.181466866993262,18
6015,43,15,112,9,-7.1893251112725824,6
6016,95,14,14,9,-7.1971223272437035,5
6017,15,17,12,10,-7.205252182553482,7
6018,93,14,98,8,-7.212314028509714,6
6019,90,15,30,9,-7.212567303813307,6
6020,88,129,16,80,-7.215072234032144,49
6021,46,49,16,31,-7.21524117201606,18
6022,30,16,114,9,-7.223280031087748,7
6023,40,27,114,18,-7.240772461331045,9
6024,107,40,48,24,-7.241941399148153,16
6025,87,29,34,18,-7.243810943600302,11
6026,5,14,31,9,-7.246607645789557,5
6027,3,32,19,19,-7.248295900826971,13
6028,8,42,13,26,-7.249552270590034,16
6029,96,12,69,8,-7.252755690648866,4
6030,81,19,75,12,-7.259552889264537,7
6031,48,14,100,8,-7.263809625362945,6
6032,38,29,16,20,-7.265887312698965,9
6033,98,17,20,11,-7.267496359610289,6
6034,70,16,110,10,-7.267896542251019,6
6035,96,10,62,7,-7.268496266352457,3
6036,62,34,107,19,-7.2691324595311855,15
6037,68,20,55,13,-7.2739791513354835,7
6038,38,24,30,16,-7.27528467950927,8
6039,60,34,49,21,-7.283728608313215,13
6040,49,45,107,28,-7.284676481696001,17
6041,17,18,23,11,-7.286484354574565,7
6042,54,18,2,12,-7.287492324178091,6
6043,40,31,43,18,-7.287691070183644,13
6044,98,27,5,16,-7.2988387616369135,11
6045,3,28,78,16,-7.304787220480848,12
6046,66,23,107,14,-7.314401309911108,9
6047,5,42,70,25,-7.323141246130925,17
6048,88,30,62,18,-7.323841783087015,12
6049,87,38,78,23,-7.33030021328082,15
6050,2,16,75,9,-7.332326563651876,7
6051,34,24,78,14,-7.336336560215487,10
6052,11,19,75,11,-7.336654356306241,8
6053,104,41,40,26,-7.342291894534158,15
6054,114,18,23,12,-7.3449426375970175,6
6055,8,45,109,26,-7.345721442245666,19
6056,104,17,62,12,-7.356292241509542,5
6057,33,16,25,11,-7.365926272964513,5
6058,80,14,31,10,-7.367135464628979,4
6059,88,12,56,7,-7.371104573008601,5
6060,71,10,73,6,-7.37323406519455,4
6061,23,48,13,27,-7.373546879981892,21
6062,81,19,71,12,-7.374213709282576,7
6063,92,15,16,11,-7.376894869640721,4
6064,56,22,7,13,-7.387479337914442,9
6065,28,15,10,10,-7.394064388880875,5
6066,49,71,39,45,-7.394965855903047,26
6067,76,14,75,8,-7.401272000460671,6
6068,86,45,43,28,-7.401609422336478,17
6069,87,60,100,35,-7.404280823590366,25
6070,94,11,20,7,-7.404911652749632,4
6071,20,30,70,19,-7.408681007686707,11
6072,41,34,36,18,-7.412500474371832,16
6073,5,18,73,11,-7.416873021801379,7
6074,16,24,6,13,-7.439865172191105,11
6075,49,22,34,13,-7.444592657229503,9
6076,71,12,11,7,-7.444969376445685,5
6077,70,12,100,7,-7.458777129644962,5
6078,80,11,27,7,-7.461746767808682,4
6079,53,12,45,7,-7.463487107897498,5
6080,39,18,110,12,-7.4641114165704305,6
6081,65,25,18,15,-7.4673190946756405,10
6082,36,14,70,8,-7.476080415111225,6
6083,74,19,34,13,-7.479438239426344,6
6084,76,15,71,8,-7.4875920550169335,7
6085,109,21,7,13,-7.49374057253885,8
6086,93,10,64,5,-7.507177747442427,5
6087,61,16,107,9,-7.509321940652875,7
6088,15,14,108,9,-7.510530648484563,5
6089,47,11,85,8,-7.514718359567318,3
6090,17,39,86,22,-7.514722263451874,17
6091,66,17,65,11,-7.515278237298981,6
6092,31,11,6,6,-7.520489323813347,5
6093,17,17,41,11,-7.526219064648916,6
6094,55,11,6,8,-7.526848268362221,3
6095,19,24,41,16,-7.531111873359517,8
6096,7,16,33,9,-7.5321884826380465,7
6097,55,22,34,13,-7.534603126846269,9
6098,46,10,85,7,-7.538229298143683,3
6099,55,74,16,47,-7.540678563620174,27
6100,103,20,39,12,-7.555167426699789,8
6101,76,18,34,10,-7.561119825945017,8
6102,49,23,75,14,-7.565086245339056,9
6103,12,37,100,22,-7.573615059890711,15
6104,112,31,53,17,-7.574348903828082,14
6105,77,25,12,15,-7.576465102864338,10
6106,85,12,3,6,-7.5842525005471515,6
6107,114,31,28,18,-7.584853881328922,13
6108,36,10,72,6,-7.585561627806541,4
6109,84,18,103,10,-7.589982363677433,8
6110,36,20,18,12,-7.594902878501233,8
6111,7,30,37,18,-7.598616530184269,12
6112,77,27,41,18,-7.59954783990565,9
6113,69,32,60,18,-7.6138451240077565,14
6114,27,14,71,9,-7.620974472293361,5
6115,61,11,69,8,-7.63321647110431,3
6116,3,28,28,17,-7.638630473496032,11
6117,5,29,97,19,-7.6394183021151285,10
6118,60,11,70,7,-7.646435749026205,4
6119,31,13,33,7,-7.647223417443057,6
6120,60,39,104,27,-7.655966632440938,12
6121,66,11,104,8,-7.658809119364056,3
6122,112,29,27,18,-7.661494705671576,11
6123,60,14,72,9,-7.664629407768881,5
6124,96,24,37,14,-7.665844925696508,10
6125,38,29,37,18,-7.668156637885104,11
6126,9,38,8,21,-7.6727541362269935,17
6127,102,18,30,10,-7.681071626833282,8
6128,11,32,5,20,-7.687442157533872,12
6129,68,39,76,27,-7.690297930054157,12
6130,7,25,111,15,-7.690323425771979,10
6131,1,28,86,17,-7.696680317913665,11
6132,68,61,75,39,-7.698232004910779,22
6133,86,42,98,25,-7.705613124334453,17
6134,96,21,114,13,-7.708209589747937,8
6135,27,29,72,17,-7.712316498929214,12
6136,39,98,16,60,-7.72023699614933,38
6137,104,17,78,11,-7.72449974280056,6
6138,57,37,11,21,-7.727829388644563,16
6139,101,14,16,9,-7.729447625525019,5
6140,72,12,76,8,-7.731997605583367,4
6141,29,18,46,9,-7.738693511487552,9
6142,84,11,44,6,-7.74146437073986,5
6143,111,10,30,7,-7.744421754490768,3
6144,68,29,28,19,-7.748993038967355,10
6145,51,19,111,12,-7.750696049131197,7
6146,11,38,100,24,-7.7524005573637345,14
6147,30,12,98,7,-7.753603265737282,5
6148,73,11,53,7,-7.756297558195459,4
6149,114,14,92,10,-7.774797164908201,4
6150,81,18,114,10,-7.77743951670038,8
6151,76,40,16,22,-7.786506155237845,18
6152,111,10,47,6,-7.786638633209638,4
6153,31,31,107,16,-7.788469010128701,15
6154,78,11,108,7,-7.797957113003344,4
6155,110,12,114,8,-7.800316810979699,4
6156,46,46,25,27,-7.8204011950255445,19
6157,108,14,54,10,-7.821734358546889,4
6158,52,10,15,6,-7.828284164082511,4
6159,17,22,5,15,-7.829641724195978,7
6160,43,58,13,33,-7.834617919431733,25
6161,93,16,70,10,-7.834949393241651,6
6162,9,50,16,33,-7.836196702611143,17
6163,1,20,114,13,-7.837742070296789,7
6164,66,13,11,7,-7.856337586346076,6
6165,91,26,106,17,-7.859341034872009,9
6166,35,12,44,7,-7.859665557157527,5
6167,2,30,28,19,-7.862984699152352,11
6168,90,25,114,15,-7.8701656835045455,10
6169,77,35,27,22,-7.8745216976485,13
6170,40,34,54,21,-7.877426017050995,13
6171,94,18,3,11,-7.8995884826671166,7
6172,29,16,17,9,-7.89967630532443,7
6173,90,14,53,9,-7.9010322992925905,5
6174,30,30,29,19,-7.902898306652615,11
6175,31,11,78,6,-7.904414780494012,5
6176,38,13,71,9,-7.906029048659732,4
6177,82,10,88,6,-7.912578083642501,4
6178,98,20,108,12,-7.913100401728397,8
6179,33,13,30,9,-7.913395188124868,4
6180,13,48,30,30,-7.92615309985384,18
6181,103,16,78,12,-7.929047988565182,4
6182,78,48,27,32,-7.930068331149942,16
6183,71,19,98,12,-7.940784287039028,7
6184,34,15,102,10,-7.962391346680716,5
6185,39,21,23,13,-7.963088024258928,8
6186,50,44,75,29,-7.963443352466475,15
6187,61,10,58,6,-7.964357976226594,4
6188,86,69,100,41,-7.971641299719466,28
6189,68,20,34,12,-7.97804478331916,8
6190,94,35,27,22,-7.986020548938502,13
6191,84,28,5,17,-7.986435375626319,11
6192,3,19,20,12,-7.987586080022353,7
6193,40,16,98,9,-7.993416961646093,7
6194,96,19,102,12,-7.995631160966492,7
6195,81,18,41,12,-8.009042710590085,6
6196,98,31,91,19,-8.010154956050261,12
6197,5,28,65,17,-8.01209130053563,11
6198,9,11,35,6,-8.012816785902416,5
6199,52,12,63,7,-8.01519600341839,5
6200,12,17,74,11,-8.01561317270324,6
6201,18,18,100,10,-8.035989461751754,8
6202,48,15,98,10,-8.040930745507076,5
6203,84,36,20,25,-8.048616703285953,11
6204,69,45,16,29,-8.054291070790876,16
6205,46,15,19,9,-8.056646218005667,6
6206,70,18,50,10,-8.072010588554928,8
6207,97,16,110,10,-8.077466293642962,6
6208,9,43,87,26,-8.078706607204955,17
6209,32,17,8,10,-8.079749532998788,7
6210,4,17,43,10,-8.083539648296876,7
6211,76,57,86,35,-8.085011849584903,22
6212,49,11,95,8,-8.09599863971906,3
6213,51,14,73,9,-8.097743889322738,5
6214,77,17,17,10,-8.106011789729994,7
6215,111,11,81,8,-8.120062859865858,3
6216,98,12,9,7,-8.123745049728663,5
6217,110,11,20,7,-8.125291114928709,4
6218,43,43,107,27,-8.125440552299427,16
6219,55,36,50,21,-8.131693382626928,15
6220,102,24,107,14,-8.132228988483364,10
6221,107,14,56,8,-8.14241374429404,6
6222,112,10,4,6,-8.145974306589785,4
6223,38,18,12,11,-8.148426278473254,7
6224,8,31,68,19,-8.152272734975396,12
6225,20,17,33,11,-8.15792468553464,6
6226,49,19,72,12,-8.165643444811542,7
6227,87,53,7,34,-8.18693322227242,19
6228,40,16,92,10,-8.191919233506125,6
6229,39,25,74,15,-8.195535087876934,10
6230,51,42,64,26,-8.201880887276834,16
6231,40,14,112,8,-8.221202026655064,6
6232,89,10,29,6,-8.222836378713618,4
6233,70,35,87,20,-8.222879447071525,15
6234,71,10,99,6,-8.224966300288866,4
6235,106,21,69,13,-8.230262561693126,8
6236,1,18,75,12,-8.241769187322507,6
6237,76,10,93,6,-8.25053412937542,4
6238,15,29,8,17,-8.254756555500954,12
6239,14,12,37,7,-8.266467835075428,5
6240,45,20,60,12,-8.270932074255702,8
6241,91,18,41,12,-8.276671952774398,6
6242,79,14,15,8,-8.279617988476957,6
6243,106,31,90,21,-8.283845461248367,10
6244,103,16,49,9,-8.289554117063618,7
6245,58,10,109,6,-8.291034573977958,4
6246,56,17,86,11,-8.300855291965847,6
6247,63,13,92,7,-8.301235837359338,6
6248,109,23,74,15,-8.306575916019817,8
6249,46,43,37,29,-8.306667442353499,14
6250,51,20,79,11,-8.309517555811905,9
6251,9,15,25,10,-8.323455878342044,5
6252,108,14,76,9,-8.33452707348594,5
6253,109,54,54,35,-8.336552490351867,19
6254,96,25,48,16,-8.343995751105185,9
6255,102,32,65,21,-8.353467426988889,11
6256,31,33,41,21,-8.353957395244581,12
6257,5,22,7,14,-8.357081514884822,8
6258,25,45,7,29,-8.372806618348298,16
6259,13,29,58,20,-8.381428024864281,9
6260,68,25,62,15,-8.382615098007266,10
6261,34,21,29,12,-8.399162943605289,9
6262,67,14,109,7,-8.410228891959633,7
6263,103,23,13,16,-8.418538595487915,7
6264,102,12,41,8,-8.421036787338002,4
6265,90,19,73,12,-8.42410199186246,7
6266,103,15,88,9,-8.430464226549896,6
6267,114,20,55,13,-8.432483182241098,7
6268,70,24,96,13,-8.43741799102626,11
6269,41,24,8,16,-8.446748885751395,8
6270,96,14,95,9,-8.450373982592186,5
6271,94,22,76,15,-8.458632259785002,7
6272,12,23,53,14,-8.460797624804181,9
6273,106,16,12,11,-8.461406597257817,5
6274,20,37,63,22,-8.464473402081476,15
6275,112,26,39,16,-8.464674026518868,10
6276,48,20,50,13,-8.466418162124782,7
6277,19,28,103,17,-8.46904787700572,11
6278,51,24,34,15,-8.469910228480797,9
6279,66,11,30,8,-8.470012652510327,3
6280,85,14,55,9,-8.476039600481299,5
6281,70,11,15,6,-8.484143116693572,5
6282,58,27,16,17,-8.488429747726556,10
6283,69,19,104,13,-8.491359963005362,6
6284,40,28,64,18,-8.496071624321132,10
6285,45,10,91,6,-8.504304930616431,4
6286,64,25,55,17,-8.512933226534457,8
6287,52,11,50,6,-8.515472572504802,5
6288,9,22,20,14,-8.515923532058862,8
6289,69,22,81,13,-8.51799786685539,9
6290,61,20,53,14,-8.524850655507475,6
6291,63,11,110,7,-8.534985747455591,4
6292,65,13,91,8,-8.541931736396268,5
6293,35,12,94,7,-8.545638882275085,5
6294,67,15,16,10,-8.550473387804702,5
6295,2,11,94,7,-8.550586885180524,4
6296,87,64,27,40,-8.551512306551714,24
6297,36,11,78,7,-8.552435160203325,4
6298,71,13,91,8,-8.567246551132914,5
6299,107,25,111,14,-8.570266784296766,11
6300,93,10,49,6,-8.572163796775678,4
6301,104,22,9,14,-8.574493523715214,8
6302,55,23,95,15,-8.575006509864881,8
6303,77,18,53,11,-8.57678025133704,7
6304,107,34,2,22,-8.596357154255273,12
6305,6,23,44,16,-8.597523681350717,7
6306,6,22,13,14,-8.600067561462975,8
6307,14,22,16,14,-8.606971231031414,8
6308,15,10,58,7,-8.609651553934281,3
6309,8,28,73,17,-8.656865963639591,11
6310,58,12,70,8,-8.66252309250944,4
6311,54,11,53,7,-8.670288326383611,4
6312,31,12,19,8,-8.676840084796208,4
6313,68,67,39,41,-8.679610428054557,26
6314,20,41,39,24,-8.683414479878408,17
6315,12,29,78,20,-8.684165205333198,9
6316,77,13,46,8,-8.692557302357292,5
6317,3,16,38,10,-8.700552917920668,6
6318,62,23,28,14,-8.703867920620004,9
6319,49,28,98,18,-8.706969661782534,10
6320,86,15,45,9,-8.710518828201984,6
6321,3,27,40,18,-8.719928293728282,9
6322,17,22,4,15,-8.727735068009611,7
6323,46,26,57,16,-8.73890097930274,10
6324,32,11,65,7,-8.739314169667134,4
6325,106,14,38,7,-8.745019433529976,7
6326,39,53,30,32,-8.747392409319964,21
6327,52,16,28,10,-8.757305556361812,6
6328,84,34,8,22,-8.76285424467774,12
6329,84,37,74,21,-8.764103490564016,16
6330,88,42,15,29,-8.764269632154088,13
6331,1,27,16,19,-8.777340054296332,8
6332,99,14,77,10,-8.784719144285264,4
6333,107,11,26,7,-8.789963547813732,4
6334,46,12,6,7,-8.79137101803374,5
6335,19,18,63,12,-8.792724982250471,6
6336,47,21,11,14,-8.793803106813352,7
6337,38,19,11,12,-8.800255391920867,7
6338,42,10,106,7,-8.802546839644405,3
6339,47,18,36,12,-8.810892372607714,6
6340,19,19,84,12,-8.81339664085273,7
6341,77,22,63,15,-8.819997532642512,7
6342,36,19,63,12,-8.822881427312195,7
6343,11,19,49,12,-8.825733499359641,7
6344,9,26,76,17,-8.828926017071298,9
6345,107,40,12,27,-8.830240406285608,13
6346,29,21,49,13,-8.838275929133859,8
6347,29,31,100,19,-8.841937017793759,12
6348,87,15,32,10,-8.844155029434871,5
6349,51,16,35,10,-8.849945437990394,6
6350,12,15,6,8,-8.87368712650089,7
6351,98,12,112,8,-8.873991556640123,4
6352,53,11,49,7,-8.876928289416249,4
6353,13,23,90,15,-8.883764352926047,8
6354,97,12,69,8,-8.888377862411462,4
6355,27,77,16,49,-8.892060221661591,28
6356,12,32,94,19,-8.90023153026558,13
6357,10,15,63,10,-8.910939208335906,5
6358,43,38,100,23,-8.917383841964034,15
6359,25,19,110,13,-8.91770167255822,6
6360,88,10,26,6,-8.919527282390273,4
6361,29,29,84,18,-8.921575167609983,11
6362,98,15,3,8,-8.926309600802394,7
6363,60,49,27,33,-8.928785554550485,16
6364,31,12,73,8,-8.93891957013575,4
6365,74,26,51,18,-8.938947542412071,8
6366,70,11,73,6,-8.941351293720283,5
6367,91,33,87,22,-8.944507965742197,11
6368,39,45,18,29,-8.951686778360688,16
6369,41,34,11,23,-8.953991407123155,11
6370,81,14,11,9,-8.967824856070829,5
6371,53,27,27,18,-8.968048711845618,9
6372,114,20,47,12,-8.969382880850311,8
6373,103,19,34,13,-8.970243702574697,6
6374,36,18,97,11,-8.970668153566258,7
6375,81,10,48,7,-8.989696104511102,3
6376,80,15,78,10,-8.990142670025016,5
6377,72,10,38,6,-8.999506480702252,4
6378,65,25,1,15,-9.00217902882169,10
6379,5,64,8,40,-9.002251377410767,24
6380,50,19,85,12,-9.007921978503544,7
6381,88,30,30,18,-9.008031571554385,12
6382,36,15,5,9,-9.008614310253616,6
6383,39,25,91,16,-9.014113578195186,9
6384,45,16,35,9,-9.040031591861498,7
6385,86,29,44,19,-9.073857704921483,10
6386,55,14,49,9,-9.07453979611351,5
6387,107,39,80,26,-9.074881524481428,13
6388,40,16,57,10,-9.07504759076948,6
6389,3,21,53,14,-9.076818822513886,7
6390,8,34,95,21,-9.079209474058969,13
6391,75,12,94,8,-9.08090116606965,4
6392,45,11,58,7,-9.091525705777384,4
6393,31,15,109,10,-9.113887572404181,5
6394,17,11,92,7,-9.114563540800479,4
6395,2,13,57,8,-9.119959996501732,5
6396,112,23,28,15,-9.120223564016392,8
6397,5,11,1,7,-9.143641454097294,4
6398,106,25,39,15,-9.155969378752738,10
6399,5,43,50,26,-9.15604936984071,17
6400,10,14,76,9,-9.15717818444399,5
6401,63,21,62,13,-9.161474645821354,8
6402,64,36,16,24,-9.166098638825638,12
6403,72,14,63,10,-9.168022793278993,4
6404,29,22,112,14,-9.17461030773198,8
6405,38,14,53,9,-9.179468731240128,5
6406,58,19,54,11,-9.183988111852093,8
6407,3,23,72,14,-9.187493129539424,9
6408,91,14,23,8,-9.188824217195526,6
6409,18,31,68,20,-9.190826393650623,11
6410,63,16,81,10,-9.193429569946275,6
6411,114,21,95,13,-9.195016624238175,8
6412,41,10,79,6,-9.204704069079497,4
6413,90,11,93,7,-9.204947446014167,4
6414,109,22,68,15,-9.205767765094535,7
6415,69,16,70,11,-9.22734622840158,5
6416,20,23,91,14,-9.233435902067155,9
6417,62,12,18,8,-9.234800982158575,4
6418,53,15,78,9,-9.245467105519944,6
6419,93,27,87,17,-9.265524424049662,10
6420,84,23,104,14,-9.266746412193928,9
6421,94,17,114,10,-9.267018335328505,7
6422,15,10,89,6,-9.268075265281286,4
6423,27,30,54,19,-9.269071237772646,11
6424,60,26,47,17,-9.272798561110864,9
6425,40,24,62,13,-9.275726600058688,11
6426,17,11,12,7,-9.294611804735958,4
6427,74,10,49,6,-9.302425288754321,4
6428,38,10,45,7,-9.31109379184883,3
6429,9,30,18,20,-9.325317307118524,10
6430,84,10,77,7,-9.326879307665173,3
6431,81,13,54,8,-9.33569894630605,5
6432,87,20,1,12,-9.344990956449259,8
6433,28,12,26,8,-9.352858082446945,4
6434,12,19,28,13,-9.36472715251189,6
6435,76,23,100,14,-9.372708881255944,9
6436,12,34,60,19,-9.373381073655496,15
6437,4,16,27,10,-9.378715415982098,6
6438,54,14,73,9,-9.382932635383147,5
6439,16,25,81,16,-9.384174025613891,9
6440,103,26,107,17,-9.385277654742342,9
6441,36,11,109,8,-9.390936468630551,3
6442,58,15,49,9,-9.396733649815888,6
6443,38,16,27,11,-9.401601002215303,5
6444,56,13,16,9,-9.403965360554952,4
6445,38,11,103,8,-9.411620771765369,3
6446,2,15,13,9,-9.422510080465477,6
6447,63,11,32,7,-9.44232166344675,4
6448,9,22,11,14,-9.452997859790166,8
6449,96,47,16,33,-9.462953828826512,14
6450,57,16,23,10,-9.474501256774843,6
6451,98,22,13,15,-9.474726692398676,7
6452,5,29,75,17,-9.487135559909316,12
6453,99,22,37,15,-9.502759058160704,7
6454,51,35,15,22,-9.503627084553731,13
6455,2,13,114,8,-9.509158562417845,5
6456,69,13,33,8,-9.51115802646404,5
6457,36,17,8,11,-9.51236026695053,6
6458,64,14,62,8,-9.515284324050942,6
6459,25,32,20,21,-9.520523686179047,11
6460,31,22,1,13,-9.525804060927038,9
6461,97,11,92,6,-9.525917165548371,5
6462,75,11,20,7,-9.527707505687728,4
6463,94,14,9,8,-9.535806051453793,6
6464,107,25,33,15,-9.539564483245073,10
6465,3,17,17,10,-9.55033737225928,7
6466,18,51,16,34,-9.558301530146911,17
6467,13,23,26,16,-9.562123129591571,7
6468,31,28,27,16,-9.569633624787402,12
6469,7,20,73,12,-9.582485903794176,8
6470,43,21,54,13,-9.585604342831406,8
6471,31,10,92,6,-9.586105290347549,4
6472,108,19,48,13,-9.586410616395145,6
6473,53,13,8,9,-9.596286006275319,4
6474,10,15,16,10,-9.607669865815328,5
6475,104,11,72,7,-9.607945163400757,4
6476,84,18,83,11,-9.609473734372155,7
6477,8,14,99,8,-9.611065592860319,6
6478,15,26,43,17,-9.619130376922648,9
6479,77,32,30,21,-9.6218312337316,11
6480,109,17,70,11,-9.623350653501724,6
6481,53,23,41,15,-9.631953807885303,8
6482,8,40,75,27,-9.637059553855455,13
6483,114,10,22,5,-9.649313306364826,5
6484,46,41,74,27,-9.651769490532573,14
6485,88,11,21,7,-9.65721273441522,4
6486,71,12,100,8,-9.660687520316314,4
6487,60,47,64,32,-9.661747726131635,15
6488,65,18,79,11,-9.675692837298339,7
6489,112,22,88,14,-9.681832903230308,8
6490,57,20,103,13,-9.684551051624602,7
6491,114,34,8,23,-9.699231858321156,11
6492,48,10,2,7,-9.702269151070572,3
6493,111,18,28,12,-9.712251206209237,6
6494,8,15,52,10,-9.715026692600484,5
6495,37,12,78,8,-9.719307443467276,4
6496,89,13,48,10,-9.72016162500569,3
6497,31,19,43,9,-9.72085277355369,10
6498,13,35,108,23,-9.73762618587381,12
6499,60,32,100,21,-9.74032342180746,11
6500,84,52,63,32,-9.747162233837335,20
6501,38,10,49,7,-9.749746841362613,3
6502,53,14,15,9,-9.75938988218119,5
6503,93,46,65,28,-9.761587206731543,18
6504,51,30,95,21,-9.770011754426973,9
6505,83,24,37,15,-9.78372636697842,9
6506,35,27,76,17,-9.787487717233065,10
6507,93,10,62,6,-9.798162399200411,4
6508,94,27,39,17,-9.799678470541032,10
6509,62,16,114,10,-9.799890996069497,6
6510,109,21,53,14,-9.80472277411344,7
6511,70,10,111,6,-9.807746966138032,4
6512,18,24,106,16,-9.811498602513076,8
6513,79,18,104,11,-9.811537818194267,7
6514,48,40,63,26,-9.811551158222231,14
6515,109,29,30,20,-9.814381976790122,9
6516,17,24,40,16,-9.815776001763272,8
6517,109,40,11,27,-9.818197495918092,13
6518,109,12,81,8,-9.819741316945185,4
6519,57,13,54,10,-9.824315369895022,3
6520,69,17,47,11,-9.824856595944091,6
6521,109,19,75,13,-9.83076635543319,6
6522,47,17,9,11,-9.833363334347133,6
6523,98,10,53,6,-9.839111782848333,4
6524,3,10,74,7,-9.841517466916367,3
6525,33,26,51,19,-9.853114112635913,7
6526,31,32,9,21,-9.853659783790295,11
6527,71,15,17,9,-9.87407872077162,6
6528,16,20,110,13,-9.893450419413215,7
6529,83,14,11,10,-9.896151919094919,4
6530,3,58,13,39,-9.902674814214107,19
6531,68,21,103,13,-9.904114100948451,8
6532,60,34,54,23,-9.913747967452045,11
6533,70,18,30,11,-9.913973705469942,7
6534,57,11,1,7,-9.916035104284749,4
6535,2,10,95,7,-9.920312629990494,3
6536,29,15,75,9,-9.923300198268766,6
6537,93,12,30,8,-9.924014583109777,4
6538,102,14,29,10,-9.929141879190583,4
6539,90,14,46,9,-9.960134782518509,5
6540,109,12,91,8,-9.971568873148838,4
6541,61,15,6,10,-9.976861344972216,5
6542,12,16,114,9,-9.985343546707199,7
6543,109,14,93,9,-9.98706709916127,5
6544,65,25,95,16,-9.987438820754926,9
6545,71,23,104,14,-10.004145398382484,9
6546,63,19,111,12,-10.01291034850113,7
6547,57,19,76,13,-10.02019313359368,6
6548,75,39,28,26,-10.021801272184058,13
6549,37,16,89,9,-10.02210147471719,7
6550,84,27,30,19,-10.023299208241367,8
6551,72,21,28,14,-10.026127135244147,7
6552,107,13,110,9,-10.034721322746929,4
6553,3,10,70,7,-10.036631807498473,3
6554,30,15,80,10,-10.043035385271976,5
6555,66,14,87,9,-10.045799735479147,5
6556,19,21,34,14,-10.046525413696886,7
6557,38,10,44,7,-10.048373138060265,3
6558,10,16,107,10,-10.056408787562024,6
6559,40,18,73,12,-10.060776256522114,6
6560,83,23,13,15,-10.067954696106945,8
6561,69,37,49,22,-10.076509248182438,15
6562,49,16,40,10,-10.077718304922938,6
6563,87,47,43,31,-10.081696034391205,16
6564,54,21,71,13,-10.113144202991709,8
6565,36,36,53,25,-10.114732824687984,11
6566,29,11,74,7,-10.117149758840515,4
6567,114,12,78,7,-10.123963867745248,5
6568,31,37,53,23,-10.136338371296794,14
6569,23,11,96,7,-10.143008283174428,4
6570,68,16,92,11,-10.147306838487292,5
6571,9,12,6,7,-10.175309866966636,5
6572,48,14,90,9,-10.193948361787585,5
6573,33,13,71,9,-10.195530501937558,4
6574,49,23,41,15,-10.197367127109926,8
6575,2,15,98,9,-10.19860338932166,6
6576,37,42,97,28,-10.199316810918765,14
6577,104,19,90,12,-10.205908373136614,7
6578,109,42,107,28,-10.207364620313752,14
6579,31,17,30,10,-10.214096274935347,7
6580,79,12,75,8,-10.235318929578343,4
6581,106,16,67,10,-10.25216143423421,6
6582,76,33,23,21,-10.259651294452182,12
6583,3,16,47,11,-10.263621577333433,5
6584,68,22,72,15,-10.275897741373278,7
6585,112,24,60,16,-10.282975838759189,8
6586,107,23,45,15,-10.289536165233185,8
6587,76,39,63,27,-10.294441268951953,12
6588,13,11,101,8,-10.296727071239353,3
6589,28,37,74,24,-10.332746781815512,13
6590,1,13,37,8,-10.342164269053162,5
6591,54,48,37,32,-10.345446907641223,16
6592,102,16,40,10,-10.346146758066931,6
6593,27,15,17,9,-10.354549099588292,6
6594,7,10,94,7,-10.355621654064777,3
6595,12,24,104,16,-10.358875950961007,8
6596,88,39,50,25,-10.36486098410092,14
6597,18,49,13,32,-10.36629502959634,17
6598,69,24,63,16,-10.366973166191586,8
6599,91,36,63,25,-10.368824470659426,11
6600,55,16,15,12,-10.370537288257989,4
6601,68,14,108,9,-10.37834742902957,5
6602,93,16,106,10,-10.37915501513517,6
6603,19,16,18,11,-10.389246220506255,5
6604,29,35,60,22,-10.420897470065029,13
6605,39,16,44,10,-10.434810009571386,6
6606,46,15,78,9,-10.43532016213296,6
6607,9,17,43,10,-10.43571876790201,7
6608,112,28,64,20,-10.456743108722609,8
6609,49,14,94,10,-10.474432971630808,4
6610,9,27,64,19,-10.495957554452962,8
6611,88,44,53,30,-10.519286458480718,14
6612,36,27,27,17,-10.52334959933135,10
6613,97,19,71,13,-10.523533962196904,6
6614,68,19,50,11,-10.535408083030939,8
6615,79,13,19,8,-10.549815768045507,5
6616,40,17,28,10,-10.551622113062642,7
6617,12,11,20,7,-10.562633058497607,4
6618,9,15,95,9,-10.569002592922947,6
6619,75,26,104,17,-10.574353916694225,9
6620,91,31,7,22,-10.609100286101581,9
6621,103,13,28,9,-10.609246701939707,4
6622,103,11,48,8,-10.609852030111927,3
6623,3,10,80,6,-10.612199935723584,4
6624,16,11,26,7,-10.64146366009584,4
6625,33,17,63,11,-10.66390349401416,6
6626,77,20,98,14,-10.67353135151257,6
6627,36,13,43,8,-10.71355202500855,5
6628,111,11,54,8,-10.714143810197234,3
6629,17,22,53,15,-10.723383781136485,7
6630,11,10,23,7,-10.736120462067522,3
6631,91,12,11,9,-10.737589094202365,3
6632,60,19,5,13,-10.737943337535816,6
6633,108,14,106,10,-10.746780907865295,4
6634,7,11,59,8,-10.771239818059202,3
6635,19,45,27,31,-10.77128036768826,14
6636,19,25,7,18,-10.77597719817787,7
6637,91,25,55,18,-10.791612827626555,7
6638,75,12,85,9,-10.804683773311504,3
6639,81,17,106,10,-10.816681182916206,7
6640,65,26,38,16,-10.834638706827015,10
6641,13,22,44,15,-10.852020262338174,7
6642,67,17,86,11,-10.856458271232293,6
6643,81,33,51,21,-10.882761671799566,12
6644,106,13,79,9,-10.885501834452416,4
6645,9,22,48,15,-10.894666127588817,7
6646,28,48,63,33,-10.937243385325445,15
6647,86,28,29,19,-10.944229389007262,9
6648,20,40,50,27,-10.968930608298043,13
6649,88,19,102,14,-10.972125082564366,5
6650,97,25,13,16,-10.985857531237668,9
6651,110,20,51,14,-11.00014817045874,6
6652,71,13,15,9,-11.00914391321025,4
6653,92,14,41,9,-11.016394202336146,5
6654,66,13,7,8,-11.03456679955437,5
6655,104,25,49,17,-11.041712547533374,8
6656,84,10,47,7,-11.043789003229907,3
6657,32,17,16,11,-11.045561391190382,6
6658,114,12,32,8,-11.045874107216173,4
6659,1,39,55,27,-11.047135752371084,12
6660,11,11,99,7,-11.04788337752713,4
6661,89,21,41,15,-11.09646589284071,6
6662,66,11,78,7,-11.09651688512087,4
6663,19,23,72,16,-11.09841396569939,7
6664,57,23,79,15,-11.100381889906581,8
6665,32,13,74,9,-11.101664191982367,4
6666,70,15,46,10,-11.123543654837011,5
6667,1,13,78,9,-11.156578268103178,4
6668,1,11,89,7,-11.209011069389929,4
6669,46,12,100,8,-11.210309669403339,4
6670,3,15,25,10,-11.214634960222725,5
6671,96,20,46,12,-11.223825219116964,8
6672,39,12,45,7,-11.230688824941204,5
6673,68,25,25,17,-11.235607083018877,8
6674,70,11,83,6,-11.265042422069474,5
6675,7,52,75,35,-11.274663385996204,17
6676,65,50,100,34,-11.275226832418381,16
6677,55,14,2,9,-11.27681615957405,5
6678,27,11,111,8,-11.279710088837584,3
6679,61,10,75,6,-11.283854363299358,4
6680,5,10,80,7,-11.295210617596888,3
6681,96,25,7,18,-11.300422106484017,7
6682,91,13,69,8,-11.30407928014614,5
6683,20,12,64,9,-11.331308462604776,3
6684,44,15,104,10,-11.332078649569059,5
6685,112,11,108,7,-11.335603356831967,4
6686,102,15,75,11,-11.35790237245839,4
6687,78,28,39,19,-11.374922957505097,9
6688,91,17,43,12,-11.378756439291882,5
6689,57,22,65,15,-11.3825342300458,7
6690,106,66,16,46,-11.389696810454694,20
6691,38,11,4,8,-11.395009854616482,3
6692,75,10,73,5,-11.395199340418813,5
6693,54,39,75,25,-11.408133317564461,14
6694,18,17,47,12,-11.411676107822023,5
6695,12,26,41,18,-11.414617123719315,8
6696,86,38,102,26,-11.442450297093961,12
6697,49,35,100,23,-11.456244824909795,12
6698,106,41,114,27,-11.462749893343949,14
6699,15,14,48,9,-11.482791416530661,5
6700,34,14,18,10,-11.48294101232062,4
6701,37,12,68,8,-11.49658369134707,4
6702,75,14,98,9,-11.49709370731316,5
6703,89,12,19,8,-11.497390115995609,4
6704,18,10,108,7,-11.508388616511892,3
6705,65,11,35,8,-11.518581403700487,3
6706,81,15,7,9,-11.525413070422038,6
6707,7,12,110,7,-11.526061320417648,5
6708,84,12,18,8,-11.52667869126048,4
6709,43,19,49,13,-11.541165906572093,6
6710,41,30,100,20,-11.550572113391238,10
6711,46,14,53,9,-11.556347535591735,5
6712,3,13,108,9,-11.562059375800658,4
6713,87,13,21,9,-11.56318091799384,4
6714,71,10,111,7,-11.563837134119526,3
6715,104,16,36,10,-11.564722196156032,6
6716,104,12,93,8,-11.57701291373734,4
6717,39,15,90,10,-11.577976501423597,5
6718,70,23,11,16,-11.609570033059047,7
6719,38,17,75,13,-11.628826987325251,4
6720,110,10,11,8,-11.637838089699006,2
6721,40,12,100,8,-11.638460148115913,4
6722,114,32,87,20,-11.64317239381751,12
6723,83,17,107,12,-11.64452174042024,5
6724,91,21,30,15,-11.67565091724384,6
6725,81,10,8,7,-11.678569579324545,3
6726,28,23,34,16,-11.682170467841415,7
6727,96,13,91,9,-11.69285419312405,4
6728,43,25,55,19,-11.714024478286158,6
6729,37,17,49,11,-11.725281827231871,6
6730,69,12,34,10,-11.742698738008174,2
6731,102,17,63,11,-11.747209471298389,6
6732,103,10,58,7,-11.772908526311582,3
6733,62,10,112,7,-11.78047192200998,3
6734,54,10,44,7,-11.791894285038762,3
6735,40,21,8,15,-11.79192140237277,6
6736,91,10,53,7,-11.811611902058752,3
6737,77,31,104,21,-11.812621663747162,10
6738,109,11,92,8,-11.825872450184745,3
6739,64,10,74,6,-11.828764368523546,4
6740,86,17,92,11,-11.833574375075663,6
6741,107,48,57,32,-11.85507238795532,16
6742,12,11,79,7,-11.866943529008417,4
6743,60,30,91,19,-11.867580664385896,11
6744,62,12,43,8,-11.874169648552916,4
6745,102,11,43,7,-11.887502689329436,4
6746,31,18,98,11,-11.908816140421925,7
6747,77,17,71,12,-11.915487518479782,5
6748,49,19,48,14,-11.919274877330183,5
6749,65,46,114,30,-11.938229846486394,16
6750,57,27,70,17,-11.940546365796532,10
6751,81,13,28,9,-11.947384191502275,4
6752,18,27,95,18,-11.951490678023534,9
6753,77,15,37,10,-11.967604181160285,5
6754,55,18,102,12,-11.98386619497443,6
6755,19,17,17,12,-11.9971982095889,5
6756,39,22,108,14,-11.99851415989162,8
6757,77,25,43,17,-12.004670640929955,8
6758,29,16,64,12,-12.010507228979474,4
6759,5,32,102,21,-12.011851390558958,11
6760,81,29,87,18,-12.015356959966109,11
6761,89,15,63,11,-12.017404575838292,4
6762,104,12,1,8,-12.02010829271743,4
6763,28,14,43,9,-12.028046594555397,5
6764,46,20,30,14,-12.044164698044927,6
6765,89,10,10,7,-12.05123505380701,3
6766,63,18,1,11,-12.054495717242014,7
6767,62,22,74,15,-12.061308273026555,7
6768,23,22,49,15,-12.076835461637529,7
6769,35,11,8,8,-12.093356369533678,3
6770,43,23,30,17,-12.09351277368479,6
6771,4,10,15,6,-12.124220843420797,4
6772,109,19,57,13,-12.12921132196382,6
6773,37,14,34,10,-12.135815020075322,4
6774,96,40,11,27,-12.14102850879166,13
6775,70,22,2,14,-12.153236389251049,8
6776,41,23,111,15,-12.165817300484488,8
6777,23,21,55,13,-12.170945018647474,8
6778,99,21,107,14,-12.174640608684577,7
6779,35,11,75,8,-12.188091693345983,3
6780,92,10,49,6,-12.189632873694912,4
6781,84,35,11,24,-12.18991190656385,11
6782,11,15,2,10,-12.196157085843714,5
6783,109,15,72,11,-12.199392565133762,4
6784,13,11,42,8,-12.203174115394763,3
6785,106,11,78,8,-12.210243252742742,3
6786,37,19,64,13,-12.216856507558592,6
6787,43,19,75,14,-12.224767647713703,5
6788,60,22,74,14,-12.23030247671151,8
6789,29,11,58,8,-12.250932195859463,3
6790,39,10,32,7,-12.259008757767623,3
6791,88,19,73,13,-12.262693289910837,6
6792,60,18,37,11,-12.263894360602315,7
6793,39,21,109,15,-12.264003725130953,6
6794,95,12,29,8,-12.273663594494513,4
6795,81,15,40,11,-12.276802562895192,4
6796,18,15,69,10,-12.281407888329312,5
6797,77,30,100,21,-12.29767742568246,9
6798,88,18,98,13,-12.300728896947142,5
6799,96,29,98,20,-12.30166544531649,9
6800,94,34,13,23,-12.315280597409899,11
6801,41,14,34,9,-12.338786367505541,5
6802,87,32,98,23,-12.344093153312015,9
6803,97,12,67,9,-12.353467827440639,3
6804,12,14,75,9,-12.356839423121738,5
6805,109,10,35,7,-12.407562430544193,3
6806,50,17,36,10,-12.423703215189777,7
6807,58,27,65,18,-12.431650709075077,9
6808,37,14,18,10,-12.438833593443574,4
6809,88,88,13,62,-12.460305993563065,26
6810,87,30,79,22,-12.466071130940083,8
6811,92,15,64,8,-12.492372460791035,7
6812,11,33,104,23,-12.522578417808797,10
6813,71,18,41,13,-12.557773267008857,5
6814,35,12,3,8,-12.563400964105028,4
6815,9,32,15,19,-12.592578406206986,13
6816,51,21,2,13,-12.595923969105383,8
6817,102,12,15,9,-12.597866884640938,3
6818,108,24,53,15,-12.606603502458741,9
6819,48,20,74,12,-12.617131151527767,8
6820,85,20,39,13,-12.618845399489867,7
6821,78,20,76,15,-12.633094549652565,5
6822,38,13,100,10,-12.63848236927712,3
6823,57,23,7,14,-12.666461617234948,9
6824,5,15,48,11,-12.675358072710559,4
6825,31,13,104,8,-12.681964820727016,5
6826,63,40,80,28,-12.682443988429268,12
6827,31,76,13,51,-12.705633823012965,25
6828,106,24,46,15,-12.725492516069494,9
6829,106,14,33,10,-12.736963404825655,4
6830,36,10,95,7,-12.746346244298937,3
6831,1,15,100,10,-12.750379039232417,5
6832,51,21,80,14,-12.779249811641696,7
6833,3,31,84,20,-12.781771350844402,11
6834,25,15,49,10,-12.785517383168525,5
6835,11,14,108,10,-12.798974196396985,4
6836,27,35,104,24,-12.83724877330016,11
6837,103,13,50,9,-12.862167277055057,4
6838,19,30,51,22,-12.868592174220957,8
6839,74,11,15,8,-12.870326474022038,3
6840,65,21,2,16,-12.890027578518191,5
6841,109,19,17,13,-12.911257852793483,6
6842,47,14,78,9,-12.914558187890036,5
6843,76,16,74,10,-12.94370107525992,6
6844,85,11,41,7,-12.952472883327006,4
6845,106,19,98,13,-12.95487415033694,6
6846,84,10,92,6,-12.962976398847763,4
6847,94,17,85,12,-12.99160031268738,5
6848,35,14,63,9,-12.998216518752985,5
6849,12,14,9,10,-13.029002866437166,4
6850,47,14,55,9,-13.036465008068175,5
6851,109,26,15,20,-13.04731499295951,6
6852,72,13,57,11,-13.071458888669092,2
6853,57,15,75,11,-13.125107209592635,4
6854,37,28,95,21,-13.149042342745602,7
6855,37,43,11,30,-13.202018650997502,13
6856,54,18,36,12,-13.21774479827317,6
6857,64,15,109,9,-13.229745561488967,6
6858,57,19,94,13,-13.247205639863786,6
6859,11,23,95,17,-13.263288005084231,6
6860,99,12,7,8,-13.27451726078842,4
6861,94,16,62,11,-13.279649048908027,5
6862,46,43,104,29,-13.294982678813746,14
6863,106,19,64,13,-13.295192075566398,6
6864,1,14,8,10,-13.305141225086524,4
6865,88,20,80,13,-13.305539707805673,7
6866,19,17,9,12,-13.318120114033066,5
6867,18,16,11,11,-13.321280125838722,5
6868,9,13,108,8,-13.341841222661904,5
6869,32,11,55,7,-13.363639630093914,4
6870,48,14,17,9,-13.364907872446567,5
6871,35,12,104,8,-13.369677424437173,4
6872,103,14,109,9,-13.379278679742844,5
6873,48,11,62,7,-13.383804058498162,4
6874,84,15,71,11,-13.41321574412034,4
6875,45,10,27,7,-13.421070416218559,3
6876,112,11,91,8,-13.423237527272493,3
6877,53,15,75,10,-13.423496737137015,5
6878,68,16,61,11,-13.424919545398382,5
6879,70,13,34,9,-13.426554854854936,4
6880,32,12,25,7,-13.427877456338669,5
6881,45,15,23,11,-13.436468047997261,4
6882,53,19,43,14,-13.438033142991662,5
6883,35,15,36,11,-13.440272285829968,4
6884,51,24,94,17,-13.451133934243908,7
6885,69,24,27,16,-13.483104419153626,8
6886,108,12,84,9,-13.488009207908556,3
6887,63,32,30,22,-13.498171962188781,10
6888,112,13,55,10,-13.49840576791747,3
6889,29,27,13,18,-13.513958263485303,9
6890,6,10,80,7,-13.522871173076236,3
6891,12,15,30,11,-13.545717330650541,4
6892,84,19,41,13,-13.556150264603872,6
6893,60,18,103,13,-13.575363139165225,5
6894,27,13,22,9,-13.578238998395374,4
6895,60,18,34,13,-13.644836415292458,5
6896,108,12,8,9,-13.645968521702336,3
6897,25,10,92,7,-13.698642336458672,3
6898,5,28,57,20,-13.702708831126639,8
6899,95,10,34,7,-13.704508911135058,3
6900,31,25,63,18,-13.714594813504084,7
6901,27,10,97,6,-13.735152835550474,4
6902,88,37,95,26,-13.752013257016607,11
6903,57,17,62,13,-13.757275808574354,4
6904,85,11,87,8,-13.78530468452242,3
6905,76,19,7,12,-13.791356001018304,7
6906,112,11,97,9,-13.794615799527316,2
6907,112,14,38,11,-13.819485047030156,3
6908,112,18,47,12,-13.820833793363406,6
6909,103,17,55,13,-13.826956770005324,4
6910,57,12,47,8,-13.842676334165546,4
6911,103,30,100,21,-13.847875266312384,9
6912,72,18,39,13,-13.872487814202467,5
6913,89,18,27,13,-13.875961301826155,5
6914,50,19,53,13,-13.883151416746285,6
6915,83,21,16,15,-13.895144807658395,6
6916,3,31,63,24,-13.905152866710317,7
6917,112,10,25,7,-13.919292260310073,3
6918,112,11,37,8,-13.937736127059292,3
6919,20,14,60,10,-13.939926452860888,4
6920,69,19,75,14,-13.942304484906572,5
6921,71,24,40,17,-13.948125771645662,7
6922,109,29,114,22,-13.96133653890183,7
6923,75,12,111,8,-13.97228180941997,4
6924,9,31,41,22,-13.990507643067815,9
6925,41,11,6,7,-13.99218654178206,4
6926,77,29,40,21,-14.048771071022594,8
6927,68,31,100,21,-14.067965798054429,10
6928,38,22,104,15,-14.07147319115554,7
6929,9,10,90,7,-14.073147353965513,3
6930,66,13,58,10,-14.087865353684418,3
6931,3,32,100,23,-14.177671200718624,9
6932,75,10,72,7,-14.207053385683185,3
6933,46,18,50,12,-14.208875687593247,6
6934,7,17,61,11,-14.217702740281519,6
6935,48,13,72,8,-14.22664791418154,5
6936,17,11,83,7,-14.269615650014424,4
6937,18,15,23,10,-14.275894417804937,5
6938,112,10,48,8,-14.307464286387088,2
6939,102,11,46,8,-14.307494713152066,3
6940,57,12,31,8,-14.310689026630854,4
6941,86,25,26,19,-14.322036756570215,6
6942,10,10,54,7,-14.334784055636703,3
6943,83,10,40,8,-14.347262135245899,2
6944,81,15,100,10,-14.382694095158197,5
6945,57,22,34,16,-14.39635519327823,6
6946,90,16,20,11,-14.40477443227544,5
6947,69,15,72,11,-14.41389414186031,4
6948,70,26,108,19,-14.427393649276276,7
6949,14,11,80,7,-14.43534539519452,4
6950,77,24,8,17,-14.435582202481529,7
6951,35,13,97,10,-14.444551731599498,3
6952,5,12,44,9,-14.447481002517359,3
6953,2,10,73,7,-14.457830254043131,3
6954,25,12,34,9,-14.468789684868277,3
6955,97,15,38,11,-14.531013843539451,4
6956,49,15,47,12,-14.532787825231312,3
6957,50,19,80,15,-14.554439051919097,4
6958,20,18,34,14,-14.557800978959815,4
6959,99,12,50,8,-14.581629542155008,4
6960,66,10,39,7,-14.612542929328725,3
6961,109,34,27,23,-14.672056456650031,11
6962,19,16,55,11,-14.68778354720052,5
6963,78,19,17,13,-14.709203332504178,6
6964,83,19,114,14,-14.712530964906863,5
6965,77,28,7,20,-14.72949510503469,8
6966,31,10,100,7,-14.730848989291468,3
6967,48,15,78,11,-14.736137197437776,4
6968,102,11,90,6,-14.739148726840867,5
6969,106,14,32,11,-14.741977351969272,3
6970,25,26,11,20,-14.778705544740388,6
6971,89,11,7,8,-14.785043291363074,3
6972,35,11,102,7,-14.787485364380142,4
6973,77,19,15,14,-14.819984931970575,5
6974,88,18,111,14,-14.89137809160146,4
6975,44,10,49,7,-14.992301775479174,3
6976,49,14,80,9,-14.993186389789676,5
6977,22,12,13,9,-14.994671319317483,3
6978,75,10,45,8,-15.003649946946844,2
6979,99,18,25,13,-15.014737107768294,5
6980,81,18,49,12,-15.043369514696261,6
6981,93,10,38,6,-15.046407356806787,4
6982,50,19,77,15,-15.082093464135088,4
6983,29,10,71,8,-15.143188317628589,2
6984,54,31,48,22,-15.152035020388912,9
6985,77,11,54,10,-15.154916790692537,1
6986,94,44,16,33,-15.20885505708528,11
6987,91,13,76,10,-15.216447591134663,3
6988,46,14,93,11,-15.25112664035686,3
6989,94,12,104,9,-15.272338655973261,3
6990,2,15,100,10,-15.363858490781979,5
6991,18,11,5,8,-15.389394006883379,3
6992,107,25,73,17,-15.46067272069853,8
6993,39,12,2,9,-15.473797666414953,3
6994,84,23,112,17,-15.486639525748986,6
6995,31,15,69,10,-15.502962092044207,5
6996,104,20,64,15,-15.51526416011922,5
6997,66,12,13,9,-15.520614540867863,3
6998,5,21,23,16,-15.554175057753401,5
6999,90,10,100,8,-15.596895375105717,2
7000,45,14,4,10,-15.600891470448106,4
7001,69,10,23,8,-15.603167423944381,2
7002,85,11,106,8,-15.605731963514023,3
7003,97,13,90,9,-15.621888085765935,4
7004,97,12,14,10,-15.664913845649805,2
7005,51,23,72,16,-15.686011493569213,7
7006,112,14,15,10,-15.700949053545523,4
7007,51,20,45,15,-15.703190735785377,5
7008,80,13,75,10,-15.718052052365538,3
7009,35,12,80,9,-15.72406211872363,3
7010,96,16,93,12,-15.733194627661215,4
7011,94,13,17,9,-15.746212612138288,4
7012,28,13,110,9,-15.755425369009838,4
7013,17,22,95,17,-15.802621580377183,5
7014,76,14,15,10,-15.823118080936444,4
7015,41,12,15,9,-15.833444649300676,3
7016,28,29,90,22,-15.880089586771646,7
7017,70,13,80,11,-15.901333417895945,2
7018,76,11,80,8,-15.945303671637879,3
7019,90,11,57,8,-15.975273202140913,3
7020,9,31,53,23,-16.014655893145633,8
7021,109,17,12,13,-16.024039547745488,4
7022,37,14,15,11,-16.033544043199246,3
7023,5,18,41,12,-16.050377082501452,6
7024,112,15,71,11,-16.116875921028463,4
7025,46,13,98,9,-16.12835125202737,4
7026,58,25,86,19,-16.26853319646311,6
7027,80,12,34,10,-16.269229317512288,2
7028,33,16,65,12,-16.286121361101067,4
7029,85,18,30,13,-16.304609608829036,5
7030,98,17,109,13,-16.306862994782453,4
7031,14,12,25,10,-16.337614979675553,2
7032,2,19,104,13,-16.352388003055772,6
7033,57,22,100,16,-16.352929528191847,6
7034,83,13,27,11,-16.368092522641103,2
7035,43,11,110,8,-16.376498956572302,3
7036,40,10,29,8,-16.378294184390825,2
7037,63,14,14,10,-16.386711509096077,4
7038,43,13,45,9,-16.39462685745925,4
7039,103,13,74,10,-16.40982303219032,3
7040,39,19,99,15,-16.42872930905631,4
7041,37,11,19,9,-16.4401797639671,2
7042,55,15,14,12,-16.464885141480416,3
7043,87,10,61,7,-16.482333693393578,3
7044,31,46,16,34,-16.494251500601976,12
7045,64,10,66,8,-16.526342406123636,2
7046,79,12,17,9,-16.52858758988839,3
7047,68,22,95,18,-16.55020486315604,4
7048,36,10,101,8,-16.627946704419486,2
7049,69,23,53,17,-16.676579450904736,6
7050,112,28,78,21,-16.67914983172849,7
7051,71,15,95,10,-16.726754189945986,5
7052,83,13,23,10,-16.74470008954982,3
7053,41,20,30,15,-16.767826748629858,5
7054,76,10,1,7,-16.815372977495876,3
7055,46,14,18,11,-16.84517490405338,3
7056,29,27,88,20,-16.85204786067182,7
7057,10,12,37,8,-16.87706142806293,4
7058,10,12,13,9,-16.892767460419815,3
7059,41,10,22,8,-16.895138763704843,2
7060,57,18,29,14,-16.901122362734938,4
7061,46,12,43,9,-16.90387334173946,3
7062,112,19,20,15,-16.964936240764278,4
7063,38,14,87,10,-16.969693008237698,4
7064,31,10,38,6,-16.97274158238423,4
7065,102,11,48,9,-16.984312347736424,2
7066,37,13,73,9,-17.03246334806977,4
7067,1,14,18,11,-17.058153705270215,3
7068,9,29,27,21,-17.072056537621446,8
7069,2,11,60,8,-17.116843000088547,3
7070,23,13,72,10,-17.14817782244226,3
7071,60,17,102,12,-17.171392721318526,5
7072,62,15,12,11,-17.172750128516864,4
7073,5,22,27,16,-17.186967099907655,6
7074,106,10,35,7,-17.31905115685177,3
7075,35,10,60,7,-17.418126947264813,3
7076,29,10,80,8,-17.45720022045759,2
7077,77,39,16,30,-17.459530597353453,9
7078,29,18,109,12,-17.571930830154635,6
7079,83,11,110,9,-17.575104905290953,2
7080,70,12,48,9,-17.60881542858036,3
7081,67,10,20,8,-17.672455088050597,2
7082,3,11,5,7,-17.694163901939536,4
7083,51,23,90,18,-17.7178788097309,5
7084,55,12,44,9,-17.771847163193577,3
7085,15,10,85,8,-17.788004047228643,2
7086,5,18,30,15,-17.810533055025342,3
7087,35,13,48,10,-17.821530991658577,3
7088,88,17,32,13,-17.824594134673823,4
7089,114,11,111,8,-17.846918134233796,3
7090,41,10,35,7,-17.84884882348167,3
7091,30,15,95,11,-17.919901608832802,4
7092,76,21,54,16,-18.08934803214948,5
7093,62,17,78,13,-18.093769732536963,4
7094,54,10,67,8,-18.121548101252504,2
7095,12,14,55,11,-18.17466355866916,3
7096,43,12,81,9,-18.327617727929393,3
7097,6,11,19,8,-18.33570620434032,3
7098,13,20,80,14,-18.33580484931627,6
7099,54,12,34,10,-18.362976743969604,2
7100,35,17,87,12,-18.4649770696095,5
7101,31,15,106,11,-18.52908676481623,4
7102,109,14,19,11,-18.610693282372278,3
7103,12,10,45,8,-18.65380711999512,2
7104,57,16,112,12,-18.74164060463068,4
7105,28,17,99,13,-18.75458480836917,4
7106,102,12,27,10,-18.772173343475483,2
7107,29,14,72,11,-18.821794346434423,3
7108,33,20,55,16,-18.82593244000092,4
7109,97,12,34,9,-18.83120290818016,3
7110,4,13,98,11,-18.93649850914462,2
7111,106,11,89,7,-18.95338953455918,4
7112,106,10,92,8,-19.04169077246869,2
7113,18,14,99,11,-19.290873438644518,3
7114,36,19,30,17,-19.305297671687285,2
7115,89,10,76,8,-19.405192223589758,2
7116,29,11,114,8,-19.42881288570476,3
7117,6,11,30,9,-19.605882514870544,2
7118,5,11,64,9,-19.69819687485363,2
7119,31,11,15,8,-19.73878794252568,3
7120,32,12,95,10,-19.760326388824463,2
7121,97,13,73,9,-19.966763707753138,4
7122,54,17,4,15,-19.99443539185139,2
7123,89,10,57,8,-20.153446064878874,2
7124,84,12,7,10,-20.16090095994254,2
7125,68,38,112,30,-20.16144061217486,8
7126,103,10,75,9,-20.24199150509897,1
7127,12,10,26,8,-20.37973185640995,2
7128,10,11,30,9,-20.38962047667116,2
7129,94,23,81,17,-20.517798479805748,6
7130,94,12,48,10,-20.576242864974443,2
7131,108,13,114,10,-20.766174427392745,3
7132,3,18,48,14,-20.77461856356065,4
7133,68,11,90,9,-20.78795619801594,2
7134,3,17,75,14,-20.897191698320935,3
7135,10,14,112,11,-21.021770709139744,3
7136,10,16,51,13,-21.051824036569297,3
7137,112,16,80,12,-21.108795407964617,4
7138,31,11,76,10,-21.157211826935978,1
7139,51,11,101,9,-21.226620175614496,2
7140,4,13,25,11,-21.420042602463127,2
7141,4,15,41,10,-21.48059017391386,5
7142,34,11,64,9,-21.53865059177988,2
7143,62,12,34,10,-21.778436974548594,2
7144,31,12,62,9,-21.79094106777599,3
7145,89,15,11,13,-21.994738492227253,2
7146,97,12,91,10,-22.175648770183784,2
7147,1,10,3,8,-22.670516239418713,2
7148,91,17,104,16,-22.905675334222092,1
7149,57,14,26,11,-23.006782602638854,3
7150,8,11,4,10,-23.17790508365148,1
7151,77,19,75,16,-23.52836570307736,3
7152,38,13,55,11,-23.805883695964802,2
7153,42,11,104,10,-24.55480599508646,1
7154,33,11,100,10,-25.460296177649866,1
7155,106,10,49,9,-25.68163240192886,1
7156,38,10,69,9,-27.69592076147955,1
7157,61,10,98,10,-28.32332956610249,0
7158,23,13,90,12,-28.362481429909806,1
7159,90,10,109,10,-29.2714816942141,0
7160,37,11,44,11,-29.88349889925713,0
7161,102,17,112,16,-31.59305348177514,1
