,againstHero,games,hero,losses,shift,wins
0,112,14,102,1,30.363340186062864,13
1,44,11,37,0,29.883498899257123,11
2,90,13,23,1,28.3624814299098,12
3,19,10,109,1,27.66236213744933,9
4,26,12,57,2,24.80508950345583,10
5,104,11,42,1,24.55480599508645,10
6,75,16,3,2,24.194103806582213,14
7,34,11,97,2,24.058676404388496,9
8,112,12,57,2,24.05133711856007,10
9,12,11,109,1,23.647352995961203,10
10,75,19,77,3,23.528365703077363,16
11,4,11,8,1,23.177905083651492,10
12,72,12,29,2,22.845970500293163,10
13,62,13,94,2,22.46818171411113,11
14,29,12,57,2,22.398372618819636,10
15,91,12,97,2,22.175648770183788,10
16,78,13,48,2,22.13337912583355,11
17,55,13,19,3,22.02845225298763,10
18,62,12,31,3,21.79094106777599,9
19,49,10,58,2,21.7746386625006,8
20,41,15,4,5,21.480590173913868,10
21,25,13,4,2,21.42004260246313,11
22,104,16,91,1,21.319718278752113,15
23,112,13,10,3,21.23417972341476,10
24,110,10,43,2,21.055981543018305,8
25,55,11,38,2,20.87506721402826,9
26,90,11,68,2,20.787956198015944,9
27,17,11,79,2,20.721013165555437,9
28,57,10,72,0,20.68783938357469,10
29,81,23,94,6,20.51779847980575,17
30,48,11,35,2,20.438098241934792,9
31,51,15,10,3,20.332726180509006,12
32,72,11,69,2,20.210260183380633,9
33,7,12,84,2,20.160900959942534,10
34,73,13,97,4,19.966763707753135,9
35,65,15,33,3,19.770112976636934,12
36,114,11,108,3,19.76837565181859,8
37,95,12,32,2,19.760326388824463,10
38,15,11,31,3,19.73878794252568,8
39,64,11,5,2,19.698196874853632,9
40,80,15,112,4,19.693979047929243,11
41,101,10,51,2,19.538804927619935,8
42,90,22,51,4,19.526276440378883,18
43,30,19,36,2,19.30529767168729,17
44,99,14,18,3,19.290873438644514,11
45,4,16,54,2,19.2440876038421,14
46,45,12,43,3,19.04326521517843,9
47,92,10,106,2,19.041690772468705,8
48,30,10,6,2,19.02037640213381,8
49,89,11,106,4,18.95338953455919,7
50,98,13,4,2,18.936498509144613,11
51,2,10,11,2,18.923084797888755,8
52,38,12,3,3,18.87397529072018,9
53,99,17,28,4,18.754584808369174,13
54,2,17,51,5,18.65389824931577,12
55,106,15,31,4,18.52908676481624,11
56,48,15,3,4,18.490434950243607,11
57,48,15,9,3,18.472872872736897,12
58,5,10,18,2,18.464269170029823,8
59,49,15,81,4,18.413832313114135,11
60,112,33,68,7,18.359935763708748,26
61,81,12,43,3,18.327617727929386,9
62,12,10,7,3,18.198433480354243,7
63,75,10,79,2,18.18520074819613,8
64,67,10,54,2,18.121548101252507,8
65,55,18,33,4,17.969879843551904,14
66,95,15,30,4,17.919901608832813,11
67,15,10,77,2,17.860876802027803,8
68,35,10,41,3,17.84884882348167,7
69,111,11,114,3,17.846918134233796,8
70,32,17,88,4,17.82459413467382,13
71,30,18,5,3,17.81053305502534,15
72,44,12,55,3,17.77184716319356,9
73,5,11,3,4,17.694163901939547,7
74,20,10,67,2,17.6724550880506,8
75,110,11,83,2,17.575104905290946,9
76,76,11,79,2,17.53144635448245,9
77,23,14,18,4,17.468338798211544,10
78,60,10,35,3,17.41812694726481,7
79,86,21,58,5,17.41327003256676,16
80,78,25,112,6,17.347844978089675,19
81,35,10,106,3,17.319051156851785,7
82,60,13,20,3,17.267904745312975,10
83,27,22,5,6,17.18696709990766,16
84,60,11,2,3,17.11684300008854,8
85,30,16,43,3,17.116460431238483,13
86,27,29,9,8,17.072056537621453,21
87,80,17,13,5,17.063751983939074,12
88,18,14,1,3,17.058153705270225,11
89,48,11,70,3,17.04295857723929,8
90,43,11,46,3,16.991693442801246,8
91,38,10,31,4,16.97274158238424,6
92,20,19,112,4,16.964936240764274,15
93,13,12,10,3,16.892767460419815,9
94,38,14,97,3,16.838290194315167,11
95,1,10,76,3,16.815372977495876,7
96,23,13,83,3,16.744700089549806,10
97,95,15,71,5,16.72675418994599,10
98,50,16,68,5,16.665846594945688,11
99,101,10,36,2,16.6279467044195,8
100,95,22,68,4,16.550204863156036,18
101,53,22,69,6,16.54470456650947,16
102,16,20,83,5,16.531803021169058,15
103,66,10,64,2,16.526342406123636,8
104,14,15,55,3,16.464885141480416,12
105,29,11,102,2,16.462227654940605,9
106,11,25,25,5,16.429746187224733,20
107,29,10,40,2,16.378294184390825,8
108,34,12,80,2,16.269229317512288,10
109,27,12,83,2,16.23514126111956,10
110,63,14,19,3,16.214836651867664,11
111,34,10,54,2,16.192576513322777,8
112,43,10,102,3,16.154622115934178,7
113,27,18,69,5,16.145804863274613,13
114,71,15,112,4,16.116875921028473,11
115,29,17,68,4,16.103821283507283,13
116,41,18,5,6,16.05037708250146,12
117,69,14,18,4,16.026981492760473,10
118,14,13,63,4,15.961958621197992,9
119,100,12,2,4,15.930884215555713,8
120,80,13,70,2,15.901333417895936,11
121,53,30,9,8,15.894615033798411,22
122,43,12,28,4,15.894105628705272,8
123,94,18,57,5,15.891839037049907,13
124,90,29,28,7,15.880089586771653,22
125,19,10,81,2,15.857835232981126,8
126,99,18,39,4,15.84878961626863,14
127,16,45,31,12,15.837412153743443,33
128,62,14,57,3,15.831783410046949,11
129,65,24,58,7,15.812414335905176,17
130,95,22,17,5,15.80262158037718,17
131,30,11,93,3,15.777207362300766,8
132,75,10,35,2,15.755761764469415,8
133,7,20,57,7,15.746440629237663,13
134,93,16,96,4,15.733194627661211,12
135,37,14,77,4,15.73169378416834,10
136,80,12,35,3,15.72406211872363,9
137,75,13,80,3,15.718052052365534,10
138,8,13,1,3,15.702434313684373,10
139,47,12,3,3,15.700624626069072,9
140,87,13,35,4,15.683184050777024,9
141,14,12,97,2,15.664913845649806,10
142,78,13,104,3,15.636975901996585,10
143,100,13,81,4,15.62463744777736,9
144,90,13,97,4,15.621888085765939,9
145,51,19,19,4,15.610466167057197,15
146,106,11,85,3,15.60573196351404,8
147,4,14,45,4,15.600891470448106,10
148,16,23,77,6,15.591779205572053,17
149,23,20,5,5,15.563915929412016,15
150,104,12,31,4,15.561592201078605,8
151,108,12,11,3,15.551347739122177,9
152,25,11,14,2,15.536643242754739,9
153,37,11,10,4,15.516949569025604,7
154,64,20,104,5,15.515264160119225,15
155,104,18,2,6,15.503443707499333,12
156,69,15,31,5,15.502962092044205,10
157,112,22,84,6,15.486639525748984,16
158,2,12,39,3,15.473797666414955,9
159,74,12,103,3,15.463990000688314,9
160,73,25,107,8,15.460672720698525,17
161,30,27,63,8,15.449959755734401,19
162,49,14,25,4,15.43786379260084,10
163,15,10,103,3,15.4100658100373,7
164,98,12,46,4,15.381140721878971,8
165,84,27,3,9,15.37291614514667,18
166,34,15,57,4,15.357045361759072,11
167,109,13,29,5,15.345893123711157,8
168,41,29,9,8,15.33957702800506,21
169,55,18,43,3,15.331339787531814,15
170,41,15,84,4,15.33074063826509,11
171,30,15,41,5,15.299076943535711,10
172,63,27,3,5,15.281871445146512,22
173,109,13,98,3,15.276765537635706,10
174,93,14,46,3,15.251126640356864,11
175,49,10,11,3,15.249342027085248,7
176,100,19,29,6,15.221800519331856,13
177,55,12,47,4,15.214446673688142,8
178,15,14,69,3,15.208966346153655,11
179,64,15,29,3,15.189033105530582,12
180,71,10,29,2,15.143188317628589,8
181,111,10,69,3,15.0816233253005,7
182,45,19,51,5,15.06403272485712,14
183,104,16,79,5,15.054954882421578,11
184,25,18,99,5,15.014737107768298,13
185,45,10,75,2,15.003649946946844,8
186,13,12,22,3,14.994671319317485,9
187,98,12,77,3,14.973611058432562,9
188,55,10,112,2,14.907032679929213,8
189,110,12,28,4,14.860268273313302,8
190,87,13,38,4,14.859584047072822,9
191,78,13,50,3,14.84559552710242,10
192,27,10,102,2,14.8415066807879,8
193,15,13,76,4,14.81353391108204,9
194,75,36,54,11,14.806584486593527,25
195,78,12,47,4,14.759178311128261,8
196,32,14,106,3,14.741977351969275,11
197,100,10,31,3,14.730848989291463,7
198,74,10,29,3,14.72390247298373,7
199,114,19,83,5,14.712530964906872,14
200,88,22,29,6,14.584788845308772,16
201,50,12,99,4,14.581629542155014,8
202,39,14,103,4,14.559450951683674,10
203,80,19,50,4,14.554439051919097,15
204,19,10,6,3,14.554142944413204,7
205,108,11,9,4,14.533752266696009,7
206,73,12,37,4,14.533349572792922,8
207,34,12,25,3,14.468789684868277,9
208,73,10,2,3,14.457830254043136,7
209,80,18,88,6,14.45456738577453,12
210,63,13,35,4,14.450412261730216,9
211,44,12,5,3,14.447481002517355,9
212,97,13,35,3,14.444551731599502,10
213,80,11,14,4,14.435345395194508,7
214,108,26,70,7,14.42739364927628,19
215,27,25,109,8,14.382423321336262,17
216,30,15,79,4,14.367578053753679,11
217,40,10,83,2,14.347262135245902,8
218,7,27,77,8,14.33556677589385,19
219,26,25,86,6,14.322036756570222,19
220,108,10,112,3,14.316449946299116,7
221,31,12,57,4,14.310689026630849,8
222,46,11,102,3,14.30749471315205,8
223,34,12,37,3,14.30057126443514,9
224,102,15,60,5,14.297767291892317,10
225,94,18,51,5,14.284138592654589,13
226,72,12,23,3,14.264075883340935,9
227,104,11,94,3,14.253478157346805,8
228,55,13,103,3,14.23298089068328,10
229,61,17,7,6,14.21770274028152,11
230,72,10,75,3,14.207053385683187,7
231,41,11,80,3,14.18671629223256,8
232,16,38,94,10,14.115630694559716,28
233,30,34,13,11,14.093936327325617,23
234,100,38,65,10,14.066095929641131,28
235,34,15,60,4,14.06538183514074,11
236,40,29,77,8,14.048771071022596,21
237,45,11,39,4,14.033377854173942,7
238,8,21,77,6,13.998411080894309,15
239,69,11,91,4,13.993001551531528,7
240,111,12,75,4,13.972281809419963,8
241,40,24,71,7,13.948125771645659,17
242,91,11,109,3,13.946188604720339,8
243,75,19,69,5,13.942304484906579,14
244,41,21,12,6,13.938646246649764,15
245,37,11,112,3,13.937736127059294,8
246,54,17,76,5,13.892444764564262,12
247,53,19,50,6,13.883151416746285,13
248,34,14,104,4,13.86429846409272,10
249,98,17,31,6,13.805084918983171,11
250,13,74,31,23,13.800549608099516,51
251,97,11,112,2,13.794615799527321,9
252,78,14,94,4,13.782893393913414,10
253,98,13,75,4,13.771823974459998,9
254,77,17,50,4,13.753479149012175,13
255,95,37,88,11,13.752013257016605,26
256,97,10,27,4,13.735152835550483,6
257,63,14,33,4,13.733555706081617,10
258,63,25,31,7,13.714594813504092,18
259,104,14,44,4,13.703910249073422,10
260,47,12,49,3,13.687802461931255,9
261,109,11,103,4,13.675879641836712,7
262,49,11,18,3,13.655065375637422,8
263,43,15,77,5,13.628489418492512,10
264,15,10,74,3,13.569326307429137,7
265,76,12,91,3,13.563460914482881,9
266,17,18,78,6,13.54486013323846,12
267,72,13,109,3,13.538745703424038,10
268,7,11,66,4,13.514093541012448,7
269,1,10,57,3,13.498323659072742,7
270,48,28,54,9,13.475788580607775,19
271,36,15,35,4,13.440272285829963,11
272,17,14,27,5,13.439086650659679,9
273,43,19,53,5,13.438033142991653,14
274,23,15,45,4,13.436468047997268,11
275,25,12,32,5,13.427877456338663,7
276,61,16,68,5,13.424919545398375,11
277,75,15,53,5,13.423496737137006,10
278,91,11,112,3,13.423237527272482,8
279,100,24,103,7,13.416971588030298,17
280,78,13,62,4,13.405073621084881,9
281,28,11,103,3,13.400171591171766,8
282,104,12,35,4,13.369677424437178,8
283,55,11,32,4,13.36363963009391,7
284,34,15,20,4,13.349753634163106,11
285,100,22,11,7,13.327325649124537,15
286,18,12,46,3,13.322032493347338,9
287,47,16,18,4,13.317575135316673,12
288,50,17,46,6,13.310329365776974,11
289,64,19,106,6,13.295192075566398,13
290,7,12,99,4,13.274517260788409,8
291,102,31,5,10,13.269431869962297,21
292,95,23,11,6,13.26328800508424,17
293,30,11,12,3,13.262903068810447,8
294,15,12,112,4,13.25658340349479,8
295,11,39,96,12,13.25258237771624,27
296,36,18,54,6,13.217744798273172,12
297,15,12,37,3,13.204885577431204,9
298,76,14,19,4,13.190869862531446,10
299,11,22,70,6,13.174919150937761,16
300,95,28,37,7,13.149042342745604,21
301,98,13,88,3,13.13778782250953,10
302,83,10,70,4,13.118339150755117,6
303,21,11,87,3,13.114631052870209,8
304,30,24,3,7,13.090996729925571,17
305,80,11,49,4,13.082676129231572,7
306,84,11,108,3,13.07106461175519,8
307,91,29,60,10,12.952631394075715,19
308,60,14,48,4,12.898116343169704,10
309,74,20,62,6,12.893098863947467,14
310,34,13,3,4,12.892571415057605,9
311,107,18,103,5,12.891833025895632,13
312,2,21,65,5,12.890027578518202,16
313,20,17,3,5,12.875807771067082,12
314,78,12,103,2,12.857012772866142,10
315,38,13,112,3,12.849363497429499,10
316,34,10,88,3,12.786710581831155,7
317,100,18,57,6,12.770507404820762,12
318,54,12,81,4,12.757047966098476,8
319,95,10,36,3,12.746346244298937,7
320,114,27,109,7,12.737377288037612,20
321,33,14,106,4,12.736963404825662,10
322,46,24,106,9,12.725492516069492,15
323,98,12,48,3,12.72400980532305,9
324,111,16,88,4,12.710530076381987,12
325,57,12,2,4,12.707474284723991,8
326,80,40,63,12,12.682443988429272,28
327,48,15,5,4,12.675358072710548,11
328,100,24,3,7,12.663085279232618,17
329,63,13,72,3,12.65810321481337,10
330,15,12,102,3,12.597866884640938,9
331,15,30,51,10,12.589187635735609,20
332,57,27,5,8,12.572003913811171,19
333,41,18,71,5,12.55777326700885,13
334,75,27,5,10,12.535083552437033,17
335,76,16,78,4,12.532424570064773,12
336,64,15,92,7,12.492372460791035,8
337,55,38,1,11,12.470203554889151,27
338,17,11,94,4,12.465558824086667,7
339,18,14,37,4,12.43883359344357,10
340,9,12,94,5,12.43258108845859,7
341,36,17,50,7,12.423703215189779,10
342,104,39,46,13,12.353574327141933,26
343,67,12,97,3,12.35346782744064,9
344,49,23,104,7,12.322985298305156,16
345,47,24,60,7,12.306617941323184,17
346,75,14,57,4,12.306540056833526,10
347,98,29,96,9,12.301665445316493,20
348,32,10,39,3,12.25900875776762,7
349,71,11,84,3,12.255989147154674,8
350,76,15,57,4,12.252643312548889,11
351,78,14,80,4,12.249303135974207,10
352,74,22,60,8,12.230302476711508,14
353,75,19,43,5,12.224767647713705,14
354,43,14,9,5,12.224469441855378,9
355,19,22,107,6,12.214517428492755,16
356,78,11,106,3,12.210243252742755,8
357,7,18,76,7,12.19661731578168,11
358,11,35,84,11,12.189911906563859,24
359,109,18,39,5,12.189314131019263,13
360,16,14,67,4,12.181707474418104,10
361,65,19,57,6,12.17988690463077,13
362,107,21,99,7,12.174640608684571,14
363,2,22,70,8,12.153236389251056,14
364,19,11,31,3,12.140248760143196,8
365,92,12,63,5,12.136993324985582,7
366,47,16,112,6,12.12589666315303,10
367,15,10,4,4,12.1242208434208,6
368,34,12,70,4,12.123530804367727,8
369,28,20,72,6,12.11934808588004,14
370,100,25,68,9,12.114564908877215,16
371,15,15,109,4,12.110158649114124,11
372,8,11,35,3,12.093356369533685,8
373,87,24,81,9,12.091256303565032,15
374,53,20,3,6,12.068087567340713,14
375,30,18,91,5,12.061464887561753,13
376,104,22,71,8,12.060518806565575,14
377,1,18,63,7,12.054495717242014,11
378,27,24,103,8,12.038419286224949,16
379,1,12,104,4,12.020108292717422,8
380,49,29,69,10,12.014682569242257,19
381,34,13,43,4,11.988958581252156,9
382,102,18,55,6,11.983866194974436,12
383,76,21,49,7,11.982123472808711,14
384,37,16,60,6,11.9668638856867,10
385,53,10,54,3,11.951994898142782,7
386,95,27,18,9,11.951490678023532,18
387,114,46,65,16,11.938229846486395,30
388,60,28,29,10,11.935295873360038,18
389,71,17,77,5,11.915487518479784,12
390,90,18,104,6,11.89837391797068,12
391,111,22,41,8,11.859477089655313,14
392,74,34,28,11,11.834419909257846,23
393,92,17,86,6,11.833574375075667,11
394,13,23,29,8,11.832910968358506,15
395,78,10,37,3,11.831707242150298,7
396,63,47,28,14,11.8288664237163,33
397,74,10,64,4,11.828764368523546,6
398,28,16,111,5,11.82030122340792,11
399,83,10,17,4,11.812775268760372,6
400,53,10,91,3,11.811611902058761,7
401,8,11,108,3,11.805411430354427,8
402,15,11,41,3,11.80165523386963,8
403,8,21,40,6,11.791921402372775,15
404,44,10,54,3,11.791894285038754,7
405,91,12,65,4,11.784658313781675,8
406,17,18,109,6,11.781743441013703,12
407,112,10,62,3,11.78047192200998,7
408,75,13,12,5,11.770852723789327,8
409,54,20,43,7,11.759609270938485,13
410,79,22,87,6,11.757907554031659,16
411,85,13,94,4,11.736414032142248,9
412,39,22,94,7,11.719613330837497,15
413,72,19,51,7,11.715625610109742,12
414,13,78,88,24,11.71558742957354,54
415,91,13,96,4,11.692854193124042,9
416,34,23,28,7,11.682170467841415,16
417,21,10,88,3,11.677382922456276,7
418,93,11,104,4,11.670878710804793,7
419,100,12,40,4,11.638460148115906,8
420,90,15,39,5,11.57797650142359,10
421,78,13,20,4,11.577779141148348,9
422,33,15,50,5,11.568332857311571,10
423,11,38,37,12,11.566356283581703,26
424,36,16,104,6,11.564722196156039,10
425,111,10,71,3,11.563837134119533,7
426,50,10,29,3,11.556789279617938,7
427,74,15,76,6,11.544600382799558,9
428,110,12,7,5,11.526061320417648,7
429,7,15,81,6,11.525413070422038,9
430,11,15,18,5,11.49652383906797,10
431,50,38,88,13,11.435059490334734,25
432,85,16,50,5,11.432524505459874,11
433,29,10,95,3,11.401888238693152,7
434,4,11,38,3,11.395009854616484,8
435,107,14,10,5,11.38119632500004,9
436,28,22,112,7,11.372427658976592,15
437,103,20,68,7,11.3687537967514,13
438,75,15,102,4,11.357902372458398,11
439,104,30,77,10,11.335858846829385,20
440,64,12,20,3,11.33130846260478,9
441,62,22,51,7,11.320895348464042,15
442,53,42,88,13,11.31002440231641,29
443,7,25,96,7,11.300422106484014,18
444,80,10,5,3,11.295210617596885,7
445,80,20,51,7,11.284900357531916,13
446,48,35,107,12,11.28123382017902,23
447,111,11,27,3,11.279710088837586,8
448,2,14,55,5,11.276816159574059,9
449,75,52,7,17,11.274663385996204,35
450,16,13,101,4,11.255156877916162,9
451,87,29,70,11,11.250414739740135,18
452,107,16,83,5,11.249585120390279,11
453,40,13,81,4,11.249205674756393,9
454,75,17,109,5,11.242273446455997,12
455,25,25,68,8,11.235607083018873,17
456,46,20,96,8,11.223825219116966,12
457,75,36,8,11,11.220741251540183,25
458,73,13,51,4,11.219804453521853,9
459,98,18,106,6,11.217270403208776,12
460,25,15,3,5,11.214634960222732,10
461,100,12,46,4,11.210309669403356,8
462,89,11,1,4,11.209011069389932,7
463,98,29,87,9,11.186830060106244,20
464,64,18,37,6,11.185324034227655,12
465,30,20,94,7,11.167617773854161,13
466,15,27,9,11,11.164728453136332,16
467,43,16,4,6,11.162760468553993,10
468,95,29,51,8,11.161050582896516,21
469,78,13,1,4,11.156578268103178,9
470,75,16,38,4,11.14383618558865,12
471,43,16,91,5,11.128114127049443,11
472,46,15,70,5,11.123543654837002,10
473,74,13,32,4,11.101664191982366,9
474,62,15,104,4,11.098747349135207,11
475,11,14,43,5,11.092426053601757,9
476,62,20,63,7,11.090581145313461,13
477,11,17,103,4,11.073354537239329,13
478,99,11,11,4,11.04788337752713,7
479,32,12,114,4,11.045874107216177,8
480,16,17,32,6,11.04556139119038,11
481,41,14,92,5,11.016394202336144,9
482,104,29,27,9,11.012310108735354,20
483,15,13,71,4,11.00914391321026,9
484,40,26,3,8,11.00717769248795,18
485,51,20,110,6,11.000148170458745,14
486,112,12,30,3,10.999416558177831,9
487,70,24,57,10,10.99751468090858,14
488,50,13,72,4,10.995949132654946,9
489,13,25,97,9,10.985857531237675,16
490,13,46,18,16,10.917911397709464,30
491,73,17,5,6,10.907383059794872,11
492,69,12,8,4,10.904584563603303,8
493,102,10,35,4,10.903207987031468,6
494,28,11,81,4,10.900813686195042,7
495,87,31,114,12,10.855794018644565,19
496,104,28,11,9,10.845922414749028,19
497,114,14,12,6,10.834474307512755,8
498,49,14,112,5,10.834140299620774,9
499,100,17,77,6,10.823147304819512,11
500,48,15,108,4,10.823092907934063,11
501,30,11,2,4,10.820419515250846,7
502,106,17,81,7,10.816681182916202,10
503,55,25,91,7,10.791612827626562,18
504,7,25,19,7,10.775977198177877,18
505,59,11,7,3,10.771239818059199,8
506,53,23,108,9,10.749834986479383,14
507,27,28,19,8,10.741284129806774,20
508,48,11,49,3,10.735556213813275,8
509,54,22,27,8,10.725257048191676,14
510,53,22,17,7,10.72338378113649,15
511,54,11,111,3,10.714143810197228,8
512,43,13,36,5,10.713552025008548,8
513,85,19,72,5,10.69575679628125,14
514,75,13,76,5,10.684711333832391,8
515,38,12,57,5,10.682623087511102,7
516,20,21,9,7,10.676297323703045,14
517,5,25,98,9,10.66291868554062,16
518,3,11,35,4,10.637414854102067,7
519,114,40,106,14,10.63191941709851,26
520,98,18,71,6,10.627953776602759,12
521,7,31,91,9,10.609100286101588,22
522,26,10,28,3,10.592168464369761,7
523,104,26,75,9,10.57435391669422,17
524,95,15,9,6,10.569002592922953,9
525,71,19,54,7,10.563773271372229,12
526,28,17,40,7,10.551622113062637,10
527,50,39,20,13,10.540260354284218,26
528,76,13,108,4,10.539317855686345,9
529,41,16,17,5,10.533333329606137,11
530,72,13,100,4,10.528540542570207,9
531,71,19,97,6,10.5235339621969,13
532,27,27,36,10,10.523349599331352,17
533,76,10,103,3,10.522979980156947,7
534,89,14,37,6,10.519274673853001,8
535,63,16,102,6,10.517349087153976,10
536,86,32,48,11,10.510093191570517,21
537,29,12,48,4,10.5062410495631,8
538,64,27,9,8,10.495957554452968,19
539,62,10,48,4,10.487894133335649,6
540,63,36,48,12,10.480037623792745,24
541,94,14,49,4,10.474432971630803,10
542,6,10,31,4,10.459894630543896,6
543,44,16,39,6,10.434810009571377,10
544,108,18,39,7,10.432805242984768,11
545,95,19,114,7,10.422604339796184,12
546,72,16,19,5,10.4070193936332,11
547,63,21,77,6,10.39288170670529,15
548,16,14,92,3,10.381584875368542,11
549,106,16,93,6,10.37915501513517,10
550,100,21,114,7,10.375864052598782,14
551,15,16,55,4,10.37053728825799,12
552,9,12,12,4,10.366855545040103,8
553,39,17,85,7,10.365791683743176,10
554,94,10,7,3,10.355621654064773,7
555,53,16,77,6,10.347606271977277,10
556,40,16,102,6,10.346146758066935,10
557,37,13,1,5,10.342164269053148,8
558,9,15,19,5,10.341402019858231,10
559,11,15,38,5,10.333740936310708,10
560,11,14,10,5,10.326527517070998,9
561,15,36,88,10,10.326397400952985,26
562,30,11,85,4,10.303891883685978,7
563,107,29,31,13,10.30345756995746,16
564,27,15,35,5,10.299796186005187,10
565,45,23,107,8,10.289536165233189,15
566,60,24,112,8,10.282975838759185,16
567,100,12,38,3,10.28200386267856,9
568,39,15,72,5,10.260914319406773,10
569,18,43,39,14,10.257246202371954,29
570,67,16,106,6,10.252161434234207,10
571,63,35,91,11,10.225389928816243,24
572,76,11,72,3,10.214708924963714,8
573,30,17,31,7,10.214096274935343,10
574,10,14,28,4,10.207926130943799,10
575,91,24,39,8,10.206322081312438,16
576,48,24,96,8,10.200121519345739,16
577,98,15,2,6,10.198603389321667,9
578,71,13,33,4,10.195530501937561,9
579,97,41,37,14,10.190687502541845,27
580,80,12,30,4,10.185455091355948,8
581,76,25,35,9,10.177855774517552,16
582,6,12,9,5,10.175309866966636,7
583,39,23,78,8,10.16867073318477,15
584,30,12,61,4,10.163971317134532,8
585,92,16,68,5,10.14730683848729,11
586,96,11,23,4,10.143008283174426,7
587,53,37,31,14,10.136338371296793,23
588,92,10,109,3,10.132066653367776,7
589,78,12,114,5,10.123963867745248,7
590,53,36,36,11,10.114732824687987,25
591,13,45,3,14,10.10303381393413,31
592,23,17,17,6,10.090670558592322,11
593,27,37,3,14,10.088019310903823,23
594,104,19,38,7,10.08102646622601,12
595,79,12,106,4,10.079963228120917,8
596,40,16,49,6,10.077718304922938,10
597,13,12,79,4,10.072956753420838,8
598,13,23,83,8,10.067954696106945,15
599,51,23,33,6,10.051201517023788,17
600,44,10,38,3,10.048373138060269,7
601,110,13,107,4,10.03472132274693,9
602,30,27,84,8,10.023299208241367,19
603,57,41,107,15,9.988909876937932,26
604,95,25,65,9,9.987438820754939,16
605,53,21,12,8,9.979940044053077,13
606,73,18,88,6,9.974203425238965,12
607,46,14,90,5,9.960134782518512,9
608,63,45,88,14,9.955054334971098,31
609,38,25,65,10,9.938323564506913,15
610,75,15,29,6,9.923300198268764,9
611,95,10,2,3,9.920312629990502,7
612,63,50,84,19,9.919938234846502,31
613,28,35,75,12,9.910859132469223,23
614,62,20,3,7,9.90834351366296,13
615,37,47,54,16,9.896946296790851,31
616,11,14,83,4,9.89615191909491,10
617,110,20,16,7,9.893450419413208,13
618,20,14,29,5,9.888770035938014,9
619,2,17,54,5,9.883928701627934,12
620,103,10,60,3,9.879239219316728,7
621,89,12,13,5,9.877754309089125,7
622,49,13,37,5,9.87740902492493,8
623,86,16,67,6,9.87443210558644,10
624,17,15,71,6,9.874078720771614,9
625,75,17,1,5,9.87310906944801,12
626,44,21,13,7,9.844973608163798,14
627,51,31,81,12,9.841137721298338,19
628,53,10,98,4,9.839111782848335,6
629,16,12,10,4,9.837247209773244,8
630,9,17,47,6,9.833363334347146,11
631,11,17,9,6,9.83179351941753,11
632,18,12,19,4,9.830216565539352,8
633,54,13,57,3,9.824315369895016,10
634,40,24,17,8,9.815776001763279,16
635,29,13,93,5,9.815241351279962,8
636,38,10,78,3,9.80978095420608,7
637,62,10,93,4,9.798162399200404,6
638,37,24,83,9,9.783726366978417,15
639,27,28,57,11,9.783695690522881,17
640,13,46,43,19,9.779544155099423,27
641,54,17,58,7,9.778768856735097,10
642,77,33,51,13,9.765558432651373,20
643,41,20,49,7,9.757184372315313,13
644,86,21,52,7,9.734029946764755,14
645,43,19,31,10,9.720852773553682,9
646,75,18,11,7,9.71088785220573,11
647,72,13,103,5,9.699905123478471,8
648,64,14,19,4,9.690080014182922,10
649,78,26,69,9,9.666260825143702,17
650,100,12,71,4,9.66068752031631,8
651,111,16,63,6,9.656549842780759,10
652,22,10,114,5,9.649313306364819,5
653,72,17,3,7,9.639566216177295,10
654,41,23,53,8,9.631953807885303,15
655,102,35,86,12,9.627012939702553,23
656,27,37,60,12,9.62572515977853,25
657,70,17,109,6,9.623350653501726,11
658,40,12,19,4,9.612489725967157,8
659,99,14,8,6,9.61106559286031,8
660,83,18,84,7,9.609473734372159,11
661,62,18,19,5,9.608410254395684,13
662,11,29,57,12,9.596520727828777,17
663,8,13,53,4,9.596286006275326,9
664,64,27,112,8,9.595012833071515,19
665,73,20,7,8,9.582485903794176,12
666,27,28,31,12,9.569633624787398,16
667,106,13,108,4,9.535201707134298,9
668,20,11,75,4,9.527707505687719,7
669,48,15,51,7,9.527077025607761,8
670,1,22,31,9,9.525804060927038,13
671,100,45,87,19,9.525689075238134,26
672,34,10,103,3,9.525596905709584,7
673,20,32,25,11,9.520523686179052,21
674,18,27,9,9,9.520249042639604,18
675,8,17,36,6,9.51236026695053,11
676,90,14,80,4,9.509239360264802,10
677,114,13,2,5,9.509158562417847,8
678,30,17,46,6,9.50446880568247,11
679,37,22,99,7,9.502759058160713,15
680,37,29,7,11,9.500511382222342,18
681,72,21,68,7,9.500041589935536,14
682,18,11,34,3,9.499952299900604,8
683,18,11,84,4,9.493458888054228,7
684,78,22,49,8,9.490956018486093,14
685,30,57,16,20,9.490852072579777,37
686,70,10,58,3,9.487562225897108,7
687,15,22,11,8,9.485047519579302,14
688,110,17,39,5,9.484612192785775,12
689,107,32,109,11,9.463956272479841,21
690,16,47,96,14,9.46295382882651,33
691,32,11,63,4,9.44232166344675,7
692,39,37,20,15,9.42792244833799,22
693,13,15,2,6,9.422510080465486,9
694,27,22,53,7,9.395074434024874,15
695,109,11,36,3,9.390936468630548,8
696,100,28,49,11,9.388414110980033,17
697,28,25,3,9,9.379650958304438,16
698,27,16,4,6,9.3787154159821,10
699,104,21,84,8,9.37162724208143,13
700,64,46,60,15,9.358603836566358,31
701,23,12,50,3,9.354699302165745,9
702,55,19,23,8,9.354242967773875,11
703,1,20,87,8,9.344990956449259,12
704,28,29,2,10,9.34282167881126,19
705,100,25,43,10,9.33116742746192,15
706,111,15,51,5,9.328246716797016,10
707,77,10,84,3,9.326879307665175,7
708,45,10,38,3,9.31109379184883,7
709,8,27,57,9,9.301352073064093,18
710,100,17,18,7,9.297622647277194,10
711,87,37,9,15,9.26416450911469,22
712,20,16,90,6,9.25670480461804,10
713,78,15,53,6,9.245467105519944,9
714,91,23,20,9,9.233435902067152,14
715,70,16,69,5,9.227346228401574,11
716,107,21,77,8,9.225690577042375,13
717,58,25,69,10,9.22400899523332,15
718,13,19,6,7,9.21551599242718,12
719,72,16,65,6,9.208422167482267,10
720,93,11,90,4,9.204947446014161,7
721,73,17,40,6,9.199997222971483,11
722,100,23,60,8,9.19569231443763,15
723,81,16,63,6,9.19342956994627,10
724,23,14,91,6,9.188824217195519,8
725,15,13,91,6,9.175439096539632,7
726,92,15,40,5,9.168940871834318,10
727,16,63,106,21,9.160803291418002,42
728,50,43,5,17,9.156049369840707,26
729,39,25,106,10,9.155969378752744,15
730,8,33,114,11,9.15311587436214,22
731,16,47,18,16,9.151603438620151,31
732,92,11,17,4,9.114563540800457,7
733,109,15,31,5,9.11388757240418,10
734,29,26,19,9,9.099210291595174,17
735,43,36,94,14,9.090567513391374,22
736,109,38,8,15,9.080033137915198,23
737,95,34,8,13,9.079209474058969,21
738,44,29,86,10,9.073857704921485,19
739,8,27,15,11,9.069685702881007,16
740,33,10,69,4,9.069652549512774,6
741,100,13,1,5,9.068173300248533,8
742,35,16,45,7,9.040031591861501,9
743,108,29,13,10,9.020970097727641,19
744,30,16,70,7,9.016092338129877,9
745,30,44,39,17,9.014074342921363,27
746,5,15,36,6,9.008614310253613,9
747,62,13,15,5,9.005083883016919,8
748,86,24,103,8,9.003989208559398,16
749,78,35,51,15,8.985936186674264,20
750,16,14,12,5,8.983913235715004,9
751,28,15,52,6,8.975367013246691,9
752,97,18,36,7,8.970668153566264,11
753,47,20,114,8,8.969382880850322,12
754,28,11,32,4,8.963821007682872,7
755,68,30,18,11,8.962998195734913,19
756,27,11,89,4,8.961649653755527,7
757,51,26,74,8,8.938947542412073,18
758,73,12,31,4,8.938919570135752,8
759,58,25,13,7,8.93732146966397,18
760,13,22,84,7,8.92622496976615,15
761,11,10,91,3,8.923724837318142,7
762,54,32,60,11,8.921440420264185,21
763,26,10,88,4,8.919527282390282,6
764,110,19,25,6,8.917701672558222,13
765,30,53,65,19,8.916092042735679,34
766,89,15,107,5,8.908975430626485,10
767,7,20,109,7,8.9080321410632,13
768,58,13,112,5,8.890258303309274,8
769,69,12,97,4,8.888377862411462,8
770,90,23,13,8,8.88376435292604,15
771,49,11,53,4,8.876928289416245,7
772,114,15,62,6,8.857020433859919,9
773,112,18,29,7,8.855419470416207,11
774,62,18,8,5,8.84901297537332,13
775,32,15,87,5,8.84415502943487,10
776,20,10,12,4,8.842914423325947,6
777,18,26,8,8,8.824824520647518,18
778,63,19,36,7,8.822881427312195,12
779,17,15,29,6,8.822347297259922,9
780,36,18,47,6,8.810892372607714,12
781,26,22,13,7,8.80503643851318,15
782,106,10,42,3,8.802546839644418,7
783,41,17,28,6,8.792780130820773,11
784,34,19,51,7,8.790432491258223,12
785,26,11,107,4,8.789963547813727,7
786,77,14,99,4,8.784719144285264,10
787,106,23,18,8,8.778191080978742,15
788,16,27,1,8,8.777340054296328,19
789,63,35,76,12,8.770301604790541,23
790,41,12,96,3,8.760253621607967,9
791,38,14,106,7,8.74501943352997,7
792,4,22,17,7,8.727735068009611,15
793,58,10,45,4,8.721721801464442,6
794,45,15,86,6,8.710518828201982,9
795,28,28,68,9,8.707268087933773,19
796,63,35,20,14,8.705248065274409,21
797,29,10,104,4,8.703420471548787,6
798,63,17,94,6,8.684130864326548,11
799,9,31,31,11,8.678153869820548,20
800,85,10,98,3,8.673802483900154,7
801,39,40,88,15,8.664769146654658,25
802,41,19,97,7,8.638943706099205,12
803,1,24,65,10,8.63311694974403,14
804,85,15,13,5,8.590889624694588,10
805,3,12,79,4,8.584201510329166,8
806,108,13,68,5,8.580585833252007,8
807,57,13,109,5,8.575637917032312,8
808,95,23,55,8,8.575006509864881,15
809,48,11,104,4,8.568096491349037,7
810,78,11,36,4,8.552435160203329,7
811,94,11,2,4,8.55058688518052,7
812,86,47,76,18,8.548031268244397,29
813,94,12,35,5,8.545638882275087,7
814,98,20,29,7,8.533348107584903,13
815,12,13,106,4,8.530975907772834,9
816,91,10,45,4,8.504304930616431,6
817,69,22,57,7,8.501708529602615,15
818,100,18,102,6,8.497510292544517,12
819,64,28,40,10,8.496071624321134,18
820,16,39,69,14,8.493540371651171,25
821,3,17,112,7,8.489497702475804,10
822,74,14,77,5,8.485489523270209,9
823,55,14,85,5,8.476039600481302,9
824,114,24,3,8,8.461132150785255,16
825,17,14,3,6,8.451772944173685,8
826,15,13,53,5,8.45144556317874,8
827,95,14,96,5,8.45037398259218,9
828,96,24,70,11,8.437417991026262,13
829,55,20,114,7,8.432483182241098,13
830,73,19,90,7,8.424101991862472,12
831,38,13,54,5,8.421224564929705,8
832,41,12,102,4,8.421036787338009,8
833,50,21,102,9,8.41869338516401,12
834,109,14,67,7,8.410228891959628,7
835,80,11,79,5,8.39440233865723,6
836,41,44,86,15,8.394182256897173,29
837,67,10,104,4,8.393331116483226,6
838,81,22,16,8,8.387289153423298,14
839,63,21,69,7,8.37549216391354,14
840,7,45,25,16,8.37280661834829,29
841,7,22,5,8,8.357081514884824,14
842,41,32,31,12,8.353957395244583,20
843,68,26,8,10,8.350318283362764,16
844,75,20,100,9,8.340891834618304,11
845,8,29,84,10,8.33757645831541,19
846,78,30,87,12,8.33618992148151,18
847,27,15,98,6,8.326557443258316,9
848,30,24,64,9,8.324576599861391,15
849,25,15,9,5,8.323455878342044,10
850,90,13,48,5,8.30973168111364,8
851,13,30,94,11,8.309149852706643,19
852,104,15,81,7,8.308547186806486,8
853,86,17,56,6,8.300855291965847,11
854,90,31,106,10,8.283845461248372,21
855,41,18,91,6,8.276671952774393,12
856,49,19,23,7,8.273514769081295,12
857,12,13,4,4,8.273106784367055,9
858,64,39,51,15,8.272173971656706,24
859,37,12,14,5,8.266467835075433,7
860,69,21,106,8,8.230262561693124,13
861,99,10,71,4,8.22496630028886,6
862,19,11,102,3,8.222044886202713,8
863,112,14,40,6,8.221202026655053,8
864,107,22,102,9,8.213723175398458,13
865,87,24,93,9,8.20135369004028,15
866,15,23,18,8,8.198983161894942,15
867,74,25,39,10,8.195535087876927,15
868,63,11,89,3,8.19292788894577,8
869,1,15,12,6,8.176621160250441,9
870,65,43,93,18,8.165860412715741,25
871,47,15,81,5,8.165398445346261,10
872,100,16,84,5,8.163740226415518,11
873,76,20,9,7,8.161384986883023,13
874,33,17,20,6,8.157924685534635,11
875,18,16,112,5,8.155957753880719,11
876,16,44,9,15,8.147460704640702,29
877,4,10,112,4,8.145974306589784,6
878,56,14,107,6,8.142413744294045,8
879,20,11,110,4,8.125291114928716,7
880,81,11,111,3,8.120062859865854,8
881,63,26,109,11,8.110737293175296,15
882,74,15,48,7,8.108554922899495,8
883,88,19,112,7,8.10654244906666,12
884,3,10,85,5,8.102330604310952,5
885,38,17,19,5,8.100688864380347,12
886,47,16,69,6,8.099464940788463,10
887,95,11,49,3,8.095998639719067,8
888,37,42,46,14,8.09589581959515,28
889,39,94,51,36,8.092875118792948,58
890,60,30,50,13,8.087484578525554,17
891,76,35,68,10,8.083319916767412,25
892,109,15,46,6,8.081904977493476,9
893,8,61,5,24,8.080732178020162,37
894,89,12,74,5,8.079770785030162,7
895,110,16,97,6,8.077466293642946,10
896,50,18,70,8,8.072010588554935,10
897,53,13,46,5,8.064750592390656,8
898,51,15,91,5,8.060157448942936,10
899,68,14,33,5,8.058871180827008,9
900,35,10,15,5,8.056529361763387,5
901,20,36,84,11,8.04861670328596,25
902,16,45,46,16,8.034750190065967,29
903,52,13,8,5,8.032663143129467,8
904,75,41,50,14,8.02466935745211,27
905,63,12,52,5,8.015196003418383,7
906,35,11,9,5,8.012816785902409,6
907,76,16,114,5,8.01045549406789,11
908,91,31,98,12,8.010154956050265,19
909,41,18,81,6,8.009042710590082,12
910,46,15,29,8,7.998285412892301,7
911,102,19,96,7,7.9956311609664965,12
912,44,22,6,7,7.994067314889742,15
913,13,16,70,6,7.990308468406848,10
914,5,28,84,11,7.986435375626319,17
915,39,63,68,25,7.985348203689877,38
916,112,26,76,11,7.979151678151438,15
917,16,20,58,7,7.973713265949866,13
918,48,11,89,3,7.971806233433707,8
919,65,25,5,10,7.967561696591304,15
920,23,21,39,8,7.9630880242589255,13
921,15,14,50,5,7.9487960460355565,9
922,53,19,61,6,7.9431150632920575,13
923,73,17,87,5,7.942207150258419,12
924,33,24,107,10,7.9345080318988535,14
925,54,22,18,9,7.917650548154775,13
926,60,18,58,7,7.916808592208974,11
927,6,14,61,5,7.915350050859163,9
928,88,10,82,4,7.912578083642496,6
929,79,14,57,6,7.91165764637429,8
930,71,13,38,4,7.906029048659733,9
931,78,11,31,5,7.904414780494012,6
932,53,14,90,5,7.90103229929259,9
933,78,18,34,7,7.896291134370744,11
934,114,25,90,10,7.8701656835045455,15
935,78,13,46,6,7.867017716751532,7
936,94,25,12,11,7.866892140629968,14
937,108,15,98,6,7.863072789163925,9
938,44,12,35,5,7.859665557157517,7
939,106,26,91,9,7.859341034872018,17
940,8,18,41,6,7.853968460697832,12
941,29,14,55,5,7.851130455007913,9
942,53,19,109,7,7.841205358929896,12
943,88,27,3,10,7.840747549885402,17
944,114,20,1,7,7.837742070296788,13
945,43,34,87,13,7.835150885725458,21
946,2,33,107,12,7.828664599470127,21
947,11,29,109,10,7.82409363266079,19
948,25,46,46,19,7.8204011950255445,27
949,35,13,51,5,7.8179533203899405,8
950,27,27,94,10,7.811103899052174,17
951,114,12,110,4,7.80031681097971,8
952,50,15,48,5,7.798532000224024,10
953,50,20,30,8,7.797701228015578,12
954,55,22,64,7,7.789831302640343,15
955,47,10,111,4,7.786638633209644,6
956,92,14,114,4,7.774797164908212,10
957,50,22,18,9,7.758401768064157,13
958,17,21,60,8,7.758065583862096,13
959,53,11,73,4,7.756297558195456,7
960,37,49,25,20,7.755599308877524,29
961,16,32,64,11,7.754231430905149,21
962,16,87,39,34,7.749220808750857,53
963,73,13,54,5,7.746921178252216,8
964,100,30,54,11,7.744879226333448,19
965,30,13,52,5,7.7446162681829085,8
966,44,11,84,5,7.741464370739849,6
967,81,15,27,6,7.7368213835310415,9
968,15,15,1,5,7.73306575970013,10
969,80,36,107,13,7.71499930787754,23
970,16,117,88,43,7.713333434358432,74
971,23,40,60,15,7.703308873703663,25
972,75,61,68,22,7.698232004910781,39
973,86,28,1,11,7.69668031791366,17
974,11,12,12,4,7.692678298811862,8
975,111,25,7,10,7.69032342577198,15
976,5,32,11,12,7.687442157533876,20
977,39,28,29,12,7.678123787816821,16
978,50,35,55,15,7.677574556383833,20
979,37,29,38,11,7.668156637885108,18
980,37,24,96,10,7.665844925696509,14
981,107,27,35,9,7.659745377736294,18
982,86,22,72,8,7.651597318688157,14
983,33,13,31,6,7.647223417443057,7
984,70,11,60,4,7.6464357490262,7
985,38,19,84,8,7.644842467332104,11
986,97,29,5,10,7.639418302115124,19
987,11,12,81,4,7.632646941640291,8
988,13,18,76,7,7.630501064893035,11
989,30,17,109,6,7.628133542119759,11
990,71,14,27,5,7.62097447229337,9
991,98,24,49,9,7.617694821913575,15
992,18,20,36,8,7.5949028785012285,12
993,58,18,88,7,7.5880987725104365,11
994,72,10,36,4,7.585561627806539,6
995,28,31,114,13,7.584853881328923,18
996,43,19,15,8,7.575222378444256,11
997,46,12,77,5,7.574271980014295,7
998,34,14,5,4,7.5706698448560905,10
999,40,66,68,24,7.5703219943157025,42
1000,42,12,69,5,7.569928254839939,7
1001,97,24,51,8,7.56785294854944,16
1002,75,23,49,9,7.565086245339055,14
1003,27,33,78,11,7.5633754544902665,22
1004,60,19,45,8,7.562934672858015,11
1005,87,38,40,16,7.562449238427529,22
1006,16,72,63,28,7.561421037601967,44
1007,54,78,88,30,7.560371458183833,48
1008,109,14,77,6,7.555022352358237,8
1009,49,13,55,5,7.545834219734257,8
1010,85,10,46,3,7.538229298143679,7
1011,33,16,7,7,7.532188482638043,9
1012,6,11,55,3,7.526848268362216,8
1013,43,34,86,12,7.52352217080424,22
1014,7,52,87,19,7.517208318589072,33
1015,104,18,69,6,7.510735223332435,12
1016,70,14,36,6,7.476080415111229,8
1017,108,15,63,6,7.475559971035058,9
1018,64,37,31,14,7.4738922265185375,23
1019,45,12,53,5,7.463487107897495,7
1020,100,12,70,5,7.458777129644957,7
1021,37,21,110,9,7.457046552670356,12
1022,68,55,87,22,7.449473442117574,33
1023,46,30,75,12,7.449361290092638,18
1024,11,12,71,5,7.444969376445684,7
1025,88,13,103,5,7.429730837512919,8
1026,47,15,28,6,7.412518705302231,9
1027,36,34,41,16,7.412500474371832,18
1028,108,22,88,8,7.409334471097551,14
1029,43,17,84,7,7.4028714682915195,10
1030,41,17,89,6,7.402414100587752,11
1031,1,10,5,4,7.391988711274886,6
1032,50,29,71,12,7.386130219514862,17
1033,30,20,11,8,7.381431949435282,12
1034,23,15,57,6,7.378386377329167,9
1035,71,19,81,7,7.374213709282583,12
1036,73,10,71,4,7.37323406519455,6
1037,34,15,74,5,7.367415754617591,10
1038,31,14,80,4,7.367135464628976,10
1039,25,16,33,5,7.36592627296452,11
1040,77,10,114,4,7.3654772203978025,6
1041,104,36,60,11,7.3607160522172075,25
1042,73,25,8,10,7.35879002547718,15
1043,17,19,9,8,7.3581791578689,11
1044,48,24,79,9,7.345817828277461,15
1045,23,18,114,6,7.344942637597016,12
1046,40,41,104,15,7.342291894534163,26
1047,75,16,2,7,7.332326563651873,9
1048,57,23,63,10,7.330641846184261,13
1049,85,13,65,5,7.3238412361926395,8
1050,70,42,5,17,7.323141246130927,25
1051,47,16,15,7,7.310604549956416,9
1052,12,29,107,10,7.3069891934013524,19
1053,54,33,40,13,7.298767912387551,20
1054,43,31,40,13,7.2876910701836355,18
1055,11,11,47,4,7.287013470663887,7
1056,9,20,104,8,7.285236260424962,12
1057,97,16,29,6,7.284915525257299,10
1058,13,20,98,7,7.284404613166717,13
1059,30,15,102,6,7.275971643900754,9
1060,27,26,77,10,7.2754077627555835,16
1061,55,20,68,7,7.273979151335479,13
1062,106,13,57,6,7.272492874678534,7
1063,84,25,29,10,7.268682540682646,15
1064,62,10,96,3,7.268496266352443,7
1065,110,16,70,6,7.267896542251015,10
1066,20,17,98,6,7.267496359610282,11
1067,63,14,10,5,7.2617205803599045,9
1068,75,19,81,7,7.259552889264539,12
1069,86,30,79,11,7.258463117259926,19
1070,84,33,39,14,7.257920848438738,19
1071,87,29,91,11,7.256753645120718,18
1072,98,19,84,6,7.255378652482318,13
1073,13,62,106,24,7.247428424926188,38
1074,31,14,5,5,7.246607645789562,9
1075,27,48,87,19,7.246227963622146,29
1076,114,27,40,9,7.240772461331043,18
1077,54,49,109,18,7.224017629711242,31
1078,11,30,68,12,7.21729133144909,18
1079,20,11,100,4,7.213419982652268,7
1080,53,13,38,5,7.198101634639961,8
1081,17,11,48,5,7.198036653114912,6
1082,34,19,30,7,7.196614878264563,12
1083,109,13,22,5,7.1904728762162415,8
1084,103,13,84,6,7.189748094528316,7
1085,8,58,63,24,7.184592805665557,34
1086,39,33,43,14,7.179919496295487,19
1087,18,11,62,4,7.178564522913039,7
1088,36,16,112,6,7.175574629533441,10
1089,98,41,86,17,7.171894084868247,24
1090,34,14,65,6,7.161205115873211,8
1091,29,14,37,6,7.147246302868531,8
1092,5,17,60,6,7.144002600647477,11
1093,40,50,55,19,7.142420946012768,31
1094,27,46,65,17,7.137136986841306,29
1095,67,12,107,4,7.124134838046416,8
1096,27,22,84,9,7.123178826909879,13
1097,86,81,96,31,7.122290387606644,50
1098,86,30,83,10,7.114862976089345,20
1099,45,33,7,13,7.114147641228475,20
1100,19,21,3,8,7.104960021856871,13
1101,1,10,45,4,7.100044646871245,6
1102,38,14,17,6,7.099034060595348,8
1103,34,26,8,10,7.095056358065477,16
1104,28,35,70,14,7.078735797739843,21
1105,102,14,98,6,7.075813129571894,8
1106,60,26,12,13,7.07409226676495,13
1107,98,11,12,4,7.0718761808279025,7
1108,15,27,87,11,7.071515465274775,16
1109,50,14,49,6,7.064134383315743,8
1110,99,18,36,6,7.061516094995872,12
1111,65,16,73,6,7.056062739811479,10
1112,13,37,69,14,7.049482158879249,23
1113,51,58,63,25,7.048475253320576,33
1114,55,25,97,9,7.041738062020972,16
1115,72,11,114,5,7.039741382461145,6
1116,85,24,84,8,7.039561068893882,16
1117,13,18,102,6,7.037755564548871,12
1118,37,19,27,7,7.034792767414984,12
1119,95,15,40,6,7.026458120737083,9
1120,89,14,104,6,7.025402807656734,8
1121,87,27,53,12,7.022639512769477,15
1122,63,25,38,8,7.013791456544735,17
1123,60,17,66,5,7.0134935146458295,12
1124,40,13,69,4,7.0067178601682825,9
1125,86,100,51,43,7.006490378168834,57
1126,93,26,54,9,7.002072182522706,17
1127,79,14,54,5,6.993661154009002,9
1128,62,15,5,6,6.992708759597391,9
1129,111,23,13,10,6.988942249892523,13
1130,17,20,55,9,6.987444025974705,11
1131,53,30,30,12,6.984989750265453,18
1132,18,23,97,9,6.965163575719862,14
1133,16,34,36,13,6.9623095532486845,21
1134,111,15,39,6,6.960860011711801,9
1135,85,13,88,5,6.960388600870984,8
1136,32,18,104,6,6.95922508638955,12
1137,90,20,63,8,6.95733483322538,12
1138,62,24,68,10,6.956994474454218,14
1139,4,25,51,9,6.952578906103857,16
1140,16,71,55,26,6.944141739769256,45
1141,76,12,48,4,6.943708984082041,8
1142,99,12,88,5,6.93913123202866,7
1143,87,32,57,12,6.935653097121787,20
1144,58,32,107,12,6.92586220332928,20
1145,75,19,30,8,6.923427737676235,11
1146,13,46,23,20,6.92089148086611,26
1147,100,60,51,27,6.9186188414136796,33
1148,28,17,29,7,6.905526522456791,10
1149,77,10,81,4,6.905311789108677,6
1150,58,21,68,8,6.90465268486649,13
1151,72,10,60,4,6.902146483608275,6
1152,107,14,61,6,6.900760430128648,8
1153,48,32,87,12,6.894587068096888,20
1154,76,16,88,7,6.891817282335726,9
1155,106,15,99,5,6.882359612487447,10
1156,16,40,3,15,6.869773503305488,25
1157,3,12,98,6,6.866274172778351,6
1158,60,43,4,19,6.864343045215706,24
1159,108,18,60,7,6.856532886501664,11
1160,7,99,51,37,6.849475435937799,62
1161,100,16,50,6,6.845077769092562,10
1162,34,23,87,9,6.8397794205744455,14
1163,78,14,96,5,6.830515928543477,9
1164,95,25,106,9,6.830338155584792,16
1165,68,69,31,28,6.821634358561019,41
1166,65,14,66,5,6.821265394674894,9
1167,56,13,4,6,6.816273515879696,7
1168,71,50,13,21,6.804323620324037,29
1169,28,16,49,7,6.801284823553003,9
1170,108,23,87,9,6.799580586486788,14
1171,55,10,31,4,6.798197972656263,6
1172,2,14,38,6,6.792448237787324,8
1173,34,16,39,7,6.78145072564027,9
1174,62,27,88,11,6.777372044873373,16
1175,47,41,13,16,6.770499309500956,25
1176,86,54,97,22,6.749652418711037,32
1177,94,10,71,4,6.748460655059317,6
1178,45,13,68,5,6.747691137383071,8
1179,84,26,48,10,6.7407911051084906,16
1180,18,10,29,3,6.739197778395282,7
1181,40,14,78,4,6.732885786530082,10
1182,74,38,96,14,6.731828732252355,24
1183,14,13,95,5,6.731405281187272,8
1184,90,23,50,9,6.721975923903932,14
1185,65,10,32,4,6.718474357729474,6
1186,28,35,97,13,6.716635909782017,22
1187,27,15,114,6,6.704132292345132,9
1188,83,15,74,7,6.703298030488857,8
1189,63,25,23,9,6.701335055503612,16
1190,10,18,86,8,6.698064905065153,10
1191,111,11,106,3,6.697425895741327,8
1192,12,29,13,8,6.694032199534924,21
1193,27,12,79,5,6.670700776711516,7
1194,85,20,54,7,6.664179187550933,13
1195,10,12,57,4,6.658857003244836,8
1196,54,21,72,8,6.6578696597772655,13
1197,83,11,71,5,6.656205380333864,6
1198,71,19,37,8,6.653996053488669,11
1199,32,26,5,10,6.647447060451906,16
1200,39,23,112,10,6.64553091891532,13
1201,86,38,17,17,6.641619574926921,21
1202,4,30,65,12,6.6356003955737535,18
1203,39,22,37,9,6.632156694863052,13
1204,107,32,62,15,6.627456297715231,17
1205,25,48,5,19,6.626414170343125,29
1206,74,38,46,14,6.622188071735937,24
1207,85,10,75,3,6.61929344121288,7
1208,20,21,68,9,6.619136630374984,12
1209,30,24,104,11,6.615090339536257,13
1210,102,13,17,5,6.612407855965594,8
1211,64,31,63,13,6.5953519944401675,18
1212,60,31,69,14,6.585373558105323,17
1213,78,23,8,9,6.580729341705669,14
1214,69,10,48,5,6.577798378248737,5
1215,53,26,114,11,6.571088082289226,15
1216,106,32,23,15,6.549055396089171,17
1217,28,16,12,6,6.545963713857721,10
1218,54,58,70,23,6.543056803225659,35
1219,85,13,11,5,6.5402245957157366,8
1220,91,13,80,5,6.531108694088673,8
1221,13,35,37,14,6.522302273576749,21
1222,100,25,63,11,6.506283863039737,14
1223,74,29,55,12,6.503619546467787,17
1224,90,11,102,6,6.502237322589002,5
1225,18,10,103,3,6.501498615339008,7
1226,107,46,53,18,6.492903474758714,28
1227,70,20,9,7,6.477071321597407,13
1228,89,10,55,4,6.472799854469153,6
1229,98,11,68,4,6.4699276959750645,7
1230,70,13,29,6,6.465173609286504,7
1231,87,19,112,8,6.4559707337711325,11
1232,8,20,91,8,6.453847873736644,12
1233,30,28,55,11,6.452965794551181,17
1234,6,10,28,4,6.452419128804086,6
1235,76,43,51,16,6.4523314110416905,27
1236,4,20,87,7,6.445923142452618,13
1237,69,18,94,7,6.432434124144747,11
1238,15,24,81,10,6.430856839870599,14
1239,40,16,33,5,6.427211772717694,11
1240,22,11,27,4,6.425149939635198,7
1241,96,23,80,9,6.423400971659428,14
1242,91,18,54,8,6.414686940093468,10
1243,34,17,68,7,6.413670809676438,10
1244,106,13,77,6,6.407119934187455,7
1245,80,20,37,8,6.401050818487373,12
1246,104,38,55,15,6.394473965912867,23
1247,33,13,96,7,6.392035038140808,6
1248,16,55,100,22,6.385211726765543,33
1249,57,14,43,4,6.384921697149044,10
1250,64,12,33,4,6.376020245344582,8
1251,86,32,81,10,6.369305995587273,22
1252,7,21,56,9,6.361794853449644,12
1253,64,19,43,8,6.3596171770522805,11
1254,92,13,27,6,6.356396578041118,7
1255,85,17,96,5,6.345069391274802,12
1256,62,22,40,11,6.34058891485694,11
1257,63,36,13,15,6.3369049290275825,21
1258,89,14,16,6,6.330684257071285,8
1259,33,13,23,5,6.330114552953447,8
1260,104,53,28,22,6.32950196987021,31
1261,39,23,77,10,6.318579228260865,13
1262,63,15,66,6,6.307276344392352,9
1263,11,14,94,5,6.305903525162971,9
1264,76,20,94,7,6.29880756689131,13
1265,30,24,37,9,6.294754233158861,15
1266,54,13,3,6,6.2904200663200225,7
1267,114,18,57,7,6.288629829852741,11
1268,87,40,19,16,6.287277196031127,24
1269,70,16,64,5,6.286009204558742,11
1270,12,14,43,5,6.280233018622484,9
1271,86,21,4,8,6.2794844995496994,13
1272,94,11,75,4,6.272377467555882,7
1273,20,45,5,17,6.270373633442785,28
1274,69,11,96,4,6.268969865653719,7
1275,15,12,95,5,6.265255655621163,7
1276,41,17,54,7,6.262569869973235,10
1277,65,62,88,23,6.254328556973986,39
1278,114,48,5,20,6.237633533478721,28
1279,8,31,9,15,6.234041807874366,16
1280,104,41,50,16,6.230364171354915,25
1281,16,42,91,15,6.227187272730326,27
1282,107,65,104,26,6.21771215256008,39
1283,86,90,88,36,6.216340947823593,54
1284,34,15,49,6,6.210584372576931,9
1285,35,15,84,6,6.209299301194261,9
1286,74,28,70,13,6.203999405338755,15
1287,63,28,2,12,6.200018491851485,16
1288,91,12,71,5,6.187474142289449,7
1289,107,34,3,16,6.186000566414524,18
1290,8,68,87,28,6.180726581231656,40
1291,13,47,36,18,6.167141158071529,29
1292,75,27,47,9,6.156969718274411,18
1293,100,25,88,10,6.151971338273168,15
1294,27,17,55,6,6.127925060038187,11
1295,25,35,88,12,6.123879676950231,23
1296,81,13,31,4,6.117159791325403,9
1297,72,13,77,6,6.113577824682306,7
1298,107,33,49,14,6.110518487198577,19
1299,30,40,60,14,6.109304893084949,26
1300,90,12,7,5,6.108519045195328,7
1301,10,13,87,5,6.098821416398097,8
1302,62,16,69,7,6.098141811871047,9
1303,54,11,47,5,6.095812400128514,6
1304,26,10,16,4,6.090476145744292,6
1305,111,23,107,11,6.08814286411973,12
1306,70,29,20,11,6.080511379179193,18
1307,23,27,41,11,6.068042449918637,16
1308,28,34,102,14,6.058897913934129,20
1309,39,14,14,6,6.04933667985342,8
1310,63,24,18,9,6.046455003215173,15
1311,70,15,93,6,6.04469500542117,9
1312,8,16,32,7,6.041444852098721,9
1313,7,24,98,9,6.0336860037819795,15
1314,75,31,31,14,6.033482134287373,17
1315,91,17,50,6,6.027790824025911,11
1316,95,20,46,8,6.027785407812038,12
1317,108,28,51,12,6.026136385597758,16
1318,81,36,13,14,6.025187055387207,22
1319,80,33,55,15,6.024950901743931,18
1320,98,24,37,10,6.023716027404386,14
1321,103,17,17,6,6.022913063656272,11
1322,76,21,60,7,6.002005566797061,14
1323,37,19,100,7,6.000890669706824,12
1324,30,26,88,12,5.999646200227325,14
1325,47,25,27,10,5.997680483822351,15
1326,102,18,88,6,5.993430232263083,12
1327,114,25,31,11,5.991876520395493,14
1328,49,29,60,12,5.990966249711065,17
1329,64,20,18,8,5.974775055211904,12
1330,102,21,87,8,5.971447061156249,13
1331,16,33,76,16,5.9691351545969855,17
1332,97,18,40,7,5.966918416140386,11
1333,68,52,53,21,5.964244334939563,31
1334,97,12,10,6,5.950831581917705,6
1335,65,37,29,16,5.950290217119017,21
1336,28,15,53,6,5.9457443646332715,9
1337,74,10,43,5,5.941779824004124,5
1338,57,15,40,6,5.936628176580016,9
1339,8,18,33,7,5.930528749487397,11
1340,30,51,107,21,5.930518845397113,30
1341,73,20,114,8,5.924435121305103,12
1342,109,27,55,13,5.923431655873009,14
1343,75,14,93,6,5.923243043930715,8
1344,78,40,16,16,5.92176468058651,24
1345,78,22,7,10,5.919551023484503,12
1346,93,10,63,4,5.9175632502755855,6
1347,41,15,45,5,5.9144627061547626,10
1348,84,27,57,13,5.910397185802947,14
1349,28,21,62,9,5.90793740164937,12
1350,62,10,38,4,5.9059609927975885,6
1351,75,59,107,20,5.896729059645907,39
1352,54,12,103,4,5.896465334872947,8
1353,101,15,68,5,5.8919398867497925,10
1354,74,34,84,16,5.891399521581718,18
1355,17,16,43,7,5.888801333071096,9
1356,65,48,20,18,5.88795471662986,30
1357,16,64,27,26,5.8869430441728525,38
1358,46,12,36,5,5.882094180819339,7
1359,97,27,68,11,5.880460614845399,16
1360,15,29,3,12,5.880092462301209,17
1361,28,12,31,5,5.87633787823225,7
1362,87,35,41,14,5.866006255304425,21
1363,62,17,9,7,5.86600144742425,10
1364,54,36,95,16,5.865979569344106,20
1365,28,21,19,8,5.865946411400911,13
1366,34,17,7,7,5.863504951401833,10
1367,7,20,112,8,5.8633899504874805,12
1368,55,61,65,26,5.858765777581566,35
1369,108,10,65,5,5.847992745343311,5
1370,23,28,76,12,5.8473918820519435,16
1371,103,12,43,6,5.842083830723205,6
1372,76,18,29,9,5.840323373706845,9
1373,41,13,78,5,5.835829243326791,8
1374,28,17,94,6,5.821481138029022,11
1375,40,16,5,7,5.820527251695649,9
1376,79,13,20,5,5.810117746469002,8
1377,16,52,37,22,5.806896201742738,30
1378,8,19,98,7,5.806615359942183,12
1379,10,11,106,3,5.8036728949329275,8
1380,91,19,31,7,5.801858258461766,12
1381,98,26,63,11,5.795644107915217,15
1382,78,29,60,13,5.785028437429672,16
1383,16,19,93,9,5.776545074834794,10
1384,11,23,98,10,5.7667243230281455,13
1385,58,13,53,7,5.756559382638666,6
1386,23,13,47,5,5.755142063292807,8
1387,36,12,77,5,5.751140829309578,7
1388,19,11,80,4,5.749943576584892,7
1389,41,19,19,7,5.745349966804544,12
1390,78,10,81,5,5.742474614478736,5
1391,40,50,39,20,5.739978674185262,30
1392,25,42,106,16,5.73768822242091,26
1393,3,22,43,8,5.7361846191153125,14
1394,34,11,38,4,5.733514369563806,7
1395,104,30,100,12,5.731738576312734,18
1396,13,48,25,22,5.729332953997915,26
1397,45,14,9,5,5.727853500458987,9
1398,25,26,51,11,5.72613511284895,15
1399,98,13,17,6,5.723425305113809,7
1400,41,18,37,7,5.716493275276269,11
1401,68,18,109,6,5.704488776223907,12
1402,74,22,109,8,5.703058853572775,14
1403,60,23,96,7,5.703006464112349,16
1404,53,17,62,7,5.701449545318567,10
1405,17,14,77,6,5.701107401476805,8
1406,70,10,32,5,5.692479372096213,5
1407,106,46,5,18,5.689619439430471,28
1408,35,21,40,8,5.6891402135768585,13
1409,28,37,9,17,5.685359581946875,20
1410,102,10,95,4,5.685319962340818,6
1411,104,47,51,17,5.68324932849397,30
1412,94,10,25,5,5.671887186214519,5
1413,75,39,37,14,5.670197882049105,25
1414,16,31,99,13,5.665818337043021,18
1415,54,11,82,4,5.664278302313932,7
1416,13,69,87,27,5.65894904240386,42
1417,20,44,16,16,5.653886889078911,28
1418,9,13,61,5,5.652969843590383,8
1419,78,16,98,7,5.650561601828994,9
1420,4,10,97,4,5.649870700339136,6
1421,39,13,97,5,5.649731064357227,8
1422,73,23,74,9,5.649045009007229,14
1423,107,38,43,15,5.64566627030258,23
1424,49,26,19,11,5.644904762300495,15
1425,75,43,9,17,5.6326941278183265,26
1426,16,41,43,16,5.630997414458815,25
1427,114,44,13,21,5.63006565787977,23
1428,84,17,19,7,5.627096636659109,10
1429,86,28,73,13,5.62531345595925,15
1430,5,21,17,7,5.625033929201379,14
1431,19,10,5,4,5.623378775596127,6
1432,9,24,84,10,5.622843694169622,14
1433,95,26,50,11,5.619957219349123,15
1434,68,26,91,12,5.61946637277209,14
1435,28,29,76,13,5.615688910158878,16
1436,30,14,90,6,5.614315415339312,8
1437,62,12,64,6,5.60460737576113,6
1438,12,20,49,6,5.604208901352286,14
1439,70,17,98,6,5.604121247592221,11
1440,85,18,68,6,5.5998206712944,12
1441,20,38,96,15,5.591064360306499,23
1442,12,27,3,10,5.5890712494486445,17
1443,89,13,53,6,5.5817208357882135,7
1444,14,14,88,6,5.580858903619985,8
1445,85,15,16,5,5.578536673206573,10
1446,20,22,44,9,5.576158683247874,13
1447,7,23,38,10,5.57543888103377,13
1448,31,10,95,4,5.5581891593402775,6
1449,13,30,95,13,5.556983808516705,17
1450,46,11,4,5,5.55622187464566,6
1451,107,61,20,26,5.555959949322172,35
1452,69,16,54,7,5.552096999235811,9
1453,78,11,77,4,5.550391664202253,7
1454,8,41,25,16,5.550067480025434,25
1455,36,53,31,23,5.548564460468652,30
1456,29,16,23,7,5.547160957253139,9
1457,25,18,84,7,5.5466876181289715,11
1458,20,22,2,9,5.544865436021075,13
1459,40,23,27,12,5.543091094529359,11
1460,41,27,69,9,5.540528561994146,18
1461,64,21,23,9,5.538877575953661,12
1462,100,20,76,9,5.5369678710761505,11
1463,33,14,102,6,5.525239013163607,8
1464,28,33,7,13,5.522079859732702,20
1465,62,10,20,4,5.517288163699186,6
1466,87,59,37,24,5.516733087496062,35
1467,95,19,83,7,5.510188596504647,12
1468,32,13,109,6,5.5080518973086185,7
1469,2,13,40,5,5.504797437287729,8
1470,44,15,64,6,5.503275136525506,9
1471,67,10,102,4,5.49724656177184,6
1472,114,23,70,9,5.484820175107314,14
1473,100,22,25,10,5.476003695191372,12
1474,63,14,61,5,5.475415218119487,9
1475,31,13,74,5,5.468299370651384,8
1476,5,31,51,11,5.465657211287606,20
1477,77,15,29,5,5.460561068340718,10
1478,89,15,88,7,5.460084177073363,8
1479,27,45,88,20,5.457295690251734,25
1480,71,14,76,7,5.456476326439047,7
1481,75,43,71,16,5.454468163058883,27
1482,97,18,57,8,5.45235309786646,10
1483,71,29,68,11,5.435653336862236,18
1484,100,30,27,14,5.4349503933724215,16
1485,104,33,63,14,5.422500590286895,19
1486,104,38,25,17,5.422383455319629,21
1487,4,11,58,4,5.405037105567146,7
1488,84,10,64,3,5.401793074305331,7
1489,100,20,41,8,5.4006229693860375,12
1490,94,19,54,8,5.400351319426252,11
1491,39,64,49,25,5.398875884855632,39
1492,54,31,90,13,5.397442007333916,18
1493,8,42,46,19,5.386306766386785,23
1494,3,12,94,5,5.374899428324899,7
1495,78,37,57,16,5.362952301819457,21
1496,75,30,63,13,5.362343223381901,17
1497,7,35,97,16,5.356987360153851,19
1498,81,15,65,6,5.355649781765623,9
1499,55,46,60,20,5.354179807158424,26
1500,7,19,62,8,5.339510147514967,11
1501,80,27,87,11,5.3384780527270195,16
1502,97,14,102,5,5.335160623731844,9
1503,87,52,50,23,5.330518704603511,29
1504,85,10,47,3,5.309476383215226,7
1505,107,19,66,8,5.307859110353934,11
1506,111,25,55,10,5.307717141421055,15
1507,16,103,65,43,5.302520370455434,60
1508,9,17,100,6,5.299356832075297,11
1509,16,64,68,24,5.298199798122404,40
1510,107,60,55,26,5.2964565535310575,34
1511,99,21,86,8,5.291638236148403,13
1512,64,14,47,5,5.28922493224529,9
1513,14,19,28,7,5.288795345484194,12
1514,56,11,88,5,5.280224334897691,6
1515,54,54,51,23,5.2789455838300325,31
1516,28,11,92,4,5.26619903758234,7
1517,86,55,75,25,5.26427494208678,30
1518,13,31,78,13,5.257129710025226,18
1519,80,16,39,7,5.2570004697562105,9
1520,35,11,31,5,5.255104723881263,6
1521,34,15,67,8,5.254716330627796,7
1522,114,15,94,7,5.246364560187277,8
1523,25,26,40,11,5.242222631716463,15
1524,41,24,3,8,5.240784980656733,16
1525,98,15,40,7,5.239271076053035,8
1526,52,14,16,6,5.238731564661996,8
1527,91,21,25,9,5.236778929543691,12
1528,9,12,23,5,5.231512665759894,7
1529,72,19,27,9,5.23109384542835,10
1530,104,24,3,10,5.226681542928665,14
1531,35,11,5,5,5.226534281744142,6
1532,13,16,103,6,5.226276270144916,10
1533,92,23,39,11,5.22393109782644,12
1534,54,54,106,25,5.222938310920249,29
1535,53,29,112,14,5.221677411254142,15
1536,40,22,37,10,5.2189812618502875,12
1537,20,18,76,9,5.218902337593747,9
1538,87,16,33,7,5.217430381961776,9
1539,33,12,91,6,5.213867650447791,6
1540,6,10,39,4,5.213256916387499,6
1541,55,37,54,17,5.207989269972247,20
1542,16,36,53,14,5.201094174764711,22
1543,46,25,39,13,5.196853389468722,12
1544,104,18,80,8,5.194103195079234,10
1545,40,13,113,5,5.193726392686624,8
1546,6,10,71,4,5.193692278292729,6
1547,75,17,97,7,5.183439015487436,10
1548,65,29,96,13,5.165027076154164,16
1549,114,20,96,8,5.164351476040407,12
1550,91,11,56,5,5.1601828143932735,6
1551,98,13,93,6,5.160023067123591,7
1552,67,12,5,5,5.159840528973067,7
1553,35,16,28,8,5.153123660542302,8
1554,76,28,50,10,5.151966096130058,18
1555,65,25,76,9,5.1515232217494615,16
1556,106,24,9,10,5.150083731218861,14
1557,104,80,65,35,5.149580826756093,45
1558,7,36,3,14,5.146402582002664,22
1559,49,20,9,9,5.1413088393621935,11
1560,43,34,65,16,5.140817317652902,18
1561,64,18,11,6,5.138351351638366,12
1562,36,21,3,8,5.136055944816986,13
1563,40,30,58,14,5.133397385337812,16
1564,62,17,60,8,5.128886027579174,9
1565,16,26,108,10,5.12442298142606,16
1566,51,72,65,29,5.113978349982022,43
1567,75,18,4,7,5.112428644465592,11
1568,23,30,68,14,5.1118494914616495,16
1569,64,39,86,17,5.108639671077766,22
1570,16,98,87,42,5.1081952355588705,56
1571,30,10,1,4,5.107240382060611,6
1572,9,30,54,13,5.106575143785501,17
1573,55,23,70,10,5.1032220329288345,13
1574,28,13,108,6,5.102919930198642,7
1575,53,25,104,11,5.0942603831986055,14
1576,90,23,65,11,5.084911236528136,12
1577,32,10,20,3,5.082163415292109,7
1578,90,13,33,5,5.072843762888294,8
1579,46,17,65,6,5.066104910854949,11
1580,41,10,61,4,5.060781095904467,6
1581,7,16,10,7,5.060407065651958,9
1582,28,13,27,4,5.05119454239968,9
1583,95,20,75,8,5.050260152484931,12
1584,63,15,85,7,5.044437930195333,8
1585,37,61,104,25,5.041376355525095,36
1586,41,16,29,7,5.03947465681018,9
1587,65,12,52,4,5.0369958566437525,8
1588,56,10,39,5,5.034025368749221,5
1589,17,13,19,5,5.032470600341316,8
1590,20,24,41,11,5.031440077185285,13
1591,13,49,64,23,5.026699897179315,26
1592,27,26,12,12,5.009793169061331,14
1593,72,17,17,7,5.00861905737698,10
1594,74,12,41,6,5.00781552916323,6
1595,93,26,5,10,5.004460526821323,16
1596,7,41,106,20,5.003800212982272,21
1597,74,15,71,7,4.993812181109021,8
1598,50,23,31,10,4.99199978599778,13
1599,64,36,65,16,4.9878415407735135,20
1600,80,10,44,5,4.9735414138069105,5
1601,40,49,107,19,4.964616090179718,30
1602,109,16,38,6,4.964461961570972,10
1603,96,23,90,9,4.963939687748078,14
1604,76,44,107,16,4.963511886446058,28
1605,51,21,96,9,4.962296641036038,12
1606,57,29,39,13,4.961767987225669,16
1607,16,103,7,45,4.951928398872167,58
1608,56,19,68,9,4.94813216675333,10
1609,76,14,18,6,4.948055179076069,8
1610,80,29,106,12,4.946009667025365,17
1611,51,15,6,6,4.9453303449739225,9
1612,39,23,81,9,4.943832581007466,14
1613,93,27,28,10,4.941127481170006,17
1614,49,11,71,5,4.940945789460408,6
1615,16,21,14,9,4.935526105012941,12
1616,114,22,9,7,4.931319071415342,15
1617,86,40,36,17,4.927433251240005,23
1618,74,56,106,24,4.924754963776778,32
1619,8,24,27,10,4.910406785021338,14
1620,54,12,108,4,4.909695920764135,8
1621,38,12,28,6,4.907164394244691,6
1622,23,14,104,5,4.897799558060741,9
1623,23,16,77,7,4.892331871891681,9
1624,75,47,51,21,4.890410363576286,26
1625,69,11,95,4,4.882909765417961,7
1626,19,19,57,8,4.879015154385094,11
1627,88,26,57,12,4.870812248870149,14
1628,29,11,1,4,4.86693457558879,7
1629,37,54,106,25,4.865641247327302,29
1630,5,10,89,3,4.86246564090175,7
1631,87,45,20,20,4.861780392772673,25
1632,52,12,107,4,4.861262849981809,8
1633,41,22,77,9,4.8601605532983365,13
1634,60,10,79,4,4.860077671823909,6
1635,27,31,15,14,4.856566063952165,17
1636,97,12,32,5,4.851459349576839,7
1637,39,17,83,7,4.845386042652696,10
1638,69,35,86,15,4.843108927419926,20
1639,83,20,64,9,4.840996077098241,11
1640,18,41,75,18,4.835583954062303,23
1641,8,15,67,6,4.831909846155583,9
1642,41,13,90,6,4.828201040811693,7
1643,65,47,9,19,4.826128695703039,28
1644,31,19,25,9,4.823839301099763,10
1645,14,15,54,5,4.820525855929132,10
1646,78,14,43,6,4.81850744055393,8
1647,8,19,3,10,4.813422384940693,9
1648,74,11,85,5,4.812388004493803,6
1649,6,12,106,5,4.810944704219048,7
1650,2,25,106,11,4.808494527305082,14
1651,54,34,68,14,4.806816214683671,20
1652,96,13,108,6,4.805162668071275,7
1653,75,44,88,18,4.804702938088107,26
1654,16,11,56,4,4.8021414027227,7
1655,75,22,96,7,4.801381492311931,15
1656,68,16,6,6,4.799676836342988,10
1657,111,11,25,5,4.797175922879397,6
1658,110,10,63,4,4.7955032342523225,6
1659,52,13,20,5,4.795236183864801,8
1660,9,17,1,9,4.794059502939978,8
1661,97,24,76,11,4.789197045000655,13
1662,76,33,5,14,4.788314400539968,19
1663,16,49,50,21,4.784924998830744,28
1664,86,57,104,25,4.778923035703435,32
1665,9,12,5,5,4.777710715122403,7
1666,11,31,20,12,4.776863569942599,19
1667,9,10,37,4,4.7723167368365935,6
1668,90,13,70,6,4.771084444295362,7
1669,12,15,31,7,4.770632464521183,8
1670,55,16,94,7,4.767452995148861,9
1671,55,12,79,5,4.763372141256469,7
1672,39,41,3,19,4.762739501109139,22
1673,19,30,68,12,4.759028599089826,18
1674,64,31,41,12,4.758473174288668,19
1675,93,16,50,6,4.755526241513054,10
1676,100,50,86,24,4.754450885173926,26
1677,90,30,5,12,4.752640516818983,18
1678,25,16,77,7,4.745845616411638,9
1679,107,25,47,11,4.7386499699721325,14
1680,87,103,107,44,4.73493153024252,59
1681,6,11,46,5,4.730994669309113,6
1682,15,14,75,5,4.729161606780822,9
1683,103,19,19,8,4.7260806188367415,11
1684,76,14,3,6,4.72601812571826,8
1685,47,20,86,8,4.725074652339407,12
1686,13,39,54,16,4.7242954885094095,23
1687,28,37,18,17,4.710953949587104,20
1688,37,46,63,19,4.710297957233593,27
1689,20,23,46,8,4.708713070266485,15
1690,13,34,1,13,4.702199298952772,21
1691,62,12,84,5,4.699556310812965,7
1692,86,60,46,23,4.689511214815467,37
1693,97,10,62,4,4.689387738532959,6
1694,71,16,5,7,4.686451238703377,9
1695,51,50,84,21,4.6822268584961195,29
1696,77,22,18,8,4.676567510317278,14
1697,16,35,84,15,4.661500226777163,20
1698,1,16,94,8,4.659339262334037,8
1699,25,15,47,7,4.655390231832646,8
1700,63,62,54,26,4.652017262215903,36
1701,57,22,102,10,4.651745927719438,12
1702,63,39,96,15,4.649023449526137,24
1703,81,19,69,9,4.644298837979568,10
1704,19,11,79,5,4.6432369038804095,6
1705,6,21,16,10,4.642825718029857,11
1706,73,14,13,6,4.642713338622983,8
1707,48,13,25,6,4.64169889765536,7
1708,73,19,109,8,4.637139105733967,11
1709,60,22,25,10,4.636282806493916,12
1710,106,15,110,7,4.633960085739299,8
1711,51,15,92,7,4.630319337525281,8
1712,114,46,68,20,4.626031537231749,26
1713,75,54,16,24,4.621070484571049,30
1714,107,52,23,23,4.6165132710939725,29
1715,72,10,40,4,4.6161082317709115,6
1716,30,14,108,6,4.615023887291243,8
1717,37,72,86,32,4.607837359690983,40
1718,38,15,18,7,4.6074157564111795,8
1719,88,10,66,4,4.60434245546846,6
1720,77,13,95,6,4.60149322445291,7
1721,7,98,88,43,4.595427152926361,55
1722,50,32,96,14,4.592653394244439,18
1723,39,30,38,13,4.587052274166916,17
1724,28,25,71,10,4.584215619303489,15
1725,99,16,65,7,4.579704538683142,9
1726,14,21,87,8,4.577898041687361,13
1727,7,23,58,11,4.575034525669344,12
1728,99,14,95,6,4.572737764013027,8
1729,11,25,41,9,4.570786215270399,16
1730,99,16,104,8,4.5627492392393,8
1731,102,20,51,9,4.560982621023824,11
1732,43,18,5,8,4.5592775438308895,10
1733,54,22,49,10,4.559262424288581,12
1734,70,15,23,7,4.554568026577778,8
1735,83,15,46,7,4.551826612706301,8
1736,99,18,15,7,4.551461310618723,11
1737,7,22,46,8,4.54597004790708,14
1738,28,16,85,7,4.545964613502572,9
1739,9,14,29,6,4.534452930887614,8
1740,106,23,75,11,4.532198108241345,12
1741,50,71,28,30,4.530365152854881,41
1742,88,12,67,4,4.530239274992248,8
1743,13,18,48,8,4.529838045170983,10
1744,74,23,50,10,4.520207268757788,13
1745,37,43,55,20,4.516821858156878,23
1746,80,10,69,5,4.508733977407145,5
1747,19,26,94,11,4.508541436381081,15
1748,87,24,97,9,4.5078366784517385,15
1749,7,22,50,10,4.50127067949432,12
1750,76,12,69,4,4.499300236532236,8
1751,93,15,37,6,4.493445665639034,9
1752,65,50,40,22,4.488092661947342,28
1753,11,21,102,10,4.481690077928582,11
1754,7,46,64,21,4.481240056988839,25
1755,100,29,7,12,4.479542671667203,17
1756,56,12,8,5,4.475636615156396,7
1757,95,33,107,15,4.475609109265348,18
1758,40,15,109,6,4.473863564525377,9
1759,100,45,13,19,4.473846856296724,26
1760,96,31,25,14,4.4728328775528,17
1761,13,36,8,15,4.469899391018221,21
1762,11,75,86,33,4.469304506132978,42
1763,91,10,57,5,4.468260927215541,5
1764,37,18,32,8,4.466542082918521,10
1765,3,15,50,7,4.464463620895282,8
1766,49,12,43,5,4.460909191235434,7
1767,64,25,8,10,4.455975265271213,15
1768,77,11,97,4,4.4549011553839994,7
1769,50,12,73,4,4.454782630059153,8
1770,95,44,16,20,4.453378575583387,24
1771,6,12,12,6,4.448996636056325,6
1772,95,15,109,6,4.444131433700797,9
1773,108,17,27,7,4.430289870166569,10
1774,23,14,20,6,4.42777867543601,8
1775,99,30,13,13,4.420966828834258,17
1776,7,64,53,28,4.416213736910661,36
1777,55,48,11,19,4.407143063823051,29
1778,34,16,76,8,4.406030161353482,8
1779,71,14,108,6,4.402422140240549,8
1780,62,26,65,12,4.393261785254975,14
1781,111,20,86,8,4.3910837466552355,12
1782,8,39,104,17,4.3875779798665295,22
1783,99,10,54,4,4.3797228746123675,6
1784,87,33,25,15,4.379098196808542,18
1785,55,24,9,10,4.371040618945099,14
1786,55,13,58,6,4.369004483506264,7
1787,40,23,23,10,4.368423326803309,13
1788,74,15,9,6,4.367415226980942,9
1789,95,20,23,9,4.3618962627692595,11
1790,77,12,12,5,4.361353303952199,7
1791,64,31,71,12,4.35947313780117,19
1792,19,11,83,5,4.3593981927010494,6
1793,68,24,49,10,4.355442333586806,14
1794,28,30,48,13,4.353346769104992,17
1795,11,21,35,9,4.351832206058097,12
1796,29,16,34,7,4.350698487191081,9
1797,65,16,6,7,4.346168811124812,9
1798,70,29,65,11,4.343984179663613,18
1799,34,20,48,9,4.343261719849951,11
1800,103,27,16,12,4.342154551822593,15
1801,60,12,22,5,4.334241842742782,7
1802,95,19,41,8,4.332143979792177,11
1803,64,14,81,6,4.322376324615616,8
1804,4,22,40,10,4.316643149060896,12
1805,70,14,71,7,4.315612188206775,7
1806,100,15,98,7,4.314873946898566,8
1807,104,27,98,14,4.313899934387766,13
1808,97,23,17,10,4.3134285513049555,13
1809,31,10,8,4,4.309099443279478,6
1810,50,10,52,5,4.308197298973349,5
1811,94,15,60,6,4.306950975679676,9
1812,30,32,68,15,4.304758571720152,17
1813,100,16,69,7,4.302668928460353,9
1814,106,27,53,13,4.302319600135898,14
1815,75,18,84,8,4.30081159040195,10
1816,25,28,54,12,4.300413553073274,16
1817,13,12,35,5,4.29516454019383,7
1818,91,30,107,12,4.264126621091653,18
1819,51,15,38,6,4.261652425824847,9
1820,13,31,77,13,4.26043013198907,18
1821,6,10,72,5,4.248570153213718,5
1822,106,14,34,7,4.243674039664675,7
1823,16,44,71,18,4.241804878716306,26
1824,109,10,47,4,4.236742850593238,6
1825,23,12,48,5,4.227938531173128,7
1826,47,28,88,13,4.227250764813229,15
1827,71,11,44,5,4.223524348839462,6
1828,51,36,109,13,4.22123810593763,23
1829,4,19,18,8,4.220670692754494,11
1830,87,21,31,10,4.220659397575877,11
1831,17,20,63,9,4.217095300732271,11
1832,60,28,81,12,4.212467831654196,16
1833,90,28,87,12,4.209781806456323,16
1834,65,56,36,24,4.205692860728479,32
1835,55,22,4,10,4.20328253931047,12
1836,63,18,79,7,4.202891326670182,11
1837,15,11,40,5,4.201647176656486,6
1838,9,14,57,6,4.20121561808404,8
1839,108,18,74,7,4.201041319943183,11
1840,13,96,51,44,4.1900110692020185,52
1841,13,70,40,31,4.18989591600041,39
1842,23,27,25,12,4.182190113226028,15
1843,43,33,7,13,4.178253566474209,20
1844,83,40,5,19,4.163709904424501,21
1845,65,27,3,11,4.160831843058934,16
1846,16,21,45,8,4.159967695863456,13
1847,28,60,84,26,4.150279635735803,34
1848,99,12,17,5,4.14837583337694,7
1849,43,14,68,6,4.147550463856525,8
1850,84,18,76,8,4.146116027740745,10
1851,20,13,73,5,4.146065391689569,8
1852,100,12,95,6,4.142851413596655,6
1853,53,47,71,20,4.141303557057986,27
1854,77,18,88,8,4.138723345512823,10
1855,71,11,20,4,4.13643055739397,7
1856,7,51,27,23,4.136091254496649,28
1857,28,27,100,11,4.132400320500453,16
1858,112,16,94,6,4.1306598471384035,10
1859,45,22,65,11,4.1259231703887,11
1860,16,44,62,17,4.1185619817851284,27
1861,3,21,57,9,4.117819968250673,12
1862,7,12,2,5,4.115660194227726,7
1863,69,27,68,12,4.109870966876623,15
1864,97,30,63,13,4.107378727934806,17
1865,93,14,109,6,4.103558953267082,8
1866,83,20,93,9,4.100880722204593,11
1867,20,24,35,10,4.098728722002914,14
1868,47,24,68,10,4.095710109800673,14
1869,104,33,54,15,4.09448807738149,18
1870,112,11,79,5,4.092088872238905,6
1871,68,13,48,6,4.089226837234984,7
1872,17,51,51,24,4.088673144397257,27
1873,36,11,19,5,4.088590218421688,6
1874,72,17,87,8,4.084226461372783,9
1875,16,42,17,16,4.080437647415331,26
1876,86,117,5,51,4.074944655375778,66
1877,7,68,31,30,4.069172309295859,38
1878,77,11,69,5,4.068890242116286,6
1879,20,12,38,4,4.067291998076464,8
1880,43,10,95,4,4.063398320607949,6
1881,14,10,20,4,4.051966837258039,6
1882,32,10,40,5,4.050021677419869,5
1883,23,43,88,17,4.047882049914368,26
1884,71,25,51,11,4.043275219347798,14
1885,98,26,76,11,4.039201436166646,15
1886,1,10,43,5,4.038976715758721,5
1887,104,10,10,5,4.031221485043642,5
1888,71,13,47,6,4.030916530509353,7
1889,7,31,47,13,4.025431088719289,18
1890,39,21,96,8,4.016816457185763,13
1891,39,49,53,21,4.016611432547999,28
1892,8,20,110,8,4.013172679497404,12
1893,66,12,31,5,4.008754872558654,7
1894,30,33,71,15,4.006253796204616,18
1895,16,111,107,44,4.005718802977025,67
1896,31,16,112,6,4.001730552260451,10
1897,16,124,51,56,3.996412569683251,68
1898,23,18,12,8,3.9935881563943543,10
1899,89,13,68,6,3.99200348329726,7
1900,60,18,97,9,3.9792005525226366,9
1901,50,21,109,9,3.977542968777512,12
1902,96,12,14,5,3.975747798085754,7
1903,74,24,93,11,3.9601017688790825,13
1904,6,11,40,5,3.9442678680230823,6
1905,80,10,97,4,3.9365866928471034,6
1906,97,35,16,16,3.9340820840887147,19
1907,12,10,58,4,3.9326217642135903,6
1908,30,23,77,10,3.931781102600119,13
1909,57,11,50,4,3.9290278222481443,7
1910,102,12,83,5,3.925479234058231,7
1911,85,15,20,7,3.9254254916442872,8
1912,5,28,2,12,3.923277825320168,16
1913,37,38,70,16,3.9227382855891664,22
1914,89,13,86,7,3.91749283769541,6
1915,12,11,15,5,3.9125883634426843,6
1916,64,11,90,5,3.90210878186129,6
1917,102,26,37,11,3.9015784283610255,15
1918,102,15,91,7,3.9012134006248127,8
1919,55,30,63,14,3.9003771949657002,16
1920,11,19,3,7,3.897505299435775,12
1921,28,23,57,10,3.897117570901977,13
1922,3,18,18,7,3.886785760617755,11
1923,28,27,17,12,3.885054779321747,15
1924,41,33,104,16,3.881745214521683,17
1925,1,23,54,10,3.8802733242992375,13
1926,72,14,49,6,3.8721720183356294,8
1927,8,33,100,14,3.8636022669254433,19
1928,74,41,63,19,3.86350929161903,22
1929,16,47,49,20,3.856038619160952,27
1930,100,29,19,13,3.845091941013316,16
1931,18,23,31,11,3.843025830767866,12
1932,20,26,7,12,3.839940256500117,14
1933,9,47,86,20,3.838091076290299,27
1934,38,13,46,5,3.833859769343221,8
1935,7,44,55,18,3.8332053851440007,26
1936,43,13,8,6,3.832590073745516,7
1937,91,26,13,12,3.831748260733109,14
1938,76,18,27,8,3.831112831762447,10
1939,85,14,51,7,3.8310675840112247,7
1940,70,30,51,14,3.8297117807076555,16
1941,17,31,39,13,3.827602699322767,18
1942,4,11,3,5,3.825046392091852,6
1943,5,28,91,11,3.8146250930665166,17
1944,110,16,5,7,3.8138584796050923,9
1945,7,10,93,5,3.7802315490169653,5
1946,104,13,92,7,3.7768187223532306,6
1947,63,19,4,8,3.775833657808686,11
1948,3,50,51,25,3.7726881330184416,25
1949,54,15,112,6,3.7699268328571702,9
1950,100,23,112,11,3.761865576918162,12
1951,13,74,55,33,3.75428432745548,41
1952,41,21,76,11,3.7501063090537037,10
1953,35,17,43,8,3.749011557971225,9
1954,103,16,79,7,3.7466875459262345,9
1955,16,83,8,36,3.7444025012578703,47
1956,53,42,40,19,3.7429391558119995,23
1957,15,31,7,16,3.741081293807926,15
1958,49,21,15,10,3.7409051763658248,11
1959,63,40,114,15,3.7382776415303285,25
1960,46,52,54,23,3.7381660486484787,29
1961,1,13,4,5,3.736039087851971,8
1962,86,65,25,30,3.735239092039536,35
1963,78,18,29,8,3.734515840907333,10
1964,112,13,11,6,3.733612834435543,7
1965,89,14,60,7,3.7237634526579124,7
1966,20,64,54,31,3.7237387131550506,33
1967,114,16,81,8,3.722693092477205,8
1968,8,55,11,24,3.718020959441049,31
1969,109,22,34,10,3.716622994018828,12
1970,11,42,88,18,3.7150827621608284,24
1971,15,21,5,8,3.714734226349825,13
1972,64,14,57,6,3.7114490151468567,8
1973,65,16,14,8,3.7073397651844364,8
1974,20,12,27,5,3.7014596968026496,7
1975,107,35,38,15,3.6995303509541118,20
1976,23,19,28,9,3.6970356039584393,10
1977,86,14,61,6,3.691831205405497,8
1978,17,13,15,5,3.6900193228115175,8
1979,34,19,55,9,3.680955248563573,10
1980,69,15,39,7,3.6806323347127163,8
1981,41,21,109,8,3.680627728838233,13
1982,16,28,79,12,3.6774259843300885,16
1983,86,66,39,31,3.67568860716317,35
1984,107,13,72,6,3.6746684377826218,7
1985,19,22,69,10,3.669724343060301,12
1986,3,16,77,8,3.6659660860802825,8
1987,39,24,31,10,3.6610558433956157,14
1988,79,13,88,5,3.6585136161817045,8
1989,90,10,71,5,3.6561036030201253,5
1990,107,21,32,10,3.6546977761524686,11
1991,55,20,77,9,3.6546881978963213,11
1992,109,15,9,8,3.6538651478462696,7
1993,17,11,18,6,3.651905683853181,5
1994,14,10,70,5,3.647042134114848,5
1995,20,52,28,23,3.6380228467997373,29
1996,1,28,51,13,3.6289700363449016,15
1997,43,19,18,10,3.6267699505365183,9
1998,69,23,28,11,3.6258297557751513,12
1999,80,26,28,12,3.6230809501897743,14
2000,19,10,58,4,3.6124257412316716,6
2001,16,25,38,9,3.6053098096509713,16
2002,29,31,107,11,3.604834531178086,20
2003,91,19,18,8,3.601007419787661,11
2004,62,12,102,5,3.595762799461338,7
2005,17,12,30,6,3.5949084621895344,6
2006,39,39,27,16,3.5923412859879735,23
2007,97,10,95,4,3.58943247133478,6
2008,58,19,39,8,3.589328168519788,11
2009,61,16,60,8,3.58082656290379,8
2010,15,34,68,14,3.5726065457182266,20
2011,39,13,33,6,3.5715142758716403,7
2012,6,28,7,15,3.5631855242339143,13
2013,79,13,108,5,3.562523700236059,8
2014,17,28,34,13,3.5624042820823494,15
2015,107,41,64,19,3.561300386963443,22
2016,11,36,54,16,3.5608789843396806,20
2017,13,64,46,27,3.5585855949926106,37
2018,28,19,36,9,3.5549996153541237,10
2019,30,13,4,6,3.554167963462701,7
2020,53,49,65,23,3.552341058928982,26
2021,100,61,107,30,3.549064244668762,31
2022,28,58,65,25,3.546718886958019,33
2023,13,31,19,13,3.544087166327379,18
2024,51,46,46,20,3.5405198677265273,26
2025,40,65,36,28,3.5400829247343655,37
2026,44,15,7,7,3.5352660207554516,8
2027,93,17,25,8,3.5300397889756283,9
2028,41,44,68,20,3.511991254144042,24
2029,13,87,107,40,3.5079765133359704,47
2030,29,18,30,7,3.5059621650422814,11
2031,49,10,33,4,3.5057518320537766,6
2032,74,16,23,7,3.505315761927058,9
2033,2,43,50,19,3.505217309368565,24
2034,25,27,109,12,3.504136926234727,15
2035,37,13,108,6,3.501919723771849,7
2036,50,26,9,11,3.4989626487903873,15
2037,97,36,114,16,3.4948097299506915,20
2038,86,115,87,55,3.4941427411544543,60
2039,29,14,69,7,3.491662637102011,7
2040,62,13,36,6,3.489528327052378,7
2041,36,30,51,14,3.4874600225025074,16
2042,94,12,109,6,3.4867912538143684,6
2043,88,64,68,28,3.486456108196302,36
2044,25,20,70,9,3.484518115943736,11
2045,60,41,114,22,3.4828028477548303,19
2046,55,16,18,8,3.4810467173744706,8
2047,96,57,54,28,3.4766133859583515,29
2048,71,28,87,13,3.475925837741299,15
2049,78,19,3,9,3.4704949105077305,10
2050,74,60,5,28,3.469996146708342,32
2051,83,31,8,15,3.465429893631149,16
2052,76,21,102,9,3.4648438438781985,12
2053,85,12,12,5,3.4594510759016344,7
2054,106,49,51,22,3.457607975311814,27
2055,33,23,5,11,3.454327509177194,12
2056,41,54,107,22,3.453178235519935,32
2057,37,21,23,10,3.453043705748743,11
2058,112,14,114,7,3.4529529803290635,7
2059,64,38,39,17,3.4500975704028978,21
2060,88,54,9,24,3.4493718580292745,30
2061,95,37,87,17,3.4486313771107997,20
2062,76,28,55,11,3.4438952481653065,17
2063,15,24,54,12,3.443630034544425,12
2064,60,58,40,26,3.4423663485116363,32
2065,87,33,49,16,3.428632483324912,17
2066,4,12,37,5,3.421871703775507,7
2067,11,12,97,6,3.419346386793516,6
2068,17,11,36,6,3.4172736451567545,5
2069,100,24,78,11,3.417029837437705,13
2070,60,11,57,5,3.4072939043921795,6
2071,27,49,51,21,3.406135874269831,28
2072,97,34,65,15,3.4017573029180164,19
2073,55,29,84,13,3.40123055779696,16
2074,43,28,88,12,3.39798547482041,16
2075,4,13,28,6,3.3940824912486867,7
2076,55,50,5,22,3.393419962444802,28
2077,73,10,104,4,3.391491099464731,6
2078,16,29,47,13,3.3912047504321565,16
2079,15,22,104,10,3.3895949828269205,12
2080,39,53,60,25,3.3874441110800544,28
2081,86,32,62,15,3.385910817077394,17
2082,65,29,69,13,3.385901307322931,16
2083,36,28,55,13,3.383336577257353,15
2084,73,15,98,7,3.380055365181917,8
2085,16,21,2,9,3.377651000783529,12
2086,27,44,86,18,3.3766892599716636,26
2087,109,23,102,10,3.367967756914995,13
2088,40,17,20,7,3.3649339637959645,10
2089,54,25,97,12,3.3648153427656755,13
2090,14,23,8,10,3.3634201583462158,13
2091,14,17,106,7,3.360059412826609,10
2092,86,13,113,5,3.3593996912401924,8
2093,88,30,70,13,3.3524090493184278,17
2094,55,15,98,6,3.3523199117731797,9
2095,83,10,20,5,3.3478898251644025,5
2096,39,20,48,8,3.347307920822049,12
2097,40,15,91,7,3.345577169162442,8
2098,54,20,98,9,3.3414082574982986,11
2099,68,13,5,6,3.3380294056441144,7
2100,13,19,62,9,3.333452628124705,10
2101,41,19,50,8,3.331657114556134,11
2102,58,15,3,6,3.3231437575395413,9
2103,98,14,97,7,3.3185319117606187,7
2104,102,12,34,5,3.318489320511487,7
2105,30,21,18,10,3.316712750453976,11
2106,97,16,84,6,3.316428205809935,10
2107,60,31,75,14,3.3139158628036856,17
2108,30,31,54,14,3.3088577106148045,17
2109,114,21,64,9,3.3046667254482847,12
2110,47,13,61,6,3.3043540506366424,7
2111,104,60,5,28,3.3007473735225052,32
2112,100,20,74,9,3.2929107546249483,11
2113,55,15,35,7,3.289902790162483,8
2114,90,25,60,10,3.288918313106561,15
2115,28,16,78,8,3.28700424949784,8
2116,108,10,38,4,3.2810871215401916,6
2117,34,23,84,11,3.279863737698051,12
2118,60,49,86,22,3.275471722293173,27
2119,114,13,67,6,3.2746706512348434,7
2120,88,53,104,23,3.2729157493477135,30
2121,28,56,54,25,3.2622780281799852,31
2122,18,56,53,26,3.2615252410170665,30
2123,12,24,86,11,3.2584506314544455,13
2124,7,24,74,9,3.257493143792888,15
2125,23,13,30,6,3.256114933007727,7
2126,114,47,25,20,3.2540864225169766,27
2127,7,19,30,10,3.2523104824501634,9
2128,23,12,81,5,3.240703587077002,7
2129,99,25,60,11,3.2381944591027096,14
2130,9,18,34,8,3.2368917561941424,10
2131,107,49,36,23,3.234838704648264,26
2132,80,14,68,6,3.230403837276107,8
2133,23,55,7,25,3.2229283053761675,30
2134,55,39,28,16,3.2184704312839787,23
2135,17,16,74,7,3.211770551027832,9
2136,50,19,97,8,3.210625734622642,11
2137,60,47,31,24,3.2094707274879264,23
2138,69,13,85,6,3.2091051872353304,7
2139,56,12,97,6,3.2085312435870676,6
2140,106,28,17,11,3.2039846830051117,17
2141,7,93,86,40,3.2025353891099297,53
2142,36,41,39,18,3.1998605067578225,23
2143,16,125,86,55,3.1954608826555724,70
2144,88,61,5,29,3.1946532218196624,32
2145,37,54,50,26,3.188335276013606,28
2146,54,31,114,15,3.1847921316014234,16
2147,29,23,27,9,3.17938876042449,14
2148,74,12,30,6,3.175828716417199,6
2149,52,10,12,5,3.1755936810484164,5
2150,13,57,27,26,3.1745225043291074,31
2151,106,25,60,10,3.171261503808182,15
2152,11,16,80,7,3.1711610880303405,9
2153,88,30,69,13,3.1706028089799125,17
2154,90,14,74,5,3.1680613510289204,9
2155,109,11,100,6,3.167660006953098,5
2156,43,27,19,12,3.1633742717174034,15
2157,86,37,112,16,3.163089684403836,21
2158,12,13,8,5,3.1620537691518766,8
2159,100,31,15,14,3.161220459105416,17
2160,86,21,82,9,3.1586560919846263,12
2161,104,51,7,23,3.158219418007504,28
2162,34,27,86,13,3.157950328589333,14
2163,20,23,109,9,3.152758187798739,14
2164,46,15,64,7,3.152048322397266,8
2165,19,22,65,10,3.1497530272597927,12
2166,30,32,19,15,3.1496092684371804,17
2167,75,23,23,12,3.1487336010920157,11
2168,112,12,45,6,3.1460936650177542,6
2169,23,48,65,23,3.1380450881841524,25
2170,76,15,2,6,3.1350168634931235,9
2171,15,17,63,8,3.121837205681444,9
2172,36,11,80,5,3.115857421175661,6
2173,25,25,17,11,3.1106502600539105,14
2174,50,24,4,12,3.110559237136959,12
2175,107,48,9,23,3.108544215551862,25
2176,43,10,72,5,3.1071314487034227,5
2177,87,40,84,18,3.1041578272455412,22
2178,92,15,60,6,3.101629065738582,9
2179,74,13,27,7,3.1002755903304404,6
2180,99,14,68,6,3.1001036150844663,8
2181,88,16,74,6,3.100015176246556,10
2182,64,10,91,4,3.0993479020870796,6
2183,8,48,51,22,3.0985900488092186,26
2184,6,17,27,8,3.094787186521294,9
2185,78,18,12,7,3.0931576694218523,11
2186,114,38,51,19,3.089797874684742,19
2187,107,59,37,27,3.0878586600356255,32
2188,45,14,87,6,3.0862202973256596,8
2189,75,30,25,13,3.069551733540898,17
2190,72,14,8,7,3.068653290400982,7
2191,39,45,54,21,3.06832776501454,24
2192,87,78,65,35,3.0670515598637706,43
2193,87,65,88,32,3.0659618360137912,33
2194,71,18,25,8,3.0644100067848146,10
2195,71,42,86,20,3.060669361739169,22
2196,38,13,96,6,3.0422152322461717,7
2197,2,10,61,4,3.0398710397259006,6
2198,25,39,65,16,3.0368934823131175,23
2199,27,12,99,6,3.0280763102634354,6
2200,23,12,102,6,3.026398853405979,6
2201,29,22,15,10,3.0200823684900446,12
2202,51,57,60,23,3.013114139998441,34
2203,100,12,85,6,3.008504371195627,6
2204,20,47,37,22,3.004985214474966,25
2205,96,14,34,6,3.0017630147825622,8
2206,4,11,69,5,2.999484176661719,6
2207,41,20,43,9,2.989275902448813,11
2208,80,15,48,6,2.985401033694241,9
2209,46,13,1,7,2.97710684527845,6
2210,84,36,106,18,2.9754739608250116,18
2211,36,32,4,13,2.9739066740354185,19
2212,2,21,37,10,2.9697580112694486,11
2213,47,11,53,5,2.9672181618537916,6
2214,87,29,69,12,2.9671312776586296,17
2215,25,18,57,8,2.964934950553875,10
2216,80,19,7,8,2.963591688050413,11
2217,114,23,46,10,2.9631435316072405,13
2218,11,17,29,8,2.9579294594394727,9
2219,80,16,8,8,2.9519293865537115,8
2220,18,37,87,16,2.947620136311876,21
2221,18,20,65,10,2.9468351166959534,10
2222,71,18,46,9,2.944852774193542,9
2223,103,16,51,7,2.943759235264632,9
2224,72,10,9,5,2.940516873871124,5
2225,36,20,87,8,2.935573250897663,12
2226,33,21,28,11,2.9340033560517895,10
2227,9,12,66,6,2.9315079085260156,6
2228,74,82,86,39,2.921287780715151,43
2229,102,19,106,10,2.9207255392565097,9
2230,37,10,33,4,2.9157377490462175,6
2231,62,27,71,13,2.9154628309711708,14
2232,25,12,108,5,2.9132670669268244,7
2233,86,100,28,44,2.9116733038896876,56
2234,57,39,15,18,2.90944440730932,21
2235,27,26,43,12,2.9051148604445527,14
2236,91,19,37,9,2.9050960547005245,10
2237,88,33,18,16,2.9003137586881174,17
2238,88,73,107,32,2.899770757279351,41
2239,44,10,70,5,2.8975248911261433,5
2240,75,24,74,10,2.8903655619324433,14
2241,100,14,34,7,2.888360425828719,7
2242,15,16,20,7,2.8857490776615986,9
2243,49,20,63,9,2.8831531570492124,11
2244,83,23,87,11,2.8800534941463094,12
2245,57,12,53,6,2.8739584447786424,6
2246,112,14,1,5,2.872325056767924,9
2247,88,10,17,6,2.869337502995377,4
2248,79,15,51,8,2.8685343243710677,7
2249,46,23,63,12,2.867241869896345,11
2250,72,14,88,6,2.8660882603566415,8
2251,41,39,27,17,2.865990068176837,22
2252,16,20,35,8,2.858432847566858,12
2253,62,15,11,7,2.85616533210433,8
2254,51,18,99,9,2.853477797374065,9
2255,73,16,96,7,2.8534303980093814,9
2256,47,11,19,5,2.8500725977528405,6
2257,97,13,33,6,2.8486496222061595,7
2258,28,13,44,7,2.8461398630992765,6
2259,51,27,43,13,2.845756036190168,14
2260,8,25,102,12,2.8455510764088037,13
2261,46,24,76,11,2.8453201116747953,13
2262,39,59,65,29,2.843397973105762,30
2263,95,33,39,15,2.841495525954098,18
2264,107,51,106,24,2.8408623146416327,27
2265,104,33,74,14,2.8329598216365466,19
2266,53,23,81,10,2.832269045840245,13
2267,75,21,112,9,2.824219405034075,12
2268,54,18,62,8,2.824080555827827,10
2269,18,13,71,6,2.821320109059578,7
2270,39,12,98,5,2.8139572577793732,7
2271,16,32,80,14,2.812380168004336,18
2272,1,32,36,16,2.8095303452930684,16
2273,99,15,41,7,2.8081672918617278,8
2274,65,85,107,39,2.8064984710190863,46
2275,106,14,112,7,2.805082024542767,7
2276,30,24,76,10,2.8011387863133463,14
2277,68,14,44,7,2.7953277213928303,7
2278,7,26,1,12,2.7932054952385035,14
2279,100,13,36,6,2.7923934619121087,7
2280,29,20,86,9,2.7920636814195925,11
2281,70,12,102,7,2.7906887378625402,5
2282,9,15,97,8,2.7891659901703596,7
2283,43,19,104,10,2.7871607244902616,9
2284,63,20,43,9,2.786559914173097,11
2285,28,31,91,14,2.785819668061851,17
2286,86,87,84,43,2.7811330297923607,44
2287,55,15,78,6,2.7795066806067297,9
2288,5,11,10,6,2.7716738654503197,5
2289,5,17,77,8,2.765837567194589,9
2290,63,92,86,39,2.762468874862493,53
2291,30,18,38,7,2.7615561749512523,11
2292,108,10,15,4,2.7564503223458745,6
2293,39,50,55,22,2.7557845118576987,28
2294,97,34,96,17,2.7556888339056806,17
2295,70,14,43,6,2.753352748891417,8
2296,112,12,8,6,2.740736306324458,6
2297,97,22,104,11,2.7396377781056174,11
2298,99,12,63,6,2.7377253409939364,6
2299,47,21,63,11,2.7370968886641944,10
2300,65,50,106,23,2.735321183024918,27
2301,75,12,34,6,2.7327928404854553,6
2302,44,16,88,8,2.7255415222047024,8
2303,55,53,88,22,2.721264805593774,31
2304,104,31,70,14,2.720810924975006,17
2305,95,11,80,5,2.7197438471090796,6
2306,49,16,70,8,2.713121422106841,8
2307,43,39,60,18,2.711882588615369,21
2308,11,24,60,11,2.710378409505632,13
2309,77,19,87,9,2.7097429007992058,10
2310,39,11,79,4,2.7039365709334446,7
2311,69,22,43,10,2.7028033480639135,12
2312,11,14,114,7,2.6963511699419747,7
2313,65,40,71,17,2.686780335165667,23
2314,8,25,48,11,2.6857985301597798,14
2315,43,15,37,8,2.682935315305951,7
2316,43,14,58,6,2.6806335210316137,8
2317,39,25,5,12,2.679132217269287,13
2318,25,17,44,8,2.673535476281759,9
2319,13,118,7,55,2.670897317194474,63
2320,97,26,46,12,2.665342497244282,14
2321,87,60,54,26,2.6650322993001607,34
2322,74,13,91,6,2.658254293210725,7
2323,86,83,8,41,2.6562990548559324,42
2324,92,29,88,13,2.6541256559252315,16
2325,57,13,36,5,2.6531160901053807,8
2326,104,69,16,31,2.6531110726496303,38
2327,34,23,27,11,2.6487847783195737,12
2328,69,11,17,5,2.645948260940654,6
2329,16,60,5,25,2.6435184456824317,35
2330,88,17,6,8,2.6434018871915526,9
2331,33,14,95,6,2.641545389608455,8
2332,110,13,54,6,2.63588490299345,7
2333,57,30,51,14,2.6325183911561103,16
2334,91,36,86,17,2.627461430980282,19
2335,39,42,28,20,2.6233394077803616,22
2336,34,29,16,13,2.621113610918131,16
2337,39,10,89,4,2.6189716831037586,6
2338,7,107,68,49,2.615642976840099,58
2339,75,28,64,13,2.6143964254367047,15
2340,75,15,108,7,2.6118802978166835,8
2341,40,29,1,13,2.608102727316189,16
2342,72,10,66,5,2.6022001256645595,5
2343,85,25,107,12,2.601380149286502,13
2344,36,23,91,10,2.600483205457648,13
2345,1,10,109,5,2.5929606771402254,5
2346,86,33,18,14,2.5923706641316473,19
2347,15,31,107,12,2.5879532445853206,19
2348,62,10,47,4,2.5775304802735826,6
2349,63,42,11,17,2.575959327519446,25
2350,21,10,65,4,2.5701476719258265,6
2351,13,74,60,32,2.5700272960349406,42
2352,43,17,71,9,2.56680210005246,8
2353,60,74,16,34,2.56546611434673,40
2354,19,25,60,13,2.5645143463204794,12
2355,86,14,14,7,2.5565201304900333,7
2356,7,21,11,9,2.554018943860651,12
2357,73,19,1,8,2.55342910039073,11
2358,44,14,76,6,2.5504141931433355,8
2359,7,74,36,34,2.5493587507973596,40
2360,63,25,60,11,2.5472563824704055,14
2361,60,35,8,17,2.536424306703015,18
2362,111,11,60,4,2.535604443502029,7
2363,23,37,87,16,2.533099907466406,21
2364,20,20,95,9,2.532527406942274,11
2365,7,29,17,13,2.532089441361392,16
2366,44,15,107,7,2.530544567099409,8
2367,99,19,30,8,2.530388293684779,11
2368,36,33,9,15,2.5279240780374668,18
2369,39,18,4,8,2.5267698999647226,10
2370,14,17,11,7,2.5264878637219237,10
2371,80,34,54,17,2.5244394841569355,17
2372,39,10,61,4,2.5176494400362808,6
2373,12,15,36,7,2.516319942513749,8
2374,76,12,90,5,2.508314572835214,7
2375,15,35,86,16,2.50310189862504,19
2376,37,18,109,8,2.501013404341532,10
2377,18,11,111,5,2.4899108726358863,6
2378,65,51,12,25,2.489865508879533,26
2379,76,15,62,7,2.4840168024368525,8
2380,11,22,19,9,2.481429305610072,13
2381,108,10,3,4,2.4778360631352716,6
2382,17,20,20,9,2.47595507024807,11
2383,28,45,51,22,2.470041612361475,23
2384,29,17,94,8,2.468897671136356,9
2385,4,17,81,7,2.4678124777063273,10
2386,74,17,69,9,2.4664972820824542,8
2387,35,23,7,11,2.4646463019795064,12
2388,17,17,1,8,2.462761073509877,9
2389,102,32,25,15,2.4608896969250456,17
2390,110,17,86,8,2.45971246028376,9
2391,85,31,86,14,2.454611381980919,17
2392,97,12,3,5,2.446105897661354,7
2393,32,10,50,6,2.444054190716271,4
2394,41,21,112,10,2.4417078305364495,11
2395,96,31,88,15,2.4406464912019903,16
2396,27,34,49,15,2.4393050039169886,19
2397,55,39,106,17,2.438139246666604,22
2398,14,19,51,7,2.4338441230915158,12
2399,91,20,75,13,2.432369433261267,7
2400,1,35,88,17,2.425177290772468,18
2401,78,15,72,6,2.424013213948672,9
2402,109,11,99,5,2.4195174025010595,6
2403,107,46,25,22,2.4187485647838765,24
2404,15,43,39,18,2.418382000362182,25
2405,60,28,28,15,2.4122250218340917,13
2406,65,11,92,5,2.4112859752548714,6
2407,8,33,93,16,2.4111455321691304,17
2408,65,79,41,34,2.4080580159017066,45
2409,106,13,66,5,2.4075033563299866,8
2410,9,18,69,8,2.405000245398061,10
2411,20,26,80,12,2.4033351571638564,14
2412,87,42,60,21,2.401272498860581,21
2413,114,15,98,7,2.3992721750256902,8
2414,46,38,28,16,2.3990178798165633,22
2415,78,22,54,10,2.3960681894605504,12
2416,114,34,39,17,2.3958348089760833,17
2417,111,12,8,6,2.390343846489095,6
2418,104,40,95,18,2.3890342183876085,22
2419,4,21,71,8,2.3871750117365993,13
2420,96,25,104,11,2.3866419839158346,14
2421,75,13,56,5,2.3840139649043497,8
2422,78,11,79,5,2.3765297335861715,6
2423,71,40,107,17,2.3760609676092463,23
2424,16,31,29,15,2.3747726163132454,16
2425,107,18,79,9,2.369737766723554,9
2426,25,32,63,16,2.3688265373602615,16
2427,40,24,50,10,2.3671440474550507,14
2428,49,13,97,5,2.366826181424206,8
2429,99,23,5,11,2.3616219022642833,12
2430,64,44,88,19,2.3590830036125556,25
2431,100,14,97,6,2.3583259709010775,8
2432,96,14,109,6,2.3566759619593642,8
2433,99,12,33,5,2.354570382478157,7
2434,4,36,31,15,2.3535355966794667,21
2435,87,19,58,9,2.349067339134257,10
2436,57,15,20,7,2.3477112943024236,8
2437,114,12,38,6,2.341526377437994,6
2438,6,13,50,6,2.3414923323310646,7
2439,11,16,34,8,2.3341210419053553,8
2440,90,19,17,10,2.330539928781357,9
2441,25,28,53,14,2.3301510854690854,14
2442,109,51,5,25,2.3285813949081655,26
2443,50,23,64,11,2.3285304422785047,12
2444,64,19,100,8,2.3242856391883238,11
2445,104,21,102,11,2.320627297470276,10
2446,88,32,91,15,2.315767764685104,17
2447,71,31,63,14,2.311262987331465,17
2448,57,23,37,11,2.3105129908375908,12
2449,109,18,48,9,2.306624480190798,9
2450,65,23,102,9,2.306006618937971,14
2451,58,12,50,6,2.3033767529431137,6
2452,16,38,48,18,2.301212431291267,20
2453,60,26,95,12,2.300035058084817,14
2454,86,21,32,10,2.2989864902239003,11
2455,38,14,80,6,2.2985101722041987,8
2456,9,15,81,7,2.2974062849528156,8
2457,100,24,5,11,2.2932427434044684,13
2458,9,20,38,9,2.2929951308054597,11
2459,106,13,4,7,2.287883468044352,6
2460,28,14,15,7,2.2866447045365526,7
2461,112,16,72,7,2.2820100055775443,9
2462,38,10,81,5,2.2819621266449914,5
2463,48,19,65,10,2.2816603054261093,9
2464,9,47,40,21,2.2806450266015683,26
2465,28,24,30,12,2.27424472642601,12
2466,30,11,81,5,2.2701194832900793,6
2467,61,10,31,5,2.2696136748473603,5
2468,76,22,39,9,2.268229299099674,13
2469,16,105,13,47,2.2678537228667803,58
2470,28,66,96,31,2.267406944603933,35
2471,85,12,7,5,2.2672729351147445,7
2472,94,10,50,4,2.2653355679184144,6
2473,106,45,88,19,2.2639858690375614,26
2474,87,62,106,30,2.2622041017840115,32
2475,95,30,25,14,2.25397314365567,16
2476,8,17,29,9,2.251936716192377,8
2477,63,11,83,4,2.2518527555221,7
2478,88,38,4,18,2.2459217004175493,20
2479,70,10,27,5,2.243263258457552,5
2480,19,17,20,8,2.242877425050817,9
2481,86,23,93,11,2.237724496402237,12
2482,68,13,102,6,2.2364570689473298,7
2483,27,12,38,5,2.2347959364398204,7
2484,4,26,114,13,2.234564836857367,13
2485,18,14,20,6,2.2334528603958916,8
2486,90,16,25,7,2.2261576936837058,9
2487,75,43,39,22,2.2252173665323527,21
2488,88,11,33,6,2.22422094342155,5
2489,84,10,15,5,2.223805292340999,5
2490,98,13,99,7,2.2212581677933785,6
2491,18,14,98,8,2.221147797140808,6
2492,93,12,51,6,2.2166321429168523,6
2493,30,19,48,8,2.2143909610782866,11
2494,5,50,96,22,2.2114271922507607,28
2495,60,63,88,28,2.2053487740970454,35
2496,49,21,8,9,2.200409925453829,12
2497,7,75,40,33,2.1957521283064803,42
2498,41,33,40,16,2.1935807772699496,17
2499,31,10,54,5,2.186668926147148,5
2500,8,64,74,28,2.186622040651489,36
2501,27,13,1,5,2.1856131991088623,8
2502,63,26,70,12,2.1813121472430437,14
2503,12,20,87,9,2.17918051466374,11
2504,84,16,93,8,2.173203038685072,8
2505,60,27,15,13,2.1718601667841333,14
2506,23,13,53,6,2.1639220781507627,7
2507,6,14,86,6,2.158350497876564,8
2508,111,49,68,24,2.156897460223202,25
2509,27,23,75,11,2.1476101427875363,12
2510,94,33,87,16,2.145346807231599,17
2511,80,14,64,7,2.1424879291036816,7
2512,55,11,69,5,2.141856565606557,6
2513,71,39,39,18,2.140211900940766,21
2514,102,22,74,10,2.1384304011801047,12
2515,29,15,103,6,2.1268509003999077,9
2516,37,26,84,12,2.124049904647881,14
2517,7,62,9,31,2.12190310948229,31
2518,53,11,70,5,2.117480208536356,6
2519,1,20,64,10,2.1164326209593654,10
2520,7,17,72,8,2.1143024060967655,9
2521,74,12,33,6,2.113811361820999,6
2522,49,10,103,5,2.112716842069853,5
2523,69,11,25,5,2.1120597510852464,6
2524,108,32,107,15,2.1055805043927105,17
2525,86,33,38,15,2.105415418702344,18
2526,76,34,87,15,2.1038909411850133,19
2527,84,18,79,9,2.0988599029371873,9
2528,49,18,64,9,2.0966931160090687,9
2529,83,34,55,17,2.0962093979720215,17
2530,97,22,8,11,2.094799206270941,11
2531,17,12,91,5,2.0932516032559634,7
2532,100,18,17,7,2.0905637214372956,11
2533,40,18,11,9,2.089442100461012,9
2534,64,43,68,18,2.086424402801588,25
2535,44,14,51,5,2.084874228955972,9
2536,74,47,65,23,2.0847963525870914,24
2537,49,22,65,10,2.0830665646343474,12
2538,82,10,63,5,2.077975861296688,5
2539,41,14,103,6,2.076284884491566,8
2540,13,27,112,14,2.0668149404635896,13
2541,109,29,84,13,2.061335008909019,16
2542,86,45,90,20,2.0574221764428238,25
2543,65,36,111,16,2.0553404376319313,20
2544,65,31,80,15,2.0509198465423397,16
2545,93,21,88,9,2.047097578055209,12
2546,62,14,55,7,2.0465381035309016,7
2547,8,55,65,26,2.0395157801522825,29
2548,68,27,38,12,2.039399077627948,15
2549,50,51,107,25,2.036952672125099,26
2550,40,59,88,27,2.0357313010299647,32
2551,83,13,50,7,2.034563553464953,6
2552,104,21,17,10,2.0345116655508866,11
2553,91,14,114,7,2.0312426341433967,7
2554,60,29,9,12,2.026686622824744,17
2555,32,11,13,5,2.026181507027534,6
2556,18,32,60,15,2.0244266182620256,17
2557,19,16,77,8,2.0216404335755893,8
2558,114,27,17,11,2.0211590753648707,16
2559,8,37,90,16,2.0194647820717804,21
2560,93,11,60,4,2.018629631632218,7
2561,49,15,29,7,2.0167142898536246,8
2562,69,14,37,7,2.015512849900141,7
2563,30,28,8,13,2.0154533572428948,15
2564,68,29,70,14,2.0151181581046385,15
2565,16,53,23,25,2.013807360415177,28
2566,83,22,97,12,2.007636873207567,10
2567,109,15,49,7,2.005068879120546,8
2568,68,26,46,12,2.0015169846627185,14
2569,75,32,87,15,2.0004298974911783,17
2570,114,26,74,13,1.9975972531686872,13
2571,104,15,112,7,1.99393597279257,8
2572,60,20,38,10,1.990189103737265,10
2573,54,31,102,15,1.988972508393918,16
2574,53,19,4,9,1.987694792892671,10
2575,28,38,25,16,1.9833898911599184,22
2576,51,11,89,5,1.9808331837442865,6
2577,109,11,62,4,1.976950135615491,7
2578,95,28,53,11,1.9769373995573185,17
2579,16,49,70,22,1.9664047334731982,27
2580,57,22,46,10,1.9631857780739914,12
2581,50,11,35,5,1.9581460146246747,6
2582,78,12,71,6,1.95458083263832,6
2583,77,22,4,10,1.951917908415357,12
2584,3,12,93,7,1.9498563082125624,5
2585,36,34,64,17,1.9485056781764598,17
2586,7,15,48,8,1.9478692265013036,7
2587,29,13,43,6,1.9447083330041282,7
2588,100,21,55,11,1.9434302154951335,10
2589,25,20,55,9,1.9429576796619945,11
2590,112,14,69,7,1.9415067419167833,7
2591,23,14,31,6,1.9392936999416424,8
2592,110,13,104,5,1.9388474450810558,8
2593,71,49,7,25,1.9387153694352777,24
2594,32,10,98,5,1.9380052263831626,5
2595,30,31,51,14,1.9376385589176917,17
2596,17,11,80,4,1.9331063026674833,7
2597,23,14,97,7,1.9330528734436567,7
2598,68,101,13,47,1.9297155210568622,54
2599,70,19,40,8,1.9276789997691202,11
2600,17,28,54,14,1.9259736473512523,14
2601,16,89,28,41,1.923978729516393,48
2602,114,21,18,10,1.923577249757446,11
2603,63,40,50,18,1.9230864117365438,22
2604,9,10,79,4,1.9224211679655938,6
2605,53,43,64,20,1.921457820047301,23
2606,99,11,76,6,1.9173589523208343,5
2607,97,32,106,16,1.9159665785715099,16
2608,110,11,17,5,1.9155371371930665,6
2609,27,18,50,7,1.9151594458607022,11
2610,107,29,69,14,1.9118248714259234,15
2611,68,38,1,18,1.9099752765436664,20
2612,51,28,23,13,1.9066169824504657,15
2613,104,13,12,6,1.9063017472195452,7
2614,8,67,28,31,1.9053784571291423,36
2615,86,40,78,19,1.9016040417460842,21
2616,55,27,99,12,1.8950724021518552,15
2617,20,35,106,16,1.890590591428699,19
2618,25,23,64,11,1.8857238852847684,12
2619,17,28,49,15,1.8850836144226455,13
2620,2,41,8,20,1.8848654476169697,21
2621,8,14,79,8,1.8787453444383122,6
2622,104,64,13,30,1.8742619730677343,34
2623,46,19,41,8,1.8674922785348607,11
2624,37,95,5,46,1.8654288703425719,49
2625,43,21,114,11,1.8643335671695769,10
2626,85,11,112,5,1.861901124722568,6
2627,49,30,7,13,1.8540125722797836,17
2628,53,22,97,10,1.849246682219108,12
2629,72,33,16,15,1.8444268023508046,18
2630,114,30,20,14,1.8395405662544742,16
2631,84,38,96,19,1.8356486827006797,19
2632,34,16,79,7,1.834523635596938,9
2633,62,30,87,14,1.829195534406874,16
2634,74,29,13,14,1.8278354237299064,15
2635,106,11,3,5,1.8270221877820192,6
2636,44,13,114,6,1.8263733365516701,7
2637,64,16,108,8,1.8224151605655865,8
2638,102,13,99,6,1.8212893413036875,7
2639,71,11,109,5,1.8196417828202216,6
2640,48,16,55,7,1.8175056975255015,9
2641,49,20,77,8,1.814545880475325,12
2642,40,18,111,9,1.8104998545748818,9
2643,13,28,72,14,1.8072183165070745,14
2644,36,22,25,11,1.8071440138268557,11
2645,30,24,69,12,1.8065594670571052,12
2646,41,28,1,12,1.8063913789876538,16
2647,51,34,31,14,1.8036645224364214,20
2648,18,32,41,16,1.8004819942826358,16
2649,19,24,86,12,1.7978104253850666,12
2650,100,33,30,14,1.796033128267335,19
2651,63,48,39,19,1.7909082037503425,29
2652,87,16,6,8,1.786303676475521,8
2653,37,25,90,12,1.7816453937181782,13
2654,23,21,100,9,1.7758002431044067,12
2655,89,11,65,5,1.7733881874637512,6
2656,33,14,11,8,1.768399073594802,6
2657,79,12,65,6,1.7650136214787935,6
2658,88,11,110,6,1.7642228121429866,5
2659,79,12,29,7,1.7612891428274893,5
2660,8,56,96,26,1.7581112090346542,30
2661,84,26,70,12,1.7530345342228948,14
2662,7,17,29,10,1.7467705733456507,7
2663,51,19,112,9,1.744621447758818,10
2664,41,72,13,35,1.7434827447987475,37
2665,60,33,36,16,1.7416473627060747,17
2666,18,11,6,5,1.7414584600944751,6
2667,36,37,88,16,1.7392851936744347,21
2668,54,97,65,46,1.736712846037994,51
2669,41,18,94,8,1.7349354911168107,10
2670,106,38,96,17,1.7318320126651918,21
2671,70,19,75,10,1.7314858975507377,9
2672,32,13,68,5,1.731166259808923,8
2673,63,15,45,7,1.7260545689947924,8
2674,106,21,30,10,1.7186910974442093,11
2675,78,19,88,9,1.714522543273063,10
2676,50,20,34,9,1.7118812894704334,11
2677,54,40,7,19,1.7088310244062668,21
2678,48,10,37,5,1.7035937503192145,5
2679,23,44,86,21,1.7030841833116428,23
2680,20,16,102,8,1.6989391239814933,8
2681,36,15,23,9,1.6972875274185721,6
2682,51,14,58,7,1.6936471630550665,7
2683,28,64,5,31,1.6933141899778523,33
2684,68,34,106,16,1.687950689096679,18
2685,47,29,51,15,1.6857225925039412,14
2686,77,11,11,5,1.6811370630932267,6
2687,45,28,31,13,1.6710870406691087,15
2688,11,17,79,9,1.6671266405555225,8
2689,9,41,39,21,1.6651416477270053,20
2690,85,16,17,7,1.6640468368595829,9
2691,37,47,74,23,1.6628163329711263,24
2692,88,56,28,26,1.6526017973059584,30
2693,36,23,68,11,1.6511686348202657,12
2694,15,16,78,8,1.6428031530867078,8
2695,12,13,38,6,1.6373364390809897,7
2696,39,67,13,31,1.632021300847581,36
2697,39,40,104,19,1.6269347944157977,21
2698,44,17,87,8,1.6239279411647842,9
2699,68,18,57,9,1.6190755944848347,9
2700,81,19,18,9,1.6163568658399623,10
2701,94,10,18,5,1.6001116131573032,5
2702,14,11,75,5,1.5947210222856318,6
2703,107,113,86,53,1.5928381105330334,60
2704,2,15,25,8,1.5845186001024008,7
2705,107,22,81,10,1.581698926790109,12
2706,55,22,90,12,1.578656952498874,10
2707,60,25,46,12,1.5735893742532674,13
2708,102,31,114,14,1.5708261870205509,17
2709,3,34,60,16,1.5692504603231587,18
2710,9,14,111,7,1.5621342613374551,7
2711,109,26,106,13,1.562107287891286,13
2712,47,18,41,9,1.5600411821999534,9
2713,104,23,83,10,1.5563880557352996,13
2714,75,44,55,19,1.5547955200380577,25
2715,51,51,41,24,1.5522887413176722,27
2716,35,15,30,7,1.5514803658178273,8
2717,87,41,74,19,1.54873499555014,22
2718,34,36,107,16,1.542968748431823,20
2719,103,12,69,6,1.5372644106543811,6
2720,13,23,45,11,1.536281477648622,12
2721,100,28,12,14,1.5326474539590187,14
2722,9,16,30,7,1.5322802404962022,9
2723,29,13,53,5,1.5317670028644748,8
2724,114,20,84,9,1.5282826629009798,11
2725,27,18,23,9,1.5258397874765746,9
2726,83,26,65,13,1.5253499649391113,13
2727,35,14,37,7,1.523131742310598,7
2728,48,10,41,5,1.515490885657423,5
2729,46,12,55,5,1.5148590180899557,7
2730,98,29,107,14,1.499083976212842,15
2731,25,18,43,7,1.4984580698640848,11
2732,9,34,63,16,1.4983458266579124,18
2733,46,52,5,24,1.4974094901037487,28
2734,53,13,100,6,1.4886628314229116,7
2735,49,18,62,8,1.4871791055161696,10
2736,60,74,71,35,1.4843115108657077,39
2737,68,10,84,4,1.478899377350919,6
2738,15,33,65,15,1.4785502956952628,18
2739,73,15,63,8,1.4760785674332926,7
2740,72,17,15,9,1.4754546744739183,8
2741,20,23,55,11,1.4733693688994074,12
2742,11,17,32,9,1.4729852723414754,8
2743,6,13,69,7,1.4672562795661186,6
2744,8,86,55,44,1.466914256590843,42
2745,71,24,3,11,1.4668209780059585,13
2746,87,48,96,22,1.4629434595612125,26
2747,23,13,43,6,1.4628793390447163,7
2748,40,64,51,31,1.4624658901194145,33
2749,31,21,47,10,1.4606130980712668,11
2750,25,23,83,10,1.4597201880554966,13
2751,8,16,38,8,1.4562520429495758,8
2752,50,16,89,7,1.4560158637801317,9
2753,53,30,55,14,1.4538038424746393,16
2754,46,62,88,31,1.4519317579443412,31
2755,106,55,63,27,1.4485566818099482,28
2756,65,22,47,11,1.444494672794184,11
2757,20,21,97,11,1.439527960881874,10
2758,50,28,25,14,1.4391705454909012,14
2759,34,10,114,4,1.4351304706118748,6
2760,109,23,76,12,1.431479784095354,11
2761,70,56,86,26,1.42921805361145,30
2762,36,35,45,19,1.423273124508123,16
2763,71,23,55,12,1.4219584840110406,11
2764,1,11,53,5,1.4196819324858228,6
2765,12,16,40,8,1.4120822666164417,8
2766,12,20,71,10,1.4059148964814159,10
2767,46,25,9,13,1.4052752923291358,12
2768,112,18,19,8,1.4017639667638642,10
2769,70,17,95,9,1.4011695857654913,8
2770,75,12,44,5,1.399837377533035,7
2771,88,19,12,9,1.3954007588930366,10
2772,91,13,9,6,1.3946381880594532,7
2773,29,36,87,16,1.3938596381681103,20
2774,106,27,100,12,1.3901554212918024,15
2775,23,17,3,8,1.386787433063704,9
2776,36,11,29,6,1.3837445576600587,5
2777,3,24,29,11,1.3836924057967053,13
2778,95,31,7,14,1.3809406634768675,17
2779,106,30,41,15,1.3806292559177733,15
2780,11,30,51,15,1.3791878722705608,15
2781,86,66,55,31,1.371489773467497,35
2782,75,10,48,5,1.3711471542080278,5
2783,30,30,27,15,1.3682494404417145,15
2784,25,26,30,14,1.363384718034577,12
2785,112,12,74,6,1.3616749140437374,6
2786,107,39,70,20,1.3599998705907188,19
2787,111,17,87,8,1.3561671479223418,9
2788,30,29,49,14,1.3512252684605828,15
2789,97,37,88,18,1.349074362930903,19
2790,18,12,27,5,1.348491059130868,7
2791,108,17,40,9,1.3479697301696818,8
2792,70,29,76,15,1.3451436146232179,14
2793,57,11,48,5,1.3440079866073944,6
2794,6,10,23,5,1.3385415186806262,5
2795,108,13,81,6,1.3379621241230502,7
2796,51,81,107,35,1.33234018945156,46
2797,94,13,37,6,1.3280387948229053,7
2798,74,18,80,9,1.3199661328668575,9
2799,11,17,69,7,1.31925934711326,10
2800,10,16,8,7,1.3145513780375315,9
2801,32,12,51,6,1.314434714983352,6
2802,109,61,86,29,1.3124186728291776,32
2803,9,28,58,13,1.310268135821902,15
2804,28,11,64,5,1.3072442451375943,6
2805,20,14,104,6,1.303497989239853,8
2806,5,44,13,21,1.302350985374302,23
2807,107,30,112,15,1.3015224651570316,15
2808,86,22,94,10,1.301305007900728,12
2809,7,22,8,10,1.29527150144924,12
2810,2,22,74,10,1.2925512141562505,12
2811,7,74,39,37,1.288018081289338,37
2812,16,53,74,25,1.2870673809929651,28
2813,33,17,54,9,1.2844291677407338,8
2814,103,13,65,7,1.2841419220170616,6
2815,97,20,109,10,1.283406905257821,10
2816,7,79,41,39,1.28035014693459,40
2817,63,50,87,23,1.2783017322984431,27
2818,30,15,15,7,1.2763156051583036,8
2819,63,26,112,13,1.275100116999867,13
2820,107,38,90,19,1.2750427230775991,19
2821,71,11,1,6,1.2732152302328,5
2822,16,35,109,16,1.2705603404572,19
2823,50,19,108,10,1.2701675761997318,9
2824,50,27,65,13,1.2644687002361983,14
2825,19,16,88,8,1.2626760862124462,8
2826,73,15,16,8,1.2607482082851333,7
2827,61,18,13,10,1.2539314981714416,8
2828,17,11,62,5,1.2486647888480191,6
2829,108,16,55,7,1.2425126869095338,9
2830,77,22,65,11,1.2403405493552604,11
2831,107,30,4,15,1.2387516471106226,15
2832,71,25,31,12,1.2380158081615504,13
2833,65,47,60,20,1.237531797135398,27
2834,63,16,95,8,1.233969730193377,8
2835,60,33,41,17,1.2319535203548815,16
2836,71,26,9,12,1.2262156519313812,14
2837,58,10,100,5,1.217244071723862,5
2838,86,81,20,38,1.214920984168942,43
2839,98,11,74,5,1.2137114800422117,6
2840,25,33,97,16,1.211209753293348,17
2841,78,12,109,6,1.2110516970103606,6
2842,63,44,7,18,1.2086828652803667,26
2843,75,52,65,26,1.1957967627587305,26
2844,12,10,19,4,1.1951611042743036,6
2845,87,17,52,9,1.1945604382246608,8
2846,25,67,16,32,1.1932865297100665,35
2847,13,100,65,47,1.189064395291106,53
2848,87,16,110,7,1.187803786715121,9
2849,20,35,51,19,1.1859303718784329,16
2850,8,77,88,37,1.1776806698246343,40
2851,103,13,57,6,1.1771234726800743,7
2852,63,42,41,20,1.1723857975845224,22
2853,87,42,104,22,1.170448333008426,20
2854,51,23,29,12,1.1550549901650442,11
2855,86,40,57,18,1.1475688399099464,22
2856,11,29,74,14,1.1468410073590314,15
2857,109,16,69,8,1.146837277614336,8
2858,64,20,45,9,1.1431500338693237,11
2859,88,24,38,10,1.1397328805109292,14
2860,86,77,54,38,1.1362741922890973,39
2861,36,26,106,13,1.1307287364062801,13
2862,3,26,31,14,1.130409883055894,12
2863,114,21,69,9,1.1298921487065041,12
2864,15,17,64,7,1.1222199728342503,10
2865,55,20,3,10,1.1206022099322261,10
2866,16,44,114,20,1.1112389462801522,24
2867,73,13,55,6,1.1082443575059586,7
2868,49,41,86,22,1.1071050880538134,19
2869,91,12,47,6,1.1047106963660296,6
2870,40,19,45,9,1.1043531225931202,10
2871,96,18,2,9,1.1039761816908797,9
2872,107,35,46,18,1.1031099530770954,17
2873,70,39,106,20,1.1024614638047308,19
2874,27,27,63,14,1.0995729583369798,13
2875,40,13,74,6,1.0901529369074687,7
2876,86,24,108,13,1.0756567255515244,11
2877,64,19,97,9,1.0748997556854092,10
2878,67,20,37,9,1.0707700527635258,11
2879,19,47,16,23,1.0685639199208614,24
2880,58,14,71,7,1.0679524363994282,7
2881,70,55,8,27,1.0665028298167964,28
2882,104,30,109,15,1.0638658496000608,15
2883,11,20,78,11,1.0625304486811955,9
2884,103,11,3,6,1.062442911366952,5
2885,100,14,44,7,1.0590413147864144,7
2886,13,39,50,19,1.056438685531628,20
2887,20,18,48,8,1.0556464172960105,10
2888,112,21,27,10,1.0546603130658319,11
2889,71,18,45,10,1.0500246166344394,8
2890,4,60,13,28,1.0440840904331967,32
2891,23,29,8,14,1.0415352116212746,15
2892,18,35,51,18,1.0414861976482428,17
2893,104,16,33,7,1.0375486456158112,9
2894,90,21,88,11,1.0373159148886417,10
2895,7,59,18,30,1.0365595161190129,29
2896,45,14,3,7,1.0349134798027078,7
2897,13,56,9,26,1.0296923282418164,30
2898,50,42,11,20,1.0236501147175256,22
2899,63,20,44,9,1.0233184771026502,11
2900,114,18,15,9,1.0230376199980897,9
2901,70,10,33,5,1.0222975969230632,5
2902,107,27,94,15,1.0140230754913535,12
2903,88,78,51,42,1.0127086502414953,36
2904,87,52,28,26,1.0126365910584707,26
2905,100,19,94,8,1.011314761300663,11
2906,45,12,88,5,1.0058195203591582,7
2907,13,43,75,20,1.005364432264769,23
2908,114,11,93,6,1.004990658958168,5
2909,12,25,68,12,0.998021547261261,13
2910,37,37,17,16,0.9978108601802018,21
2911,39,49,11,24,0.9952251008535992,25
2912,78,29,107,14,0.9948158487515276,15
2913,68,26,94,13,0.978428606131044,13
2914,94,17,65,9,0.9759953242635651,8
2915,54,74,16,37,0.9751249558189032,37
2916,107,65,5,32,0.9748363761521144,33
2917,78,12,9,6,0.9745877106891208,6
2918,39,37,50,18,0.9722598320230015,19
2919,53,40,51,20,0.9719493528973242,20
2920,54,13,12,7,0.9644229325307597,6
2921,104,38,106,19,0.9604760273979323,19
2922,106,11,103,6,0.9583580547252424,5
2923,62,12,30,5,0.9579903874565542,7
2924,54,17,29,8,0.9568622693148616,9
2925,39,30,19,13,0.956766216468027,17
2926,14,14,5,6,0.9561035605846475,8
2927,11,48,87,25,0.955780667336121,23
2928,11,53,28,27,0.947100114927894,26
2929,63,23,53,11,0.9461903574638922,12
2930,18,29,40,12,0.9358054757186772,17
2931,33,17,86,9,0.9246066959077469,8
2932,77,24,68,12,0.9242995453914955,12
2933,75,27,114,13,0.9181862737012574,14
2934,106,100,86,49,0.9173221659807225,51
2935,50,20,112,9,0.9149514035999706,11
2936,84,27,65,13,0.9123622527895624,14
2937,39,14,1,5,0.9120351629887077,9
2938,43,17,50,7,0.911659904777202,10
2939,114,58,86,29,0.910815171729828,29
2940,76,16,95,8,0.9107888940485349,8
2941,36,35,75,19,0.9076169876586753,16
2942,112,11,14,6,0.9022319115654415,5
2943,62,14,50,6,0.9017457082495502,8
2944,68,17,74,7,0.9001065237726507,10
2945,57,29,41,14,0.8954953678172469,15
2946,39,40,47,19,0.8944840301858614,21
2947,2,25,87,12,0.8933815990593449,13
2948,60,17,83,8,0.8851626447494981,9
2949,83,21,88,11,0.8798897555023182,10
2950,12,15,50,5,0.8796715451198309,10
2951,84,17,91,8,0.8755346549877653,9
2952,112,18,23,8,0.8735906898502468,10
2953,108,11,7,6,0.8716332223147827,5
2954,60,17,84,10,0.871614356489069,7
2955,87,37,109,17,0.8703115701493915,20
2956,8,67,37,33,0.8700084298071539,34
2957,10,10,114,4,0.8617397018011257,6
2958,46,30,87,13,0.8552141932237232,17
2959,77,14,64,8,0.8550421959375887,6
2960,3,20,64,10,0.8512006423900937,10
2961,39,13,102,6,0.8492100400200487,7
2962,60,14,98,7,0.8439389777307171,7
2963,103,10,94,5,0.8351093164432406,5
2964,2,16,46,8,0.8285194662826778,8
2965,33,15,114,8,0.8283609152315331,7
2966,29,12,106,6,0.8264692442725535,6
2967,28,48,37,24,0.8263140292594408,24
2968,33,21,13,10,0.825882476116428,11
2969,84,15,95,7,0.8218033746912388,8
2970,114,19,45,9,0.8205689132017492,10
2971,7,16,79,8,0.808566327439515,8
2972,96,58,107,27,0.8081270899904945,31
2973,84,31,50,16,0.8064114901977948,15
2974,56,14,40,7,0.8062835825274064,7
2975,30,26,40,13,0.8045580871786187,13
2976,39,62,107,31,0.8038504831284023,31
2977,27,55,107,26,0.7992639473344534,29
2978,2,22,88,11,0.7956469041111237,11
2979,28,16,89,7,0.7901986413516635,9
2980,75,14,33,6,0.7900898585820654,8
2981,96,15,3,8,0.788360761162582,7
2982,4,18,104,10,0.7872554057904764,8
2983,39,48,41,25,0.7814214856066571,23
2984,35,25,86,11,0.7790661728530307,14
2985,13,51,28,25,0.7790491963091711,26
2986,87,22,99,10,0.7762165713325069,12
2987,84,33,54,16,0.7745949946915583,17
2988,55,21,57,9,0.7741765920845296,12
2989,10,19,84,9,0.7730240789929571,10
2990,17,34,107,17,0.7719574333138971,17
2991,97,20,93,10,0.7717644600090583,10
2992,50,20,69,11,0.7658320012010581,9
2993,39,43,100,20,0.7598624549967821,23
2994,60,60,77,30,0.7576892401995746,30
2995,87,18,103,10,0.7529802168659739,8
2996,14,15,13,6,0.7511854242648525,9
2997,46,24,84,11,0.744605770354001,13
2998,36,13,74,5,0.7437175733038444,8
2999,38,22,64,11,0.741675899909912,11
3000,25,24,15,13,0.7394428200536315,11
3001,78,28,63,14,0.7387444601081155,14
3002,5,40,63,22,0.7358500176759455,18
3003,40,77,86,36,0.7352757671814381,41
3004,17,18,87,9,0.7339013030227953,9
3005,95,41,5,21,0.731606653431554,20
3006,68,24,17,11,0.7306498470996444,13
3007,19,33,15,16,0.7305240237414572,17
3008,3,27,9,13,0.7284011303001918,14
3009,71,10,96,5,0.7278695572627789,5
3010,68,67,27,33,0.7269677534425136,34
3011,8,24,17,12,0.7243993806611897,12
3012,34,25,13,12,0.7239998114991918,13
3013,38,11,41,6,0.722845576682056,5
3014,86,89,65,46,0.7181707847876222,43
3015,61,18,40,9,0.7154895706830828,9
3016,82,13,28,7,0.7153587234866209,6
3017,78,26,19,12,0.7133948255014945,14
3018,106,18,27,7,0.7074485049679566,11
3019,51,32,12,16,0.7062882632515936,16
3020,18,23,104,13,0.701208945227421,10
3021,38,11,91,5,0.7003822911270713,6
3022,57,11,95,4,0.6989616542578664,7
3023,16,34,90,18,0.6982734048169781,16
3024,86,73,13,37,0.6943738187395494,36
3025,11,17,93,10,0.6934063282822602,7
3026,3,40,68,19,0.6924118113820608,21
3027,30,62,86,29,0.691988434677015,33
3028,19,27,54,14,0.6912195373922535,13
3029,62,10,98,5,0.6900751788017032,5
3030,65,19,78,8,0.6880603416300906,11
3031,18,19,25,10,0.6816652439852776,9
3032,109,14,23,7,0.6795387556597896,7
3033,68,61,86,31,0.6740238717236793,30
3034,109,26,60,13,0.673756859043161,13
3035,37,40,114,18,0.6680388190804037,22
3036,55,60,51,29,0.6653649036389611,31
3037,13,36,17,17,0.6540411403366837,19
3038,2,10,109,5,0.6444253237530958,5
3039,38,29,13,16,0.6435009476526603,13
3040,86,27,77,13,0.6434105237769749,14
3041,98,16,50,8,0.6426219058041094,8
3042,62,10,72,5,0.6423355932907711,5
3043,25,25,41,14,0.6394054706376684,11
3044,88,36,109,17,0.6373634891887677,19
3045,111,17,36,8,0.6365354853619557,9
3046,11,32,13,16,0.636077472688013,16
3047,70,22,41,12,0.6354721735396393,10
3048,87,53,3,26,0.6346454534083896,27
3049,13,34,20,16,0.632497829596757,18
3050,4,28,64,13,0.6316212138641686,15
3051,57,36,13,19,0.6298547457994883,17
3052,60,23,1,11,0.6297573562891167,12
3053,65,40,37,21,0.6273579146862459,19
3054,36,33,71,17,0.6241330409639582,16
3055,76,30,96,14,0.6223340675935091,16
3056,12,19,18,9,0.6189201728029503,10
3057,40,12,38,5,0.6179079194784384,7
3058,87,54,30,26,0.6174654268347555,28
3059,31,22,58,11,0.6168553703735019,11
3060,107,70,63,38,0.6147702937762416,32
3061,72,12,11,6,0.6087108948499106,6
3062,91,16,70,7,0.6063303701253773,9
3063,41,27,114,14,0.6047868123599981,13
3064,13,55,53,25,0.6028868868296878,30
3065,41,57,88,27,0.6028240463673848,30
3066,28,56,109,26,0.602402202314137,30
3067,63,15,34,7,0.6010869874219945,8
3068,71,32,106,15,0.6009609652453856,17
3069,111,10,12,6,0.6003907747378726,4
3070,71,10,23,4,0.6000287508458257,6
3071,94,14,88,6,0.594908220356331,8
3072,112,21,9,11,0.5891782951722581,10
3073,76,13,36,4,0.5885035889042722,9
3074,81,16,68,8,0.5833845458965541,8
3075,62,25,39,13,0.58110831275913,12
3076,90,18,84,9,0.5795253040496203,9
3077,114,40,7,19,0.5741553045041318,21
3078,69,15,71,8,0.5724150990318919,7
3079,49,25,51,12,0.572100334327297,13
3080,69,14,12,8,0.5699279230894607,6
3081,40,10,94,5,0.5678516928680516,5
3082,88,21,35,11,0.5635135884116244,10
3083,29,10,108,5,0.5615423900676226,5
3084,83,10,2,5,0.5594397265150824,5
3085,57,46,16,23,0.5579479306524194,23
3086,76,37,104,17,0.5571874176779715,20
3087,114,14,30,7,0.5541405297268072,7
3088,5,49,54,23,0.5526115688513309,26
3089,3,14,109,7,0.5522306780191789,7
3090,51,37,69,17,0.5481183874143157,20
3091,92,17,7,7,0.5480230211986101,10
3092,98,27,16,13,0.5462850233229243,14
3093,64,29,54,15,0.5456745481805155,14
3094,86,12,66,6,0.5447941989519712,6
3095,68,28,78,14,0.5423739975206195,14
3096,60,77,7,38,0.5423394255026432,39
3097,65,32,11,17,0.5420670901860699,15
3098,106,10,1,5,0.539652861011431,5
3099,65,37,17,16,0.5366069246519296,21
3100,11,18,17,9,0.5333410210662327,9
3101,107,20,6,10,0.5288105428737948,10
3102,73,19,28,10,0.5214155246375574,9
3103,106,68,28,33,0.5161436710076662,35
3104,84,27,78,13,0.5159724183872996,14
3105,4,18,9,9,0.5118055197130339,9
3106,47,12,72,5,0.5048188031697544,7
3107,64,32,87,15,0.5008683686632482,17
3108,90,13,91,6,0.5003235284827323,7
3109,23,20,54,10,0.5000451529620598,10
3110,88,35,31,18,0.4999807976090588,17
3111,107,97,7,43,0.499325728982042,54
3112,5,59,87,29,0.4991669720547012,30
3113,50,65,54,32,0.4949296901820479,33
3114,74,22,18,12,0.49290222508995235,10
3115,57,14,104,5,0.4845128262229356,9
3116,84,10,94,5,0.4811703860633969,5
3117,86,56,3,26,0.48051928158753043,30
3118,95,28,74,13,0.47842550860281996,15
3119,75,31,41,14,0.47837138213253816,17
3120,107,59,60,29,0.47676663680262105,30
3121,25,51,39,26,0.4759465051184244,25
3122,11,70,16,30,0.47507446014630583,40
3123,40,39,16,20,0.4700829739213681,19
3124,65,54,31,26,0.46913887469692744,28
3125,107,84,28,40,0.460482572110683,44
3126,13,36,109,19,0.4565630401717373,17
3127,61,12,51,7,0.4524104182911938,5
3128,97,39,107,20,0.4513498337115768,19
3129,30,19,78,10,0.4504186941395626,9
3130,64,17,17,9,0.45034602156283254,8
3131,107,78,54,37,0.44966762811852085,41
3132,80,11,9,7,0.4439834453330457,4
3133,17,30,50,16,0.44354818573896915,14
3134,90,15,11,7,0.4409004522210816,8
3135,107,73,84,36,0.4361795606795497,37
3136,12,26,39,13,0.43310825183302515,13
3137,68,55,107,28,0.43234743420276955,27
3138,40,43,31,22,0.429627197462679,21
3139,3,18,61,7,0.42655437314042427,11
3140,104,47,114,22,0.42561908324396974,25
3141,68,46,63,23,0.4255709909849699,23
3142,46,11,19,6,0.4237898327913996,5
3143,5,14,38,7,0.4168378546295618,7
3144,20,16,69,8,0.4110151707783569,8
3145,31,33,86,17,0.4107692180392416,16
3146,50,18,79,9,0.4091046493522828,9
3147,39,63,87,32,0.40785126861156634,31
3148,65,19,109,11,0.40467480974394743,8
3149,1,13,62,7,0.40260932742909444,6
3150,49,25,3,12,0.40202274304396013,13
3151,51,57,87,28,0.4011075857008794,29
3152,107,88,8,41,0.39506784448005633,47
3153,61,16,65,9,0.395050527419345,7
3154,55,16,41,8,0.3929137359889599,8
3155,102,14,84,7,0.3912018744364814,7
3156,8,13,44,6,0.3904420875790005,7
3157,69,30,36,15,0.38598798110099336,15
3158,8,35,50,16,0.38293825667797665,19
3159,16,30,111,14,0.38292925496486846,16
3160,114,16,49,9,0.38282715464735084,7
3161,112,42,16,21,0.3797850384223862,21
3162,114,28,71,14,0.3795577437704574,14
3163,70,22,97,12,0.3783758219642565,10
3164,14,18,84,8,0.37783903496494214,10
3165,50,31,51,16,0.3741743899822504,15
3166,87,28,47,14,0.37376203212616155,14
3167,40,21,75,10,0.36863713867004627,11
3168,16,23,4,10,0.3685363738737263,13
3169,95,26,28,12,0.36814720179538635,14
3170,92,18,13,7,0.36521745881563183,11
3171,49,10,5,5,0.3484948933204418,5
3172,51,46,9,22,0.3398399478360059,24
3173,109,13,4,6,0.3380907022892352,7
3174,83,20,106,11,0.33164456490941063,9
3175,3,13,46,7,0.32759691142996444,6
3176,55,38,96,18,0.3245672587151402,20
3177,80,17,71,9,0.3237123360021306,8
3178,86,34,2,18,0.32232529406269955,16
3179,33,23,16,13,0.319652521857061,10
3180,83,25,28,14,0.3193130867023741,11
3181,60,48,53,25,0.3118269913878374,23
3182,23,19,111,11,0.30722018824927017,8
3183,1,35,107,18,0.30511491832295773,17
3184,114,60,88,30,0.29749332449413723,30
3185,88,15,48,6,0.2955612335778544,9
3186,27,17,25,9,0.2912949474117505,8
3187,80,34,86,17,0.2891436647516337,17
3188,27,29,11,14,0.28800876199323994,15
3189,68,63,60,33,0.28538797843058167,30
3190,70,21,39,11,0.2845470082736238,10
3191,67,12,25,6,0.2816428039469064,6
3192,96,12,67,7,0.27996501259109813,5
3193,7,20,70,8,0.27895885562124206,12
3194,53,18,5,8,0.2778213329671456,10
3195,112,16,17,8,0.27197121777913047,8
3196,81,24,88,12,0.2692388574128349,12
3197,36,11,38,4,0.26679215079866997,7
3198,13,41,15,21,0.26328429172163104,20
3199,37,22,76,12,0.2606095394442829,10
3200,71,36,88,16,0.25752053570309325,20
3201,4,32,68,16,0.25730955252799864,16
3202,76,36,11,17,0.25521929449008574,19
3203,37,51,51,28,0.2542884534727083,23
3204,81,21,3,10,0.25253107561483373,11
3205,17,11,108,5,0.2506467392789146,6
3206,15,44,16,23,0.2501293322970628,21
3207,88,38,20,20,0.24807571543102264,18
3208,40,25,47,14,0.24655985846699452,11
3209,39,10,93,5,0.24650819188032075,5
3210,62,18,27,9,0.24532717492411,9
3211,43,12,112,6,0.23582743390542227,6
3212,8,46,39,24,0.2299191470614597,22
3213,65,10,101,5,0.22906131925901718,5
3214,67,12,84,5,0.22644335659627104,7
3215,104,38,68,18,0.22065757437372407,20
3216,107,40,18,22,0.21456452912257484,18
3217,53,21,44,9,0.2122113313421154,12
3218,28,11,66,5,0.2056598644516812,6
3219,46,23,17,12,0.20521498367655996,11
3220,8,46,20,23,0.2023315764151644,23
3221,63,48,40,23,0.20172959340563693,25
3222,65,101,63,50,0.2015263747176784,51
3223,76,11,47,3,0.1986777302440924,8
3224,20,20,30,10,0.1944033306484096,10
3225,107,61,74,29,0.19420996588142148,32
3226,2,32,97,16,0.19179066671966688,16
3227,88,19,61,8,0.1901426643579958,11
3228,88,35,37,17,0.1877253046596751,18
3229,35,12,70,7,0.18631436457958764,5
3230,44,15,65,6,0.18351226600640885,9
3231,50,25,114,12,0.18060110833646845,13
3232,7,87,65,46,0.17939405354363122,41
3233,71,33,8,17,0.17759312635004623,16
3234,11,47,106,26,0.17225906773687616,21
3235,8,28,76,13,0.16855819265900343,15
3236,7,51,4,26,0.16136746029798088,25
3237,62,12,106,6,0.1584669634691407,6
3238,7,16,83,7,0.15765677447455273,9
3239,112,31,65,16,0.15691587782419453,15
3240,64,22,27,12,0.15578729394667262,10
3241,20,10,72,5,0.15576959543407512,5
3242,13,19,96,9,0.15564789635830772,10
3243,49,72,13,39,0.15282112160160313,33
3244,84,22,80,10,0.15202664995311643,12
3245,51,20,98,10,0.14461940831704007,10
3246,68,81,51,38,0.13625619543388945,43
3247,73,10,25,5,0.1328731236438802,5
3248,98,14,19,6,0.12846875445523867,8
3249,69,25,7,13,0.12779683769016903,12
3250,28,22,98,9,0.12169006680659694,13
3251,28,19,79,10,0.11459893657872618,9
3252,16,50,41,23,0.114002356766615,27
3253,46,52,11,26,0.11145382950255933,26
3254,68,10,79,4,0.11002938828097442,6
3255,2,18,84,9,0.10504403066305398,9
3256,50,57,86,30,0.09835934402357824,27
3257,86,30,53,13,0.09593092236920715,17
3258,74,39,25,20,0.09563368284676016,19
3259,87,14,92,7,0.09367358040314991,7
3260,44,26,16,14,0.09298306483163052,12
3261,30,15,96,8,0.09214636377364425,7
3262,114,29,36,13,0.09213128587786307,16
3263,106,19,43,10,0.09144216539691846,9
3264,95,52,86,24,0.08956033992826938,28
3265,84,37,88,17,0.08333477514829757,20
3266,97,36,74,17,0.07931920932357782,19
3267,84,11,69,5,0.0764184866169909,6
3268,62,19,37,8,0.06880627143278654,11
3269,106,21,40,10,0.06808253080226546,11
3270,3,27,69,15,0.06495501975423415,12
3271,29,19,38,9,0.056275627076261485,10
3272,8,70,106,37,0.05212763279076112,33
3273,23,20,15,10,0.052043691980666475,10
3274,73,16,106,8,0.04700386219362951,8
3275,83,17,51,10,0.04607341431682285,7
3276,47,10,58,5,0.04544416959920028,5
3277,72,10,30,5,0.04324886744884253,5
3278,74,41,54,20,0.04296760366186976,21
3279,31,11,97,5,0.04256244744109723,6
3280,16,28,102,14,0.03953820636299188,14
3281,9,50,68,25,0.039410551307440755,25
3282,55,52,87,26,0.039341837208104025,26
3283,54,69,8,32,0.03842810546346955,37
3284,84,19,17,10,0.032612383959908106,9
3285,11,56,107,27,0.03172545530345329,29
3286,106,42,50,20,0.025298087208634697,22
3287,88,46,49,23,0.025210795706532754,23
3288,65,69,68,34,0.017933868360567002,35
3289,60,15,80,7,0.014675025668747566,8
3290,15,10,48,5,0.011064943202326916,5
3291,109,17,83,7,0.00972932964701334,10
3292,62,24,100,11,0.008635198292372989,13
3293,109,15,43,8,0.007388230876879002,7
3294,114,69,107,34,0.005243500728873689,35
3295,63,15,58,6,0.0031719369071327363,9
3296,58,15,63,9,-0.0031719369071322285,6
3297,107,69,114,35,-0.0052435007288730625,34
3298,43,15,109,7,-0.007388230876878528,8
3299,100,24,62,13,-0.008635198292374172,11
3300,106,47,76,26,-0.009505075346386196,21
3301,83,17,109,10,-0.009729329647013785,7
3302,48,10,15,5,-0.01106494320232656,5
3303,80,15,60,8,-0.014675025668747439,7
3304,68,69,65,35,-0.017933868360567613,34
3305,49,46,88,23,-0.025210795706531827,23
3306,50,42,106,22,-0.02529808720863334,20
3307,17,19,84,9,-0.03261238395990876,10
3308,8,69,54,37,-0.03842810546346945,32
3309,87,52,55,26,-0.039341837208104025,26
3310,68,50,9,25,-0.03941055130744142,25
3311,97,11,31,6,-0.042562447441096586,5
3312,54,41,74,21,-0.04296760366187002,20
3313,30,10,72,5,-0.04324886744884253,5
3314,58,10,47,5,-0.04544416959920099,5
3315,51,17,83,7,-0.04607341431682421,10
3316,106,16,73,8,-0.0470038621936304,8
3317,15,20,23,10,-0.05204369198066665,10
3318,106,70,8,33,-0.05212763279076128,37
3319,38,19,29,10,-0.05627562707626055,9
3320,69,27,3,12,-0.06495501975423389,15
3321,40,21,106,11,-0.0680825308022658,10
3322,37,19,62,11,-0.06880627143278734,8
3323,69,11,84,6,-0.0764184866169909,5
3324,74,36,97,19,-0.07931920932357782,17
3325,88,37,84,20,-0.0833347751482989,17
3326,86,52,95,28,-0.08956033992827091,24
3327,43,19,106,9,-0.09144216539691921,10
3328,36,29,114,16,-0.09213128587786189,13
3329,96,15,30,7,-0.09214636377364507,8
3330,16,26,44,12,-0.09298306483163078,14
3331,92,14,87,7,-0.09367358040315074,7
3332,25,39,74,19,-0.0956336828467596,20
3333,53,30,86,17,-0.09593092236920858,13
3334,86,57,50,27,-0.09835934402357775,30
3335,84,18,2,9,-0.10504403066305477,9
3336,79,10,68,6,-0.11002938828097442,4
3337,11,52,46,26,-0.11145382950255996,26
3338,41,50,16,27,-0.1140023567666159,23
3339,79,19,28,9,-0.11459893657872618,10
3340,98,22,28,13,-0.1216900668065983,9
3341,7,25,69,12,-0.1277968376901685,13
3342,19,14,98,8,-0.12846875445523917,6
3343,25,10,73,5,-0.1328731236438802,5
3344,51,81,68,43,-0.13625619543388776,38
3345,98,20,51,10,-0.14461940831704023,10
3346,80,22,84,12,-0.15202664995311627,10
3347,13,72,49,33,-0.15282112160160244,39
3348,96,19,13,10,-0.1556478963583079,9
3349,72,10,20,5,-0.15576959543407548,5
3350,27,22,64,10,-0.15578729394667262,12
3351,65,31,112,15,-0.15691587782419436,16
3352,83,16,7,9,-0.1576567744745514,7
3353,106,12,62,6,-0.15846696346914188,6
3354,4,51,7,25,-0.16136746029798163,26
3355,76,28,8,15,-0.1685581926590033,13
3356,106,47,11,21,-0.17225906773687602,26
3357,8,33,71,16,-0.17759312635004632,17
3358,65,87,7,41,-0.17939405354363064,46
3359,114,25,50,13,-0.18060110833646717,12
3360,65,15,44,9,-0.1835122660064091,6
3361,70,12,35,5,-0.18631436457958692,7
3362,37,35,88,18,-0.18772530465967646,17
3363,61,19,88,11,-0.19014266435799543,8
3364,97,32,2,16,-0.1917906667196678,16
3365,47,11,76,8,-0.19867773024409274,3
3366,63,101,65,51,-0.20152637471767987,50
3367,40,48,63,25,-0.20172959340563568,23
3368,20,46,8,23,-0.20233157641516486,23
3369,17,23,46,11,-0.2052149836765593,12
3370,66,11,28,6,-0.20565986445168055,5
3371,44,21,53,12,-0.2122113313421161,9
3372,18,40,107,18,-0.21456452912257684,22
3373,68,38,104,20,-0.22065757437372266,18
3374,84,12,67,7,-0.22644335659627166,5
3375,101,10,65,5,-0.2290613192590168,5
3376,39,46,8,22,-0.22991914706145986,24
3377,112,12,43,6,-0.23582743390542227,6
3378,27,18,62,9,-0.24532717492411,9
3379,93,10,39,5,-0.24650819188031967,5
3380,47,25,40,11,-0.24655985846699366,14
3381,16,44,15,21,-0.25012933229706297,23
3382,108,11,17,6,-0.25064673927891384,5
3383,3,21,81,11,-0.25253107561483423,10
3384,51,51,37,23,-0.2542884534727087,28
3385,68,32,4,16,-0.2573095525279973,16
3386,88,36,71,20,-0.2575205357030929,16
3387,76,22,37,10,-0.26060953944428406,12
3388,15,41,13,20,-0.2632842917216306,21
3389,38,11,36,7,-0.26679215079866964,4
3390,88,24,81,12,-0.2692388574128355,12
3391,17,16,112,8,-0.27197121777913247,8
3392,5,18,53,10,-0.277821332967146,8
3393,70,20,7,12,-0.27895885562124184,8
3394,67,12,96,5,-0.279965012591097,7
3395,25,12,67,6,-0.2816428039469064,6
3396,39,21,70,10,-0.2845470082736231,11
3397,60,63,68,30,-0.28538797843058206,33
3398,11,29,27,15,-0.28800876199323994,14
3399,86,34,80,17,-0.2891436647516337,17
3400,25,17,27,8,-0.29129494741175216,9
3401,48,15,88,9,-0.29556123357785347,6
3402,88,60,114,30,-0.2974933244941375,30
3403,107,35,1,17,-0.30511491832295834,18
3404,111,19,23,8,-0.30722018824927033,11
3405,53,48,60,23,-0.3118269913878375,25
3406,28,25,83,11,-0.3193130867023753,14
3407,16,23,33,10,-0.3196525218570616,13
3408,2,34,86,16,-0.32232529406269944,18
3409,71,17,80,8,-0.3237123360021318,9
3410,96,38,55,20,-0.32456725871514125,18
3411,46,13,3,6,-0.3275969114299653,7
3412,106,20,83,9,-0.3316445649094112,11
3413,4,13,109,7,-0.3380907022892352,6
3414,9,46,51,24,-0.33983994783600563,22
3415,5,10,49,5,-0.3484948933204407,5
3416,13,18,92,11,-0.3652174588156323,7
3417,28,26,95,14,-0.36814720179538646,12
3418,4,23,16,13,-0.36853637387372506,10
3419,75,21,40,11,-0.3686371386700461,10
3420,47,28,87,14,-0.3737620321261605,14
3421,51,31,50,15,-0.37417438998225105,16
3422,84,18,14,10,-0.37783903496494253,8
3423,97,22,70,10,-0.3783758219642562,12
3424,71,28,114,14,-0.3795577437704577,14
3425,16,42,112,21,-0.3797850384223861,21
3426,49,16,114,7,-0.38282715464734857,9
3427,111,30,16,16,-0.3829292549648681,14
3428,50,35,8,19,-0.3829382566779763,16
3429,36,30,69,15,-0.3859879811009911,15
3430,44,13,8,7,-0.3904420875789997,6
3431,84,14,102,7,-0.39120187443648013,7
3432,41,16,55,8,-0.39291373598895946,8
3433,65,16,61,7,-0.3950505274193441,9
3434,8,88,107,47,-0.39506784448005616,41
3435,87,57,51,29,-0.4011075857008784,28
3436,3,25,49,13,-0.40202274304396185,12
3437,62,13,1,6,-0.40260932742909444,7
3438,109,19,65,8,-0.40467480974394743,11
3439,87,63,39,31,-0.4078512686115662,32
3440,79,18,50,9,-0.4091046493522828,9
3441,86,33,31,16,-0.4107692180392426,17
3442,69,16,20,8,-0.41101517077835736,8
3443,38,14,5,7,-0.4168378546295618,7
3444,19,11,46,5,-0.4237898327914003,6
3445,63,46,68,23,-0.4255709909849707,23
3446,114,47,104,25,-0.4256190832439694,22
3447,61,18,3,11,-0.42655437314042405,7
3448,31,43,40,21,-0.4296271974626791,22
3449,107,55,68,27,-0.4323474342027697,28
3450,39,26,12,13,-0.4331082518330257,13
3451,84,73,107,37,-0.43617956067955155,36
3452,11,15,90,8,-0.4409004522210813,7
3453,50,30,17,14,-0.4435481857389689,16
3454,9,11,80,4,-0.4439834453330448,7
3455,54,78,107,41,-0.4496676281185206,37
3456,17,17,64,8,-0.4503460215628323,9
3457,78,19,30,9,-0.4504186941395628,10
3458,107,39,97,19,-0.4513498337115769,20
3459,51,12,61,5,-0.4524104182911935,7
3460,109,36,13,17,-0.45656304017173654,19
3461,28,84,107,44,-0.4604825721106823,40
3462,31,54,65,28,-0.4691388746969265,26
3463,16,39,40,19,-0.4700829739213682,20
3464,39,51,25,25,-0.4759465051184236,26
3465,60,59,107,30,-0.4767666368026221,29
3466,41,31,75,17,-0.47837138213253816,14
3467,74,28,95,15,-0.4784255086028221,13
3468,3,56,86,30,-0.4805192815875298,26
3469,94,10,84,5,-0.4811703860633948,5
3470,104,14,57,9,-0.4845128262229359,5
3471,18,22,74,10,-0.4929022250899522,12
3472,54,65,50,33,-0.494929690182047,32
3473,87,59,5,30,-0.49916697205470045,29
3474,7,97,107,54,-0.49932572898204264,43
3475,31,35,88,17,-0.499980797609059,18
3476,54,20,23,10,-0.5000451529620575,10
3477,91,13,90,7,-0.5003235284827329,6
3478,87,32,64,17,-0.5008683686632488,15
3479,72,12,47,7,-0.504818803169754,5
3480,9,18,4,9,-0.5118055197130339,9
3481,78,27,84,14,-0.515972418387299,13
3482,28,68,106,35,-0.5161436710076651,33
3483,28,19,73,9,-0.5214155246375576,10
3484,6,20,107,10,-0.528810542873795,10
3485,17,18,11,9,-0.5333410210662319,9
3486,17,37,65,21,-0.5366069246519297,16
3487,1,10,106,5,-0.5396528610114302,5
3488,11,32,65,15,-0.5420670901860701,17
3489,7,77,60,39,-0.5423394255026428,38
3490,78,28,68,14,-0.5423739975206194,14
3491,66,12,86,6,-0.5447941989519703,6
3492,54,29,64,14,-0.5456745481805153,15
3493,16,27,98,14,-0.5462850233229247,13
3494,7,17,92,10,-0.5480230211986107,7
3495,69,37,51,20,-0.548118387414316,17
3496,109,14,3,7,-0.5522306780191784,7
3497,54,49,5,26,-0.5526115688513301,23
3498,30,14,114,7,-0.5541405297268066,7
3499,104,37,76,20,-0.5571874176779698,17
3500,16,46,57,23,-0.5579479306524189,23
3501,2,10,83,5,-0.559439726515081,5
3502,108,10,29,5,-0.5615423900676234,5
3503,35,21,88,10,-0.5635135884116247,11
3504,94,10,40,5,-0.5678516928680514,5
3505,12,14,69,6,-0.5699279230894615,8
3506,51,25,49,13,-0.5721003343272967,12
3507,71,15,69,7,-0.5724150990318926,8
3508,7,40,114,21,-0.5741553045041317,19
3509,84,18,90,9,-0.5795253040496205,9
3510,39,25,62,12,-0.5811083127591289,13
3511,68,16,81,8,-0.5833845458965539,8
3512,36,13,76,9,-0.5885035889042698,4
3513,9,21,112,10,-0.5891782951722585,11
3514,88,14,94,8,-0.594908220356331,6
3515,23,10,71,6,-0.6000287508458257,4
3516,12,10,111,4,-0.6003907747378741,6
3517,106,32,71,17,-0.6009609652453869,15
3518,34,15,63,8,-0.6010869874219955,7
3519,109,56,28,30,-0.6024022023141372,26
3520,88,57,41,30,-0.6028240463673847,27
3521,53,55,13,30,-0.602886886829687,25
3522,114,27,41,13,-0.6047868123599985,14
3523,70,16,91,9,-0.6063303701253777,7
3524,11,12,72,6,-0.6087108948499106,6
3525,63,70,107,32,-0.6147702937762418,38
3526,58,22,31,11,-0.6168553703735028,11
3527,30,54,87,28,-0.6174654268347542,26
3528,38,12,40,7,-0.6179079194784384,5
3529,18,19,12,10,-0.6189201728029502,9
3530,96,30,76,16,-0.6223340675935105,14
3531,71,33,36,16,-0.6241330409639598,17
3532,37,40,65,19,-0.6273579146862459,21
3533,1,23,60,12,-0.6297573562891176,11
3534,13,36,57,17,-0.6298547457994873,19
3535,64,28,4,15,-0.6316212138641698,13
3536,20,34,13,18,-0.6324978295967559,16
3537,20,16,93,9,-0.6327174645108351,7
3538,3,53,87,27,-0.6346454534083904,26
3539,41,22,70,10,-0.6354721735396389,12
3540,13,32,11,16,-0.6360774726880134,16
3541,36,17,111,9,-0.6365354853619557,8
3542,41,25,25,11,-0.6394054706376676,14
3543,72,10,62,5,-0.6423355932907707,5
3544,50,16,98,8,-0.6426219058041119,8
3545,77,27,86,14,-0.643410523776974,13
3546,13,29,38,13,-0.6435009476526606,16
3547,109,10,2,5,-0.6444253237530958,5
3548,17,36,13,19,-0.6540411403366841,17
3549,51,60,55,31,-0.6653649036389623,29
3550,114,40,37,22,-0.6680388190804033,18
3551,60,26,109,13,-0.6737568590431613,13
3552,86,61,68,30,-0.6740238717236797,31
3553,23,14,109,7,-0.6795387556597896,7
3554,25,19,18,9,-0.6816652439852758,10
3555,78,19,65,11,-0.6880603416300914,8
3556,98,10,62,5,-0.6900751788017029,5
3557,54,27,19,13,-0.6912195373922553,14
3558,86,62,30,33,-0.6919884346770153,29
3559,68,40,3,21,-0.692411811382061,19
3560,93,17,11,7,-0.6934063282822591,10
3561,13,73,86,36,-0.6943738187395492,37
3562,90,34,16,16,-0.6982734048169768,18
3563,95,11,57,7,-0.6989616542578677,4
3564,91,11,38,6,-0.7003822911270713,5
3565,104,23,18,10,-0.7012089452274208,13
3566,12,32,51,16,-0.706288263251594,16
3567,27,18,106,11,-0.7074485049679552,7
3568,19,26,78,14,-0.7133948255014938,12
3569,28,13,82,6,-0.7153587234866207,7
3570,40,18,61,9,-0.7154895706830816,9
3571,65,89,86,43,-0.7181707847876246,46
3572,41,11,38,5,-0.7228455766820556,6
3573,13,25,34,13,-0.7239998114991915,12
3574,17,24,8,12,-0.7243993806611906,12
3575,27,67,68,34,-0.7269677534425147,33
3576,96,10,71,5,-0.7278695572627789,5
3577,9,27,3,14,-0.7284011303001917,13
3578,15,33,19,17,-0.7305240237414563,16
3579,17,24,68,13,-0.7306498470996451,11
3580,5,41,95,20,-0.7316066534315533,21
3581,87,18,17,9,-0.7339013030227953,9
3582,86,77,40,41,-0.7352757671814375,36
3583,63,40,5,18,-0.7358500176759462,22
3584,63,28,78,14,-0.7387444601081149,14
3585,15,24,25,11,-0.7394428200536295,13
3586,64,22,38,11,-0.741675899909911,11
3587,74,13,36,8,-0.743717573303844,5
3588,84,24,46,13,-0.7446057703540011,11
3589,13,15,14,9,-0.751185424264851,6
3590,103,18,87,8,-0.752980216865975,10
3591,77,60,60,30,-0.757689240199574,30
3592,100,43,39,23,-0.7598624549967818,20
3593,69,20,50,9,-0.7658320012010571,11
3594,93,20,97,10,-0.7717644600090567,10
3595,107,34,17,17,-0.7719574333138975,17
3596,84,19,10,10,-0.7730240789929577,9
3597,57,21,55,12,-0.7741765920845289,9
3598,54,33,84,17,-0.7745949946915581,16
3599,99,22,87,12,-0.7762165713325071,10
3600,28,51,13,26,-0.7790491963091725,25
3601,86,25,35,14,-0.7790661728530298,11
3602,41,48,39,23,-0.7814214856066567,25
3603,104,18,4,8,-0.7872554057904768,10
3604,3,15,96,7,-0.7883607611625825,8
3605,33,14,75,8,-0.7900898585820659,6
3606,89,16,28,9,-0.7901986413516622,7
3607,88,22,2,11,-0.7956469041111237,11
3608,107,55,27,29,-0.7992639473344536,26
3609,107,62,39,31,-0.8038504831284012,31
3610,40,26,30,13,-0.8045580871786177,13
3611,40,14,56,7,-0.8062835825274064,7
3612,50,31,84,15,-0.8064114901977935,16
3613,107,58,96,31,-0.8081270899904945,27
3614,79,16,7,8,-0.8085663274395147,8
3615,20,27,74,13,-0.8203305748765273,14
3616,45,19,114,10,-0.8205689132017484,9
3617,95,15,84,8,-0.8218033746912378,7
3618,13,21,33,11,-0.8258824761164265,10
3619,37,48,28,24,-0.8263140292594411,24
3620,106,12,29,6,-0.8264692442725535,6
3621,114,15,33,7,-0.8283609152315335,8
3622,46,16,2,8,-0.8285194662826783,8
3623,94,10,103,5,-0.8351093164432413,5
3624,98,14,60,7,-0.8439389777307166,7
3625,102,13,39,7,-0.8492100400200481,6
3626,64,20,3,10,-0.851200642390092,10
3627,64,14,77,6,-0.8550421959375909,8
3628,87,30,46,17,-0.8552141932237242,13
3629,114,10,10,6,-0.8617397018011254,4
3630,37,67,8,34,-0.8700084298071528,33
3631,109,37,87,20,-0.8703115701493915,17
3632,84,17,60,7,-0.8716143564890693,10
3633,7,11,108,5,-0.8716332223147826,6
3634,23,18,112,10,-0.8735906898502463,8
3635,91,17,84,9,-0.8755346549877636,8
3636,11,24,48,12,-0.8788776562363085,12
3637,50,15,12,10,-0.8796715451198305,5
3638,88,21,83,10,-0.8798897555023183,11
3639,83,17,60,9,-0.8851626447494985,8
3640,87,25,2,13,-0.8933815990593448,12
3641,47,40,39,21,-0.8944840301858618,19
3642,41,29,57,15,-0.8954953678172468,14
3643,74,17,68,10,-0.9001065237726515,7
3644,50,14,62,8,-0.9017457082495504,6
3645,14,11,112,5,-0.9022319115654427,6
3646,75,35,36,16,-0.9076169876586756,19
3647,95,16,76,8,-0.9107888940485349,8
3648,86,58,114,29,-0.9108151717298286,29
3649,50,17,43,10,-0.911659904777202,7
3650,1,14,39,9,-0.9120351629887077,5
3651,65,27,84,14,-0.9123622527895618,13
3652,112,20,50,11,-0.9149514035999712,9
3653,114,27,75,14,-0.9181862737012573,13
3654,68,24,77,12,-0.9242995453914947,12
3655,86,17,33,8,-0.9246066959077452,9
3656,40,29,18,17,-0.9358054757186769,12
3657,53,23,63,12,-0.9461903574638926,11
3658,28,53,11,26,-0.9471001149278931,27
3659,87,48,11,23,-0.9557806673361199,25
3660,5,14,14,8,-0.9561035605846475,6
3661,19,30,39,17,-0.9567662164680278,13
3662,29,17,54,9,-0.9568622693148616,8
3663,30,12,62,7,-0.9579903874565545,5
3664,103,11,106,5,-0.9583580547252434,6
3665,106,38,104,19,-0.9604760273979325,19
3666,12,13,54,6,-0.9644229325307594,7
3667,51,40,53,20,-0.9719493528973238,20
3668,50,37,39,19,-0.9722598320230015,18
3669,9,12,78,6,-0.9745877106891214,6
3670,5,65,107,33,-0.9748363761521153,32
3671,16,74,54,37,-0.9751249558189024,37
3672,65,17,94,8,-0.9759953242635646,9
3673,94,26,68,13,-0.9784286061310443,13
3674,107,29,78,15,-0.9948158487515274,14
3675,11,49,39,25,-0.9952251008535983,24
3676,17,37,37,21,-0.9978108601802036,16
3677,68,25,12,13,-0.9980215472612626,12
3678,93,11,114,5,-1.0049906589581687,6
3679,75,43,13,23,-1.0053644322647692,20
3680,88,12,45,7,-1.005819520359159,5
3681,94,19,100,11,-1.0113147613006637,8
3682,28,52,87,26,-1.0126365910584707,26
3683,51,78,88,36,-1.0127086502414946,42
3684,94,27,107,12,-1.0140230754913548,15
3685,33,10,70,5,-1.0222975969230645,5
3686,15,18,114,9,-1.0230376199980897,9
3687,44,20,63,11,-1.0233184771026504,9
3688,11,42,50,22,-1.023650114717526,20
3689,9,56,13,30,-1.029692328241817,26
3690,3,14,45,7,-1.0349134798027073,7
3691,18,59,7,29,-1.0365595161190124,30
3692,88,21,90,10,-1.0373159148886413,11
3693,33,16,104,9,-1.037548645615811,7
3694,51,35,18,17,-1.0414861976482428,18
3695,8,29,23,15,-1.0415352116212755,14
3696,13,60,4,32,-1.0440840904331994,28
3697,45,18,71,8,-1.050024616634439,10
3698,27,21,112,11,-1.0546603130658312,10
3699,48,18,20,10,-1.0556464172960118,8
3700,50,39,13,20,-1.0564386855316292,19
3701,44,14,100,7,-1.059041314786415,7
3702,3,11,103,5,-1.062442911366954,6
3703,78,20,11,9,-1.0625304486811953,11
3704,109,30,104,15,-1.063865849600061,15
3705,8,55,70,28,-1.0665028298167962,27
3706,71,14,58,7,-1.067952436399428,7
3707,16,47,19,24,-1.0685639199208607,23
3708,37,20,67,11,-1.0707700527635244,9
3709,97,19,64,10,-1.0748997556854094,9
3710,108,24,86,11,-1.0756567255515241,13
3711,74,13,40,7,-1.0901529369074696,6
3712,63,27,27,13,-1.0995729583369782,14
3713,106,39,70,19,-1.1024614638047292,20
3714,46,35,107,17,-1.1031099530770958,18
3715,2,18,96,9,-1.1039761816908782,9
3716,45,19,40,10,-1.1043531225931214,9
3717,47,12,91,6,-1.104710696366028,6
3718,86,41,49,19,-1.107105088053815,22
3719,55,13,73,7,-1.1082443575059588,6
3720,114,44,16,24,-1.1112389462801515,20
3721,3,20,55,10,-1.1206022099322233,10
3722,64,17,15,10,-1.1222199728342503,7
3723,69,21,114,12,-1.1298921487065041,9
3724,31,26,3,12,-1.1304098830558946,14
3725,106,26,36,13,-1.1307287364062808,13
3726,54,77,86,39,-1.1362741922890973,38
3727,38,24,88,14,-1.139732880510929,10
3728,45,20,64,11,-1.143150033869323,9
3729,69,16,109,8,-1.1468372776143363,8
3730,74,29,11,15,-1.1468410073590314,14
3731,57,40,86,22,-1.1475688399099468,18
3732,29,23,51,11,-1.1550549901650442,12
3733,74,14,12,7,-1.1676100167547812,7
3734,104,42,87,20,-1.170448333008427,22
3735,41,42,63,22,-1.1723857975845224,20
3736,57,13,103,7,-1.1771234726800728,6
3737,88,77,8,40,-1.177680669824634,37
3738,51,35,20,16,-1.185930371878434,19
3739,110,16,87,9,-1.1878037867151192,7
3740,65,100,13,53,-1.1890643952911066,47
3741,16,67,25,35,-1.193286529710067,32
3742,52,17,87,8,-1.19456043822466,9
3743,19,10,12,6,-1.195161104274304,4
3744,65,52,75,26,-1.1957967627587298,26
3745,107,56,11,30,-1.205224980974254,26
3746,7,44,63,26,-1.2086828652803665,18
3747,109,12,78,6,-1.2110516970103615,6
3748,97,33,25,17,-1.2112097532933461,16
3749,74,11,98,6,-1.2137114800422124,5
3750,20,81,86,43,-1.214920984168943,38
3751,100,10,58,5,-1.2172440717238615,5
3752,9,26,71,14,-1.2262156519313807,12
3753,41,33,60,16,-1.2319535203548821,17
3754,95,16,63,8,-1.233969730193377,8
3755,93,21,107,10,-1.2375139728583175,11
3756,60,47,65,27,-1.2375317971353974,20
3757,31,25,71,13,-1.2380158081615502,12
3758,4,30,107,15,-1.2387516471106224,15
3759,65,22,77,11,-1.2403405493552595,11
3760,55,16,108,9,-1.242512686909534,7
3761,62,11,17,6,-1.2486647888480198,5
3762,13,18,61,8,-1.2539314981714413,10
3763,16,15,73,7,-1.2607482082851342,8
3764,14,15,107,7,-1.262180496300674,8
3765,88,16,19,8,-1.2626760862124464,8
3766,65,27,50,14,-1.2644687002361992,13
3767,108,19,50,9,-1.270167576199734,10
3768,109,35,16,19,-1.2705603404571966,16
3769,1,11,71,5,-1.2732152302328004,6
3770,112,26,63,13,-1.2751001169998664,13
3771,15,15,30,8,-1.2763156051583031,7
3772,87,50,63,27,-1.2783017322984436,23
3773,41,79,7,40,-1.2803501469345888,39
3774,109,20,97,10,-1.2834069052578214,10
3775,65,13,103,6,-1.2841419220170633,7
3776,54,17,33,8,-1.2844291677407338,9
3777,74,53,16,28,-1.2870673809929654,25
3778,39,74,7,37,-1.288018081289336,37
3779,74,22,2,12,-1.2925512141562505,10
3780,8,22,7,12,-1.2952715014492404,10
3781,94,22,86,12,-1.3013050079007265,10
3782,112,30,107,15,-1.3015224651570323,15
3783,13,44,5,23,-1.3023509853743016,21
3784,104,14,20,8,-1.3034979892398526,6
3785,64,11,28,6,-1.3072442451375934,5
3786,58,28,9,15,-1.3102681358219028,13
3787,86,61,109,32,-1.3124186728291767,29
3788,51,12,32,6,-1.314434714983353,6
3789,8,16,10,9,-1.3145513780375313,7
3790,69,17,11,10,-1.3192593471132597,7
3791,80,18,74,9,-1.3199661328668575,9
3792,37,13,94,7,-1.3280387948229058,6
3793,107,81,51,46,-1.3323401894515607,35
3794,81,13,108,7,-1.3379621241230497,6
3795,23,10,6,5,-1.3385415186806267,5
3796,48,11,57,6,-1.344007986607393,5
3797,76,29,70,14,-1.3451436146232192,15
3798,40,17,108,8,-1.3479697301696822,9
3799,27,12,18,7,-1.348491059130869,5
3800,88,37,97,19,-1.3490743629309028,18
3801,49,29,30,15,-1.3512252684605837,14
3802,87,17,111,9,-1.3561671479223416,8
3803,70,39,107,19,-1.3599998705907195,20
3804,74,12,112,6,-1.3616749140437368,6
3805,30,26,25,12,-1.3633847180345777,14
3806,76,47,106,22,-1.3637390504385927,25
3807,27,30,30,15,-1.3682494404417145,15
3808,48,10,75,5,-1.3711471542080287,5
3809,55,66,86,35,-1.3714897734674971,31
3810,51,30,11,15,-1.3791878722705624,15
3811,41,30,106,15,-1.3806292559177735,15
3812,7,31,95,17,-1.3809406634768695,14
3813,29,24,3,13,-1.3836924057967057,11
3814,29,11,36,5,-1.3837445576600587,6
3815,3,17,23,9,-1.3867874330637044,8
3816,100,27,106,15,-1.3901554212918004,12
3817,87,36,29,20,-1.3938596381681114,16
3818,9,13,91,7,-1.3946381880594534,6
3819,44,12,75,7,-1.3998373775330364,5
3820,95,17,70,8,-1.4011695857654913,9
3821,19,18,112,10,-1.4017639667638637,8
3822,9,25,46,12,-1.4052752923291365,13
3823,71,20,12,10,-1.4059148964814152,10
3824,40,16,12,8,-1.412082266616442,8
3825,53,11,1,6,-1.4196819324858239,5
3826,55,23,71,11,-1.421958484011042,12
3827,45,35,36,16,-1.4232731245081227,19
3828,16,70,11,41,-1.4242284882623955,29
3829,86,56,70,30,-1.4292180536114512,26
3830,76,23,109,11,-1.4314797840953537,12
3831,114,10,34,6,-1.4351304706118744,4
3832,25,28,50,14,-1.4391705454909016,14
3833,97,21,20,10,-1.4395279608818727,11
3834,47,22,65,11,-1.444494672794184,11
3835,63,55,106,28,-1.4485566818099482,27
3836,88,62,46,31,-1.4519317579443416,31
3837,55,30,53,16,-1.4538038424746405,14
3838,89,16,50,9,-1.4560158637801313,7
3839,38,16,8,8,-1.4562520429495762,8
3840,83,23,25,13,-1.459720188055496,10
3841,47,21,31,11,-1.4606130980712662,10
3842,51,64,40,33,-1.4624658901194143,31
3843,43,13,23,7,-1.4628793390447175,6
3844,96,48,87,26,-1.4629434595612116,22
3845,3,24,71,13,-1.4668209780059573,11
3846,55,86,8,42,-1.4669142565908446,44
3847,69,13,6,6,-1.4672562795661197,7
3848,32,17,11,8,-1.4729852723414758,9
3849,55,23,20,12,-1.4733693688994078,11
3850,15,17,72,8,-1.4754546744739179,9
3851,63,15,73,7,-1.4760785674332912,8
3852,65,33,15,18,-1.478550295695263,15
3853,84,10,68,6,-1.4788993773509191,4
3854,71,74,60,39,-1.4843115108657061,35
3855,62,18,49,10,-1.4871791055161696,8
3856,100,13,53,7,-1.488662831422911,6
3857,5,52,46,28,-1.4974094901037482,24
3858,63,34,9,18,-1.4983458266579128,16
3859,43,18,25,11,-1.498458069864085,7
3860,107,29,98,15,-1.4990839762128414,14
3861,55,12,46,7,-1.514859018089955,5
3862,41,10,48,5,-1.5154908856574238,5
3863,37,14,35,7,-1.523131742310598,7
3864,65,26,83,13,-1.5253499649391125,13
3865,23,18,27,9,-1.5258397874765752,9
3866,84,20,114,11,-1.52828266290098,9
3867,53,13,29,8,-1.5317670028644754,5
3868,30,16,9,9,-1.5322802404962022,7
3869,12,28,100,14,-1.5326474539590176,14
3870,45,23,13,12,-1.5362814776486233,11
3871,69,12,103,6,-1.537264410654381,6
3872,107,36,34,20,-1.5429687484318224,16
3873,74,61,107,33,-1.5445233108407423,28
3874,74,41,87,22,-1.5487349955501406,19
3875,30,15,35,8,-1.5514803658178284,7
3876,41,51,51,27,-1.5522887413176736,24
3877,55,44,75,25,-1.5547955200380577,19
3878,83,23,104,13,-1.5563880557352991,10
3879,41,18,47,9,-1.5600411821999551,9
3880,106,26,109,13,-1.5621072878912867,13
3881,111,14,9,7,-1.5621342613374538,7
3882,60,34,3,18,-1.5692504603231594,16
3883,86,100,106,52,-1.5692663469089445,48
3884,114,31,102,17,-1.5708261870205498,14
3885,46,25,60,13,-1.5735893742532685,12
3886,90,22,55,10,-1.578656952498874,12
3887,81,22,107,12,-1.5816989267901087,10
3888,25,15,2,7,-1.5845186001024019,8
3889,86,113,107,60,-1.592838110533033,53
3890,75,11,14,6,-1.594721022285632,5
3891,18,10,94,5,-1.600111613157304,5
3892,18,19,81,10,-1.6163568658399634,9
3893,57,18,68,9,-1.6190755944848343,9
3894,87,17,44,9,-1.6239279411647838,8
3895,104,40,39,21,-1.6269347944157968,19
3896,13,67,39,36,-1.6320213008475832,31
3897,38,13,12,7,-1.6373364390809892,6
3898,78,16,15,8,-1.6428031530867082,8
3899,68,23,36,12,-1.6511686348202665,11
3900,28,56,88,30,-1.6526017973059586,26
3901,74,47,37,24,-1.6628163329711265,23
3902,48,19,106,10,-1.6634533717988316,9
3903,17,16,85,9,-1.6640468368595824,7
3904,39,41,9,20,-1.665141647727009,21
3905,79,17,11,8,-1.6671266405555225,9
3906,31,28,45,15,-1.6710870406691087,13
3907,11,11,77,6,-1.6811370630932267,5
3908,51,29,47,14,-1.68572259250394,15
3909,106,34,68,18,-1.6879506890966793,16
3910,5,64,28,33,-1.6933141899778517,31
3911,58,14,51,7,-1.6936471630550654,7
3912,23,15,36,6,-1.6972875274185715,9
3913,102,16,20,8,-1.6989391239814924,8
3914,86,44,23,23,-1.7030841833116435,21
3915,37,10,48,5,-1.703593750319215,5
3916,7,40,54,21,-1.7088310244062668,19
3917,34,20,50,11,-1.7118812894704334,9
3918,88,19,78,10,-1.7145225432730629,9
3919,30,21,106,11,-1.718691097444211,10
3920,45,15,63,8,-1.7260545689947928,7
3921,68,13,32,8,-1.7311662598089228,5
3922,75,19,70,9,-1.7314858975507368,10
3923,96,38,106,21,-1.7318320126651903,17
3924,106,19,48,10,-1.7335189393534853,9
3925,94,18,41,10,-1.7349354911168113,8
3926,65,97,54,51,-1.736712846037994,46
3927,88,37,36,21,-1.7392851936744331,16
3928,6,11,18,6,-1.7414584600944745,5
3929,36,33,60,17,-1.7416473627060742,16
3930,13,72,41,37,-1.7434827447987489,35
3931,112,19,51,10,-1.744621447758819,9
3932,29,17,7,7,-1.7467705733456498,10
3933,70,26,84,14,-1.7530345342228948,12
3934,96,56,8,30,-1.7581112090346545,26
3935,29,12,79,5,-1.76128914282749,7
3936,110,11,88,5,-1.7642228121429868,6
3937,65,12,79,6,-1.7650136214787937,6
3938,11,14,33,6,-1.768399073594802,8
3939,65,11,89,6,-1.7733881874637512,5
3940,100,21,23,12,-1.7758002431044055,9
3941,90,25,37,13,-1.7816453937181784,12
3942,6,16,87,8,-1.7863036764755194,8
3943,39,48,63,29,-1.7909082037503425,19
3944,30,33,100,19,-1.7960331282673354,14
3945,86,24,19,12,-1.797810425385066,12
3946,41,32,18,16,-1.8004819942826362,16
3947,31,34,51,20,-1.8036645224364214,14
3948,1,28,41,16,-1.8063913789876536,12
3949,69,24,30,12,-1.8065594670571032,12
3950,25,22,36,11,-1.8071440138268584,11
3951,72,28,13,14,-1.807218316507074,14
3952,48,24,11,13,-1.8103920900926083,11
3953,111,18,40,9,-1.8104998545748818,9
3954,77,20,49,12,-1.8145458804753243,8
3955,55,16,48,9,-1.8175056975255017,7
3956,109,11,71,6,-1.819641782820222,5
3957,99,13,102,7,-1.8212893413036864,6
3958,108,16,64,8,-1.8224151605655852,8
3959,114,13,44,7,-1.8263733365516708,6
3960,3,11,106,6,-1.8270221877820196,5
3961,13,29,74,15,-1.8278354237299068,14
3962,87,30,62,16,-1.829195534406874,14
3963,79,16,34,9,-1.8345236355969372,7
3964,96,38,84,19,-1.835648682700679,19
3965,20,30,114,16,-1.839540566254475,14
3966,16,33,72,18,-1.8444268023508033,15
3967,97,22,53,12,-1.8492466822191078,10
3968,7,30,49,17,-1.8540125722797829,13
3969,112,11,85,6,-1.86190112472257,5
3970,114,21,43,10,-1.8643335671695762,11
3971,5,95,37,49,-1.865428870342572,46
3972,41,19,46,11,-1.8674922785348609,8
3973,13,64,104,34,-1.8742619730677357,30
3974,79,14,8,6,-1.8787453444383126,8
3975,8,41,2,21,-1.8848654476169693,20
3976,49,28,17,13,-1.8850836144226466,15
3977,64,23,25,12,-1.8857238852847689,11
3978,106,35,20,19,-1.890590591428699,16
3979,99,27,55,15,-1.895072402151854,12
3980,78,40,86,21,-1.9016040417460842,19
3981,28,67,8,36,-1.9053784571291421,31
3982,12,13,104,7,-1.9063017472195456,6
3983,23,28,51,15,-1.9066169824504664,13
3984,1,38,68,20,-1.9099752765436673,18
3985,69,29,107,15,-1.9118248714259243,14
3986,50,18,27,11,-1.915159445860703,7
3987,17,11,110,6,-1.9155371371930654,5
3988,106,32,97,16,-1.9159665785715099,16
3989,76,11,99,5,-1.9173589523208336,6
3990,64,43,53,23,-1.9214578200473016,20
3991,79,10,9,6,-1.9224211679655938,4
3992,50,40,63,22,-1.9230864117365445,18
3993,18,21,114,11,-1.923577249757447,10
3994,28,89,16,48,-1.9239787295163941,41
3995,54,28,17,14,-1.9259736473512514,14
3996,40,19,70,11,-1.9276789997691202,8
3997,13,101,68,54,-1.9297155210568622,47
3998,97,14,23,7,-1.9330528734436563,7
3999,80,11,17,7,-1.9331063026674833,4
4000,51,31,30,17,-1.9376385589176919,14
4001,98,10,32,5,-1.9380052263831622,5
4002,7,49,71,24,-1.9387153694352766,25
4003,104,13,110,8,-1.9388474450810558,5
4004,31,14,23,8,-1.9392936999416424,6
4005,69,14,112,7,-1.9415067419167844,7
4006,55,20,25,11,-1.9429576796619947,9
4007,55,21,100,10,-1.9434302154951335,11
4008,43,13,29,7,-1.944708333004128,6
4009,48,15,7,7,-1.9478692265013033,8
4010,64,34,36,17,-1.9485056781764598,17
4011,93,12,3,5,-1.9498563082125628,7
4012,4,22,77,12,-1.9519179084153562,10
4013,71,12,78,6,-1.9545808326383198,6
4014,35,11,50,6,-1.9581460146246743,5
4015,46,22,57,12,-1.9631857780739894,10
4016,70,49,16,27,-1.9664047334731969,22
4017,53,28,95,17,-1.9769373995573178,11
4018,62,11,109,7,-1.97695013561549,4
4019,89,11,51,6,-1.9808331837442865,5
4020,25,38,28,22,-1.983389891159918,16
4021,4,19,53,10,-1.987694792892672,9
4022,102,31,54,16,-1.9889725083939205,15
4023,38,20,60,10,-1.9901891037372657,10
4024,112,15,104,8,-1.9939359727925703,7
4025,74,26,114,13,-1.997597253168688,13
4026,87,32,75,17,-2.0004298974911783,15
4027,46,26,68,14,-2.0015169846627177,12
4028,49,15,109,8,-2.005068879120546,7
4029,97,22,83,10,-2.007636873207568,12
4030,23,53,16,28,-2.0138073604151776,25
4031,70,29,68,15,-2.015118158104638,14
4032,8,28,30,15,-2.0154533572428934,13
4033,37,14,69,7,-2.015512849900142,7
4034,29,15,49,8,-2.0167142898536237,7
4035,60,11,93,7,-2.018629631632218,4
4036,90,37,8,21,-2.01946478207178,16
4037,17,27,114,16,-2.021159075364869,11
4038,77,16,19,8,-2.021640433575591,8
4039,60,32,18,17,-2.0244266182620265,15
4040,13,11,32,6,-2.026181507027533,5
4041,9,29,60,17,-2.026686622824744,12
4042,114,14,91,7,-2.031242634143396,7
4043,17,21,104,11,-2.0345116655508884,10
4044,50,13,83,6,-2.034563553464953,7
4045,88,59,40,32,-2.0357313010299647,27
4046,107,51,50,26,-2.036952672125099,25
4047,38,27,68,15,-2.039399077627948,12
4048,65,55,8,29,-2.0395157801522825,26
4049,55,14,62,7,-2.046538103530902,7
4050,88,21,93,12,-2.047097578055207,9
4051,11,36,76,20,-2.0480657920426975,16
4052,80,31,65,16,-2.05091984654234,15
4053,111,36,65,20,-2.0553404376319313,16
4054,90,45,86,25,-2.0574221764428238,20
4055,84,29,109,16,-2.0613350089090186,13
4056,112,27,13,13,-2.066814940463589,14
4057,103,14,41,8,-2.076284884491567,6
4058,63,10,82,5,-2.0779758612966877,5
4059,65,22,49,12,-2.0830665646343465,10
4060,65,47,74,24,-2.0847963525870905,23
4061,51,14,44,9,-2.0848742289559725,5
4062,68,43,64,25,-2.0864244028015873,18
4063,11,18,40,9,-2.089442100461012,9
4064,17,18,100,11,-2.090563721437295,7
4065,91,12,17,7,-2.0932516032559643,5
4066,8,22,97,11,-2.094799206270941,11
4067,55,34,83,17,-2.0962093979720193,17
4068,64,18,49,9,-2.0966931160090687,9
4069,79,18,84,9,-2.0988599029371886,9
4070,38,33,86,18,-2.1054154187023446,15
4071,107,32,108,17,-2.10558050439271,15
4072,25,11,69,6,-2.112059751085246,5
4073,103,10,49,5,-2.1127168420698537,5
4074,33,12,74,6,-2.113811361821,6
4075,72,17,7,9,-2.1143024060967655,8
4076,64,20,1,10,-2.116432620959366,10
4077,70,11,53,6,-2.117480208536356,5
4078,9,62,7,31,-2.1219031094822904,31
4079,84,26,37,14,-2.1240499046478805,12
4080,103,15,29,9,-2.126850900399907,6
4081,39,39,71,21,-2.140211900940766,18
4082,69,11,55,6,-2.141856565606558,5
4083,64,14,80,7,-2.1424879291036816,7
4084,87,33,94,17,-2.145346807231599,16
4085,75,23,27,12,-2.147610142787537,11
4086,68,49,111,25,-2.156897460223202,24
4087,86,14,6,8,-2.158350497876565,6
4088,53,13,23,7,-2.1639220781507644,6
4089,15,27,60,14,-2.171860166784133,13
4090,93,16,84,8,-2.173203038685071,8
4091,87,20,12,11,-2.1791805146637397,9
4092,70,26,63,14,-2.1813121472430432,12
4093,1,13,27,8,-2.1856131991088628,5
4094,74,64,8,36,-2.1866220406514896,28
4095,54,10,31,5,-2.1866689261471493,5
4096,40,33,41,17,-2.193580777269949,16
4097,40,75,7,42,-2.1957521283064807,33
4098,8,21,49,12,-2.200409925453829,9
4099,88,63,60,35,-2.2053487740970468,28
4100,96,50,5,28,-2.21142719225076,22
4101,48,19,30,11,-2.214390961078286,8
4102,51,12,93,6,-2.216632142916852,6
4103,98,14,18,6,-2.2211477971408065,8
4104,99,13,98,6,-2.22125816779338,7
4105,15,10,84,5,-2.223805292340998,5
4106,33,11,88,5,-2.224220943421554,6
4107,39,43,75,21,-2.225217366532354,22
4108,25,16,90,9,-2.226157693683706,7
4109,74,27,20,15,-2.230377352624161,12
4110,20,14,18,8,-2.233452860395892,6
4111,114,26,4,13,-2.2345648368573685,13
4112,38,12,27,7,-2.23479593643982,5
4113,102,13,68,7,-2.236457068947329,6
4114,93,23,86,12,-2.237724496402238,11
4115,20,17,19,9,-2.242877425050817,8
4116,27,10,70,5,-2.243263258457554,5
4117,4,38,88,20,-2.24592170041755,18
4118,83,11,63,7,-2.251852755522098,4
4119,29,17,8,8,-2.251936716192377,9
4120,25,30,95,16,-2.25397314365567,14
4121,106,62,87,32,-2.262204101784014,30
4122,88,45,106,26,-2.2639858690375605,19
4123,50,10,94,6,-2.2653355679184144,4
4124,7,12,85,7,-2.267272935114745,5
4125,96,66,28,35,-2.2674069446039327,31
4126,13,105,16,58,-2.2678537228667808,47
4127,39,22,76,13,-2.2682292990996733,9
4128,31,10,61,5,-2.2696136748473594,5
4129,81,11,30,6,-2.2701194832900797,5
4130,30,24,28,12,-2.27424472642601,12
4131,40,47,9,26,-2.2806450266015688,21
4132,65,19,48,9,-2.2816603054261098,10
4133,81,10,38,5,-2.2819621266449897,5
4134,72,16,112,9,-2.282010005577547,7
4135,15,14,28,7,-2.2866447045365517,7
4136,4,13,106,6,-2.287883468044352,7
4137,38,20,9,11,-2.29299513080546,9
4138,5,24,100,13,-2.2932427434044693,11
4139,81,15,9,8,-2.297406284952818,7
4140,80,14,38,8,-2.298510172204199,6
4141,32,21,86,11,-2.2989864902239,10
4142,95,26,60,14,-2.3000350580848172,12
4143,48,38,16,20,-2.301212431291267,18
4144,50,12,58,6,-2.303376752943112,6
4145,102,23,65,14,-2.30600661893797,9
4146,48,18,109,9,-2.3066244801907967,9
4147,37,23,57,12,-2.3105129908375908,11
4148,63,31,71,17,-2.3112629873314643,14
4149,91,32,88,17,-2.315767764685103,15
4150,102,21,104,10,-2.320627297470276,11
4151,100,19,64,11,-2.3242856391883246,8
4152,64,23,50,12,-2.3285304422785043,11
4153,5,51,109,26,-2.3285813949081646,25
4154,53,28,25,14,-2.3301510854690832,14
4155,17,19,90,9,-2.330539928781356,10
4156,34,16,11,8,-2.3341210419053553,8
4157,50,13,6,7,-2.341492332331065,6
4158,38,12,114,6,-2.3415263774379937,6
4159,20,15,57,8,-2.347711294302424,7
4160,58,19,87,10,-2.349067339134257,9
4161,31,36,4,21,-2.3535355966794675,15
4162,33,12,99,7,-2.354570382478156,5
4163,109,14,96,8,-2.3566759619593642,6
4164,97,14,100,8,-2.3583259709010784,6
4165,88,44,64,25,-2.359083003612554,19
4166,5,23,99,12,-2.3616219022642833,11
4167,97,13,49,8,-2.3668261814242064,5
4168,50,24,40,14,-2.3671440474550494,10
4169,63,32,25,16,-2.368826537360261,16
4170,79,18,107,9,-2.369737766723554,9
4171,29,31,16,16,-2.3747726163132454,15
4172,107,40,71,23,-2.3760609676092477,17
4173,79,11,78,6,-2.376529733586171,5
4174,56,13,75,8,-2.3840139649043506,5
4175,104,25,96,14,-2.3866419839158355,11
4176,71,21,4,13,-2.3871750117365993,8
4177,95,40,104,22,-2.389034218387607,18
4178,8,12,111,6,-2.390343846489093,6
4179,39,34,114,17,-2.3958348089760833,17
4180,54,22,78,12,-2.3960681894605513,10
4181,28,38,46,22,-2.3990178798165633,16
4182,98,15,114,8,-2.3992721750256893,7
4183,60,42,87,21,-2.4012724988605805,21
4184,80,26,20,14,-2.4033351571638573,12
4185,69,18,9,10,-2.4050002453980612,8
4186,66,13,106,8,-2.407503356329986,5
4187,41,79,65,45,-2.4080580159017053,34
4188,93,33,8,17,-2.4111455321691304,16
4189,92,11,65,6,-2.411285975254871,5
4190,28,28,60,13,-2.412225021834092,15
4191,20,38,88,19,-2.4156839797078273,19
4192,39,43,15,25,-2.418382000362182,18
4193,25,46,107,24,-2.4187485647838773,22
4194,99,11,109,6,-2.419517402501058,5
4195,72,15,78,9,-2.424013213948673,6
4196,88,35,1,18,-2.42517729077247,17
4197,75,20,91,7,-2.4323694332612673,13
4198,51,19,14,12,-2.4338441230915153,7
4199,106,39,55,22,-2.4381392466666045,17
4200,49,34,27,19,-2.439305003916989,15
4201,88,31,96,16,-2.4406464912019885,15
4202,112,21,41,11,-2.4417078305364504,10
4203,50,10,32,4,-2.4440541907162716,6
4204,3,12,97,7,-2.446105897661353,5
4205,86,31,85,17,-2.4546113819809183,14
4206,86,17,110,9,-2.4597124602837575,8
4207,25,32,102,17,-2.4608896969250464,15
4208,1,17,17,9,-2.4627610735098764,8
4209,7,23,35,12,-2.4646463019795055,11
4210,69,17,74,8,-2.466497282082454,9
4211,81,17,4,10,-2.467812477706327,7
4212,94,17,29,9,-2.4688976711363555,8
4213,51,45,28,23,-2.4700416123614737,22
4214,20,20,17,11,-2.47595507024807,9
4215,3,10,108,6,-2.477836063135272,4
4216,19,22,11,13,-2.4814293056100714,9
4217,62,15,76,8,-2.4840168024368525,7
4218,12,51,65,26,-2.4898655088795336,25
4219,111,11,18,6,-2.489910872635885,5
4220,109,18,37,10,-2.5010134043415313,8
4221,86,35,15,19,-2.503101898625041,16
4222,90,12,76,7,-2.508314572835213,5
4223,36,15,12,8,-2.5163199425137495,7
4224,61,10,39,6,-2.517649440036281,4
4225,102,28,16,15,-2.521941049128146,13
4226,54,34,80,17,-2.5244394841569355,17
4227,11,17,14,10,-2.5264878637219237,7
4228,4,18,39,10,-2.5267698999647226,8
4229,9,33,36,18,-2.527924078037467,15
4230,30,19,99,11,-2.5303882936847786,8
4231,107,15,44,8,-2.5305445670994087,7
4232,17,29,7,16,-2.5320894413613915,13
4233,95,20,20,11,-2.5325274069422727,9
4234,87,37,23,21,-2.533099907466406,16
4235,60,11,111,7,-2.535604443502029,4
4236,8,35,60,18,-2.536424306703014,17
4237,60,25,63,14,-2.5472563824704046,11
4238,36,74,7,40,-2.54935875079736,34
4239,76,14,44,8,-2.550414193143335,6
4240,1,19,73,11,-2.5534291003907295,8
4241,11,21,7,12,-2.554018943860652,9
4242,60,25,19,12,-2.5645143463204776,13
4243,16,74,60,40,-2.565466114346731,34
4244,71,17,43,8,-2.566802100052458,9
4245,60,74,13,42,-2.5700272960349397,32
4246,65,10,21,6,-2.570147671925826,4
4247,11,42,63,25,-2.575959327519446,17
4248,47,10,62,6,-2.5775304802735826,4
4249,107,31,15,19,-2.5879532445853206,12
4250,18,33,86,19,-2.5923706641316473,14
4251,109,10,1,5,-2.592960677140225,5
4252,91,23,36,13,-2.600483205457647,10
4253,107,25,85,13,-2.601380149286501,12
4254,66,10,72,5,-2.6022001256645586,5
4255,1,29,40,16,-2.608102727316189,13
4256,108,15,75,8,-2.611880297816683,7
4257,64,28,75,15,-2.614396425436705,13
4258,68,107,7,58,-2.6156429768400975,49
4259,89,10,39,6,-2.6189716831037586,4
4260,16,29,34,16,-2.621113610918132,13
4261,28,42,39,22,-2.623339407780362,20
4262,86,36,91,19,-2.627461430980282,17
4263,51,30,57,16,-2.6325183911561094,14
4264,54,13,110,7,-2.6358849029934492,6
4265,95,14,33,8,-2.6415453896084555,6
4266,6,17,88,9,-2.643401887191552,8
4267,5,60,16,35,-2.643518445682432,25
4268,17,11,69,6,-2.6459482609406546,5
4269,27,23,34,12,-2.648784778319574,11
4270,16,69,104,38,-2.6531110726496308,31
4271,36,13,57,8,-2.653116090105381,5
4272,88,29,92,16,-2.65412565592523,13
4273,8,83,86,42,-2.6562990548559324,41
4274,91,13,74,7,-2.658254293210725,6
4275,54,60,87,34,-2.6650322993001607,26
4276,46,26,97,14,-2.665342497244284,12
4277,7,118,13,63,-2.6708973171944717,55
4278,44,17,25,9,-2.673535476281759,8
4279,5,25,39,13,-2.6791322172692884,12
4280,58,14,43,8,-2.6806335210316137,6
4281,37,15,43,7,-2.6829353153059516,8
4282,107,21,93,12,-2.6848247910711387,9
4283,48,25,8,14,-2.6857985301597798,11
4284,71,40,65,23,-2.6867803351656674,17
4285,114,14,11,7,-2.6963511699419747,7
4286,43,22,69,12,-2.702803348063912,10
4287,79,11,39,7,-2.7039365709334438,4
4288,87,19,77,10,-2.7097429007992067,9
4289,60,24,11,13,-2.7103784095056325,11
4290,60,39,43,21,-2.71188258861537,18
4291,70,16,49,8,-2.7131214221068403,8
4292,80,11,95,6,-2.7197438471090796,5
4293,70,31,104,17,-2.7208109249750048,14
4294,88,53,55,31,-2.721264805593774,22
4295,88,16,44,8,-2.7255415222047015,8
4296,34,12,75,6,-2.7327928404854562,6
4297,106,50,65,27,-2.735321183024918,23
4298,63,21,47,10,-2.7370968886641953,11
4299,63,12,99,6,-2.7377253409939377,6
4300,104,22,97,11,-2.7396377781056187,11
4301,8,12,112,6,-2.740736306324458,6
4302,43,14,70,8,-2.753352748891417,6
4303,96,34,97,17,-2.7556888339056815,17
4304,55,50,39,28,-2.7557845118577005,22
4305,15,10,108,6,-2.7564503223458745,4
4306,38,18,30,11,-2.7615561749512523,7
4307,86,92,63,53,-2.762468874862493,39
4308,77,17,5,9,-2.7658375671945885,8
4309,10,11,5,5,-2.7716738654503192,6
4310,78,15,55,9,-2.779506680606731,6
4311,84,87,86,44,-2.7811330297923607,43
4312,91,31,28,17,-2.78581966806185,14
4313,43,20,63,11,-2.786559914173096,9
4314,104,19,43,9,-2.787160724490262,10
4315,97,15,9,7,-2.7891659901703596,8
4316,102,12,70,5,-2.7906887378625402,7
4317,86,20,29,11,-2.792063681419593,9
4318,36,13,100,7,-2.7923934619121096,6
4319,1,26,7,14,-2.793205495238504,12
4320,44,14,68,7,-2.795327721392829,7
4321,76,24,30,14,-2.801138786313347,10
4322,112,14,106,7,-2.805082024542768,7
4323,107,85,65,46,-2.8064984710190863,39
4324,41,15,99,8,-2.808167291861728,7
4325,36,32,1,16,-2.8095303452930684,16
4326,80,32,16,18,-2.812380168004337,14
4327,98,12,39,7,-2.813957257779375,5
4328,71,13,18,7,-2.821320109059578,6
4329,62,18,54,10,-2.824080555827827,8
4330,112,21,75,12,-2.824219405034075,9
4331,81,23,53,13,-2.832269045840244,10
4332,74,33,104,19,-2.832959821636547,14
4333,39,33,95,18,-2.8414955259540986,15
4334,65,59,39,30,-2.843397973105762,29
4335,76,24,46,13,-2.8453201116747966,11
4336,102,25,8,13,-2.845551076408804,12
4337,43,27,51,14,-2.845756036190169,13
4338,44,13,28,6,-2.846139863099275,7
4339,33,13,97,7,-2.8486496222061595,6
4340,19,11,47,6,-2.850072597752839,5
4341,96,16,73,9,-2.853430398009382,7
4342,99,18,51,9,-2.8534777973740635,9
4343,11,15,62,8,-2.85616533210433,7
4344,35,20,16,12,-2.8584328475668594,8
4345,27,39,41,22,-2.8659900681768367,17
4346,88,14,72,8,-2.866088260356642,6
4347,63,23,46,11,-2.867241869896345,12
4348,51,15,79,7,-2.868534324371066,8
4349,17,10,88,4,-2.869337502995377,6
4350,1,14,112,9,-2.8723250567679255,5
4351,53,12,57,6,-2.8739584447786406,6
4352,87,23,83,12,-2.880053494146307,11
4353,63,20,49,11,-2.8831531570492124,9
4354,20,16,15,9,-2.8857490776615986,7
4355,34,14,100,7,-2.888360425828717,7
4356,74,24,75,14,-2.8903655619324415,10
4357,70,10,44,5,-2.8975248911261424,5
4358,18,33,88,17,-2.9003137586881174,16
4359,37,19,91,10,-2.9050960547005253,9
4360,43,26,27,14,-2.9051148604445527,12
4361,15,39,57,21,-2.909444407309322,18
4362,28,100,86,56,-2.9116733038896894,44
4363,108,12,25,7,-2.9132670669268257,5
4364,71,27,62,14,-2.9154628309711708,13
4365,33,10,37,6,-2.9157377490462184,4
4366,106,19,102,9,-2.9207255392565092,10
4367,86,82,74,43,-2.9212877807151494,39
4368,109,36,88,20,-2.9253944348142844,16
4369,66,12,9,6,-2.9315079085260156,6
4370,28,21,33,10,-2.934003356051787,11
4371,87,20,36,12,-2.9355732508976633,8
4372,9,10,72,5,-2.9405168738711245,5
4373,51,16,103,9,-2.9437592352646322,7
4374,46,18,71,9,-2.9448527741935417,9
4375,65,20,18,10,-2.9468351166959508,10
4376,87,37,18,21,-2.947620136311878,16
4377,8,16,80,8,-2.9519293865537106,8
4378,29,17,11,9,-2.9579294594394727,8
4379,46,23,114,13,-2.9631435316072414,10
4380,7,19,80,11,-2.9635916880504127,8
4381,57,18,25,10,-2.964934950553877,8
4382,69,29,87,17,-2.9671312776586287,12
4383,53,11,47,6,-2.967218161853792,5
4384,37,21,2,11,-2.96975801126945,10
4385,4,32,36,19,-2.9739066740354194,13
4386,106,36,84,18,-2.9754739608250116,18
4387,1,13,46,6,-2.9771068452784495,7
4388,48,15,80,9,-2.9854010336942434,6
4389,43,20,41,11,-2.989275902448812,9
4390,69,11,4,6,-2.9994841766617175,5
4391,34,14,96,8,-3.001763014782562,6
4392,37,47,20,25,-3.0049852144749636,22
4393,85,12,100,6,-3.0085043711956274,6
4394,60,57,51,34,-3.013114139998441,23
4395,15,22,29,12,-3.0200823684900424,10
4396,102,12,23,6,-3.026398853405979,6
4397,99,12,27,6,-3.0280763102634345,6
4398,65,39,25,23,-3.0368934823131157,16
4399,61,10,2,6,-3.039871039725901,4
4400,96,13,38,7,-3.0422152322461713,6
4401,86,42,71,22,-3.0606693617391714,20
4402,25,18,71,10,-3.0644100067848146,8
4403,88,65,87,33,-3.0659618360137917,32
4404,65,78,87,43,-3.0670515598637706,35
4405,54,45,39,24,-3.0683277650145424,21
4406,8,14,72,7,-3.068653290400982,7
4407,25,30,75,17,-3.069551733540898,13
4408,87,14,45,8,-3.086220297325659,6
4409,37,59,107,32,-3.087858660035624,27
4410,51,38,114,19,-3.0897978746847414,19
4411,12,18,78,11,-3.093157669421852,7
4412,27,17,6,9,-3.0947871865212924,8
4413,51,48,8,26,-3.0985900488092186,22
4414,91,10,64,6,-3.0993479020870796,4
4415,74,16,88,10,-3.1000151762465555,6
4416,68,14,99,8,-3.100103615084465,6
4417,27,13,74,6,-3.1002755903304386,7
4418,60,15,92,9,-3.101629065738581,6
4419,84,40,87,22,-3.1041578272455426,18
4420,72,10,43,5,-3.1071314487034236,5
4421,9,48,107,25,-3.1085442155518606,23
4422,4,24,50,12,-3.1105592371369597,12
4423,17,25,25,14,-3.1106502600539105,11
4424,80,11,36,6,-3.1158574211756616,5
4425,63,17,15,9,-3.1218372056814427,8
4426,2,15,76,9,-3.135016863493125,6
4427,65,48,23,25,-3.1380450881841506,23
4428,45,12,112,6,-3.1460936650177533,6
4429,23,23,75,11,-3.148733601092015,12
4430,19,32,30,17,-3.14960926843718,15
4431,65,22,19,12,-3.1497530272597936,10
4432,64,15,46,8,-3.1520483223972673,7
4433,109,23,20,14,-3.152758187798737,9
4434,86,27,34,14,-3.1579503285893336,13
4435,7,51,104,28,-3.158219418007504,23
4436,82,21,86,12,-3.1586560919846263,9
4437,15,31,100,17,-3.1612204591054165,14
4438,8,13,12,8,-3.162053769151877,5
4439,112,37,86,21,-3.1630896844038348,16
4440,19,27,43,15,-3.1633742717174025,12
4441,100,11,109,5,-3.167660006953099,6
4442,74,14,90,9,-3.168061351028922,5
4443,69,30,88,17,-3.1706028089799116,13
4444,80,16,11,9,-3.1711610880303405,7
4445,60,25,106,15,-3.171261503808182,10
4446,27,57,13,31,-3.1745225043291074,26
4447,12,10,52,5,-3.1755936810484173,5
4448,30,12,74,6,-3.175828716417198,6
4449,27,23,29,14,-3.17938876042449,9
4450,114,31,54,16,-3.1847921316014234,15
4451,50,54,37,28,-3.1883352760136074,26
4452,5,61,88,32,-3.1946532218196624,29
4453,86,125,16,70,-3.1954608826555715,55
4454,39,41,36,23,-3.1998605067578225,18
4455,86,93,7,53,-3.2025353891099275,40
4456,17,28,106,17,-3.2039846830051117,11
4457,97,12,56,6,-3.2085312435870676,6
4458,85,13,69,7,-3.2091051872353304,6
4459,31,47,60,23,-3.2094707274879264,24
4460,97,19,50,11,-3.210625734622642,8
4461,74,16,17,9,-3.21177055102783,7
4462,28,39,55,23,-3.2184704312839756,16
4463,7,55,23,30,-3.222928305376168,25
4464,68,14,80,8,-3.230403837276107,6
4465,36,49,107,26,-3.234838704648262,23
4466,34,18,9,10,-3.2368917561941424,8
4467,60,25,99,14,-3.238194459102709,11
4468,81,12,23,7,-3.2407035870770007,5
4469,30,19,7,9,-3.2523104824501616,10
4470,25,47,114,27,-3.2540864225169766,20
4471,30,13,23,7,-3.2561149330077273,6
4472,74,24,7,15,-3.257493143792889,9
4473,86,24,12,13,-3.2584506314544455,11
4474,53,56,18,30,-3.2615252410170648,26
4475,54,56,28,31,-3.262278028179984,25
4476,104,53,88,30,-3.272915749347715,23
4477,67,13,114,7,-3.274670651234843,6
4478,86,49,60,27,-3.2754717222931737,22
4479,84,23,34,12,-3.279863737698052,11
4480,38,10,108,6,-3.2810871215401947,4
4481,78,16,28,8,-3.2870042494978406,8
4482,60,25,90,15,-3.2889183131065622,10
4483,35,15,55,8,-3.2899027901624813,7
4484,74,20,100,11,-3.292910754624951,9
4485,5,60,104,32,-3.3007473735225057,28
4486,61,13,47,7,-3.3043540506366424,6
4487,64,21,114,12,-3.304666725448282,9
4488,54,31,30,17,-3.308857710614803,14
4489,75,31,60,17,-3.313915862803686,14
4490,84,16,97,10,-3.316428205809935,6
4491,18,21,30,11,-3.316712750453976,10
4492,34,12,102,7,-3.3184893205114876,5
4493,97,14,98,7,-3.3185319117606182,7
4494,3,15,58,9,-3.323143757539543,6
4495,50,19,41,11,-3.331657114556132,8
4496,62,19,13,10,-3.3334526281247046,9
4497,5,13,68,7,-3.3380294056441127,6
4498,98,20,54,11,-3.3414082574983,9
4499,91,15,40,8,-3.345577169162442,7
4500,48,20,39,12,-3.3473079208220478,8
4501,20,10,83,5,-3.347889825164404,5
4502,107,15,14,9,-3.3479962116917545,6
4503,98,15,55,9,-3.3523199117731797,6
4504,70,30,88,17,-3.3524090493184286,13
4505,113,13,86,8,-3.3593996912401902,5
4506,106,17,14,10,-3.3600594128266095,7
4507,8,23,14,13,-3.3634201583462153,10
4508,97,25,54,13,-3.364815342765676,12
4509,20,17,40,10,-3.3649339637959637,7
4510,102,23,109,13,-3.3679677569149944,10
4511,86,44,27,26,-3.3766892599716627,18
4512,2,21,16,12,-3.37765100078353,9
4513,98,15,73,8,-3.3800553651819163,7
4514,55,28,36,15,-3.383336577257353,13
4515,69,29,65,16,-3.3859013073229325,13
4516,62,32,86,17,-3.3859108170773924,15
4517,60,53,39,28,-3.3874441110800557,25
4518,104,22,15,12,-3.389594982826921,10
4519,47,29,16,16,-3.391204750432155,13
4520,104,10,73,6,-3.391491099464731,4
4521,5,50,55,28,-3.393419962444799,22
4522,28,13,4,7,-3.3940824912486858,6
4523,88,28,43,16,-3.3979854748204095,12
4524,84,29,55,16,-3.4012305577969593,13
4525,65,34,97,19,-3.401757302918018,15
4526,51,49,27,28,-3.406135874269831,21
4527,57,11,60,6,-3.407293904392181,5
4528,78,24,100,13,-3.417029837437706,11
4529,36,11,17,5,-3.417273645156755,6
4530,97,12,11,6,-3.419346386793516,6
4531,37,12,4,7,-3.4218717037755084,5
4532,49,33,87,17,-3.4286324833249107,16
4533,40,58,60,32,-3.4423663485116376,26
4534,90,38,107,20,-3.442650987354403,18
4535,54,24,15,12,-3.443630034544425,12
4536,55,28,76,17,-3.4438952481653042,11
4537,87,37,95,20,-3.4486313771107993,17
4538,9,54,88,30,-3.4493718580292736,24
4539,39,38,64,21,-3.4500975704028973,17
4540,114,14,112,7,-3.4529529803290626,7
4541,23,21,37,11,-3.4530437057487418,10
4542,107,54,41,32,-3.453178235519936,22
4543,5,23,33,12,-3.454327509177194,11
4544,51,49,106,27,-3.457607975311812,22
4545,12,12,85,7,-3.459451075901635,5
4546,8,31,83,16,-3.465429893631149,15
4547,5,60,74,32,-3.4699961467083447,28
4548,3,19,78,10,-3.47049491050773,9
4549,87,28,71,15,-3.4759258377412983,13
4550,54,57,96,29,-3.47661338595835,28
4551,18,16,55,8,-3.481046717374471,8
4552,114,41,60,19,-3.4828028477548303,22
4553,70,20,25,11,-3.484518115943737,9
4554,68,64,88,36,-3.486456108196303,28
4555,109,12,94,6,-3.4867912538143684,6
4556,51,30,36,16,-3.4874600225025065,14
4557,36,13,62,7,-3.489528327052378,6
4558,69,14,29,7,-3.49166263710201,7
4559,114,36,97,20,-3.494809729950691,16
4560,9,26,50,15,-3.4989626487903873,11
4561,108,13,37,7,-3.5019197237718496,6
4562,109,27,25,15,-3.504136926234725,12
4563,50,43,2,24,-3.505217309368565,19
4564,23,16,74,9,-3.5053157619270587,7
4565,33,10,49,6,-3.5057518320537775,4
4566,30,18,29,11,-3.505962165042281,7
4567,107,87,13,47,-3.5079765133359704,40
4568,68,44,41,24,-3.511991254144042,20
4569,25,17,93,9,-3.530039788975629,8
4570,7,15,44,8,-3.535266020755452,7
4571,36,65,40,37,-3.5400829247343655,28
4572,46,46,51,26,-3.5405198677265264,20
4573,19,31,13,18,-3.544087166327379,13
4574,65,58,28,33,-3.546718886958019,25
4575,107,61,100,31,-3.5490642446687617,30
4576,65,49,53,26,-3.552341058928982,23
4577,4,13,30,7,-3.554167963462701,6
4578,36,19,28,10,-3.554999615354126,9
4579,46,64,13,37,-3.5585855949926106,27
4580,54,36,11,20,-3.5608789843396815,16
4581,64,41,107,22,-3.561300386963444,19
4582,34,28,17,15,-3.5624042820823494,13
4583,108,13,79,8,-3.562523700236057,5
4584,7,28,6,13,-3.5631855242339143,15
4585,33,13,39,7,-3.571514275871642,6
4586,68,34,15,20,-3.572606545718227,14
4587,60,16,61,8,-3.58082656290379,8
4588,39,19,58,11,-3.589328168519788,8
4589,95,10,97,6,-3.58943247133478,4
4590,27,39,39,23,-3.5923412859879735,16
4591,30,12,17,6,-3.5949084621895326,6
4592,102,12,62,7,-3.5957627994613386,5
4593,18,19,91,11,-3.6010074197876603,8
4594,107,31,29,20,-3.604834531178086,11
4595,38,25,16,16,-3.6053098096509713,9
4596,58,10,19,6,-3.612425741231674,4
4597,28,26,80,14,-3.6230809501897747,12
4598,28,23,69,12,-3.6258297557751527,11
4599,18,19,43,9,-3.6267699505365183,10
4600,51,28,1,15,-3.6289700363449007,13
4601,28,52,20,29,-3.638022846799735,23
4602,70,10,14,5,-3.6470421341148493,5
4603,18,11,17,5,-3.6519056838531805,6
4604,9,15,109,7,-3.6538651478462696,8
4605,77,20,55,11,-3.6546881978963213,9
4606,32,21,107,11,-3.6546977761524695,10
4607,71,10,90,5,-3.656103603020123,5
4608,88,13,79,8,-3.6585136161817045,5
4609,31,24,39,14,-3.6610558433956144,10
4610,77,16,3,8,-3.6659660860802834,8
4611,69,22,19,12,-3.669724343060302,10
4612,72,13,107,7,-3.6746684377826218,6
4613,39,66,86,35,-3.675688607163168,31
4614,79,28,16,16,-3.6774259843300863,12
4615,109,21,41,13,-3.680627728838234,8
4616,39,15,69,8,-3.680632334712715,7
4617,55,19,34,10,-3.680955248563573,9
4618,15,13,17,8,-3.6900193228115183,5
4619,61,14,86,8,-3.691831205405496,6
4620,28,19,23,10,-3.6970356039584393,9
4621,38,35,107,20,-3.69953035095411,15
4622,27,12,20,7,-3.701459696802648,5
4623,14,16,65,8,-3.707339765184437,8
4624,57,14,64,8,-3.711449015146855,6
4625,5,21,15,13,-3.7147342263498238,8
4626,88,42,11,24,-3.7150827621608298,18
4627,34,22,109,12,-3.7166229940188273,10
4628,11,55,8,31,-3.7180209594410503,24
4629,81,16,114,8,-3.722693092477206,8
4630,54,64,20,33,-3.7237387131550492,31
4631,60,14,89,7,-3.723763452657912,7
4632,11,13,112,7,-3.733612834435544,6
4633,29,18,78,10,-3.7345158409073327,8
4634,25,65,86,35,-3.735239092039536,30
4635,4,13,1,8,-3.7360390878519714,5
4636,54,52,46,29,-3.7381660486484787,23
4637,114,40,63,25,-3.7382776415303276,15
4638,15,21,49,11,-3.740905176365823,10
4639,7,31,15,15,-3.741081293807926,16
4640,40,42,53,23,-3.7429391558119995,19
4641,8,83,16,47,-3.7444025012578677,36
4642,79,16,103,9,-3.7466875459262354,7
4643,43,17,35,9,-3.749011557971226,8
4644,76,21,41,10,-3.750106309053706,11
4645,55,74,13,41,-3.754284327455479,33
4646,112,23,100,12,-3.761865576918162,11
4647,112,15,54,9,-3.769926832857171,6
4648,51,50,3,25,-3.7726881330184416,25
4649,4,19,63,11,-3.7758336578086884,8
4650,92,13,104,6,-3.7768187223532292,7
4651,93,10,7,5,-3.7802315490169662,5
4652,5,16,110,9,-3.8138584796050923,7
4653,91,28,5,17,-3.814625093066516,11
4654,3,11,4,6,-3.825046392091852,5
4655,39,31,17,18,-3.8276026993227674,13
4656,51,30,70,16,-3.8297117807076546,14
4657,51,14,85,7,-3.8310675840112265,7
4658,27,18,76,10,-3.831112831762446,8
4659,13,26,91,14,-3.8317482607331113,12
4660,8,13,43,7,-3.8325900737455147,6
4661,55,44,7,26,-3.8332053851439998,18
4662,46,13,38,8,-3.8338597693432233,5
4663,86,47,9,27,-3.8380910762902993,20
4664,7,26,20,14,-3.839940256500115,12
4665,31,23,18,12,-3.8430258307678655,11
4666,19,29,100,16,-3.8450919410133126,13
4667,49,47,16,27,-3.856038619160952,20
4668,63,41,74,22,-3.8635092916190312,19
4669,100,33,8,19,-3.8636022669254437,14
4670,49,14,72,8,-3.8721720183356294,6
4671,54,23,1,13,-3.8802733242992384,10
4672,104,33,41,17,-3.881745214521683,16
4673,17,27,28,15,-3.885054779321748,12
4674,18,18,3,11,-3.886785760617755,7
4675,57,23,28,13,-3.8971175709019774,10
4676,3,19,11,12,-3.8975052994357746,7
4677,63,30,55,16,-3.900377194965694,14
4678,91,15,102,8,-3.901213400624812,7
4679,37,26,102,15,-3.901578428361024,11
4680,90,11,64,6,-3.902108781861291,5
4681,15,11,12,6,-3.9125883634426826,5
4682,86,13,89,6,-3.9174928376954097,7
4683,70,38,37,22,-3.9227382855891673,16
4684,2,28,5,16,-3.923277825320168,12
4685,20,15,85,8,-3.925425491644285,7
4686,83,12,102,7,-3.9254792340582285,5
4687,50,11,57,7,-3.929027822248146,4
4688,77,23,30,13,-3.931781102600119,10
4689,58,10,12,6,-3.932621764213588,4
4690,16,35,97,19,-3.9340820840887147,16
4691,97,10,80,6,-3.9365866928471034,4
4692,40,11,6,6,-3.9442678680230827,5
4693,93,24,74,13,-3.960101768879081,11
4694,14,12,96,7,-3.975747798085754,5
4695,109,21,50,12,-3.977542968777511,9
4696,97,18,60,9,-3.9792005525226375,9
4697,68,13,89,7,-3.9920034832972595,6
4698,12,18,23,10,-3.9935881563943534,8
4699,51,124,16,68,-3.996412569683251,56
4700,112,16,31,10,-4.001730552260451,6
4701,87,34,76,20,-4.002198997417191,14
4702,107,111,16,67,-4.005718802977024,44
4703,71,33,30,18,-4.006253796204616,15
4704,31,12,66,7,-4.0087548725586535,5
4705,110,20,8,12,-4.013172679497405,8
4706,53,49,39,28,-4.0166114325479985,21
4707,96,21,39,13,-4.016816457185763,8
4708,47,31,7,18,-4.025431088719288,13
4709,47,13,71,7,-4.030916530509354,6
4710,10,10,104,5,-4.031221485043642,5
4711,43,10,1,5,-4.03897671575872,5
4712,76,26,98,15,-4.039201436166646,11
4713,51,25,71,14,-4.0432752193478,11
4714,88,43,23,26,-4.047882049914368,17
4715,40,10,32,5,-4.050021677419869,5
4716,20,10,14,6,-4.051966837258037,4
4717,107,73,88,42,-4.059899124075387,31
4718,95,10,43,6,-4.0633983206079485,4
4719,87,115,86,61,-4.065315076657942,54
4720,38,12,20,8,-4.067291998076463,4
4721,69,11,77,6,-4.068890242116286,5
4722,31,68,7,38,-4.069172309295859,30
4723,5,117,86,66,-4.074944655375777,51
4724,17,42,16,26,-4.080437647415331,16
4725,87,17,72,9,-4.084226461372779,8
4726,19,11,36,6,-4.0885902184216905,5
4727,51,51,17,27,-4.088673144397257,24
4728,48,13,68,7,-4.089226837234984,6
4729,79,11,112,6,-4.092088872238905,5
4730,54,33,104,18,-4.094488077381487,15
4731,68,24,47,14,-4.095710109800673,10
4732,35,24,20,14,-4.098728722002913,10
4733,93,20,83,11,-4.100880722204593,9
4734,63,30,97,17,-4.107378727934806,13
4735,68,27,69,15,-4.109870966876622,12
4736,2,12,7,7,-4.115660194227726,5
4737,57,21,3,12,-4.117819968250674,9
4738,62,44,16,27,-4.118561981785128,17
4739,65,22,45,11,-4.125923170388699,11
4740,94,16,112,10,-4.1306598471384035,6
4741,106,51,107,28,-4.131711792879518,23
4742,100,27,28,16,-4.1324003205004525,11
4743,27,51,7,28,-4.136091254496651,23
4744,20,11,71,7,-4.136430557393971,4
4745,88,18,77,10,-4.138723345512824,8
4746,71,47,53,27,-4.141303557057988,20
4747,95,12,100,6,-4.142851413596655,6
4748,73,13,20,8,-4.146065391689571,5
4749,76,18,84,10,-4.146116027740745,8
4750,68,14,43,8,-4.147550463856526,6
4751,17,12,99,7,-4.14837583337694,5
4752,84,60,28,34,-4.150279635735799,26
4753,45,21,16,13,-4.159967695863457,8
4754,3,27,65,16,-4.160831843058934,11
4755,5,40,83,21,-4.1637099044245005,19
4756,7,33,43,20,-4.178253566474207,13
4757,25,27,23,15,-4.182190113226027,12
4758,40,70,13,39,-4.189895916000412,31
4759,51,96,13,52,-4.190011069202016,44
4760,74,18,108,11,-4.201041319943182,7
4761,57,14,9,8,-4.201215618084039,6
4762,40,11,15,6,-4.201647176656486,5
4763,79,18,63,11,-4.2028913266701835,7
4764,4,22,55,12,-4.203282539310471,10
4765,36,56,65,32,-4.205692860728475,24
4766,87,28,90,16,-4.209781806456323,12
4767,81,28,60,16,-4.212467831654196,12
4768,63,20,17,11,-4.21709530073227,9
4769,31,21,87,11,-4.220659397575877,10
4770,18,19,4,11,-4.220670692754493,8
4771,109,36,51,23,-4.2212381059376325,13
4772,44,11,71,6,-4.223524348839462,5
4773,88,28,47,15,-4.22725076481323,13
4774,48,12,23,7,-4.227938531173128,5
4775,47,10,109,6,-4.236742850593237,4
4776,71,44,16,26,-4.241804878716307,18
4777,34,14,106,7,-4.243674039664674,7
4778,72,10,6,5,-4.248570153213719,5
4779,77,31,13,18,-4.260430131989071,13
4780,38,15,51,9,-4.261652425824846,6
4781,107,30,91,18,-4.264126621091654,12
4782,35,12,13,7,-4.295164540193832,5
4783,54,28,25,16,-4.300413553073274,12
4784,84,18,75,10,-4.30081159040195,8
4785,53,27,106,14,-4.302319600135899,13
4786,69,16,100,9,-4.302668928460351,7
4787,68,32,30,17,-4.304758571720151,15
4788,60,15,94,9,-4.3069509756796736,6
4789,52,10,50,5,-4.308197298973348,5
4790,8,10,31,6,-4.309099443279481,4
4791,30,20,20,11,-4.312859032774339,9
4792,17,23,97,13,-4.313428551304956,10
4793,98,27,104,13,-4.313899934387767,14
4794,98,15,100,8,-4.314873946898567,7
4795,71,14,70,7,-4.315612188206777,7
4796,40,22,4,12,-4.316643149060896,10
4797,81,14,64,8,-4.322376324615616,6
4798,41,19,95,11,-4.332143979792176,8
4799,22,12,60,7,-4.334241842742782,5
4800,16,27,103,15,-4.342154551822592,12
4801,48,20,34,11,-4.343261719849951,9
4802,65,29,70,18,-4.3439841796636145,11
4803,6,16,65,9,-4.346168811124812,7
4804,34,16,29,9,-4.350698487191081,7
4805,35,21,11,12,-4.351832206058097,9
4806,48,30,28,17,-4.353346769104993,13
4807,49,24,68,14,-4.355442333586808,10
4808,83,11,19,6,-4.359398192701051,5
4809,71,31,64,19,-4.35947313780117,12
4810,12,12,77,7,-4.361353303952197,5
4811,23,20,95,11,-4.361896262769259,9
4812,9,15,74,9,-4.36741522698094,6
4813,23,23,40,13,-4.36842332680331,10
4814,58,13,55,7,-4.369004483506263,6
4815,9,24,55,14,-4.371040618945101,10
4816,25,33,87,18,-4.379098196808543,15
4817,54,10,99,6,-4.3797228746123675,4
4818,104,39,8,22,-4.387577979866528,17
4819,86,20,111,12,-4.3910837466552355,8
4820,65,26,62,14,-4.393261785254973,12
4821,108,14,71,8,-4.402422140240547,6
4822,76,16,34,8,-4.406030161353481,8
4823,11,48,55,29,-4.407143063823052,19
4824,53,64,7,36,-4.416213736910661,28
4825,13,30,99,17,-4.420966828834257,13
4826,20,14,23,8,-4.42777867543601,6
4827,27,17,108,10,-4.43028987016657,7
4828,109,15,95,9,-4.444131433700797,6
4829,12,12,6,6,-4.448996636056325,6
4830,16,44,95,24,-4.453378575583385,20
4831,73,12,50,8,-4.454782630059153,4
4832,97,11,77,7,-4.454901155383999,4
4833,8,25,64,15,-4.455975265271213,10
4834,43,12,49,7,-4.460909191235433,5
4835,50,15,3,8,-4.464463620895281,7
4836,32,18,37,10,-4.466542082918519,8
4837,57,10,91,5,-4.468260927215542,5
4838,8,36,13,21,-4.469899391018223,15
4839,25,31,96,17,-4.472832877552798,14
4840,13,45,100,26,-4.473846856296722,19
4841,109,15,40,9,-4.473863564525377,6
4842,107,33,95,18,-4.475609109265347,15
4843,8,12,56,7,-4.475636615156397,5
4844,7,29,100,17,-4.479542671667202,12
4845,64,46,7,25,-4.4812400569888355,21
4846,102,21,11,11,-4.481690077928583,10
4847,40,50,65,28,-4.488092661947341,22
4848,37,15,93,9,-4.4934456656390305,6
4849,69,12,76,8,-4.499300236532236,4
4850,50,22,7,12,-4.501270679494319,10
4851,97,24,87,15,-4.5078366784517385,9
4852,94,26,19,15,-4.50854143638108,11
4853,69,10,80,5,-4.508733977407145,5
4854,93,16,20,8,-4.515352163146577,8
4855,55,43,37,23,-4.516821858156877,20
4856,50,23,74,13,-4.520207268757788,10
4857,48,18,13,10,-4.529838045170984,8
4858,67,12,88,8,-4.530239274992248,4
4859,28,71,50,41,-4.530365152854882,30
4860,75,23,106,12,-4.532198108241345,11
4861,29,14,9,8,-4.534452930887615,6
4862,85,16,28,9,-4.545964613502572,7
4863,46,22,7,14,-4.5459700479070815,8
4864,15,18,99,11,-4.551461310618722,7
4865,46,15,83,8,-4.551826612706302,7
4866,23,15,70,8,-4.554568026577778,7
4867,49,22,54,12,-4.559262424288583,10
4868,5,18,43,10,-4.5592775438308895,8
4869,51,20,102,11,-4.560982621023822,9
4870,104,16,99,8,-4.562749239239297,8
4871,41,25,11,16,-4.570786215270398,9
4872,95,14,99,8,-4.572737764013027,6
4873,58,23,7,12,-4.575034525669345,11
4874,87,21,14,13,-4.5778980416873605,8
4875,65,16,99,9,-4.579704538683142,7
4876,71,25,28,15,-4.584215619303487,10
4877,38,30,39,17,-4.587052274166916,13
4878,96,32,50,18,-4.592653394244437,14
4879,88,98,7,55,-4.595427152926362,43
4880,95,13,77,7,-4.601493224452909,6
4881,66,10,88,6,-4.60434245546846,4
4882,18,15,38,8,-4.607415756411176,7
4883,86,72,37,40,-4.607837359690986,32
4884,108,14,30,8,-4.615023887291242,6
4885,40,10,72,6,-4.6161082317709115,4
4886,23,52,107,29,-4.616513271093973,23
4887,16,54,75,30,-4.621070484571048,24
4888,68,46,114,26,-4.626031537231749,20
4889,92,15,51,8,-4.63031933752528,7
4890,110,15,106,8,-4.633960085739299,7
4891,25,22,60,12,-4.636282806493915,10
4892,109,19,73,11,-4.637139105733963,8
4893,25,13,48,7,-4.641698897655362,6
4894,13,14,73,8,-4.6427133386229835,6
4895,16,21,6,11,-4.642825718029856,10
4896,79,11,19,6,-4.64323690388041,5
4897,69,19,81,10,-4.644298837979568,9
4898,96,39,63,24,-4.649023449526139,15
4899,102,22,57,12,-4.651745927719437,10
4900,54,62,63,36,-4.6520172622159,26
4901,47,15,25,8,-4.655390231832644,7
4902,94,16,1,8,-4.659339262334038,8
4903,84,35,16,20,-4.661500226777163,15
4904,18,22,77,14,-4.676567510317278,8
4905,84,50,51,29,-4.68222685849612,21
4906,5,16,71,9,-4.686451238703376,7
4907,62,10,97,6,-4.689387738532959,4
4908,46,60,86,37,-4.689511214815467,23
4909,84,12,62,7,-4.699556310812963,5
4910,1,34,13,21,-4.702199298952773,13
4911,46,23,20,15,-4.708713070266484,8
4912,63,46,37,27,-4.710297957233592,19
4913,18,37,28,20,-4.710953949587104,17
4914,12,14,74,8,-4.7158981291394015,6
4915,54,39,13,23,-4.724295488509412,16
4916,86,20,47,12,-4.7250746523394085,8
4917,3,14,76,8,-4.7260181257182605,6
4918,19,19,103,11,-4.726080618836743,8
4919,75,14,15,9,-4.7291616067808215,5
4920,46,11,6,6,-4.730994669309113,5
4921,47,25,107,14,-4.7386499699721325,11
4922,77,16,25,9,-4.745845616411638,7
4923,5,30,90,18,-4.752640516818982,12
4924,86,50,100,26,-4.754450885173925,24
4925,50,16,93,10,-4.755526241513055,6
4926,41,31,64,19,-4.758473174288668,12
4927,68,30,19,18,-4.759028599089826,12
4928,3,41,39,22,-4.7627395011091425,19
4929,79,12,55,7,-4.763372141256467,5
4930,94,16,55,9,-4.767452995148862,7
4931,31,15,12,8,-4.770632464521183,7
4932,70,13,90,7,-4.771084444295363,6
4933,37,10,9,6,-4.7723167368365935,4
4934,20,31,11,19,-4.776863569942599,12
4935,5,12,9,7,-4.777710715122403,5
4936,104,57,86,32,-4.778923035703436,25
4937,50,49,16,28,-4.784924998830744,21
4938,5,33,76,19,-4.788314400539968,14
4939,76,24,97,13,-4.7891970450006545,11
4940,1,17,9,8,-4.79405950293998,9
4941,20,13,52,8,-4.795236183864801,5
4942,63,10,110,6,-4.795503234252321,4
4943,25,11,111,6,-4.797175922879397,5
4944,6,16,68,10,-4.799676836342989,6
4945,96,22,75,15,-4.80138149231193,7
4946,56,11,16,7,-4.802141402722699,4
4947,88,44,75,26,-4.804702938088101,18
4948,108,13,96,7,-4.805162668071275,6
4949,68,34,54,20,-4.806816214683671,14
4950,106,25,2,14,-4.808494527305082,11
4951,106,12,6,7,-4.810944704219048,5
4952,85,11,74,6,-4.812388004493803,5
4953,3,19,8,9,-4.813422384940692,10
4954,43,14,78,8,-4.8185074405539305,6
4955,54,15,14,10,-4.820525855929131,5
4956,25,19,31,10,-4.823839301099763,9
4957,9,47,65,28,-4.82612869570304,19
4958,90,13,41,7,-4.828201040811693,6
4959,67,15,8,9,-4.8319098461555825,6
4960,75,41,18,23,-4.835583954062301,18
4961,64,20,83,11,-4.840996077098241,9
4962,86,35,69,20,-4.843108927419924,15
4963,83,17,39,10,-4.845386042652696,7
4964,32,12,97,7,-4.851459349576838,5
4965,15,31,27,17,-4.856566063952166,14
4966,79,10,60,6,-4.86007767182391,4
4967,77,22,41,13,-4.860160553298337,9
4968,107,12,52,8,-4.8612628499818085,4
4969,20,45,87,25,-4.861780392772671,20
4970,89,10,5,7,-4.862465640901751,3
4971,106,54,37,29,-4.865641247327304,25
4972,1,11,29,7,-4.8669345755887905,4
4973,57,26,88,14,-4.87081224887015,12
4974,57,19,19,11,-4.879015154385094,8
4975,95,11,69,7,-4.882909765417962,4
4976,51,47,75,26,-4.890410363576285,21
4977,77,16,23,9,-4.892331871891682,7
4978,104,14,23,9,-4.897799558060742,5
4979,28,12,38,6,-4.907164394244693,6
4980,108,12,54,8,-4.909695920764134,4
4981,27,24,8,14,-4.910406785021338,10
4982,106,56,74,32,-4.924754963776778,24
4983,36,40,86,23,-4.927433251240003,17
4984,9,22,114,15,-4.931319071415344,7
4985,71,11,49,6,-4.9409457894604065,5
4986,28,27,93,17,-4.941127481170006,10
4987,81,23,39,14,-4.943832581007466,9
4988,6,15,51,9,-4.945330344973923,6
4989,106,29,80,17,-4.946009667025365,12
4990,18,14,76,8,-4.948055179076069,6
4991,68,19,56,10,-4.94813216675333,9
4992,7,103,16,58,-4.951928398872169,45
4993,39,29,57,16,-4.961767987225668,13
4994,96,21,51,12,-4.962296641036039,9
4995,107,44,76,28,-4.963511886446056,16
4996,90,23,96,14,-4.963939687748077,9
4997,38,16,109,10,-4.9644619615709695,6
4998,107,49,40,30,-4.964616090179718,19
4999,44,10,80,5,-4.973541413806909,5
5000,65,36,64,20,-4.987841540773512,16
5001,31,23,50,13,-4.991999785997781,10
5002,71,15,74,8,-4.993812181109021,7
5003,106,41,7,21,-5.003800212982272,20
5004,5,26,93,16,-5.004460526821323,10
5005,41,12,74,6,-5.00781552916323,6
5006,17,17,72,10,-5.008619057376982,7
5007,12,26,27,14,-5.00979316906133,12
5008,64,49,13,26,-5.0266998971793155,23
5009,41,24,20,13,-5.0314400771852865,11
5010,19,13,17,8,-5.032470600341317,5
5011,39,10,56,5,-5.034025368749221,5
5012,52,12,65,8,-5.036995856643753,4
5013,29,16,41,9,-5.03947465681018,7
5014,104,61,37,36,-5.041376355525097,25
5015,85,15,63,8,-5.044437930195333,7
5016,75,20,95,12,-5.050260152484932,8
5017,27,13,28,9,-5.051194542399679,4
5018,10,16,7,9,-5.060407065651959,7
5019,61,10,41,6,-5.060781095904467,4
5020,65,17,46,11,-5.06610491085495,6
5021,33,13,90,8,-5.072843762888294,5
5022,20,10,32,7,-5.08216341529211,3
5023,65,23,90,12,-5.084911236528136,11
5024,104,25,53,14,-5.094260383198605,11
5025,108,13,28,7,-5.102919930198643,6
5026,70,23,55,13,-5.1032220329288345,10
5027,54,30,9,17,-5.1065751437855,13
5028,1,10,30,6,-5.107240382060612,4
5029,86,39,64,22,-5.108639671077766,17
5030,68,30,23,16,-5.1118494914616495,14
5031,4,18,75,11,-5.1124286444655915,7
5032,65,72,51,43,-5.1139783499820215,29
5033,108,26,16,16,-5.1244229814260605,10
5034,60,17,62,9,-5.128886027579172,8
5035,58,30,40,16,-5.133397385337809,14
5036,3,21,36,13,-5.136055944816986,8
5037,11,18,64,12,-5.138351351638367,6
5038,65,34,43,18,-5.1408173176529015,16
5039,9,20,49,11,-5.141308839362197,9
5040,3,36,7,22,-5.146402582002665,14
5041,65,80,104,45,-5.149580826756094,35
5042,9,24,106,14,-5.150083731218861,10
5043,76,25,65,16,-5.1515232217494615,9
5044,50,28,76,18,-5.1519660961300575,10
5045,28,16,35,8,-5.1531236605423,8
5046,5,12,67,7,-5.159840528973067,5
5047,93,13,98,7,-5.16002306712359,6
5048,56,11,91,6,-5.160182814393273,5
5049,96,20,114,12,-5.164351476040406,8
5050,96,29,65,16,-5.165027076154162,13
5051,97,17,75,10,-5.183439015487436,7
5052,71,10,6,6,-5.19369227829273,4
5053,113,13,40,8,-5.193726392686624,5
5054,80,18,104,10,-5.194103195079233,8
5055,39,25,46,12,-5.196853389468722,13
5056,53,36,16,22,-5.201094174764714,14
5057,54,37,55,20,-5.2079892699722485,17
5058,39,10,6,6,-5.213256916387498,4
5059,91,12,33,6,-5.213867650447791,6
5060,33,16,87,9,-5.217430381961776,7
5061,76,18,20,9,-5.218902337593748,9
5062,37,22,40,12,-5.218981261850287,10
5063,112,29,53,15,-5.221677411254142,14
5064,106,54,54,29,-5.222938310920249,25
5065,39,23,92,12,-5.223931097826438,11
5066,103,16,13,10,-5.226276270144915,6
5067,5,11,35,6,-5.226534281744142,5
5068,3,24,104,14,-5.226681542928666,10
5069,27,19,72,10,-5.23109384542835,9
5070,23,12,9,7,-5.231512665759891,5
5071,25,21,91,12,-5.23677892954369,9
5072,16,14,52,8,-5.238731564661997,6
5073,40,15,98,8,-5.239271076053038,7
5074,3,24,41,16,-5.240784980656734,8
5075,40,26,25,15,-5.242222631716463,11
5076,94,15,114,8,-5.246364560187277,7
5077,67,15,34,7,-5.254716330627796,8
5078,31,11,35,6,-5.255104723881262,5
5079,39,16,80,9,-5.2570004697562105,7
5080,78,31,13,18,-5.257129710025224,13
5081,75,55,86,30,-5.26427494208678,25
5082,92,11,28,7,-5.266199037582341,4
5083,51,54,54,31,-5.278945583830036,23
5084,88,11,56,6,-5.280224334897691,5
5085,28,19,14,12,-5.2887953454841945,7
5086,47,14,64,9,-5.289224932245289,5
5087,86,21,99,13,-5.291638236148403,8
5088,55,60,107,34,-5.296456553531057,26
5089,68,64,16,40,-5.298199798122404,24
5090,100,17,9,11,-5.299356832075297,6
5091,65,103,16,60,-5.302520370455433,43
5092,55,25,111,15,-5.307717141421055,10
5093,66,19,107,11,-5.307859110353936,8
5094,47,10,85,7,-5.309476383215227,3
5095,86,75,11,43,-5.329870824958233,32
5096,50,52,87,29,-5.330518704603512,23
5097,102,14,97,9,-5.335160623731844,5
5098,87,27,80,16,-5.338478052727015,11
5099,62,19,7,11,-5.339510147514966,8
5100,60,46,55,26,-5.354179807158422,20
5101,65,15,81,9,-5.355649781765625,6
5102,97,35,7,19,-5.356987360153851,16
5103,63,30,75,17,-5.362343223381898,13
5104,57,37,78,21,-5.362952301819457,16
5105,107,103,87,60,-5.3677008823199115,43
5106,94,12,3,7,-5.374899428324898,5
5107,46,42,8,23,-5.3863067663867845,19
5108,90,31,54,18,-5.397442007333916,13
5109,49,64,39,39,-5.3988758848556335,25
5110,54,19,94,11,-5.4003513194262505,8
5111,41,20,100,12,-5.40062296938604,8
5112,64,10,84,7,-5.40179307430533,3
5113,58,11,4,7,-5.405037105567146,4
5114,25,38,104,21,-5.42238345531963,17
5115,63,33,104,19,-5.4225005902868935,14
5116,27,30,100,16,-5.434950393372421,14
5117,68,29,71,18,-5.435653336862234,11
5118,57,18,97,10,-5.45235309786646,8
5119,71,43,75,27,-5.454468163058883,16
5120,76,14,71,7,-5.456476326439049,7
5121,88,45,27,25,-5.4572956902517324,20
5122,88,15,89,8,-5.460084177073363,7
5123,29,15,77,10,-5.460561068340717,5
5124,51,31,5,20,-5.465657211287607,11
5125,74,13,31,8,-5.468299370651384,5
5126,61,14,63,9,-5.475415218119486,5
5127,25,22,100,12,-5.476003695191371,10
5128,70,23,114,14,-5.484820175107314,9
5129,102,10,67,6,-5.497246561771841,4
5130,64,15,44,9,-5.503275136525506,6
5131,40,13,2,8,-5.504797437287729,5
5132,109,13,32,7,-5.508051897308618,6
5133,83,19,95,12,-5.510188596504647,7
5134,37,59,87,35,-5.516733087496061,24
5135,20,10,62,6,-5.517288163699186,4
5136,7,33,28,20,-5.522079859732704,13
5137,102,14,33,8,-5.525239013163607,6
5138,76,20,100,11,-5.5369678710761505,9
5139,23,21,64,12,-5.5388775759536575,9
5140,69,27,41,18,-5.540528561994146,9
5141,27,23,40,11,-5.543091094529357,12
5142,2,22,20,13,-5.544865436021075,9
5143,84,18,25,11,-5.5466876181289715,7
5144,23,16,29,9,-5.547160957253139,7
5145,31,53,36,30,-5.548564460468652,23
5146,25,41,8,25,-5.550067480025435,16
5147,77,11,78,7,-5.550391664202254,4
5148,54,16,69,9,-5.552096999235808,7
5149,20,61,107,35,-5.555959949322172,26
5150,4,11,46,6,-5.55622187464566,5
5151,95,30,13,17,-5.556983808516705,13
5152,95,10,31,6,-5.5581891593402775,4
5153,38,23,7,13,-5.575438881033769,10
5154,44,22,20,13,-5.576158683247875,9
5155,16,15,85,10,-5.578536673206573,5
5156,88,14,14,8,-5.580858903619988,6
5157,53,13,89,7,-5.581720835788214,6
5158,3,27,12,17,-5.589071249448644,10
5159,96,38,20,23,-5.5910643603065,15
5160,68,18,85,12,-5.599820671294398,6
5161,98,17,70,11,-5.604121247592223,6
5162,49,20,12,14,-5.604208901352283,6
5163,64,12,62,6,-5.604607375761128,6
5164,90,14,30,8,-5.614315415339312,6
5165,76,29,28,16,-5.615688910158877,13
5166,91,26,68,14,-5.6194663727720915,12
5167,50,26,95,15,-5.619957219349124,11
5168,84,24,9,14,-5.622843694169617,10
5169,5,10,19,6,-5.6233787755961275,4
5170,17,21,5,14,-5.625033929201381,7
5171,73,28,86,15,-5.62531345595925,13
5172,19,17,84,10,-5.627096636659111,7
5173,13,44,114,23,-5.630065657879772,21
5174,43,41,16,25,-5.630997414458816,16
5175,9,43,75,26,-5.632694127818325,17
5176,19,26,49,15,-5.644904762300495,11
5177,43,38,107,23,-5.645666270302581,15
5178,74,23,73,14,-5.649045009007229,9
5179,97,13,39,8,-5.649731064357227,5
5180,97,10,4,6,-5.649870700339136,4
5181,98,16,78,9,-5.6505616018289935,7
5182,61,13,9,8,-5.652969843590385,5
5183,16,44,20,28,-5.653886889078911,16
5184,87,69,13,42,-5.658949042403857,27
5185,82,11,54,7,-5.66427830231393,4
5186,99,31,16,18,-5.66581833704302,13
5187,37,39,75,25,-5.670197882049106,14
5188,25,10,94,5,-5.671887186214519,5
5189,51,47,104,30,-5.683249328493965,17
5190,95,10,102,6,-5.68531996234082,4
5191,9,37,28,20,-5.685359581946876,17
5192,40,21,35,13,-5.689140213576859,8
5193,5,46,106,28,-5.689619439430468,18
5194,32,10,70,5,-5.692479372096212,5
5195,77,14,17,8,-5.701107401476806,6
5196,62,17,53,10,-5.701449545318568,7
5197,96,23,60,16,-5.70300646411235,7
5198,109,18,68,12,-5.704488776223907,6
5199,37,18,41,11,-5.716493275276267,7
5200,17,13,98,7,-5.72342530511381,6
5201,51,26,25,15,-5.726135112848949,11
5202,9,14,45,9,-5.727853500458989,5
5203,25,48,13,26,-5.729332953997916,22
5204,12,19,88,11,-5.730617287446644,8
5205,100,30,104,18,-5.731738576312735,12
5206,38,11,34,7,-5.733514369563806,4
5207,43,22,3,14,-5.736184619115312,8
5208,106,42,25,26,-5.737688222420908,16
5209,39,50,40,30,-5.739978674185259,20
5210,81,10,78,5,-5.742474614478735,5
5211,19,19,41,12,-5.745349966804545,7
5212,80,11,19,7,-5.749943576584892,4
5213,77,12,36,7,-5.751140829309579,5
5214,47,13,23,8,-5.7551420632928085,5
5215,53,13,58,6,-5.756559382638664,7
5216,98,23,11,13,-5.7667243230281455,10
5217,87,98,16,57,-5.766791908129217,41
5218,93,19,16,10,-5.776545074834796,9
5219,60,29,78,16,-5.785028437429672,13
5220,63,26,98,15,-5.795644107915215,11
5221,31,19,91,12,-5.801858258461768,7
5222,106,11,10,8,-5.803672894932928,3
5223,98,19,8,12,-5.806615359942182,7
5224,37,52,16,30,-5.806896201742739,22
5225,20,13,79,8,-5.810117746469,5
5226,5,16,40,9,-5.82052725169565,7
5227,94,17,28,11,-5.821481138029024,6
5228,78,13,41,8,-5.835829243326792,5
5229,29,18,76,9,-5.840323373706845,9
5230,43,12,103,6,-5.842083830723205,6
5231,76,28,23,16,-5.847391882051943,12
5232,65,10,108,5,-5.847992745343311,5
5233,65,61,55,35,-5.858765777581568,26
5234,112,20,7,12,-5.863389950487481,8
5235,7,17,34,10,-5.863504951401834,7
5236,19,21,28,13,-5.865946411400912,8
5237,95,36,54,20,-5.865979569344108,16
5238,9,17,62,10,-5.866001447424248,7
5239,41,35,87,21,-5.8660062553044225,14
5240,31,12,28,7,-5.87633787823225,5
5241,3,29,15,17,-5.880092462301208,12
5242,68,27,97,16,-5.880460614845397,11
5243,36,12,46,7,-5.88209418081934,5
5244,74,22,102,13,-5.882481039476403,9
5245,27,64,16,38,-5.886943044172855,26
5246,20,48,65,30,-5.887954716629861,18
5247,43,16,17,9,-5.888801333071093,7
5248,84,34,74,18,-5.89139952158172,16
5249,68,15,101,10,-5.891939886749793,5
5250,103,12,54,8,-5.896465334872947,4
5251,107,59,75,39,-5.896729059645905,20
5252,38,10,62,6,-5.90596099279759,4
5253,62,21,28,12,-5.907937401649371,9
5254,57,27,84,14,-5.910397185802948,13
5255,45,15,41,10,-5.914462706154762,5
5256,63,10,93,6,-5.917563250275586,4
5257,7,22,78,12,-5.919551023484503,10
5258,16,40,78,24,-5.921764680586511,16
5259,93,14,75,8,-5.9232430439307135,6
5260,55,27,109,14,-5.923431655873009,13
5261,114,20,73,12,-5.924435121305104,8
5262,33,18,8,11,-5.930528749487397,7
5263,40,15,57,9,-5.936628176580016,6
5264,43,10,74,5,-5.941779824004124,5
5265,53,15,28,9,-5.945744364633271,6
5266,29,37,65,21,-5.950290217119017,16
5267,10,12,97,6,-5.950831581917707,6
5268,53,52,68,31,-5.964244334939566,21
5269,40,18,97,11,-5.966918416140385,7
5270,76,33,16,17,-5.9691351545969855,16
5271,87,21,102,13,-5.971447061156248,8
5272,18,20,64,12,-5.974775055211904,8
5273,60,29,49,17,-5.990966249711066,12
5274,31,25,114,14,-5.9918765203954925,11
5275,27,25,47,15,-5.997680483822353,10
5276,88,26,30,14,-5.999646200227326,12
5277,100,19,37,12,-6.000890669706825,7
5278,60,21,76,14,-6.002005566797062,7
5279,17,17,103,11,-6.022913063656272,6
5280,37,24,98,14,-6.023716027404387,10
5281,55,33,80,18,-6.02495090174393,15
5282,13,36,81,22,-6.025187055387207,14
5283,51,28,108,16,-6.026136385597759,12
5284,46,20,95,12,-6.027785407812037,8
5285,50,17,91,11,-6.027790824025908,6
5286,31,31,75,17,-6.03348213428737,14
5287,98,24,7,15,-6.033686003781978,9
5288,32,16,8,9,-6.041444852098721,7
5289,93,15,70,9,-6.04469500542117,6
5290,18,24,63,15,-6.046455003215171,9
5291,14,14,39,8,-6.049336679853417,6
5292,102,34,28,20,-6.058897913934129,14
5293,41,27,23,16,-6.068042449918635,11
5294,20,29,70,18,-6.0805113791791925,11
5295,107,23,111,12,-6.08814286411973,11
5296,16,10,26,6,-6.090476145744291,4
5297,47,11,54,6,-6.095812400128514,5
5298,69,16,62,9,-6.0981418118710495,7
5299,87,13,10,8,-6.098821416398099,5
5300,7,12,90,7,-6.108519045195329,5
5301,60,40,30,26,-6.10930489308495,14
5302,49,33,107,19,-6.110518487198577,14
5303,77,13,72,7,-6.113577824682308,6
5304,31,13,81,9,-6.1171597913254026,4
5305,88,35,25,23,-6.12387967695023,12
5306,55,17,27,11,-6.127925060038187,6
5307,88,25,100,15,-6.151971338273167,10
5308,47,27,75,18,-6.156969718274411,9
5309,36,47,13,29,-6.167141158071527,18
5310,87,68,8,40,-6.180726581231656,28
5311,3,34,107,18,-6.186000566414521,16
5312,71,12,91,7,-6.18747414228945,5
5313,2,28,63,16,-6.200018491851487,12
5314,70,28,74,15,-6.203999405338755,13
5315,84,15,35,9,-6.209299301194262,6
5316,49,15,34,9,-6.210584372576932,6
5317,88,90,86,54,-6.216340947823593,36
5318,104,65,107,39,-6.217712152560083,26
5319,91,42,16,27,-6.227187272730331,15
5320,50,41,104,25,-6.230364171354916,16
5321,9,31,8,16,-6.234041807874366,15
5322,5,48,114,28,-6.237633533478722,20
5323,88,62,65,39,-6.254328556973988,23
5324,54,17,41,10,-6.262569869973235,7
5325,95,12,15,7,-6.265255655621161,5
5326,96,11,69,7,-6.268969865653717,4
5327,5,45,20,28,-6.270373633442783,17
5328,75,11,94,7,-6.272377467555882,4
5329,4,21,86,13,-6.2794844995496994,8
5330,43,14,12,9,-6.280233018622482,5
5331,64,16,70,11,-6.2860092045587415,5
5332,19,40,87,24,-6.287277196031124,16
5333,57,18,114,11,-6.288629829852742,7
5334,3,13,54,7,-6.2904200663200225,6
5335,37,24,30,15,-6.294754233158862,9
5336,94,20,76,13,-6.29880756689131,7
5337,94,14,11,9,-6.305903525162971,5
5338,66,15,63,9,-6.307276344392351,6
5339,77,23,39,13,-6.318579228260862,10
5340,28,53,104,31,-6.329501969870212,22
5341,23,13,33,8,-6.330114552953446,5
5342,16,14,89,8,-6.330684257071285,6
5343,13,36,63,21,-6.336904929027583,15
5344,40,22,62,11,-6.340588914856938,11
5345,96,17,85,12,-6.345069391274802,5
5346,27,13,92,7,-6.356396578041118,6
5347,43,19,64,11,-6.3596171770522805,8
5348,56,21,7,12,-6.361794853449643,9
5349,81,32,86,22,-6.369305995587273,10
5350,33,12,64,8,-6.376020245344582,4
5351,43,14,57,10,-6.38492169714904,4
5352,100,55,16,33,-6.385211726765545,22
5353,96,13,33,6,-6.392035038140809,7
5354,55,38,104,23,-6.394473965912865,15
5355,37,20,80,12,-6.401050818487372,8
5356,77,13,106,7,-6.407119934187455,6
5357,68,17,34,10,-6.413670809676438,7
5358,54,18,91,10,-6.414686940093467,8
5359,80,23,96,14,-6.423400971659429,9
5360,27,11,22,7,-6.425149939635198,4
5361,33,16,40,11,-6.427211772717695,5
5362,81,24,15,14,-6.430856839870597,10
5363,94,18,69,11,-6.432434124144747,7
5364,87,20,4,13,-6.445923142452617,7
5365,51,43,76,27,-6.45233141104169,16
5366,28,10,6,6,-6.452419128804086,4
5367,55,28,30,17,-6.45296579455118,11
5368,91,20,8,12,-6.453847873736644,8
5369,112,19,87,11,-6.455970733771133,8
5370,29,13,70,7,-6.465173609286503,6
5371,68,11,98,7,-6.4699276959750645,4
5372,55,10,89,6,-6.472799854469152,4
5373,9,20,70,13,-6.477071321597405,7
5374,53,46,107,28,-6.492903474758716,18
5375,103,10,18,7,-6.501498615339008,3
5376,55,29,74,17,-6.503619546467788,12
5377,63,25,100,14,-6.506283863039738,11
5378,37,35,13,21,-6.522302273576748,14
5379,80,13,91,8,-6.531108694088673,5
5380,102,21,76,13,-6.53829498253982,8
5381,11,13,85,8,-6.5402245957157366,5
5382,70,58,54,35,-6.543056803225656,23
5383,12,16,28,10,-6.545963713857721,6
5384,23,32,106,17,-6.5490553960891695,15
5385,114,26,53,15,-6.571088082289226,11
5386,48,10,69,5,-6.577798378248735,5
5387,8,23,78,14,-6.580729341705669,9
5388,69,31,60,17,-6.585373558105323,14
5389,63,31,64,18,-6.595351994440166,13
5390,17,13,102,8,-6.612407855965595,5
5391,104,24,30,13,-6.615090339536257,11
5392,68,21,20,12,-6.619136630374986,9
5393,75,10,85,7,-6.619293441212882,3
5394,46,38,74,24,-6.622188071735937,14
5395,5,48,25,29,-6.626414170343123,19
5396,62,32,107,17,-6.627456297715231,15
5397,37,22,39,13,-6.632156694863052,9
5398,65,30,4,18,-6.635600395573753,12
5399,17,38,86,21,-6.641619574926921,17
5400,112,23,39,13,-6.645530918915318,10
5401,5,26,32,16,-6.6474470604519045,10
5402,37,19,71,11,-6.65399605348867,8
5403,71,11,83,6,-6.6562053803338666,5
5404,72,21,54,13,-6.6578696597772655,8
5405,57,12,10,8,-6.658857003244836,4
5406,54,20,85,13,-6.664179187550933,7
5407,79,12,27,7,-6.670700776711516,5
5408,13,29,12,21,-6.694032199534926,8
5409,106,11,111,8,-6.697425895741327,3
5410,86,18,10,10,-6.698064905065152,8
5411,23,25,63,16,-6.701335055503609,9
5412,74,15,83,8,-6.703298030488857,7
5413,114,15,27,9,-6.704132292345129,6
5414,97,35,28,22,-6.716635909782018,13
5415,32,10,65,6,-6.718474357729474,4
5416,50,23,90,14,-6.721975923903932,9
5417,95,13,14,8,-6.731405281187272,5
5418,96,38,74,24,-6.731828732252354,14
5419,78,14,40,10,-6.732885786530082,4
5420,29,10,18,7,-6.739197778395282,3
5421,48,26,84,16,-6.740791105108492,10
5422,68,13,45,8,-6.747691137383073,5
5423,71,10,94,6,-6.748460655059317,4
5424,97,54,86,32,-6.749652418711037,22
5425,13,41,47,25,-6.770499309500958,16
5426,88,27,62,16,-6.777372044873372,11
5427,39,16,34,9,-6.781450725640269,7
5428,38,14,2,8,-6.792448237787324,6
5429,31,10,55,6,-6.798197972656263,4
5430,87,23,108,14,-6.799580586486786,9
5431,49,16,28,9,-6.8012848235530035,7
5432,13,50,71,29,-6.804323620324037,21
5433,4,13,56,7,-6.816273515879698,6
5434,66,14,65,9,-6.821265394674894,5
5435,31,69,68,41,-6.8216343585610195,28
5436,106,25,95,16,-6.830338155584793,9
5437,96,14,78,9,-6.830515928543477,5
5438,87,23,34,14,-6.839779420574447,9
5439,50,16,100,10,-6.845077769092562,6
5440,51,99,7,62,-6.849475435937795,37
5441,60,18,108,11,-6.856532886501664,7
5442,4,43,60,24,-6.864343045215706,19
5443,98,12,3,6,-6.866274172778351,6
5444,3,40,16,25,-6.869773503305486,15
5445,99,15,106,10,-6.882359612487446,5
5446,88,16,76,9,-6.891817282335724,7
5447,61,14,107,8,-6.900760430128648,6
5448,60,10,72,6,-6.902146483608277,4
5449,68,21,58,13,-6.90465268486649,8
5450,81,10,77,6,-6.905311789108675,4
5451,29,17,28,10,-6.905526522456792,7
5452,51,60,100,33,-6.918618841413681,27
5453,23,46,13,26,-6.920891480866107,20
5454,30,19,75,11,-6.923427737676235,8
5455,107,32,58,20,-6.925862203329278,12
5456,57,32,87,20,-6.9356530971217865,12
5457,88,12,99,7,-6.939131232028662,5
5458,48,12,76,8,-6.943708984082041,4
5459,55,71,16,45,-6.9441417397692575,26
5460,51,25,4,16,-6.952578906103856,9
5461,68,24,62,14,-6.956994474454217,10
5462,63,20,90,12,-6.95733483322538,8
5463,104,18,32,12,-6.959225086389547,6
5464,88,13,85,8,-6.960388600870984,5
5465,39,15,111,9,-6.9608600117118025,6
5466,36,34,16,21,-6.96230955324868,13
5467,97,23,18,14,-6.965163575719862,9
5468,30,30,53,18,-6.98498975026545,12
5469,55,20,17,11,-6.987444025974705,9
5470,13,23,111,13,-6.988942249892523,10
5471,5,15,62,9,-6.9927087595973925,6
5472,54,14,79,9,-6.993661154009002,5
5473,54,26,93,17,-7.002072182522708,9
5474,51,100,86,57,-7.006490378168833,43
5475,69,13,40,9,-7.006717860168283,4
5476,66,17,60,12,-7.01349351464583,5
5477,38,25,63,17,-7.013791456544737,8
5478,53,27,87,15,-7.0226395127694765,12
5479,104,14,89,8,-7.025402807656737,6
5480,40,15,95,9,-7.026458120737084,6
5481,27,19,37,12,-7.034792767414986,7
5482,102,18,13,12,-7.037755564548871,6
5483,84,24,85,16,-7.039561068893883,8
5484,114,11,72,6,-7.039741382461142,5
5485,97,25,55,16,-7.041738062020974,9
5486,63,58,51,33,-7.048475253320579,25
5487,69,37,13,23,-7.049482158879248,14
5488,73,16,65,10,-7.056062739811477,6
5489,36,18,99,12,-7.061516094995873,6
5490,49,14,50,8,-7.064134383315742,6
5491,87,27,15,16,-7.071515465274776,11
5492,12,11,98,7,-7.0718761808279025,4
5493,12,26,60,13,-7.0740922667649535,13
5494,98,14,102,8,-7.075813129571892,6
5495,70,35,28,21,-7.078735797739843,14
5496,8,26,34,16,-7.095056358065476,10
5497,17,14,38,8,-7.099034060595349,6
5498,45,10,1,6,-7.100044646871247,4
5499,3,21,19,13,-7.104960021856871,8
5500,7,33,45,20,-7.114147641228475,13
5501,83,30,86,20,-7.114862976089347,10
5502,96,81,86,50,-7.122290387606646,31
5503,84,22,27,13,-7.123178826909879,9
5504,107,12,67,8,-7.124134838046419,4
5505,65,46,27,29,-7.137136986841305,17
5506,55,50,40,31,-7.142420946012767,19
5507,60,17,5,11,-7.144002600647478,6
5508,37,14,29,8,-7.14724630286853,6
5509,65,14,34,8,-7.161205115873211,6
5510,14,14,86,8,-7.166696838482464,6
5511,86,41,98,24,-7.171894084868248,17
5512,112,16,36,10,-7.175574629533439,6
5513,62,11,18,7,-7.178564522913038,4
5514,43,33,39,19,-7.179919496295487,14
5515,63,58,8,34,-7.184592805665555,24
5516,84,13,103,7,-7.1897480945283165,6
5517,22,13,109,8,-7.19047287621624,5
5518,30,19,34,12,-7.196614878264562,7
5519,48,11,17,6,-7.198036653114912,5
5520,38,13,53,8,-7.198101634639961,5
5521,100,11,20,7,-7.213419982652268,4
5522,68,30,11,18,-7.217291331449089,12
5523,109,49,54,31,-7.224017629711239,18
5524,40,27,114,18,-7.240772461331045,9
5525,87,48,27,29,-7.246227963622146,19
5526,5,14,31,9,-7.246607645789562,5
5527,106,62,13,38,-7.247428424926185,24
5528,84,19,98,13,-7.255378652482316,6
5529,91,29,87,18,-7.256753645120718,11
5530,39,33,84,19,-7.2579208484387365,14
5531,79,30,86,19,-7.258463117259924,11
5532,81,19,75,12,-7.259552889264539,7
5533,10,14,63,9,-7.261720580359904,5
5534,98,17,20,11,-7.267496359610283,6
5535,70,16,110,10,-7.267896542251016,6
5536,96,10,62,7,-7.268496266352443,3
5537,29,25,84,15,-7.268682540682646,10
5538,57,13,106,7,-7.272492874678534,6
5539,68,20,55,13,-7.273979151335479,7
5540,77,26,27,16,-7.275407762755583,10
5541,98,20,13,13,-7.284404613166717,7
5542,29,16,97,10,-7.284915525257297,6
5543,104,20,9,12,-7.285236260424964,8
5544,47,11,11,7,-7.287013470663886,4
5545,40,31,43,18,-7.287691070183636,13
5546,40,33,54,20,-7.298767912387552,13
5547,107,29,12,19,-7.306989193401351,10
5548,15,16,47,9,-7.310604549956418,7
5549,5,42,70,25,-7.323141246130922,17
5550,65,13,85,8,-7.3238412361926395,5
5551,63,23,57,13,-7.330641846184262,10
5552,2,16,75,9,-7.332326563651874,7
5553,104,41,40,26,-7.342291894534161,15
5554,114,18,23,12,-7.344942637597017,6
5555,79,24,48,15,-7.345817828277464,9
5556,9,19,17,11,-7.358179157868899,8
5557,8,25,73,15,-7.3587900254771785,10
5558,60,36,104,25,-7.360716052217208,11
5559,114,10,77,6,-7.365477220397804,4
5560,33,16,25,11,-7.36592627296452,5
5561,80,14,31,10,-7.367135464628977,4
5562,74,15,34,10,-7.367415754617588,5
5563,71,10,73,6,-7.373234065194552,4
5564,81,19,71,12,-7.374213709282582,7
5565,57,15,23,9,-7.378386377329164,6
5566,11,20,30,12,-7.381431949435282,8
5567,71,29,50,17,-7.386130219514863,12
5568,5,10,1,6,-7.391988711274882,4
5569,89,17,41,11,-7.402414100587752,6
5570,84,17,43,10,-7.402871468291519,7
5571,88,22,108,14,-7.409334471097551,8
5572,41,34,36,18,-7.412500474371831,16
5573,28,15,47,9,-7.412518705302231,6
5574,103,13,88,8,-7.429730837512917,5
5575,71,12,11,7,-7.444969376445684,5
5576,75,30,46,18,-7.449361290092636,12
5577,87,55,68,33,-7.449473442117574,22
5578,110,21,37,12,-7.457046552670356,9
5579,70,12,100,7,-7.4587771296449565,5
5580,53,12,45,7,-7.463487107897495,5
5581,31,37,64,23,-7.4738922265185375,14
5582,63,15,108,9,-7.475559971035059,6
5583,36,14,70,8,-7.476080415111231,6
5584,69,18,104,12,-7.510735223332436,6
5585,87,52,7,33,-7.517208318589071,19
5586,86,34,43,22,-7.523522170804235,12
5587,55,11,6,8,-7.526848268362213,3
5588,7,16,33,9,-7.532188482638043,7
5589,46,10,85,7,-7.538229298143678,3
5590,55,13,49,8,-7.5458342197342585,5
5591,77,14,109,8,-7.555022352358235,6
5592,88,78,54,48,-7.560371458183832,30
5593,63,72,16,44,-7.561421037601965,28
5594,40,38,87,22,-7.562449238427529,16
5595,45,19,60,11,-7.562934672858015,8
5596,78,33,27,22,-7.5633754544902665,11
5597,49,23,75,14,-7.565086245339051,9
5598,51,24,97,16,-7.567852948549441,8
5599,69,12,42,7,-7.569928254839939,5
5600,68,66,40,42,-7.570321994315703,24
5601,5,14,34,10,-7.5706698448560905,4
5602,77,12,46,7,-7.574271980014295,5
5603,15,19,43,11,-7.575222378444256,8
5604,107,51,30,31,-7.577901126247483,20
5605,114,31,28,18,-7.584853881328922,13
5606,36,10,72,6,-7.585561627806541,4
5607,88,18,58,11,-7.5880987725104365,7
5608,36,20,18,12,-7.59490287850123,8
5609,49,24,98,15,-7.617694821913574,9
5610,27,14,71,9,-7.62097447229337,5
5611,76,18,13,11,-7.630501064893033,7
5612,81,12,11,8,-7.632646941640291,4
5613,5,29,97,19,-7.639418302115126,10
5614,84,19,38,11,-7.644842467332106,8
5615,60,11,70,7,-7.646435749026202,4
5616,31,13,33,7,-7.647223417443056,6
5617,72,22,86,14,-7.651597318688159,8
5618,35,27,107,18,-7.659745377736293,9
5619,96,24,37,14,-7.66584492569651,10
5620,38,29,37,18,-7.668156637885105,11
5621,55,35,50,20,-7.677574556383835,15
5622,29,28,39,16,-7.678123787816819,12
5623,11,32,5,20,-7.6874421575338765,12
5624,7,25,111,15,-7.6903234257719815,10
5625,12,12,11,8,-7.692678298811862,4
5626,1,28,86,17,-7.696680317913658,11
5627,68,61,75,39,-7.698232004910782,22
5628,60,40,23,25,-7.703308873703664,15
5629,88,117,16,74,-7.71333343435843,43
5630,107,36,80,23,-7.714999307877538,13
5631,1,15,15,10,-7.733065759700131,5
5632,27,15,81,9,-7.7368213835310415,6
5633,84,11,44,6,-7.741464370739851,5
5634,52,13,30,8,-7.74461626818291,5
5635,54,30,100,19,-7.74487922633345,11
5636,54,13,73,8,-7.746921178252214,5
5637,39,87,16,53,-7.749220808750857,34
5638,64,32,16,21,-7.754231430905149,11
5639,25,49,37,29,-7.755599308877523,20
5640,73,11,53,7,-7.756297558195456,4
5641,60,21,17,13,-7.758065583862096,8
5642,18,22,50,13,-7.75840176806416,9
5643,114,14,92,10,-7.774797164908212,4
5644,111,10,47,6,-7.786638633209642,4
5645,64,22,55,15,-7.789831302640345,7
5646,30,20,50,12,-7.797701228015578,8
5647,48,15,50,10,-7.798532000224026,5
5648,110,12,114,8,-7.80031681097971,4
5649,94,27,27,17,-7.811103899052177,10
5650,51,13,35,8,-7.81795332038994,5
5651,46,46,25,27,-7.8204011950255445,19
5652,109,29,11,19,-7.8240936326607935,10
5653,107,33,2,21,-7.828664599470125,12
5654,87,34,43,21,-7.835150885725456,13
5655,1,20,114,13,-7.837742070296789,7
5656,3,27,88,17,-7.840747549885402,10
5657,109,19,53,12,-7.841205358929898,7
5658,55,14,29,9,-7.851130455007914,5
5659,41,18,8,12,-7.853968460697833,6
5660,91,26,106,17,-7.859341034872017,9
5661,35,12,44,7,-7.859665557157517,5
5662,98,15,108,9,-7.863072789163925,6
5663,12,25,94,14,-7.866892140629969,11
5664,46,13,78,7,-7.867017716751532,6
5665,90,25,114,15,-7.8701656835045455,10
5666,34,18,78,11,-7.896291134370742,7
5667,90,14,53,9,-7.901032299292589,5
5668,31,11,78,6,-7.904414780494012,5
5669,38,13,71,9,-7.906029048659733,4
5670,57,14,79,8,-7.91165764637429,6
5671,82,10,88,6,-7.9125780836424955,4
5672,61,14,6,9,-7.915350050859162,5
5673,58,18,60,11,-7.916808592208974,7
5674,18,22,54,13,-7.917650548154778,9
5675,107,24,33,14,-7.934508031898854,10
5676,87,17,73,12,-7.94220715025842,5
5677,61,19,53,13,-7.9431150632920575,6
5678,50,14,15,9,-7.948796046035556,5
5679,39,21,23,13,-7.9630880242589255,8
5680,5,25,65,15,-7.967561696591303,10
5681,89,11,48,8,-7.971806233433708,3
5682,58,20,16,13,-7.973713265949866,7
5683,76,26,112,15,-7.97915167815144,11
5684,68,63,39,38,-7.985348203689875,25
5685,84,28,5,17,-7.986435375626319,11
5686,70,16,13,10,-7.990308468406848,6
5687,6,22,44,15,-7.994067314889739,7
5688,96,19,102,12,-7.995631160966494,7
5689,29,15,46,7,-7.9982854128923,8
5690,81,18,41,12,-8.009042710590084,6
5691,98,31,91,19,-8.010154956050265,12
5692,114,16,76,11,-8.01045549406789,5
5693,9,11,35,6,-8.012816785902407,5
5694,52,12,63,7,-8.015196003418383,5
5695,50,41,75,27,-8.02466935745211,14
5696,8,13,52,8,-8.032663143129467,5
5697,46,45,16,29,-8.034750190065965,16
5698,84,36,20,25,-8.04861670328596,11
5699,15,10,35,5,-8.056529361763387,5
5700,33,14,68,9,-8.058871180827014,5
5701,91,15,51,10,-8.060157448942936,5
5702,46,13,53,8,-8.064750592390654,5
5703,70,18,50,10,-8.072010588554933,8
5704,97,16,110,10,-8.077466293642948,6
5705,74,12,89,7,-8.079770785030162,5
5706,5,61,8,37,-8.080732178020163,24
5707,46,15,109,9,-8.081904977493476,6
5708,68,35,76,25,-8.083319916767413,10
5709,50,30,60,17,-8.087484578525556,13
5710,51,94,39,58,-8.092875118792946,36
5711,46,42,37,28,-8.095895819595153,14
5712,49,11,95,8,-8.095998639719069,3
5713,69,16,47,10,-8.099464940788463,6
5714,19,17,38,12,-8.100688864380347,5
5715,85,10,3,5,-8.102330604310954,5
5716,112,19,88,12,-8.10654244906666,7
5717,48,15,74,8,-8.108554922899495,7
5718,109,26,63,15,-8.110737293175294,11
5719,111,11,81,8,-8.120062859865854,3
5720,110,11,20,7,-8.125291114928718,4
5721,107,14,56,8,-8.142413744294045,6
5722,112,10,4,6,-8.145974306589782,4
5723,9,44,16,29,-8.147460704640704,15
5724,112,16,18,11,-8.155957753880717,5
5725,20,17,33,11,-8.157924685534638,6
5726,9,20,76,13,-8.161384986883025,7
5727,14,21,16,13,-8.162649800607642,8
5728,84,16,100,11,-8.163740226415522,5
5729,81,15,47,10,-8.165398445346261,5
5730,93,43,65,25,-8.165860412715737,18
5731,12,15,1,9,-8.17662116025044,6
5732,89,11,63,8,-8.192927888945773,3
5733,39,25,74,15,-8.19553508787693,10
5734,18,23,15,15,-8.198983161894938,8
5735,93,24,87,15,-8.201353690040278,9
5736,40,14,112,8,-8.221202026655053,6
5737,102,11,19,8,-8.222044886202713,3
5738,71,10,99,6,-8.22496630028886,4
5739,106,21,69,13,-8.230262561693124,8
5740,14,12,37,7,-8.266467835075433,5
5741,51,39,64,24,-8.272173971656702,15
5742,4,13,12,9,-8.273106784367057,4
5743,23,19,49,12,-8.273514769081293,7
5744,91,18,41,12,-8.276671952774393,6
5745,106,31,90,21,-8.28384546124837,10
5746,56,17,86,11,-8.300855291965847,6
5747,81,15,104,8,-8.308547186806486,7
5748,94,30,13,19,-8.309149852706645,11
5749,48,13,90,8,-8.30973168111364,5
5750,9,15,25,10,-8.323455878342047,5
5751,64,24,30,15,-8.324576599861391,9
5752,98,15,27,9,-8.326557443258316,6
5753,87,30,78,18,-8.33618992148151,12
5754,84,29,8,19,-8.33757645831541,10
5755,100,20,75,11,-8.340891834618308,9
5756,8,26,68,16,-8.350318283362764,10
5757,31,32,41,20,-8.353957395244585,12
5758,5,22,7,14,-8.357081514884824,8
5759,25,45,7,29,-8.372806618348289,16
5760,69,21,63,14,-8.375492163913538,7
5761,16,22,81,14,-8.387289153423302,8
5762,104,10,67,6,-8.393331116483225,4
5763,86,44,41,29,-8.394182256897173,15
5764,79,11,80,6,-8.394402338657228,5
5765,67,14,109,7,-8.41022889195963,7
5766,102,21,50,12,-8.41869338516401,9
5767,102,12,41,8,-8.421036787338009,4
5768,54,13,38,8,-8.421224564929705,5
5769,90,19,73,12,-8.424101991862472,7
5770,114,20,55,13,-8.432483182241098,7
5771,70,24,96,13,-8.437417991026262,11
5772,96,14,95,9,-8.450373982592183,5
5773,53,13,15,8,-8.451445563178742,5
5774,3,14,17,8,-8.451772944173683,6
5775,3,24,114,16,-8.461132150785257,8
5776,85,14,55,9,-8.476039600481302,5
5777,77,14,74,9,-8.485489523270209,5
5778,112,17,3,10,-8.489497702475802,7
5779,69,39,16,25,-8.493540371651168,14
5780,40,28,64,18,-8.49607162432113,10
5781,102,18,100,12,-8.497510292544515,6
5782,57,22,69,15,-8.501708529602617,7
5783,45,10,91,6,-8.504304930616431,4
5784,106,13,12,9,-8.530975907772833,4
5785,29,20,98,13,-8.533348107584901,7
5786,35,12,94,7,-8.545638882275087,5
5787,76,47,86,29,-8.5480312682444,18
5788,2,11,94,7,-8.550586885180518,4
5789,36,11,78,7,-8.552435160203329,4
5790,104,11,48,7,-8.568096491349037,4
5791,55,23,95,15,-8.57500650986488,8
5792,109,13,57,8,-8.575637917032312,5
5793,68,13,108,8,-8.580585833252005,5
5794,79,12,3,8,-8.584201510329168,4
5795,13,15,85,10,-8.590889624694588,5
5796,65,24,1,14,-8.633116949744032,10
5797,97,19,41,12,-8.638943706099203,7
5798,88,40,39,25,-8.66476914665466,15
5799,98,10,85,7,-8.673802483900154,3
5800,31,31,9,20,-8.678153869820548,11
5801,94,17,63,11,-8.684130864326548,6
5802,104,10,29,6,-8.703420471548785,4
5803,20,35,63,21,-8.70524806527441,14
5804,68,28,28,19,-8.707268087933775,9
5805,86,15,45,9,-8.710518828201982,6
5806,45,10,58,6,-8.721721801464438,4
5807,17,22,4,15,-8.72773506800961,7
5808,106,14,38,7,-8.74501943352997,7
5809,96,12,41,9,-8.760253621607967,3
5810,76,35,63,23,-8.77030160479054,12
5811,1,27,16,19,-8.77734005429633,8
5812,18,23,106,15,-8.778191080978738,8
5813,99,14,77,10,-8.784719144285262,4
5814,107,11,26,7,-8.789963547813729,4
5815,51,19,34,12,-8.790432491258223,7
5816,28,17,41,11,-8.792780130820775,6
5817,42,10,106,7,-8.802546839644418,3
5818,13,22,26,15,-8.80503643851318,7
5819,47,18,36,12,-8.810892372607713,6
5820,29,15,17,9,-8.822347297259919,6
5821,36,19,63,12,-8.822881427312195,7
5822,8,26,18,18,-8.824824520647523,8
5823,12,10,20,6,-8.842914423325945,4
5824,87,15,32,10,-8.84415502943487,5
5825,8,18,62,13,-8.84901297537332,5
5826,29,18,112,11,-8.855419470416209,7
5827,62,15,114,9,-8.857020433859917,6
5828,53,11,49,7,-8.876928289416243,4
5829,13,23,90,15,-8.883764352926041,8
5830,97,12,69,8,-8.888377862411463,4
5831,112,13,58,8,-8.890258303309274,5
5832,109,20,7,13,-8.908032141063202,7
5833,107,15,89,10,-8.908975430626485,5
5834,87,32,48,21,-8.911539377843575,11
5835,65,53,30,34,-8.916092042735682,19
5836,25,19,110,13,-8.917701672558223,6
5837,88,10,26,6,-8.91952728239028,4
5838,60,32,54,21,-8.921440420264183,11
5839,91,10,11,7,-8.923724837318142,3
5840,84,22,13,15,-8.926224969766146,7
5841,13,25,58,18,-8.937321469663969,7
5842,31,12,73,8,-8.93891957013575,4
5843,74,26,51,18,-8.938947542412075,8
5844,89,11,27,7,-8.96164965375553,4
5845,18,30,68,19,-8.962998195734913,11
5846,32,11,28,7,-8.963821007682874,4
5847,114,20,47,12,-8.969382880850324,8
5848,36,18,97,11,-8.970668153566264,7
5849,52,15,28,9,-8.975367013246691,6
5850,12,14,16,9,-8.983913235715004,5
5851,51,35,78,20,-8.985936186674266,15
5852,103,24,86,16,-9.003989208559398,8
5853,15,13,62,8,-9.005083883016919,5
5854,36,15,5,9,-9.008614310253614,6
5855,39,44,30,27,-9.014074342921361,17
5856,70,16,30,9,-9.016092338129875,7
5857,13,29,108,19,-9.020970097727641,10
5858,45,16,35,9,-9.0400315918615,7
5859,1,13,100,8,-9.068173300248535,5
5860,69,10,33,6,-9.069652549512774,4
5861,15,27,8,16,-9.069685702881003,11
5862,86,29,44,19,-9.073857704921481,10
5863,8,34,95,21,-9.07920947405897,13
5864,8,38,109,23,-9.080033137915198,15
5865,94,36,43,22,-9.090567513391377,14
5866,19,26,29,17,-9.099210291595174,9
5867,31,15,109,10,-9.113887572404183,5
5868,17,11,92,7,-9.114563540800457,4
5869,18,47,16,31,-9.151603438620151,16
5870,114,33,8,22,-9.153115874362141,11
5871,106,25,39,15,-9.155969378752744,10
5872,5,43,50,26,-9.156049369840705,17
5873,40,15,92,10,-9.168940871834318,5
5874,91,13,15,7,-9.175439096539634,6
5875,91,14,23,8,-9.188824217195519,6
5876,63,16,81,10,-9.193429569946268,6
5877,60,23,100,15,-9.195692314437633,8
5878,40,17,73,11,-9.199997222971483,6
5879,90,11,93,7,-9.204947446014161,4
5880,65,16,72,10,-9.208422167482269,6
5881,6,19,13,12,-9.21551599242718,7
5882,69,25,58,15,-9.22400899523332,10
5883,77,21,107,13,-9.225690577042377,8
5884,69,16,70,11,-9.227346228401576,5
5885,20,23,91,14,-9.233435902067152,9
5886,53,15,78,9,-9.245467105519943,6
5887,9,37,87,22,-9.264164509114686,15
5888,18,17,100,10,-9.29762264727719,7
5889,57,27,8,18,-9.301352073064093,9
5890,38,10,45,7,-9.31109379184883,3
5891,84,10,77,7,-9.326879307665175,3
5892,51,15,111,10,-9.328246716797015,5
5893,43,25,100,15,-9.331167427461924,10
5894,2,29,28,19,-9.34282167881126,10
5895,87,20,1,12,-9.344990956449259,8
5896,23,19,55,11,-9.354242967773875,8
5897,50,12,23,9,-9.354699302165743,3
5898,60,46,64,31,-9.358603836566358,15
5899,84,21,104,13,-9.37162724208143,8
5900,4,16,27,10,-9.378715415982104,6
5901,3,25,28,16,-9.379650958304438,9
5902,49,28,100,17,-9.388414110980035,11
5903,36,11,109,8,-9.390936468630553,3
5904,53,22,27,15,-9.395074434024878,7
5905,2,15,13,9,-9.422510080465482,6
5906,20,37,39,22,-9.42792244833799,15
5907,63,11,32,7,-9.44232166344675,4
5908,96,47,16,33,-9.462953828826512,14
5909,109,32,107,21,-9.463956272479837,11
5910,39,17,110,12,-9.484612192785775,5
5911,11,22,15,14,-9.485047519579302,8
5912,58,10,70,7,-9.487562225897111,3
5913,16,57,30,37,-9.490852072579779,20
5914,49,22,78,14,-9.490956018486093,8
5915,84,11,18,7,-9.493458888054228,4
5916,34,11,18,8,-9.499952299900604,3
5917,68,21,72,14,-9.500041589935536,7
5918,7,29,37,18,-9.500511382222342,11
5919,99,22,37,15,-9.502759058160713,7
5920,46,17,30,11,-9.504468805682468,6
5921,2,13,114,8,-9.50915856241785,5
5922,80,14,90,10,-9.509239360264804,4
5923,36,17,8,11,-9.51236026695053,6
5924,9,27,18,18,-9.520249042639605,9
5925,25,32,20,21,-9.520523686179052,11
5926,103,10,34,7,-9.525596905709584,3
5927,87,45,100,26,-9.525689075238134,19
5928,31,22,1,13,-9.525804060927038,9
5929,51,15,48,8,-9.527077025607763,7
5930,75,11,20,7,-9.527707505687719,4
5931,108,13,106,9,-9.535201707134298,4
5932,31,28,27,16,-9.569633624787404,12
5933,7,20,73,12,-9.582485903794177,8
5934,112,27,64,19,-9.59501283307151,8
5935,53,13,8,9,-9.596286006275326,4
5936,57,29,11,17,-9.596520727828777,12
5937,19,18,62,13,-9.608410254395684,5
5938,84,18,83,11,-9.60947373437216,7
5939,8,14,99,8,-9.611065592860308,6
5940,19,12,40,8,-9.612489725967157,4
5941,109,17,70,11,-9.623350653501726,6
5942,109,22,74,15,-9.62539761750223,7
5943,60,37,27,25,-9.62572515977853,12
5944,53,23,41,15,-9.631953807885303,8
5945,3,17,72,10,-9.639566216177297,7
5946,114,10,22,5,-9.649313306364819,5
5947,63,16,111,10,-9.656549842780757,6
5948,71,12,100,8,-9.66068752031631,4
5949,69,26,78,17,-9.666260825143704,9
5950,19,14,64,10,-9.690080014182922,4
5951,103,13,72,8,-9.699905123478475,5
5952,11,18,75,11,-9.710887852205726,7
5953,31,19,43,9,-9.720852773553686,10
5954,52,21,86,14,-9.734029946764757,7
5955,49,20,41,13,-9.757184372315313,7
5956,51,33,77,20,-9.765558432651375,13
5957,58,17,54,10,-9.778768856735095,7
5958,43,46,13,27,-9.779544155099417,19
5959,57,28,27,17,-9.78369569052288,11
5960,83,24,37,15,-9.783726366978415,9
5961,93,10,62,6,-9.798162399200404,4
5962,78,10,38,7,-9.809780954206076,3
5963,93,13,29,8,-9.815241351279962,5
5964,17,24,40,16,-9.815776001763277,8
5965,57,13,54,10,-9.824315369895016,3
5966,19,12,18,8,-9.830216565539352,4
5967,9,17,11,11,-9.83179351941753,6
5968,47,17,9,11,-9.833363334347146,6
5969,10,12,16,8,-9.837247209773246,4
5970,98,10,53,6,-9.839111782848335,4
5971,81,31,51,19,-9.84113772129834,12
5972,13,21,44,14,-9.844973608163802,7
5973,1,17,75,12,-9.87310906944801,5
5974,71,15,17,9,-9.874078720771612,6
5975,67,16,86,10,-9.874432105586441,6
5976,37,13,49,8,-9.877409024924928,5
5977,13,12,89,7,-9.877754309089127,5
5978,60,10,103,7,-9.87923921931673,3
5979,54,17,2,12,-9.883928701627932,5
5980,29,14,20,9,-9.888770035938014,5
5981,16,20,110,13,-9.89345041941321,7
5982,83,14,11,10,-9.896151919094907,4
5983,54,47,37,31,-9.89694629679085,16
5984,3,20,62,13,-9.90834351366296,7
5985,75,35,28,23,-9.910859132469225,12
5986,84,50,63,31,-9.919938234846498,19
5987,2,10,95,7,-9.9203126299905,3
5988,29,15,75,9,-9.923300198268764,6
5989,65,25,38,15,-9.938323564506913,10
5990,88,45,63,31,-9.955054334971098,14
5991,90,14,46,9,-9.960134782518512,5
5992,88,18,73,12,-9.974203425238962,6
5993,12,21,53,13,-9.979940044053077,8
5994,109,14,93,9,-9.987067099161266,5
5995,65,25,95,16,-9.987438820754939,9
5996,107,41,57,26,-9.988909876937932,15
5997,84,27,30,19,-10.023299208241367,8
5998,107,13,110,9,-10.034721322746934,4
5999,38,10,44,7,-10.048373138060267,3
6000,33,23,51,17,-10.051201517023788,6
6001,83,23,13,15,-10.067954696106943,8
6002,79,12,13,8,-10.072956753420838,4
6003,49,16,40,10,-10.077718304922938,6
6004,106,12,79,8,-10.079963228120917,4
6005,38,19,104,12,-10.081026466226012,7
6006,3,37,27,23,-10.088019310903825,14
6007,17,17,23,11,-10.090670558592322,6
6008,3,45,13,31,-10.10303381393413,14
6009,36,36,53,25,-10.11473282468799,11
6010,114,12,78,7,-10.123963867745248,5
6011,109,10,92,7,-10.132066653367776,3
6012,31,37,53,23,-10.136338371296794,14
6013,23,11,96,7,-10.143008283174424,4
6014,68,16,92,11,-10.14730683848729,5
6015,61,12,30,8,-10.163971317134532,4
6016,78,23,39,15,-10.16867073318477,8
6017,9,12,6,7,-10.175309866966634,5
6018,35,25,76,16,-10.177855774517555,9
6019,30,12,80,8,-10.185455091355948,4
6020,37,41,97,27,-10.190687502541847,14
6021,33,13,71,9,-10.195530501937561,4
6022,2,15,98,9,-10.198603389321665,6
6023,96,24,48,16,-10.200121519345737,8
6024,106,63,16,43,-10.201810935158226,20
6025,39,24,91,16,-10.206322081312436,8
6026,28,14,10,10,-10.2079261309438,4
6027,31,17,30,10,-10.214096274935343,7
6028,72,11,76,8,-10.214708924963714,3
6029,91,35,63,24,-10.225389928816243,11
6030,106,16,67,10,-10.252161434234205,6
6031,39,43,18,29,-10.257246202371956,14
6032,72,15,39,10,-10.260914319406771,5
6033,38,12,100,9,-10.282003862678563,3
6034,112,24,60,16,-10.282975838759182,8
6035,107,23,45,15,-10.289536165233189,8
6036,35,15,27,10,-10.299796186005187,5
6037,31,29,107,16,-10.30345756995746,13
6038,85,11,30,7,-10.303891883685978,4
6039,88,36,15,26,-10.326397400952988,10
6040,10,14,11,9,-10.326527517070998,5
6041,38,15,11,10,-10.333740936310704,5
6042,19,15,9,10,-10.341402019858233,5
6043,1,13,37,8,-10.34216426905315,5
6044,102,16,40,10,-10.346146758066936,6
6045,77,16,53,10,-10.347606271977275,6
6046,7,10,94,7,-10.355621654064775,3
6047,85,17,39,10,-10.365791683743177,7
6048,12,12,9,8,-10.366855545040101,4
6049,55,16,15,12,-10.37053728825799,4
6050,114,21,100,14,-10.37586405259878,7
6051,93,16,106,10,-10.37915501513517,6
6052,92,14,16,11,-10.38158487536854,3
6053,77,21,63,15,-10.392881706705289,6
6054,19,16,72,11,-10.407019393633206,5
6055,114,19,95,12,-10.422604339796184,7
6056,39,18,108,11,-10.432805242984767,7
6057,39,16,44,10,-10.434810009571377,6
6058,31,10,6,6,-10.459894630543896,4
6059,49,14,94,10,-10.474432971630804,4
6060,48,36,63,24,-10.480037623792747,12
6061,48,10,62,6,-10.487894133335649,4
6062,9,27,64,19,-10.495957554452968,8
6063,48,12,29,8,-10.5062410495631,4
6064,48,32,86,21,-10.510093191570515,11
6065,102,16,63,10,-10.517349087153978,6
6066,37,14,89,8,-10.519274673853,6
6067,103,10,76,7,-10.522979980156947,3
6068,36,27,27,17,-10.523349599331356,10
6069,97,19,71,13,-10.523533962196899,6
6070,100,13,72,9,-10.528540542570205,4
6071,17,16,41,11,-10.533333329606139,5
6072,108,13,76,9,-10.539317855686345,4
6073,20,39,50,26,-10.540260354284218,13
6074,40,17,28,10,-10.551622113062638,7
6075,54,19,71,12,-10.56377327137223,7
6076,9,15,95,9,-10.569002592922953,6
6077,88,18,102,13,-10.569492123514113,5
6078,75,26,104,17,-10.574353916694225,9
6079,28,10,26,7,-10.592168464369761,3
6080,91,31,7,22,-10.60910028610159,9
6081,71,18,98,12,-10.627953776602759,6
6082,106,40,114,26,-10.63191941709851,14
6083,35,11,3,7,-10.637414854102069,4
6084,98,25,5,16,-10.662918685540621,9
6085,9,21,20,14,-10.676297323703047,7
6086,57,12,38,7,-10.682623087511102,5
6087,76,13,75,8,-10.684711333832395,5
6088,72,19,85,14,-10.69575679628125,5
6089,36,13,43,8,-10.713552025008546,5
6090,111,11,54,8,-10.714143810197228,3
6091,17,22,53,15,-10.723383781136489,7
6092,27,22,54,14,-10.72525704819168,8
6093,49,11,48,8,-10.735556213813274,3
6094,19,28,27,20,-10.741284129806774,8
6095,108,23,53,14,-10.749834986479383,9
6096,7,11,59,8,-10.771239818059199,3
6097,19,25,7,18,-10.775977198177875,7
6098,91,25,55,18,-10.791612827626562,7
6099,81,17,106,10,-10.816681182916206,7
6100,2,11,30,7,-10.820419515250846,4
6101,108,15,48,11,-10.823092907934063,4
6102,77,17,100,11,-10.823147304819512,6
6103,112,14,49,9,-10.834140299620776,5
6104,12,14,114,8,-10.834474307512755,6
6105,11,28,104,19,-10.845922414749024,9
6106,114,31,87,19,-10.855794018644563,12
6107,81,11,28,7,-10.900813686195038,4
6108,35,10,102,6,-10.90320798703147,4
6109,8,12,69,8,-10.904584563603306,4
6110,5,17,73,11,-10.90738305979487,6
6111,18,46,13,30,-10.917911397709467,16
6112,97,25,13,16,-10.985857531237674,9
6113,72,13,50,9,-10.99594913265495,4
6114,57,24,70,14,-10.997514680908582,10
6115,30,12,112,9,-10.999416558177835,3
6116,110,20,51,14,-11.000148170458745,6
6117,3,26,40,18,-11.007177692487943,8
6118,71,13,15,9,-11.00914391321026,4
6119,27,29,104,20,-11.01231010873536,9
6120,92,14,41,9,-11.016394202336143,5
6121,32,17,16,11,-11.045561391190384,6
6122,114,12,32,8,-11.045874107216177,4
6123,11,11,99,7,-11.04788337752713,4
6124,103,17,11,13,-11.073354537239329,4
6125,63,20,62,13,-11.090581145313465,7
6126,43,14,11,9,-11.092426053601756,5
6127,104,15,62,11,-11.098747349135209,4
6128,32,13,74,9,-11.101664191982367,4
6129,70,15,46,10,-11.123543654837002,5
6130,91,16,43,11,-11.128114127049445,5
6131,38,16,75,12,-11.14383618558865,4
6132,102,22,107,14,-11.147471989575463,8
6133,1,13,78,9,-11.156578268103178,4
6134,51,29,95,21,-11.161050582896516,8
6135,4,16,43,10,-11.162760468553993,6
6136,9,27,15,16,-11.164728453136332,11
6137,94,20,30,13,-11.167617773854161,7
6138,37,18,64,12,-11.185324034227655,6
6139,87,29,98,20,-11.186830060106244,9
6140,1,11,89,7,-11.20901106938993,4
6141,46,12,100,8,-11.210309669403358,4
6142,3,15,25,10,-11.21463496022273,5
6143,106,18,98,12,-11.217270403208776,6
6144,51,13,73,9,-11.219804453521853,4
6145,8,36,75,25,-11.220741251540183,11
6146,96,20,46,12,-11.223825219116964,8
6147,68,25,25,17,-11.235607083018872,8
6148,109,17,75,12,-11.242273446455997,5
6149,81,13,40,9,-11.249205674756395,4
6150,83,16,107,11,-11.24958512039028,5
6151,70,29,87,18,-11.250414739740132,11
6152,101,13,16,9,-11.255156877916162,4
6153,7,52,75,35,-11.2746633859962,17
6154,55,14,2,9,-11.276816159574057,5
6155,27,11,111,8,-11.279710088837586,3
6156,107,35,48,23,-11.28123382017902,12
6157,51,20,80,13,-11.284900357531916,7
6158,5,10,80,7,-11.295210617596885,3
6159,96,25,7,18,-11.300422106484014,7
6160,88,42,53,29,-11.310024402316408,13
6161,51,22,62,15,-11.32089534846404,7
6162,20,12,64,9,-11.331308462604776,3
6163,77,30,104,20,-11.335858846829382,10
6164,102,15,75,11,-11.3579023724584,4
6165,68,20,103,13,-11.368753796751397,7
6166,112,22,28,15,-11.372427658976596,7
6167,10,14,107,9,-11.38119632500004,5
6168,38,11,4,8,-11.395009854616482,3
6169,95,10,29,7,-11.401888238693147,3
6170,50,16,85,11,-11.432524505459872,5
6171,88,38,50,25,-11.435059490334734,13
6172,86,35,102,24,-11.47108362289953,11
6173,18,15,11,10,-11.496523839067972,5
6174,81,15,7,9,-11.525413070422037,6
6175,7,12,110,7,-11.526061320417652,5
6176,76,15,74,9,-11.544600382799558,6
6177,29,10,50,7,-11.55678927961794,3
6178,71,10,111,7,-11.563837134119527,3
6179,104,16,36,10,-11.564722196156035,6
6180,37,38,11,26,-11.566356283581701,12
6181,50,15,33,10,-11.568332857311571,5
6182,20,13,78,9,-11.57777914114835,4
6183,39,15,90,10,-11.577976501423594,5
6184,40,12,100,8,-11.638460148115906,4
6185,104,11,93,7,-11.670878710804795,4
6186,88,10,21,7,-11.67738292245627,3
6187,28,23,34,16,-11.682170467841411,7
6188,96,13,91,9,-11.692854193124042,4
6189,88,78,13,54,-11.71558742957354,24
6190,51,19,72,12,-11.715625610109745,7
6191,94,22,39,15,-11.719613330837495,7
6192,94,13,85,9,-11.736414032142248,4
6193,87,22,79,16,-11.757907554031659,6
6194,43,20,54,13,-11.759609270938485,7
6195,12,13,75,8,-11.770852723789327,5
6196,62,10,112,7,-11.78047192200998,3
6197,109,18,17,12,-11.781743441013703,6
6198,65,12,91,8,-11.784658313781671,4
6199,54,10,44,7,-11.791894285038754,3
6200,40,21,8,15,-11.791921402372775,6
6201,41,11,15,8,-11.80165523386963,3
6202,108,11,8,8,-11.805411430354427,3
6203,91,10,53,7,-11.811611902058761,3
6204,17,10,83,6,-11.812775268760374,4
6205,111,16,28,11,-11.820301223407922,5
6206,64,10,74,6,-11.828764368523549,4
6207,28,47,63,33,-11.828866423716303,14
6208,37,10,78,7,-11.831707242150298,3
6209,29,23,13,15,-11.832910968358506,8
6210,86,17,92,11,-11.83357437507567,6
6211,28,34,74,23,-11.834419909257845,11
6212,41,22,111,14,-11.859477089655313,8
6213,104,18,90,12,-11.89837391797068,6
6214,77,17,71,12,-11.915487518479782,5
6215,29,28,60,18,-11.935295873360038,10
6216,65,46,114,30,-11.938229846486397,16
6217,18,27,95,18,-11.951490678023534,9
6218,54,10,53,7,-11.951994898142779,3
6219,60,16,37,10,-11.9668638856867,6
6220,49,21,76,14,-11.98212347280871,7
6221,55,18,102,12,-11.983866194974432,6
6222,43,13,34,9,-11.988958581252158,4
6223,69,29,49,19,-12.014682569242261,10
6224,104,12,1,8,-12.020108292717424,4
6225,103,24,27,16,-12.03841928622495,8
6226,63,18,1,11,-12.054495717242014,7
6227,71,22,104,14,-12.060518806565574,8
6228,91,18,30,13,-12.061464887561756,5
6229,3,20,53,14,-12.068087567340713,6
6230,81,24,87,15,-12.09125630356504,9
6231,35,11,8,8,-12.093356369533684,3
6232,109,15,15,11,-12.110158649114124,4
6233,68,25,100,16,-12.114564908877218,9
6234,72,20,28,14,-12.11934808588004,6
6235,70,12,34,8,-12.123530804367727,4
6236,4,10,15,6,-12.1242208434208,4
6237,112,16,47,10,-12.125896663153027,6
6238,63,12,92,7,-12.136993324985582,5
6239,31,11,19,8,-12.140248760143196,3
6240,70,22,2,14,-12.153236389251056,8
6241,99,21,107,14,-12.174640608684573,7
6242,57,19,65,13,-12.179886904630772,6
6243,67,14,16,10,-12.181707474418104,4
6244,39,18,109,13,-12.189314131019263,5
6245,84,35,11,24,-12.189911906563859,11
6246,76,18,7,11,-12.196617315781682,7
6247,106,11,78,8,-12.21024325274275,3
6248,107,22,19,16,-12.214517428492758,6
6249,9,14,43,9,-12.224469441855376,5
6250,43,19,75,14,-12.224767647713705,5
6251,60,22,74,14,-12.230302476711504,8
6252,80,14,78,10,-12.249303135974206,4
6253,57,15,76,11,-12.252643312548889,4
6254,84,11,71,8,-12.255989147154674,3
6255,39,10,32,7,-12.25900875776762,3
6256,96,29,98,20,-12.301665445316491,9
6257,57,14,75,10,-12.306540056833528,4
6258,60,24,47,17,-12.306617941323186,7
6259,104,23,49,16,-12.322985298305156,7
6260,97,12,67,9,-12.35346782744064,3
6261,46,39,104,26,-12.353574327141937,13
6262,50,17,36,10,-12.423703215189779,7
6263,94,12,9,7,-12.432581088458589,5
6264,37,14,18,10,-12.438833593443572,4
6265,94,11,17,7,-12.465558824086667,4
6266,1,38,55,27,-12.470203554889151,11
6267,92,15,64,8,-12.492372460791037,7
6268,78,16,76,12,-12.532424570064771,4
6269,5,27,75,17,-12.535083552437035,10
6270,71,18,41,13,-12.557773267008848,5
6271,5,27,57,19,-12.572003913811173,8
6272,51,30,15,20,-12.589187635735605,10
6273,102,12,15,9,-12.597866884640942,3
6274,72,13,63,10,-12.658103214813368,3
6275,3,24,100,17,-12.663085279232618,7
6276,5,15,48,11,-12.675358072710548,4
6277,63,40,80,28,-12.682443988429267,12
6278,2,12,57,8,-12.707474284723991,4
6279,88,16,111,12,-12.710530076381987,4
6280,48,12,98,9,-12.72400980532305,3
6281,106,24,46,15,-12.725492516069489,9
6282,106,14,33,10,-12.736963404825662,4
6283,109,27,114,20,-12.737377288037608,7
6284,36,10,95,7,-12.746346244298937,3
6285,81,12,54,8,-12.757047966098474,4
6286,57,18,100,12,-12.77050740482076,6
6287,109,17,30,12,-12.77620316977717,5
6288,88,10,34,7,-12.786710581831153,3
6289,112,13,38,10,-12.849363497429499,3
6290,103,12,78,10,-12.857012772866142,2
6291,3,17,20,12,-12.875807771067082,5
6292,65,21,2,16,-12.8900275785182,5
6293,103,18,107,13,-12.891833025895632,5
6294,3,13,34,9,-12.892571415057605,4
6295,62,20,74,14,-12.893098863947467,6
6296,48,14,60,10,-12.898116343169702,4
6297,60,29,91,19,-12.952631394075716,10
6298,108,11,84,8,-13.07106461175519,3
6299,49,11,80,7,-13.08267612923157,4
6300,3,24,30,17,-13.090996729925564,7
6301,87,11,21,8,-13.114631052870209,3
6302,70,10,83,6,-13.118339150755117,4
6303,88,13,98,10,-13.137787822509532,3
6304,37,28,95,21,-13.149042342745602,7
6305,102,15,30,10,-13.159479789794938,5
6306,70,22,11,16,-13.174919150937757,6
6307,19,14,76,10,-13.190869862531446,4
6308,37,12,15,9,-13.204885577431204,3
6309,54,18,36,12,-13.217744798273172,6
6310,96,39,11,27,-13.252582377716239,12
6311,112,12,15,8,-13.25658340349479,4
6312,11,23,95,17,-13.263288005084238,6
6313,5,31,102,21,-13.269431869962297,10
6314,99,12,7,8,-13.274517260788413,4
6315,106,19,64,13,-13.295192075566398,6
6316,46,17,50,11,-13.310329365776978,6
6317,18,16,47,12,-13.317575135316673,4
6318,46,12,18,9,-13.322032493347338,3
6319,11,22,100,15,-13.327325649124537,7
6320,20,15,34,11,-13.349753634163106,4
6321,32,11,55,7,-13.36363963009391,4
6322,35,12,104,8,-13.369677424437175,4
6323,103,11,28,8,-13.400171591171766,3
6324,62,13,78,9,-13.40507362108488,4
6325,103,24,100,17,-13.416971588030298,7
6326,112,11,91,8,-13.423237527272477,3
6327,53,15,75,10,-13.423496737137004,5
6328,68,16,61,11,-13.424919545398375,5
6329,32,12,25,7,-13.427877456338663,5
6330,45,15,23,11,-13.436468047997268,4
6331,53,19,43,14,-13.438033142991657,5
6332,27,14,17,9,-13.439086650659679,5
6333,35,15,36,11,-13.440272285829963,4
6334,54,28,48,19,-13.475788580607775,9
6335,57,10,1,7,-13.498323659072739,3
6336,66,11,7,7,-13.514093541012448,4
6337,109,13,72,10,-13.538745703424034,3
6338,78,18,17,12,-13.544860133238458,6
6339,91,12,76,9,-13.56346091448288,3
6340,74,10,15,7,-13.56932630742914,3
6341,77,15,43,10,-13.628489418492514,5
6342,18,11,49,8,-13.655065375637419,3
6343,103,11,109,7,-13.675879641836712,4
6344,49,12,47,9,-13.687802461931257,3
6345,44,14,104,10,-13.703910249073422,4
6346,31,25,63,18,-13.714594813504094,7
6347,33,14,63,10,-13.733555706081619,4
6348,27,10,97,6,-13.735152835550487,4
6349,88,37,95,26,-13.752013257016609,11
6350,50,17,77,13,-13.753479149012174,4
6351,75,13,98,9,-13.771823974459997,4
6352,94,14,78,10,-13.782893393913412,4
6353,112,11,97,9,-13.794615799527321,2
6354,31,74,13,51,-13.800549608099518,23
6355,31,17,98,11,-13.805084918983175,6
6356,104,14,34,10,-13.864298464092721,4
6357,50,19,53,13,-13.883151416746287,6
6358,76,17,54,12,-13.892444764564262,5
6359,112,11,37,8,-13.937736127059297,3
6360,12,21,41,15,-13.938646246649764,6
6361,69,19,75,14,-13.94230448490658,5
6362,109,11,91,8,-13.94618860472034,3
6363,71,24,40,17,-13.948125771645659,7
6364,75,12,111,8,-13.972281809419961,4
6365,91,11,69,7,-13.993001551531528,4
6366,77,21,8,15,-13.998411080894305,6
6367,39,11,45,7,-14.033377854173942,4
6368,77,29,40,21,-14.048771071022598,8
6369,60,15,34,11,-14.065381835140743,4
6370,65,38,100,28,-14.066095929641138,10
6371,13,34,30,23,-14.093936327325613,11
6372,94,38,16,28,-14.115630694559716,10
6373,80,11,41,8,-14.186716292232557,3
6374,75,10,72,7,-14.207053385683185,3
6375,7,17,61,11,-14.217702740281519,6
6376,103,13,55,10,-14.23298089068328,3
6377,94,11,104,8,-14.253478157346805,3
6378,23,12,72,9,-14.264075883340938,3
6379,51,18,94,13,-14.284138592654589,5
6380,60,15,102,10,-14.297767291892317,5
6381,37,12,34,9,-14.300571264435137,3
6382,102,11,46,8,-14.307494713152051,3
6383,57,12,31,8,-14.310689026630849,4
6384,112,10,108,7,-14.316449946299121,3
6385,86,25,26,19,-14.32203675657022,6
6386,77,27,7,19,-14.33556677589385,8
6387,83,10,40,8,-14.347262135245904,2
6388,79,15,30,11,-14.36757805375368,4
6389,109,25,27,17,-14.382423321336262,8
6390,90,16,20,11,-14.40477443227545,5
6391,70,26,108,19,-14.427393649276276,7
6392,14,11,80,7,-14.435345395194508,4
6393,35,13,97,10,-14.4445517315995,3
6394,5,12,44,9,-14.447481002517355,3
6395,35,13,63,9,-14.450412261730216,4
6396,88,18,80,12,-14.454567385774531,6
6397,2,10,73,7,-14.457830254043136,3
6398,25,12,34,9,-14.468789684868275,3
6399,37,12,73,8,-14.533349572792924,4
6400,9,11,108,7,-14.533752266696007,4
6401,6,10,19,7,-14.554142944413206,3
6402,50,19,80,15,-14.554439051919099,4
6403,103,14,39,10,-14.559450951683674,4
6404,99,12,50,8,-14.581629542155014,4
6405,29,22,88,16,-14.584788845308772,6
6406,83,19,114,14,-14.71253096490687,5
6407,29,10,74,7,-14.72390247298373,3
6408,31,10,100,7,-14.730848989291465,3
6409,102,11,90,6,-14.739148726840858,5
6410,106,14,32,11,-14.741977351969277,3
6411,47,12,78,8,-14.759178311128258,4
6412,54,36,75,25,-14.80658448659353,11
6413,76,13,15,9,-14.81353391108204,4
6414,102,10,27,8,-14.8415066807879,2
6415,50,13,78,10,-14.845595527102414,3
6416,38,13,87,9,-14.859584047072818,4
6417,28,12,110,8,-14.8602682733133,4
6418,112,10,55,8,-14.907032679929216,2
6419,77,12,98,9,-14.973611058432565,3
6420,22,12,13,9,-14.994671319317485,3
6421,75,10,45,8,-15.003649946946844,2
6422,99,18,25,13,-15.014737107768294,5
6423,79,16,104,11,-15.05495488242158,5
6424,51,19,45,14,-15.064032724857126,5
6425,69,10,111,7,-15.0816233253005,3
6426,29,10,71,8,-15.14318831762859,2
6427,29,15,64,12,-15.189033105530587,3
6428,69,14,15,11,-15.208966346153654,3
6429,47,12,55,8,-15.214446673688142,4
6430,29,19,100,13,-15.221800519331856,6
6431,11,10,49,7,-15.249342027085248,3
6432,46,14,93,11,-15.251126640356869,3
6433,98,13,109,10,-15.276765537635708,3
6434,3,27,63,22,-15.281871445146514,5
6435,41,15,30,10,-15.299076943535713,5
6436,84,15,41,11,-15.33074063826509,4
6437,43,18,55,15,-15.331339787531817,3
6438,9,29,41,21,-15.339577028005058,8
6439,29,13,109,8,-15.345893123711155,5
6440,57,15,34,11,-15.357045361759068,4
6441,3,27,84,18,-15.372916145146673,9
6442,46,12,98,8,-15.381140721878973,4
6443,103,10,15,7,-15.4100658100373,3
6444,25,14,49,10,-15.43786379260084,4
6445,63,27,30,19,-15.449959755734394,8
6446,107,25,73,17,-15.460672720698524,8
6447,103,12,74,9,-15.463990000688312,3
6448,39,12,2,9,-15.473797666414958,3
6449,84,22,112,16,-15.486639525748986,6
6450,31,15,69,10,-15.502962092044207,5
6451,2,18,104,12,-15.50344370749933,6
6452,104,20,64,15,-15.515264160119221,5
6453,10,11,37,7,-15.516949569025604,4
6454,14,11,25,9,-15.536643242754739,2
6455,11,12,108,9,-15.551347739122178,3
6456,31,12,104,8,-15.561592201078605,4
6457,5,20,23,15,-15.563915929412014,5
6458,77,23,16,17,-15.591779205572045,6
6459,45,14,4,10,-15.600891470448104,4
6460,85,11,106,8,-15.605731963514037,3
6461,19,19,51,15,-15.610466167057197,4
6462,97,13,90,9,-15.62188808576594,4
6463,81,13,100,9,-15.624637447777362,4
6464,104,13,78,10,-15.636975901996578,3
6465,97,12,14,10,-15.664913845649806,2
6466,35,13,87,9,-15.683184050777022,4
6467,3,12,47,9,-15.700624626069072,3
6468,1,13,8,10,-15.702434313684371,3
6469,80,13,75,10,-15.71805205236554,3
6470,35,12,80,9,-15.72406211872363,3
6471,77,14,37,10,-15.73169378416834,4
6472,96,16,93,12,-15.73319462766121,4
6473,57,20,7,13,-15.746440629237659,7
6474,35,10,75,8,-15.755761764469415,2
6475,93,11,30,8,-15.77720736230077,3
6476,17,22,95,17,-15.802621580377178,5
6477,58,24,65,17,-15.81241433590518,7
6478,57,14,62,11,-15.83178341004695,3
6479,31,45,16,33,-15.837412153743443,12
6480,39,18,99,14,-15.84878961626863,4
6481,81,10,19,8,-15.857835232981126,2
6482,28,29,90,22,-15.880089586771652,7
6483,57,18,94,13,-15.891839037049907,5
6484,28,12,43,8,-15.894105628705272,4
6485,9,30,53,22,-15.894615033798411,8
6486,70,13,80,11,-15.90133341789594,2
6487,2,12,100,8,-15.930884215555713,4
6488,63,13,14,9,-15.961958621197994,4
6489,18,14,69,10,-16.02698149276047,4
6490,5,18,41,12,-16.050377082501456,6
6491,68,17,29,13,-16.10382128350728,4
6492,112,15,71,11,-16.11687592102847,4
6493,69,18,27,13,-16.145804863274613,5
6494,102,10,43,7,-16.154622115934174,3
6495,54,10,34,8,-16.192576513322773,2
6496,19,14,63,11,-16.214836651867664,3
6497,83,12,27,10,-16.235141261119562,2
6498,80,12,34,10,-16.269229317512288,2
6499,40,10,29,8,-16.37829418439082,2
6500,25,25,11,20,-16.429746187224737,5
6501,102,11,29,9,-16.462227654940605,2
6502,55,15,14,12,-16.464885141480416,3
6503,64,10,66,8,-16.526342406123632,2
6504,83,20,16,15,-16.531803021169054,5
6505,69,22,53,16,-16.54470456650947,6
6506,68,22,95,18,-16.550204863156033,4
6507,36,10,101,8,-16.627946704419497,2
6508,68,16,50,11,-16.665846594945688,5
6509,71,15,95,10,-16.72675418994599,5
6510,83,13,23,10,-16.744700089549813,3
6511,76,10,1,7,-16.815372977495876,3
6512,97,14,38,11,-16.838290194315167,3
6513,10,12,13,9,-16.89276746041982,3
6514,112,19,20,15,-16.964936240764274,4
6515,31,10,38,6,-16.97274158238424,4
6516,46,11,43,8,-16.991693442801246,3
6517,70,11,48,8,-17.04295857723929,3
6518,1,14,18,11,-17.058153705270225,3
6519,13,17,80,12,-17.06375198393908,5
6520,9,29,27,21,-17.072056537621457,8
6521,43,16,30,13,-17.116460431238483,3
6522,2,11,60,8,-17.11684300008854,3
6523,5,22,27,16,-17.186967099907662,6
6524,20,13,60,10,-17.267904745312975,3
6525,106,10,35,7,-17.319051156851785,3
6526,112,25,78,19,-17.347844978089675,6
6527,58,21,86,16,-17.41327003256676,5
6528,35,10,60,7,-17.41812694726481,3
6529,18,14,23,10,-17.468338798211544,4
6530,79,11,76,9,-17.53144635448245,2
6531,83,11,110,9,-17.575104905290946,2
6532,67,10,20,8,-17.6724550880506,2
6533,3,11,5,7,-17.694163901939547,4
6534,55,12,44,9,-17.771847163193563,3
6535,5,18,30,15,-17.81053305502534,3
6536,88,17,32,13,-17.824594134673823,4
6537,114,11,111,8,-17.846918134233796,3
6538,41,10,35,7,-17.84884882348167,3
6539,77,10,15,8,-17.86087680202781,2
6540,30,15,95,11,-17.91990160883281,4
6541,33,18,55,14,-17.969879843551904,4
6542,54,10,67,8,-18.121548101252507,2
6543,79,10,75,8,-18.185200748196127,2
6544,7,10,12,7,-18.198433480354236,3
6545,43,12,81,9,-18.327617727929386,3
6546,68,33,112,26,-18.359935763708748,7
6547,81,15,49,11,-18.413832313114135,4
6548,18,10,5,8,-18.464269170029826,2
6549,9,15,48,12,-18.472872872736897,3
6550,3,15,48,11,-18.490434950243607,4
6551,31,15,106,11,-18.52908676481624,4
6552,51,17,2,12,-18.653898249315773,5
6553,28,17,99,13,-18.754584808369174,4
6554,3,12,38,9,-18.873975290720182,3
6555,11,10,2,8,-18.92308479788875,2
6556,4,13,98,11,-18.936498509144613,2
6557,106,11,89,7,-18.95338953455919,4
6558,6,10,30,8,-19.02037640213381,2
6559,106,10,92,8,-19.041690772468705,2
6560,43,12,45,9,-19.04326521517843,3
6561,54,16,4,14,-19.244087603842104,2
6562,18,14,99,11,-19.290873438644514,3
6563,36,19,30,17,-19.30529767168729,2
6564,51,22,90,18,-19.526276440378883,4
6565,51,10,101,8,-19.538804927619935,2
6566,112,15,80,11,-19.69397904792924,4
6567,5,11,64,9,-19.698196874853632,2
6568,31,11,15,8,-19.738787942525683,3
6569,32,12,95,10,-19.760326388824467,2
6570,108,11,114,8,-19.76837565181859,3
6571,33,15,65,12,-19.770112976636934,3
6572,97,13,73,9,-19.966763707753135,4
6573,84,12,7,10,-20.160900959942534,2
6574,69,11,72,9,-20.210260183380633,2
6575,10,15,51,12,-20.332726180509006,3
6576,35,11,48,9,-20.438098241934796,2
6577,94,23,81,17,-20.51779847980575,6
6578,72,10,57,10,-20.68783938357469,0
6579,79,11,17,9,-20.72101316555543,2
6580,12,11,30,9,-20.751004345403043,2
6581,68,11,90,9,-20.787956198015944,2
6582,38,11,55,9,-20.87506721402826,2
6583,43,10,110,8,-21.055981543018305,2
6584,10,13,112,10,-21.234179723414762,3
6585,91,16,104,15,-21.31971827875211,1
6586,4,13,25,11,-21.42004260246313,2
6587,4,15,41,10,-21.480590173913868,5
6588,58,10,49,8,-21.7746386625006,2
6589,31,12,62,9,-21.790941067775986,3
6590,19,13,55,10,-22.028452252987634,3
6591,48,13,78,11,-22.133379125833553,2
6592,97,12,91,10,-22.175648770183788,2
6593,57,12,29,10,-22.398372618819636,2
6594,94,13,62,11,-22.468181714111132,2
6595,29,12,72,10,-22.84597050029316,2
6596,8,11,4,10,-23.17790508365148,1
6597,77,19,75,16,-23.528365703077355,3
6598,109,11,12,10,-23.647352995961207,1
6599,57,12,112,10,-24.05133711856007,2
6600,97,11,34,9,-24.058676404388496,2
6601,3,16,75,14,-24.194103806582213,2
6602,42,11,104,10,-24.554805995086454,1
6603,57,12,26,10,-24.80508950345583,2
6604,109,10,19,9,-27.66236213744933,1
6605,23,13,90,12,-28.362481429909796,1
6606,37,11,44,11,-29.883498899257123,0
6607,102,14,112,13,-30.363340186062864,1
