,againstHero,games,hero,losses,shift,wins
0,112,17,102,1,31.59305348177514,16
1,44,11,37,0,29.88349889925713,11
2,90,13,23,1,28.362481429909806,12
3,98,10,61,0,28.323329566102494,10
4,69,10,38,1,27.695920761479556,9
5,49,10,106,1,25.681632401928862,9
6,100,11,33,1,25.460296177649866,10
7,104,11,42,1,24.55480599508646,10
8,55,13,38,2,23.805883695964802,11
9,75,19,77,3,23.52836570307736,16
10,4,11,8,1,23.177905083651485,10
11,26,14,57,3,23.006782602638854,11
12,104,18,91,1,22.937436859705542,17
13,3,10,1,2,22.670516239418717,8
14,91,12,97,2,22.175648770183784,10
15,11,15,89,2,21.994738492227253,13
16,62,12,31,3,21.790941067775986,9
17,34,12,62,2,21.778436974548594,10
18,64,11,34,2,21.53865059177988,9
19,41,15,4,5,21.48059017391386,10
20,25,13,4,2,21.420042602463127,11
21,101,11,51,2,21.226620175614492,9
22,76,11,31,1,21.157211826935978,10
23,80,16,112,4,21.108795407964617,12
24,51,16,10,3,21.051824036569297,13
25,109,10,90,1,21.034570289962243,9
26,112,14,10,3,21.021770709139737,11
27,75,17,3,3,20.89719169832094,14
28,90,11,68,2,20.787956198015937,9
29,48,18,3,4,20.77461856356065,14
30,114,13,108,3,20.76617442739275,10
31,81,23,94,6,20.517798479805748,17
32,30,11,10,2,20.38962047667116,9
33,26,10,12,2,20.379731856409943,8
34,75,10,103,1,20.24199150509897,9
35,112,38,68,8,20.161440612174868,30
36,7,12,84,2,20.160900959942538,10
37,57,10,89,2,20.153446064878874,8
38,76,12,89,2,20.057237370983124,10
39,4,17,54,2,19.994435391851386,15
40,73,13,97,4,19.966763707753138,9
41,94,10,38,2,19.793182522248046,8
42,95,12,32,2,19.760326388824467,10
43,15,11,31,3,19.738787942525676,8
44,64,11,5,2,19.698196874853622,9
45,30,11,6,2,19.605882514870544,9
46,114,11,29,3,19.42881288570476,8
47,30,19,36,2,19.305297671687292,17
48,99,14,18,3,19.290873438644518,11
49,92,10,106,2,19.04169077246869,8
50,89,11,106,4,18.95338953455918,7
51,98,13,4,2,18.93649850914462,11
52,34,12,97,3,18.831202908180163,9
53,55,20,33,4,18.82593244000092,16
54,27,12,102,2,18.772173343475483,10
55,99,17,28,4,18.75458480836917,13
56,112,16,57,4,18.741640604630682,12
57,45,10,12,2,18.653807119995122,8
58,106,15,31,4,18.52908676481623,11
59,87,17,35,5,18.4649770696095,12
60,34,12,54,2,18.362976743969607,10
61,80,20,13,6,18.335804849316265,14
62,19,11,6,3,18.335706204340323,8
63,81,12,43,3,18.327617727929393,9
64,55,14,12,3,18.17466355866916,11
65,67,10,54,2,18.121548101252504,8
66,54,21,76,5,18.08934803214948,16
67,95,15,30,4,17.919901608832795,11
68,35,10,41,3,17.84884882348167,7
69,111,11,114,3,17.846918134233793,8
70,32,17,88,4,17.824594134673823,13
71,48,13,35,3,17.821530991658573,10
72,30,18,5,3,17.81053305502534,15
73,85,10,15,2,17.788004047228643,8
74,44,12,55,3,17.77184716319358,9
75,90,23,51,5,17.7178788097309,18
76,5,11,3,4,17.694163901939536,7
77,78,18,62,4,17.68760040703652,14
78,20,10,67,2,17.672455088050597,8
79,48,12,70,3,17.608815428580364,9
80,110,11,83,2,17.575104905290953,9
81,109,18,29,6,17.571930830154646,12
82,16,39,77,9,17.459530597353453,30
83,80,10,29,2,17.457200220457587,8
84,60,10,35,3,17.41812694726481,7
85,15,15,76,4,17.413278847676434,11
86,35,10,106,3,17.31905115685177,7
87,27,22,5,6,17.18696709990766,16
88,102,17,60,5,17.171392721318526,12
89,60,11,2,3,17.116843000088547,8
90,27,29,9,8,17.072056537621442,21
91,18,14,1,3,17.058153705270215,11
92,73,13,37,4,17.032463348069772,9
93,38,10,31,4,16.97274158238423,6
94,20,19,112,4,16.964936240764278,15
95,43,12,46,3,16.90387334173946,9
96,29,18,57,4,16.901122362734938,14
97,22,10,41,2,16.895138763704843,8
98,13,12,10,3,16.89276746041981,9
99,37,12,10,4,16.877061428062927,8
100,88,27,29,7,16.85204786067182,20
101,18,14,46,3,16.84517490405338,11
102,30,20,41,5,16.767826748629854,15
103,23,13,83,3,16.74470008954982,10
104,95,15,71,5,16.726754189945982,10
105,78,28,112,7,16.67914983172849,21
106,53,23,69,6,16.676579450904736,17
107,48,13,94,3,16.653883625052593,10
108,101,10,36,2,16.627946704419482,8
109,19,15,109,4,16.588566849406615,11
110,95,22,68,4,16.55020486315604,18
111,17,12,79,3,16.528587589888392,9
112,66,10,64,2,16.52634240612363,8
113,16,46,31,12,16.494251500601973,34
114,61,10,87,3,16.482333693393578,7
115,14,15,55,3,16.46488514148042,12
116,19,11,37,2,16.4401797639671,9
117,87,15,38,4,16.440170970047017,11
118,99,19,39,4,16.42872930905631,15
119,74,13,103,3,16.409823032190317,10
120,45,13,43,4,16.39462685745925,9
121,14,14,63,4,16.386711509096077,10
122,29,10,40,2,16.378294184390825,8
123,110,11,43,3,16.376498956572302,8
124,27,13,83,2,16.3680925226411,11
125,100,22,57,6,16.352929528191847,16
126,104,19,2,6,16.35238800305577,13
127,25,12,14,2,16.337614979675553,10
128,109,17,98,4,16.30686299478245,13
129,30,18,85,5,16.304609608829036,13
130,65,16,33,4,16.286121361101067,12
131,34,12,80,2,16.26922931751229,10
132,86,25,58,6,16.268533196463114,19
133,98,13,46,4,16.128351252027375,9
134,71,15,112,4,16.11687592102847,11
135,41,18,5,6,16.050377082501452,12
136,72,15,29,4,16.043829927756203,11
137,15,14,37,3,16.033544043199246,11
138,53,31,9,8,16.014655893145633,23
139,57,11,90,3,15.975273202140915,8
140,80,11,76,3,15.945303671637879,8
141,80,13,70,2,15.901333417895945,11
142,90,29,28,7,15.88008958677165,22
143,15,12,41,3,15.833444649300676,9
144,95,22,17,5,15.802621580377183,17
145,110,13,28,4,15.75542536900984,9
146,17,13,94,4,15.746212612138288,9
147,93,16,96,4,15.733194627661216,12
148,80,12,35,3,15.724062118723628,9
149,75,13,80,3,15.718052052365538,10
150,45,20,51,5,15.703190735785379,15
151,15,14,112,4,15.700949053545523,10
152,72,23,51,7,15.686011493569213,16
153,14,12,97,2,15.664913845649805,10
154,90,13,97,4,15.621888085765939,9
155,106,11,85,3,15.605731963514026,8
156,23,10,69,2,15.603167423944381,8
157,4,14,45,4,15.60089147044811,10
158,100,10,90,2,15.59689537510572,8
159,23,21,5,5,15.554175057753397,16
160,13,12,66,3,15.520614540867863,9
161,64,20,104,5,15.515264160119216,15
162,69,15,31,5,15.502962092044207,10
163,112,23,84,6,15.486639525748984,17
164,2,12,39,3,15.473797666414951,9
165,73,25,107,8,15.46067272069853,17
166,5,11,18,3,15.389394006883377,8
167,12,16,62,5,15.366878044727521,11
168,100,15,2,5,15.36385849078198,10
169,104,12,94,3,15.27233865597326,9
170,93,14,46,3,15.251126640356858,11
171,16,44,94,11,15.208855057085275,33
172,54,11,77,1,15.154916790692539,10
173,48,31,54,9,15.15203502038891,22
174,71,10,29,2,15.143188317628589,8
175,77,19,50,4,15.082093464135092,15
176,38,10,93,4,15.046407356806787,6
177,49,18,81,6,15.043369514696264,12
178,25,18,99,5,15.014737107768298,13
179,45,10,75,2,15.00364994694684,8
180,13,12,22,3,14.994671319317483,9
181,80,14,49,5,14.99318638978968,9
182,49,10,44,3,14.992301775479177,7
183,76,14,91,3,14.966787278347377,11
184,111,18,88,4,14.891378091601458,14
185,15,19,77,5,14.819984931970572,14
186,102,11,35,4,14.787485364380144,7
187,7,11,89,3,14.785043291363074,8
188,11,26,25,6,14.778705544740387,20
189,27,19,89,5,14.746406878256858,14
190,32,14,106,3,14.741977351969275,11
191,78,15,48,4,14.736137197437774,11
192,100,10,31,3,14.730848989291468,7
193,7,28,77,8,14.729495105034692,20
194,114,19,83,5,14.712530964906861,14
195,17,19,78,6,14.709203332504174,13
196,55,16,19,5,14.687783547200517,11
197,39,10,66,3,14.612542929328729,7
198,50,12,99,4,14.581629542155012,8
199,34,18,20,4,14.557800978959818,14
200,80,19,50,4,14.554439051919097,15
201,47,15,49,3,14.53278782523131,12
202,38,15,97,4,14.531013843539451,11
203,104,23,38,7,14.499014536690481,16
204,12,18,109,5,14.482637172197817,13
205,34,12,25,3,14.468789684868279,9
206,73,10,2,3,14.457830254043134,7
207,44,12,5,3,14.447481002517359,9
208,97,13,35,3,14.444551731599496,10
209,8,24,77,7,14.435582202481532,17
210,80,11,14,4,14.435345395194517,7
211,108,26,70,7,14.427393649276278,19
212,100,15,81,5,14.3826940951582,10
213,40,10,83,2,14.347262135245902,8
214,54,10,10,3,14.334784055636703,7
215,26,25,86,6,14.322036756570213,19
216,31,12,57,4,14.310689026630854,8
217,46,11,102,3,14.307494713152066,8
218,48,10,112,2,14.307464286387091,8
219,23,15,18,5,14.275894417804937,10
220,83,11,17,4,14.269615650014424,7
221,72,13,48,5,14.226647914181537,8
222,61,17,7,6,14.217702740281522,11
223,50,18,46,6,14.208875687593249,12
224,72,10,75,3,14.207053385683185,7
225,100,32,3,9,14.177671200718626,23
226,58,13,66,3,14.08786535368442,10
227,90,10,9,3,14.073147353965513,7
228,100,31,68,10,14.067965798054423,21
229,40,29,77,8,14.0487710710226,21
230,6,11,41,4,13.99218654178206,7
231,41,31,9,9,13.990507643067811,22
232,111,12,75,4,13.972281809419972,8
233,114,29,109,7,13.96133653890183,22
234,40,24,71,7,13.948125771645659,17
235,75,19,69,5,13.942304484906572,14
236,60,14,20,4,13.939926452860888,10
237,37,11,112,3,13.937736127059289,8
238,25,10,112,3,13.919292260310073,7
239,63,31,3,7,13.905152866710317,24
240,16,21,83,6,13.895144807658395,15
241,53,19,50,6,13.883151416746278,13
242,39,18,72,5,13.872487814202465,13
243,27,35,109,12,13.84726709200119,23
244,47,12,57,4,13.842676334165546,8
245,55,17,103,4,13.826956770005326,13
246,47,18,112,6,13.820833793363406,12
247,38,14,112,3,13.819485047030156,11
248,97,11,112,2,13.794615799527316,9
249,87,11,85,3,13.78530468452242,8
250,62,17,57,4,13.757275808574349,13
251,95,37,88,11,13.752013257016605,26
252,97,10,27,4,13.735152835550473,6
253,63,25,31,7,13.714594813504087,18
254,34,10,95,3,13.704508911135058,7
255,57,28,5,8,13.702708831126637,20
256,92,10,25,3,13.698642336458672,7
257,8,12,108,3,13.645968521702336,9
258,34,18,60,5,13.644836415292458,13
259,22,13,27,4,13.578238998395374,9
260,103,18,60,5,13.575363139165225,13
261,41,19,84,6,13.556150264603875,13
262,80,10,6,3,13.522871173076231,7
263,76,21,78,5,13.52214163403542,16
264,13,27,29,9,13.513958263485302,18
265,55,13,112,3,13.49840576791747,10
266,30,32,63,10,13.49817196218878,22
267,84,12,108,3,13.488009207908556,9
268,27,24,69,8,13.483104419153626,16
269,94,24,51,7,13.451133934243908,17
270,36,15,35,4,13.440272285829971,11
271,43,19,53,5,13.43803314299166,14
272,23,15,45,4,13.436468047997263,11
273,15,27,109,6,13.433613800365606,21
274,25,12,32,5,13.427877456338669,7
275,34,13,70,4,13.426554854854936,9
276,19,14,89,4,13.426371568520798,10
277,61,16,68,5,13.424919545398383,11
278,75,15,53,5,13.423496737137011,10
279,91,11,112,3,13.423237527272498,8
280,27,10,45,3,13.421070416218555,7
281,71,15,84,4,13.41321574412034,11
282,62,11,48,4,13.383804058498162,7
283,109,14,103,5,13.379278679742843,9
284,104,12,35,4,13.369677424437175,8
285,17,14,48,5,13.364907872446567,9
286,55,11,32,4,13.363639630093912,7
287,108,13,9,5,13.341841222661904,8
288,11,16,18,5,13.321280125838719,11
289,9,17,19,5,13.31812011403307,12
290,80,20,88,7,13.305539707805673,13
291,8,14,1,4,13.305141225086524,10
292,64,19,106,6,13.295192075566392,13
293,104,43,46,14,13.294982678813746,29
294,7,12,99,4,13.27451726078842,8
295,95,23,11,6,13.263288005084235,17
296,94,19,57,6,13.247205639863786,13
297,109,15,64,6,13.229745561488967,9
298,36,18,54,6,13.217744798273168,12
299,95,28,37,7,13.149042342745599,21
300,75,15,57,4,13.125107209592635,11
301,100,31,103,10,13.109980501741743,21
302,57,13,72,2,13.071458888669092,11
303,55,14,47,5,13.036465008068177,9
304,9,14,12,4,13.029002866437166,10
305,63,14,35,5,12.998216518752985,9
306,85,17,94,5,12.991600312687378,12
307,92,10,84,4,12.962976398847768,6
308,98,19,106,6,12.954874150336938,13
309,41,11,85,4,12.952472883327006,7
310,74,16,76,6,12.943701075259918,10
311,78,14,47,5,12.914558187890036,9
312,17,19,109,6,12.911257852793483,13
313,2,21,65,5,12.890027578518191,16
314,34,24,57,7,12.872133630873055,17
315,15,11,74,3,12.87032647402204,8
316,51,30,19,8,12.868592174220957,22
317,50,13,103,4,12.862167277055054,9
318,104,35,27,11,12.83724877330016,24
319,1,11,76,4,12.827717897490277,7
320,108,14,11,4,12.798974196396992,10
321,49,15,25,5,12.785517383168523,10
322,84,31,3,11,12.7817713508444,20
323,80,21,51,7,12.779249811641694,14
324,26,12,16,4,12.76532683036784,8
325,100,15,1,5,12.750379039232417,10
326,95,10,36,3,12.746346244298936,7
327,11,44,37,14,12.738426249160874,30
328,33,14,106,4,12.736963404825657,10
329,46,24,106,9,12.725492516069494,15
330,13,76,31,25,12.705633823012963,51
331,80,40,63,12,12.682443988429267,28
332,104,13,31,5,12.68196482072701,8
333,48,15,5,4,12.675358072710559,11
334,7,23,57,9,12.666461617234948,14
335,39,20,85,7,12.618845399489865,13
336,74,20,48,8,12.617131151527765,12
337,53,24,108,9,12.606603502458741,15
338,15,12,102,3,12.597866884640942,9
339,2,21,51,8,12.59592396910538,13
340,15,32,9,13,12.592578406206988,19
341,100,14,38,3,12.572962429479661,11
342,3,12,35,4,12.563400964105028,8
343,41,18,71,5,12.557773267008855,13
344,104,33,11,10,12.522578417808795,23
345,64,15,92,7,12.492372460791035,8
346,79,30,87,8,12.466071130940087,22
347,13,88,88,26,12.460305993563065,62
348,18,14,37,4,12.438833593443572,10
349,65,27,58,9,12.431650709075077,18
350,36,17,50,7,12.423703215189775,10
351,35,10,109,3,12.407562430544194,7
352,75,14,12,5,12.356839423121738,9
353,67,12,97,3,12.353467827440639,9
354,98,32,87,9,12.34409315331202,23
355,34,14,41,5,12.338786367505541,9
356,78,10,89,3,12.322206367086617,7
357,13,34,94,11,12.315280597409904,23
358,98,29,96,9,12.301665445316491,20
359,98,18,88,5,12.300728896947142,13
360,100,30,77,9,12.29767742568246,21
361,72,16,69,5,12.288894925910649,11
362,69,15,18,5,12.281407888329316,10
363,40,15,81,4,12.276802562895192,11
364,29,12,95,4,12.273663594494513,8
365,109,21,39,6,12.264003725130951,15
366,37,18,60,7,12.263894360602317,11
367,73,19,88,6,12.262693289910839,13
368,32,10,39,3,12.259008757767624,7
369,58,11,29,3,12.250932195859463,8
370,74,22,60,8,12.23030247671151,14
371,75,19,43,5,12.224767647713705,14
372,64,19,37,6,12.216856507558594,13
373,30,22,91,6,12.212093275229307,16
374,78,11,106,3,12.210243252742742,8
375,42,11,13,3,12.203174115394766,8
376,72,15,109,4,12.199392565133763,11
377,2,15,11,5,12.196157085843712,10
378,11,35,84,11,12.189911906563855,24
379,49,10,92,4,12.189632873694913,6
380,75,11,35,3,12.188091693345983,8
381,107,21,99,7,12.174640608684578,14
382,55,21,23,8,12.170945018647474,13
383,111,23,41,8,12.165817300484488,15
384,2,22,70,8,12.153236389251047,14
385,11,40,96,13,12.141028508791658,27
386,34,14,37,4,12.135815020075322,10
387,57,19,109,6,12.12921132196382,13
388,15,10,4,4,12.124220843420797,6
389,30,23,43,6,12.093512773684786,17
390,8,11,35,3,12.093356369533678,8
391,49,22,23,7,12.076835461637527,15
392,74,22,62,7,12.061308273026555,15
393,1,18,63,7,12.054495717242016,11
394,10,10,89,3,12.05123505380701,7
395,30,20,46,6,12.044164698044929,14
396,43,14,28,5,12.028046594555397,9
397,1,12,104,4,12.02010829271743,8
398,63,15,89,4,12.017404575838292,11
399,87,29,81,11,12.015356959966109,18
400,102,32,5,11,12.011851390558954,21
401,43,25,77,8,12.004670640929955,17
402,108,22,39,8,11.99851415989162,14
403,17,17,19,5,11.997198209588895,12
404,102,18,55,6,11.983866194974429,12
405,37,15,77,5,11.967604181160285,10
406,95,27,18,9,11.951490678023532,18
407,28,13,81,4,11.947384191502273,9
408,70,27,57,10,11.940546365796532,17
409,114,46,65,16,11.938229846486395,30
410,48,19,49,5,11.919274877330185,14
411,71,17,77,5,11.915487518479784,12
412,98,18,31,7,11.908816140421921,11
413,43,11,102,4,11.887502689329436,7
414,43,12,62,4,11.874169648552916,8
415,91,30,60,11,11.8675806643859,19
416,79,11,12,4,11.866943529008417,7
417,92,17,86,6,11.833574375075663,11
418,74,10,64,4,11.828764368523547,6
419,92,11,109,3,11.825872450184745,8
420,104,31,77,10,11.812621663747164,21
421,53,10,91,3,11.811611902058752,7
422,8,21,40,6,11.791921402372768,15
423,44,10,54,3,11.791894285038762,7
424,112,10,62,3,11.780471922009976,7
425,58,10,103,3,11.772908526311582,7
426,63,17,102,6,11.747209471298389,11
427,34,12,69,2,11.742698738008174,10
428,55,25,43,6,11.714024478286158,19
429,91,13,96,4,11.692854193124049,9
430,34,23,28,7,11.682170467841413,16
431,8,10,81,3,11.678569579324542,7
432,72,15,23,5,11.667454901588142,10
433,107,17,83,5,11.64452174042024,12
434,87,32,114,12,11.643172393817506,20
435,100,12,40,4,11.638460148115916,8
436,11,10,110,2,11.637838089699006,8
437,75,17,38,4,11.628826987325251,13
438,37,14,1,5,11.627292625477205,9
439,11,23,70,7,11.609570033059047,16
440,90,15,39,5,11.577976501423594,10
441,93,12,104,4,11.577012913737342,8
442,36,16,104,6,11.564722196156035,10
443,111,10,71,3,11.563837134119524,7
444,21,13,87,4,11.56318091799384,9
445,108,13,3,4,11.562059375800656,9
446,53,14,46,5,11.556347535591735,9
447,100,30,41,10,11.550572113391238,20
448,18,12,84,4,11.526678691260484,8
449,110,12,7,5,11.526061320417648,7
450,7,15,81,6,11.525413070422038,9
451,7,20,76,8,11.522456617485858,12
452,35,11,65,3,11.518581403700487,8
453,108,10,18,3,11.50838861651189,7
454,98,14,75,5,11.497093707313164,9
455,68,12,37,4,11.496583691347068,8
456,18,14,34,4,11.482941012320621,10
457,48,14,15,5,11.48279141653066,9
458,114,41,106,14,11.462749893343949,27
459,100,35,49,12,11.456244824909797,23
460,41,26,12,8,11.414617123719317,18
461,47,17,18,5,11.411676107822023,12
462,75,39,54,14,11.408133317564468,25
463,73,10,75,5,11.395199340418811,5
464,4,11,38,3,11.395009854616482,8
465,65,22,57,7,11.382534230045803,15
466,43,17,91,5,11.378756439291882,12
467,39,28,78,9,11.374922957505095,19
468,75,15,102,4,11.357902372458392,11
469,108,11,112,4,11.335603356831966,7
470,104,15,44,5,11.332078649569057,10
471,64,12,20,3,11.331308462604776,9
472,69,13,91,5,11.30407928014614,8
473,80,10,5,3,11.295210617596885,7
474,75,10,61,4,11.28385436329936,6
475,111,11,27,3,11.279710088837586,8
476,2,14,55,5,11.276816159574052,9
477,100,50,65,16,11.275226832418385,34
478,75,52,7,17,11.2746633859962,35
479,83,11,70,5,11.265042422069474,6
480,25,25,68,8,11.235607083018879,17
481,45,12,39,5,11.230688824941206,7
482,46,20,96,8,11.223825219116968,12
483,25,15,3,5,11.214634960222725,10
484,100,12,46,4,11.210309669403342,8
485,89,11,1,4,11.209011069389932,7
486,78,13,1,4,11.156578268103182,9
487,46,15,70,5,11.123543654837006,10
488,62,17,94,6,11.117470705270842,11
489,48,11,102,3,11.116814719382416,8
490,74,13,32,4,11.10166419198237,9
491,79,23,57,8,11.10038188990658,15
492,78,11,66,4,11.09651688512087,7
493,41,21,89,6,11.096465892840714,15
494,107,44,109,14,11.05111003010284,30
495,99,11,11,4,11.04788337752713,7
496,55,39,1,12,11.047135752371082,27
497,32,12,114,4,11.045874107216173,8
498,16,17,32,6,11.045561391190379,11
499,47,10,84,3,11.043789003229906,7
500,49,25,104,8,11.041712547533377,17
501,7,13,66,5,11.034566799554367,8
502,41,14,92,5,11.016394202336146,9
503,15,13,71,4,11.00914391321025,9
504,51,20,110,6,11.00014817045874,14
505,57,49,107,17,10.985936793318814,32
506,13,25,97,9,10.985857531237667,16
507,50,40,20,13,10.968930608298047,27
508,29,28,86,9,10.944229389007265,19
509,63,48,28,15,10.937243385325443,33
510,48,22,9,7,10.894666127588817,15
511,79,13,106,4,10.885501834452416,9
512,51,33,81,12,10.882761671799567,21
513,86,17,67,6,10.856458271232293,11
514,44,22,13,7,10.85202026233818,15
515,38,26,65,10,10.83463870682701,16
516,106,17,81,7,10.816681182916202,10
517,85,12,75,3,10.8046837733115,9
518,55,25,91,7,10.79161282762655,18
519,7,25,19,7,10.77597719817787,18
520,27,45,19,14,10.771280367688261,31
521,59,11,7,3,10.7712398180592,8
522,106,14,108,4,10.746780907865295,10
523,5,19,60,6,10.737943337535818,13
524,11,12,91,3,10.737589094202368,9
525,23,10,11,3,10.736120462067522,7
526,53,22,17,7,10.723383781136485,15
527,54,11,111,3,10.714143810197234,8
528,43,13,36,5,10.713552025008552,8
529,98,20,77,6,10.67353135151257,14
530,63,17,33,6,10.663903494014164,11
531,80,10,3,4,10.612199935723586,6
532,48,11,103,3,10.609852030111929,8
533,28,13,103,4,10.609246701939709,9
534,7,31,91,9,10.609100286101583,22
535,104,26,75,9,10.574353916694225,17
536,95,15,9,6,10.569002592922947,9
537,20,11,12,4,10.562633058497603,7
538,28,17,40,7,10.551622113062646,10
539,19,13,79,5,10.549815768045507,8
540,50,19,68,8,10.535408083030939,11
541,71,19,97,6,10.523533962196902,13
542,27,27,36,10,10.52334959933135,17
543,53,44,88,14,10.519286458480718,30
544,64,27,9,8,10.495957554452962,19
545,94,14,49,4,10.474432971630804,10
546,64,28,112,8,10.456743108722605,20
547,43,17,9,7,10.435718767902006,10
548,78,15,46,6,10.435320162132959,9
549,44,16,39,6,10.434810009571388,10
550,60,35,29,13,10.42089747006503,22
551,16,66,106,21,10.396735673348633,45
552,18,16,19,5,10.389246220506259,11
553,106,16,93,6,10.37915501513517,10
554,108,14,68,5,10.37834742902957,9
555,15,16,55,4,10.370537288257989,12
556,63,36,91,11,10.368824470659426,25
557,63,24,69,8,10.366973166191585,16
558,13,49,18,17,10.366295029596339,32
559,50,39,88,14,10.364860984100918,25
560,104,24,12,8,10.358875950961007,16
561,94,10,7,3,10.355621654064775,7
562,17,15,27,6,10.354549099588292,9
563,40,16,102,6,10.346146758066931,10
564,37,48,54,16,10.345446907641227,32
565,74,37,28,13,10.332746781815512,24
566,101,11,13,3,10.296727071239353,8
567,63,39,76,12,10.294441268951951,27
568,60,24,112,8,10.282975838759189,16
569,72,22,68,7,10.275897741373278,15
570,47,16,3,5,10.263621577333433,11
571,23,33,76,12,10.25965129445218,21
572,67,16,106,6,10.252161434234207,10
573,75,12,79,4,10.235318929578343,8
574,97,10,48,4,10.2212335454347,6
575,30,17,31,7,10.214096274935345,10
576,90,19,104,7,10.205908373136616,12
577,97,42,37,14,10.199316810918761,28
578,98,15,2,6,10.198603389321663,9
579,41,23,49,8,10.197367127109924,15
580,71,13,33,4,10.195530501937558,9
581,90,14,48,5,10.193948361787585,9
582,6,12,9,5,10.175309866966638,7
583,92,16,68,5,10.147306838487294,11
584,96,11,23,4,10.143008283174428,7
585,53,37,31,14,10.136338371296794,23
586,78,12,114,5,10.123963867745244,7
587,74,11,29,4,10.117149758840515,7
588,53,36,36,11,10.114732824687982,25
589,71,21,54,8,10.113144202991709,13
590,40,16,49,6,10.077718304922936,10
591,49,37,69,15,10.076509248182436,22
592,13,23,83,8,10.067954696106945,15
593,73,18,40,6,10.060776256522114,12
594,107,16,10,6,10.056408787562026,10
595,44,10,38,3,10.048373138060263,7
596,34,21,19,7,10.046525413696887,14
597,80,15,30,5,10.04303538527198,10
598,70,10,3,3,10.036631807498475,7
599,110,13,107,4,10.034721322746927,9
600,28,21,72,7,10.026127135244147,14
601,30,27,84,8,10.023299208241372,19
602,28,39,75,13,10.021801272184058,26
603,76,19,57,6,10.02019313359368,13
604,111,19,63,7,10.01291034850113,12
605,64,18,29,5,10.005731422414543,13
606,104,23,71,9,10.004145398382484,14
607,95,25,65,9,9.98743882075493,16
608,114,16,12,7,9.985343546707197,9
609,6,15,61,5,9.976861344972216,10
610,46,14,90,5,9.960134782518509,9
611,29,14,102,4,9.929141879190585,10
612,49,17,103,7,9.927099269198688,10
613,75,15,29,6,9.923300198268768,9
614,95,10,2,3,9.920312629990494,7
615,1,11,57,4,9.916035104284747,7
616,30,18,70,7,9.91397370546994,11
617,54,34,60,11,9.913747967452041,23
618,103,21,68,8,9.904114100948451,13
619,13,58,3,19,9.90267481421411,39
620,11,14,83,4,9.896151919094924,10
621,110,20,16,7,9.893450419413218,13
622,17,15,71,6,9.87407872077162,9
623,9,32,31,11,9.853659783790295,21
624,51,26,33,7,9.853114112635913,19
625,74,10,3,3,9.841517466916368,7
626,53,10,98,4,9.839111782848335,6
627,9,17,47,6,9.833363334347133,11
628,75,19,109,6,9.83076635543319,13
629,7,26,96,8,9.825450759982106,18
630,47,17,69,6,9.824856595944091,11
631,54,13,57,3,9.824315369895022,10
632,72,24,19,8,9.81989282907299,16
633,81,12,109,4,9.819741316945185,8
634,11,40,109,13,9.818197495918092,27
635,40,24,17,8,9.815776001763272,16
636,63,40,48,14,9.811551158222233,26
637,104,18,79,7,9.811537818194267,11
638,106,24,18,8,9.811498602513073,16
639,111,10,70,4,9.807746966138032,6
640,53,21,109,7,9.80472277411344,14
641,114,16,62,6,9.799890996069497,10
642,62,10,93,4,9.798162399200413,6
643,76,27,35,10,9.787487717233065,17
644,37,24,83,9,9.783726366978422,15
645,95,30,51,9,9.77001175442697,21
646,15,14,53,5,9.75938988218119,9
647,49,10,38,3,9.749746841362613,7
648,63,52,84,20,9.74716223383734,32
649,102,38,86,13,9.743964141517802,25
650,108,35,13,12,9.737626185873808,23
651,43,19,31,10,9.72085277355369,9
652,78,12,37,4,9.719307443467278,8
653,52,15,8,5,9.715026692600484,10
654,16,48,96,14,9.712671053609279,34
655,28,18,111,6,9.712251206209237,12
656,2,10,48,3,9.702269151070572,7
657,8,34,114,11,9.699231858321156,23
658,88,22,112,8,9.681832903230312,14
659,79,18,65,7,9.67569283729834,11
660,64,47,60,15,9.661747726131631,32
661,100,12,71,4,9.660687520316314,8
662,21,11,88,4,9.657212734415223,7
663,74,41,46,14,9.651769490532574,27
664,22,10,114,5,9.649313306364824,5
665,75,40,8,13,9.637059553855455,27
666,41,23,53,8,9.631953807885305,15
667,70,17,109,6,9.623350653501722,11
668,30,32,77,11,9.6218312337316,21
669,43,26,15,9,9.619130376922648,17
670,99,14,8,6,9.611065592860317,8
671,83,18,84,7,9.609473734372155,11
672,72,11,104,4,9.607945163400757,7
673,16,15,10,5,9.607669865815327,10
674,8,13,53,4,9.596286006275319,9
675,48,19,108,6,9.58641061639515,13
676,92,10,31,4,9.586105290347549,6
677,54,21,43,8,9.585604342831404,13
678,73,20,7,8,9.582485903794176,12
679,49,18,37,7,9.571164342243115,11
680,27,28,31,12,9.569633624787398,16
681,26,23,13,7,9.562123129591575,16
682,16,51,18,17,9.55830153014691,34
683,17,17,3,7,9.550337372259282,10
684,48,14,89,3,9.539867725349152,11
685,33,25,107,10,9.539564483245075,15
686,9,14,94,6,9.535806051453793,8
687,20,11,75,4,9.527707505687728,7
688,92,11,97,5,9.525917165548373,6
689,1,22,31,9,9.525804060927042,13
690,20,32,25,11,9.520523686179047,21
691,8,17,36,6,9.512360266950532,11
692,33,13,69,5,9.51115802646404,8
693,114,13,2,5,9.509158562417845,8
694,15,35,51,13,9.50362708455373,22
695,37,22,99,7,9.502759058160704,15
696,75,29,5,12,9.487135559909316,17
697,13,22,98,7,9.474726692398676,15
698,23,16,57,6,9.474501256774843,10
699,11,22,9,8,9.452997859790166,14
700,32,11,63,4,9.44232166344675,7
701,13,15,2,6,9.422510080465475,9
702,16,13,56,4,9.403965360554954,9
703,27,16,38,5,9.401601002215303,11
704,109,11,36,3,9.390936468630548,8
705,107,26,103,9,9.38527765474234,17
706,81,25,16,9,9.384174025613891,16
707,73,14,54,5,9.38293263538315,9
708,103,12,38,3,9.379557577066372,9
709,27,16,4,6,9.378715415982096,10
710,60,34,12,15,9.373381073655496,19
711,28,19,12,6,9.364727152511893,13
712,26,12,28,4,9.352858082446945,8
713,1,20,87,8,9.344990956449255,12
714,54,13,81,5,9.33569894630605,8
715,77,10,84,3,9.326879307665175,7
716,18,30,9,10,9.325317307118523,20
717,45,10,38,3,9.31109379184883,7
718,49,10,74,4,9.302425288754323,6
719,12,11,17,4,9.294611804735958,7
720,62,24,40,11,9.275726600058688,13
721,47,26,60,9,9.272798561110866,17
722,54,30,27,11,9.269071237772646,19
723,114,17,94,7,9.267018335328505,10
724,104,23,84,9,9.26674641219393,14
725,87,27,93,10,9.26552442404966,17
726,20,16,90,6,9.256704804618028,10
727,78,15,53,6,9.245467105519946,9
728,18,12,62,4,9.234800982158571,8
729,91,23,20,9,9.233435902067155,14
730,93,10,100,3,9.229250964204905,7
731,70,16,69,5,9.227346228401577,11
732,68,22,109,7,9.205767765094537,15
733,93,11,90,4,9.204947446014167,7
734,79,10,41,4,9.204704069079494,6
735,95,21,114,8,9.195016624238175,13
736,81,16,63,6,9.193429569946275,10
737,68,31,18,11,9.190826393650621,20
738,23,14,91,6,9.188824217195526,8
739,54,19,58,8,9.183988111852093,11
740,43,48,87,17,9.179610719744838,31
741,53,14,38,5,9.17946873124013,9
742,112,22,29,8,9.174610307731976,14
743,63,14,72,4,9.168022793278993,10
744,16,36,64,12,9.166098638825636,24
745,62,21,63,8,9.161474645821357,13
746,76,14,10,5,9.157178184443993,9
747,50,43,5,17,9.15604936984071,26
748,39,25,106,10,9.15596937875274,15
749,1,11,5,4,9.143641454097294,7
750,28,23,112,8,9.12022356401639,15
751,57,13,2,5,9.119959996501729,8
752,92,11,17,4,9.114563540800479,7
753,109,15,31,5,9.11388757240418,10
754,72,20,49,7,9.109802917699248,13
755,58,11,45,4,9.091525705777382,7
756,94,12,75,4,9.080901166069646,8
757,53,21,3,7,9.076818822513886,14
758,57,16,40,6,9.075047590769481,10
759,80,39,107,13,9.074881524481428,26
760,49,14,55,5,9.07453979611351,9
761,44,29,86,10,9.073857704921485,19
762,35,16,45,7,9.040031591861496,9
763,91,25,39,9,9.014113578195186,16
764,5,15,36,6,9.008614310253613,9
765,30,30,88,12,9.008031571554385,18
766,85,19,50,7,9.007921978503543,12
767,8,64,5,24,9.002251377410767,40
768,1,25,65,10,9.00217902882169,15
769,38,10,72,4,8.999506480702252,6
770,78,15,80,5,8.990142670025016,10
771,48,10,81,3,8.9896961045111,7
772,97,18,36,7,8.970668153566256,11
773,34,19,103,6,8.970243702574694,13
774,47,20,114,8,8.969382880850313,12
775,27,27,53,9,8.968048711845617,18
776,11,14,81,5,8.967824856070829,9
777,11,34,41,11,8.953991407123153,23
778,18,45,39,16,8.95168677836069,29
779,69,14,48,6,8.947708246863762,8
780,87,33,91,11,8.944507965742199,22
781,73,11,70,5,8.94135129372028,6
782,51,26,74,8,8.938947542412071,18
783,73,12,31,4,8.93891957013575,8
784,27,49,60,16,8.928785554550483,33
785,49,22,29,8,8.92665983569728,14
786,3,15,98,7,8.926309600802396,8
787,84,29,29,11,8.921575167609982,18
788,26,10,88,4,8.919527282390272,6
789,110,19,25,6,8.91770167255822,13
790,100,38,43,15,8.917383841964035,23
791,63,15,10,5,8.910939208335906,10
792,94,32,12,13,8.900231530265584,19
793,27,65,87,24,8.893120352605743,41
794,16,77,27,28,8.892060221661595,49
795,69,12,97,4,8.888377862411463,8
796,90,23,13,8,8.883764352926049,15
797,45,24,107,9,8.882581208643296,15
798,49,11,53,4,8.87692828941625,7
799,112,12,98,4,8.873991556640124,8
800,6,15,12,7,8.87368712650089,8
801,35,16,51,6,8.849945437990394,10
802,65,47,93,19,8.847119413638655,28
803,32,15,87,5,8.844155029434871,10
804,100,31,29,12,8.841937017793759,19
805,12,40,107,13,8.83024040628561,27
806,89,12,15,5,8.83007520186948,7
807,76,26,9,9,8.8289260170713,17
808,63,19,36,7,8.822881427312195,12
809,63,22,77,7,8.819997532642512,15
810,84,19,19,7,8.813396640852732,12
811,36,18,47,6,8.810892372607718,12
812,106,10,42,3,8.802546839644403,7
813,11,19,38,7,8.80025539192087,12
814,11,21,47,7,8.793803106813352,14
815,63,18,19,6,8.792724982250471,12
816,6,12,46,5,8.791371018033741,7
817,26,11,107,4,8.789963547813729,7
818,77,14,99,4,8.784719144285264,10
819,16,27,1,8,8.777340054296332,19
820,15,42,88,13,8.764269632154086,29
821,74,37,84,16,8.764103490564013,21
822,8,34,84,12,8.76285424467774,22
823,28,16,52,6,8.75730555636181,10
824,30,53,39,21,8.747392409319959,32
825,38,14,106,7,8.745019433529976,7
826,49,20,11,7,8.744249175882365,13
827,65,11,32,4,8.739314169667136,7
828,57,26,46,10,8.738900979302741,16
829,4,22,17,7,8.727735068009611,15
830,40,27,3,9,8.719928293728287,18
831,45,15,86,6,8.710518828201984,9
832,107,44,43,16,8.708997727097914,28
833,98,28,49,10,8.706969661782532,18
834,28,23,62,9,8.703867920620008,14
835,38,16,3,6,8.700552917920668,10
836,46,13,77,5,8.692557302357292,8
837,39,41,20,17,8.683414479878406,24
838,39,67,68,26,8.67961042805456,41
839,19,12,31,4,8.67684008479621,8
840,53,11,54,4,8.67028832638361,7
841,70,12,58,4,8.66252309250944,8
842,73,28,8,11,8.656865963639591,17
843,76,13,72,4,8.643851121564206,9
844,58,10,15,3,8.609651553934281,7
845,13,22,6,8,8.600067561462977,14
846,44,23,6,7,8.597523681350719,16
847,2,34,107,12,8.596357154255273,22
848,53,18,77,7,8.576780251337041,11
849,95,23,55,8,8.57500650986488,15
850,9,22,104,8,8.574493523715214,14
851,100,24,76,10,8.57272751966319,14
852,49,10,93,4,8.57216379677568,6
853,111,25,107,11,8.570266784296765,14
854,91,13,71,5,8.567246551132914,8
855,78,11,36,4,8.552435160203324,7
856,94,11,2,4,8.550586885180525,7
857,16,15,67,5,8.550473387804702,10
858,94,12,35,5,8.545638882275084,7
859,91,13,65,5,8.541931736396267,8
860,110,11,63,4,8.534985747455591,7
861,53,20,61,6,8.524850655507475,14
862,81,22,69,9,8.517997866855394,13
863,20,22,9,8,8.515923532058864,14
864,50,11,52,5,8.515472572504802,6
865,55,25,64,8,8.51293322653446,17
866,95,35,8,14,8.511725721270738,21
867,91,10,45,4,8.504304930616431,6
868,64,28,40,10,8.496071624321134,18
869,104,19,69,6,8.491359963005367,13
870,16,27,58,10,8.488429747726556,17
871,15,11,70,5,8.48414311669357,6
872,55,14,85,5,8.476039600481302,9
873,30,11,66,3,8.470012652510327,8
874,34,24,51,9,8.4699102284808,15
875,103,28,19,11,8.469047877005721,17
876,50,20,48,7,8.466418162124782,13
877,39,26,112,10,8.464674026518864,16
878,63,37,20,15,8.464473402081477,22
879,12,16,106,5,8.461406597257815,11
880,53,23,12,9,8.46079762480418,14
881,76,22,94,7,8.458632259785002,15
882,95,14,96,5,8.450373982592184,9
883,8,24,41,8,8.446748885751393,16
884,100,33,60,12,8.438543952400131,21
885,96,24,70,11,8.437417991026258,13
886,55,20,114,7,8.432483182241096,13
887,88,15,103,6,8.430464226549896,9
888,73,19,90,7,8.424101991862461,12
889,41,12,102,4,8.421036787338002,8
890,13,23,103,7,8.418538595487911,16
891,109,14,67,7,8.410228891959635,7
892,29,21,34,9,8.399162943605287,12
893,62,25,68,10,8.382615098007266,15
894,19,19,108,7,8.381442328055748,12
895,58,29,13,9,8.381428024864276,20
896,7,45,25,16,8.3728066183483,29
897,39,28,94,11,8.363460408949939,17
898,7,22,5,8,8.357081514884822,14
899,41,33,31,12,8.353957395244583,21
900,65,32,102,11,8.353467426988884,21
901,48,25,96,9,8.343995751105185,16
902,54,54,109,19,8.336552490351869,35
903,76,14,108,5,8.33452707348594,9
904,25,15,9,5,8.323455878342038,10
905,79,20,51,9,8.309517555811908,11
906,37,43,46,14,8.306667442353499,29
907,91,13,109,5,8.302894097359495,8
908,92,13,63,6,8.301235837359338,7
909,86,17,56,6,8.300855291965847,11
910,109,10,58,4,8.291034573977958,6
911,90,31,106,10,8.283845461248369,21
912,15,14,79,6,8.279617988476957,8
913,41,18,91,6,8.2766719527744,12
914,60,20,45,8,8.270932074255704,12
915,37,12,14,5,8.26646783507543,7
916,8,29,15,12,8.254756555500954,17
917,93,10,76,4,8.25053412937542,6
918,75,18,1,6,8.241769187322511,12
919,69,21,106,8,8.230262561693127,13
920,37,31,7,12,8.226042864777218,19
921,99,10,71,4,8.224966300288866,6
922,87,35,70,15,8.222879447071525,20
923,112,14,40,6,8.221202026655064,8
924,64,42,51,16,8.201880887276834,26
925,74,25,39,10,8.195535087876934,15
926,92,16,40,6,8.191919233506125,10
927,7,53,87,19,8.186933222272419,34
928,62,15,64,7,8.162083910878938,8
929,33,17,20,6,8.157924685534638,11
930,12,18,38,7,8.148426278473252,11
931,4,10,112,4,8.145974306589784,6
932,56,14,107,6,8.142413744294041,8
933,50,36,55,15,8.131693382626922,21
934,20,11,110,4,8.125291114928707,7
935,9,12,98,5,8.123745049728663,7
936,81,11,111,3,8.120062859865856,8
937,17,17,77,7,8.106011789729994,10
938,73,14,51,5,8.09774388932274,9
939,43,17,4,7,8.083539648296874,10
940,8,17,32,7,8.079749532998788,10
941,87,43,9,17,8.078706607204952,26
942,110,16,97,6,8.077466293642962,10
943,50,18,70,8,8.072010588554928,10
944,97,29,68,11,8.062315589675796,18
945,19,15,46,6,8.056646218005667,9
946,30,15,12,5,8.054443061149305,10
947,16,45,69,16,8.054291070790875,29
948,20,36,84,11,8.048616703285955,25
949,98,15,48,5,8.040930745507078,10
950,100,18,18,8,8.035989461751754,10
951,63,12,52,5,8.01519600341839,7
952,35,11,9,5,8.012816785902414,6
953,65,28,5,11,8.012091300535628,17
954,91,31,98,12,8.010154956050263,19
955,41,18,81,6,8.009042710590085,12
956,34,30,87,11,7.997798450633536,19
957,102,19,96,7,7.995631160966492,12
958,98,16,40,7,7.993416961646092,9
959,72,24,3,10,7.988593694419687,14
960,20,19,3,7,7.987586080022351,12
961,5,28,84,11,7.986435375626316,17
962,27,35,94,13,7.986020548938503,22
963,34,20,68,8,7.978044783319159,12
964,100,69,86,28,7.971641299719461,41
965,58,10,61,4,7.964357976226594,6
966,75,44,50,15,7.963443352466475,29
967,23,21,39,8,7.963088024258928,13
968,102,15,34,5,7.962391346680716,10
969,86,59,76,23,7.950570859260315,36
970,87,15,66,6,7.94612104522059,9
971,43,46,86,17,7.944824738230932,29
972,98,19,71,7,7.940784287039028,12
973,30,48,13,18,7.92615309985384,30
974,30,25,38,8,7.923368604045866,17
975,30,13,33,4,7.91339518812487,9
976,108,20,98,8,7.913100401728397,12
977,88,10,82,4,7.912578083642501,6
978,71,13,38,4,7.906029048659731,9
979,78,11,31,5,7.904414780494012,6
980,29,30,30,11,7.902898306652615,19
981,53,14,90,5,7.9010322992925905,9
982,17,16,29,7,7.899676305324428,9
983,3,18,94,7,7.8995884826671166,11
984,54,34,40,13,7.877426017050995,21
985,27,35,77,13,7.8745216976485,22
986,114,25,90,10,7.870165683504547,15
987,28,30,2,11,7.862984699152351,19
988,44,12,35,5,7.859665557157527,7
989,106,26,91,9,7.859341034872011,17
990,29,12,89,5,7.8577761539455,7
991,11,13,66,6,7.856337586346077,7
992,114,20,1,7,7.837742070296789,13
993,16,50,9,17,7.836196702611142,33
994,70,16,93,6,7.834949393241649,10
995,13,58,43,25,7.834617919431734,33
996,5,22,17,7,7.829641724195981,15
997,15,10,52,4,7.828284164082511,6
998,54,14,108,4,7.821734358546891,10
999,25,46,46,19,7.820401195025543,27
1000,114,12,110,4,7.800316810979699,8
1001,108,11,78,4,7.797957113003343,7
1002,107,31,31,15,7.788469010128701,16
1003,47,10,111,4,7.786638633209638,6
1004,16,40,76,18,7.786506155237847,22
1005,114,18,81,8,7.77743951670038,10
1006,107,46,49,17,7.77551908328081,29
1007,92,14,114,4,7.774797164908201,10
1008,53,11,73,4,7.756297558195458,7
1009,98,12,30,5,7.75360326573728,7
1010,100,38,11,14,7.7524005573637345,24
1011,111,19,51,7,7.750696049131197,12
1012,28,29,68,10,7.748993038967358,19
1013,30,10,111,3,7.74442175449077,7
1014,44,11,84,5,7.741464370739859,6
1015,46,18,29,9,7.738693511487552,9
1016,107,35,62,15,7.732225326199554,20
1017,16,14,101,5,7.729447625525021,9
1018,11,37,57,16,7.727829388644561,21
1019,78,17,104,6,7.72449974280056,11
1020,72,29,27,12,7.712316498929215,17
1021,114,21,96,8,7.708209589747937,13
1022,98,42,86,17,7.705613124334454,25
1023,75,61,68,22,7.69823200491078,39
1024,86,28,1,11,7.696680317913666,17
1025,111,25,7,10,7.690323425771979,15
1026,76,39,68,12,7.690297930054157,27
1027,5,32,11,12,7.687442157533873,20
1028,100,38,12,15,7.682762116528133,23
1029,8,38,9,17,7.672754136226992,21
1030,37,29,38,11,7.668156637885104,18
1031,37,24,96,10,7.665844925696507,14
1032,72,14,60,5,7.664629407768883,9
1033,27,29,112,11,7.661494705671576,18
1034,104,11,66,3,7.658809119364057,8
1035,104,39,60,12,7.65596663244094,27
1036,33,13,31,6,7.647223417443057,7
1037,70,11,60,4,7.646435749026204,7
1038,97,29,5,10,7.639418302115126,19
1039,28,28,3,11,7.638630473496032,17
1040,69,11,61,3,7.633216471104308,8
1041,71,14,27,5,7.6209744722933594,9
1042,60,32,69,14,7.6138451240077565,18
1043,41,27,77,9,7.599547839905652,18
1044,18,20,36,8,7.594902878501233,12
1045,103,18,84,8,7.589982363677433,10
1046,72,10,36,4,7.585561627806544,6
1047,28,31,114,13,7.584853881328921,18
1048,3,12,85,6,7.584252500547151,6
1049,16,100,39,39,7.584140410281982,61
1050,49,22,43,8,7.5800813989411955,14
1051,12,25,77,10,7.576465102864336,15
1052,53,31,112,14,7.574348903828081,17
1053,75,23,49,9,7.565086245339052,14
1054,34,18,76,8,7.561119825945015,10
1055,16,74,55,27,7.540678563620176,47
1056,85,10,46,3,7.538229298143683,7
1057,34,22,55,9,7.534603126846269,13
1058,33,16,7,7,7.5321884826380465,9
1059,6,11,55,3,7.526848268362221,8
1060,41,17,17,6,7.526219064648913,11
1061,27,49,78,17,7.520666840665303,32
1062,6,11,31,5,7.520489323813347,6
1063,65,17,66,6,7.515278237298981,11
1064,86,39,17,17,7.514722263451873,22
1065,85,11,47,3,7.51471835956732,8
1066,62,12,38,4,7.514124412933275,8
1067,107,16,61,7,7.509321940652872,9
1068,64,10,93,5,7.507177747442428,5
1069,7,21,109,8,7.493740572538848,13
1070,71,15,76,7,7.4875920550169335,8
1071,34,19,74,6,7.4794382394263454,13
1072,70,14,36,6,7.476080415111225,8
1073,18,25,65,10,7.467319094675642,15
1074,110,18,39,6,7.464111416570432,12
1075,45,12,53,5,7.463487107897499,7
1076,27,11,80,4,7.4617467678086795,7
1077,100,12,70,5,7.458777129644962,7
1078,30,30,109,10,7.445205658638929,20
1079,11,12,71,5,7.444969376445687,7
1080,6,24,16,11,7.439865172191104,13
1081,30,17,62,7,7.428902113557475,10
1082,73,18,5,7,7.416873021801379,11
1083,36,34,41,16,7.412500474371831,18
1084,70,30,20,11,7.408681007686706,19
1085,20,11,94,4,7.40491165274963,7
1086,75,14,76,6,7.401272000460674,8
1087,39,71,49,26,7.39496585590305,45
1088,10,15,28,5,7.394064388880875,10
1089,7,22,56,9,7.387479337914444,13
1090,16,15,92,4,7.376894869640722,11
1091,71,19,81,7,7.374213709282574,12
1092,13,48,23,21,7.373546879981892,27
1093,73,10,71,4,7.373234065194549,6
1094,56,12,88,5,7.371104573008601,7
1095,31,14,80,4,7.367135464628979,10
1096,25,16,33,5,7.365926272964513,11
1097,109,45,8,19,7.345721442245663,26
1098,23,18,114,6,7.3449426375970175,12
1099,40,41,104,15,7.3422918945341555,26
1100,75,19,11,8,7.336654356306241,11
1101,78,24,34,10,7.336336560215486,14
1102,75,16,2,7,7.332326563651876,9
1103,16,30,38,9,7.3245864834549135,21
1104,62,30,88,12,7.323841783087015,18
1105,70,42,5,17,7.323141246130925,25
1106,78,28,3,12,7.304787220480845,16
1107,5,27,98,11,7.298838761636912,16
1108,43,31,40,13,7.287691070183644,18
1109,2,18,54,6,7.287492324178089,12
1110,23,18,17,7,7.286484354574564,11
1111,55,20,68,7,7.273979151335484,13
1112,62,10,96,3,7.268496266352457,7
1113,110,16,70,6,7.267896542251018,10
1114,20,17,98,6,7.267496359610289,11
1115,100,14,48,6,7.263809625362946,8
1116,75,19,81,7,7.259552889264536,12
1117,51,16,89,6,7.254363659794548,10
1118,69,12,96,4,7.2527556906488675,8
1119,11,26,103,9,7.251690186306055,17
1120,13,42,8,16,7.249552270590032,26
1121,19,32,3,13,7.248295900826971,19
1122,31,14,5,5,7.246607645789558,9
1123,114,27,40,9,7.240772461331045,18
1124,114,16,30,7,7.22328003108775,9
1125,78,31,12,10,7.222144018862549,21
1126,16,49,46,18,7.215241172016058,31
1127,16,129,88,49,7.2150722340321485,80
1128,30,15,90,6,7.21256730381331,9
1129,98,14,93,6,7.212314028509714,8
1130,12,17,15,7,7.2052521825534805,10
1131,15,20,78,9,7.204629583422441,11
1132,14,14,95,5,7.1971223272437035,9
1133,112,15,43,6,7.1893251112725824,9
1134,63,50,88,18,7.181466866993264,32
1135,98,24,29,9,7.180316216962127,15
1136,36,16,112,6,7.175574629533444,10
1137,30,13,61,5,7.169715355965248,8
1138,114,19,57,7,7.168179779176467,12
1139,17,23,60,9,7.159951280063795,14
1140,114,25,3,9,7.152889180930058,16
1141,27,29,103,11,7.148363895164129,18
1142,29,14,37,6,7.147246302868525,8
1143,97,26,51,9,7.145200913148905,17
1144,111,12,69,5,7.144443379259749,7
1145,33,13,78,5,7.142209395263028,8
1146,27,39,15,17,7.136849333340005,22
1147,30,14,58,5,7.134101849433167,9
1148,16,77,63,30,7.1283657008650145,47
1149,13,12,93,5,7.127658172301537,7
1150,72,21,77,9,7.125122343869388,12
1151,67,12,107,4,7.124134838046416,8
1152,57,10,35,3,7.121001943594234,7
1153,86,30,83,10,7.114862976089353,20
1154,45,33,7,13,7.114147641228474,20
1155,13,64,106,25,7.112707704477979,39
1156,40,51,55,19,7.109300201154281,32
1157,100,32,54,12,7.106265052685026,20
1158,1,10,45,4,7.100044646871245,6
1159,63,26,38,8,7.091217263422916,18
1160,27,21,55,7,7.087211713998168,14
1161,104,27,3,10,7.0862804085077595,17
1162,63,15,12,7,7.082818499870268,8
1163,85,10,53,3,7.078145746437185,7
1164,37,50,25,21,7.070541112352608,29
1165,99,18,36,6,7.061516094995866,12
1166,3,26,57,10,7.046184284491371,16
1167,72,11,114,5,7.039741382461145,6
1168,94,18,60,7,7.0351599724686675,11
1169,37,19,27,7,7.034792767414978,12
1170,80,10,43,4,7.031005677454651,6
1171,95,15,40,6,7.026458120737086,9
1172,87,27,53,12,7.022639512769474,15
1173,51,16,92,7,7.0168491500307955,9
1174,100,26,102,9,7.010528546414991,17
1175,40,13,69,4,7.006717860168273,9
1176,89,18,37,9,7.006041314616403,9
1177,30,26,37,9,6.995271622141733,17
1178,4,21,87,7,6.993636995986404,14
1179,62,15,5,6,6.992708759597396,9
1180,111,24,13,11,6.988942249892514,13
1181,17,20,55,9,6.987444025974706,11
1182,53,30,30,12,6.984989750265449,18
1183,15,12,6,4,6.9844847610743175,8
1184,57,22,43,7,6.979538883847618,15
1185,23,14,47,5,6.976037054038962,9
1186,18,23,97,9,6.9651635757198616,14
1187,16,34,36,13,6.962309553248682,21
1188,102,22,87,8,6.961827622477074,14
1189,111,15,39,6,6.960860011711803,9
1190,32,18,104,6,6.9592250863895515,12
1191,91,19,50,7,6.959059467736711,12
1192,109,30,55,14,6.952801077513015,16
1193,4,25,51,9,6.952578906103851,16
1194,58,20,88,8,6.951724289335951,12
1195,86,24,52,9,6.945114778958064,15
1196,60,33,50,15,6.944865376684978,18
1197,49,16,58,7,6.942973037040069,9
1198,99,12,88,5,6.93913123202866,7
1199,86,83,96,32,6.934057728364641,51
1200,87,39,40,17,6.915208460636839,22
1201,58,21,68,8,6.904652684866492,13
1202,68,32,8,13,6.897514212007414,19
1203,39,16,14,7,6.8922808961517115,9
1204,88,13,67,4,6.891493842154361,9
1205,18,17,112,6,6.887267609994756,11
1206,106,15,99,5,6.882359612487443,10
1207,65,30,76,10,6.878261201466494,20
1208,16,43,91,15,6.876030290903075,28
1209,34,12,38,4,6.871444823359393,8
1210,29,19,69,8,6.870269758663409,11
1211,60,43,4,19,6.864343045215706,24
1212,11,36,68,15,6.855439241001142,21
1213,7,99,51,37,6.849475435937798,62
1214,75,28,47,9,6.839491111976113,19
1215,20,15,29,6,6.832826874702712,9
1216,95,25,106,9,6.830338155584791,16
1217,68,69,31,28,6.821634358561019,41
1218,49,14,18,5,6.821290318156634,9
1219,56,13,4,6,6.816273515879686,7
1220,50,22,102,10,6.809919414830619,12
1221,14,21,28,7,6.807027415542909,14
1222,28,14,108,6,6.806119384401875,8
1223,28,16,49,7,6.801284823553006,9
1224,47,15,100,6,6.796575245042939,9
1225,2,14,38,6,6.792448237787319,8
1226,80,29,87,11,6.787984537789177,18
1227,79,15,108,5,6.783855393965387,10
1228,97,20,57,8,6.78123727728494,12
1229,8,10,42,5,6.780541784776636,5
1230,17,15,30,7,6.7793579151449554,8
1231,103,18,17,6,6.777134032154198,12
1232,65,43,29,17,6.767708276680646,26
1233,51,64,63,28,6.753726451822532,36
1234,39,43,88,17,6.751316626963761,26
1235,33,17,50,7,6.750798742645289,10
1236,63,27,109,12,6.749986635160673,15
1237,94,10,71,4,6.748460655059323,6
1238,45,13,68,5,6.747691137383074,8
1239,100,23,74,9,6.742923050259366,14
1240,104,16,19,6,6.742171792497148,10
1241,41,13,80,5,6.741244434437033,8
1242,15,20,69,7,6.736896270525394,13
1243,74,38,96,14,6.7318287322523656,24
1244,39,21,103,9,6.726065933595929,12
1245,30,32,55,12,6.725062001131899,20
1246,103,13,94,6,6.717236128190117,7
1247,28,35,97,13,6.716635909782017,22
1248,86,115,51,49,6.705427698133431,66
1249,83,15,74,7,6.703298030488861,8
1250,63,25,23,9,6.701335055503619,16
1251,64,38,31,15,6.680717740842574,23
1252,30,35,3,12,6.678994379061112,23
1253,23,31,68,14,6.6769594800553715,17
1254,34,34,86,14,6.6743605007457365,20
1255,14,15,88,6,6.669368246830069,9
1256,85,20,54,7,6.664179187550934,13
1257,19,13,80,5,6.657036501175089,8
1258,83,11,71,5,6.6562053803338666,6
1259,71,19,37,8,6.653996053488666,11
1260,32,26,5,10,6.647447060451906,16
1261,76,51,51,19,6.64314149833777,32
1262,102,19,88,6,6.636908554010762,13
1263,74,16,71,7,6.635644376222863,9
1264,4,30,65,12,6.635600395573753,18
1265,39,22,37,9,6.6321566948630455,13
1266,47,43,13,17,6.6302542913878515,26
1267,98,29,63,12,6.629039814212708,17
1268,39,102,51,41,6.628453471772387,61
1269,25,48,5,19,6.626414170343125,29
1270,102,12,77,5,6.618078815941925,7
1271,70,18,64,6,6.6150540525041945,12
1272,70,15,29,7,6.61208942766715,8
1273,11,25,35,10,6.609898653259957,15
1274,30,13,93,5,6.605367379129463,8
1275,64,20,43,8,6.605345215745442,12
1276,71,52,13,22,6.6022668326221785,30
1277,73,16,13,6,6.598047492921335,10
1278,41,14,90,6,6.596764805214359,8
1279,49,33,3,14,6.592008597219497,19
1280,86,29,73,13,6.584732384148775,16
1281,27,11,101,4,6.582303845846215,7
1282,84,28,57,13,6.577348977317855,15
1283,53,26,114,11,6.571088082289225,15
1284,78,29,69,12,6.570244276121929,17
1285,75,31,63,13,6.570041946714362,18
1286,34,24,49,10,6.563193871261933,14
1287,74,15,91,6,6.5630560139016625,9
1288,112,15,30,5,6.562692428407154,10
1289,64,22,19,7,6.560999233342087,15
1290,55,26,97,10,6.55988722490137,16
1291,85,15,65,6,6.556919781757104,9
1292,23,28,41,11,6.550829980754917,17
1293,106,32,23,15,6.549055396089183,17
1294,58,16,112,7,6.5464579572728105,9
1295,39,30,77,13,6.543255167179636,17
1296,81,48,13,18,6.534046463710123,30
1297,94,14,34,6,6.531647534575397,8
1298,91,13,80,5,6.531108694088667,8
1299,102,12,38,3,6.529266346603467,9
1300,44,16,64,6,6.52641817446092,10
1301,95,12,49,4,6.5227719302817135,8
1302,13,84,87,32,6.521909690525375,52
1303,98,16,12,6,6.5172917110234705,10
1304,60,20,66,7,6.5151715619171755,13
1305,55,66,65,27,6.5120252706716855,39
1306,74,29,55,12,6.5036195464677915,17
1307,13,25,76,10,6.503302760367724,15
1308,90,11,102,6,6.502237322589013,5
1309,112,28,76,12,6.4984423567384235,16
1310,100,62,87,27,6.484057869538874,35
1311,80,10,77,4,6.4777469157069785,6
1312,98,11,68,4,6.469927695975062,7
1313,35,12,15,6,6.467296765301501,6
1314,11,15,10,6,6.454288934219358,9
1315,8,20,91,8,6.453847873736635,12
1316,93,28,54,10,6.453790444084362,18
1317,68,16,33,6,6.451134609706935,10
1318,78,40,87,16,6.450776166412695,24
1319,41,25,19,9,6.446423665891765,16
1320,29,29,15,12,6.442607839265635,17
1321,69,18,94,7,6.432434124144731,11
1322,89,15,74,6,6.429670108852098,9
1323,75,21,100,10,6.42687784088126,11
1324,96,23,80,9,6.423400971659434,14
1325,84,28,48,11,6.421668889523295,17
1326,41,48,86,18,6.421498587390495,30
1327,61,10,23,4,6.419517618014351,6
1328,29,23,68,9,6.416741070326833,14
1329,7,20,62,8,6.416308867276496,12
1330,64,38,65,16,6.415105269042925,22
1331,91,18,54,8,6.414686940093471,10
1332,48,21,55,8,6.406579400537662,13
1333,80,20,37,8,6.401050818487377,12
1334,79,12,49,4,6.395374558799645,8
1335,54,62,70,25,6.393751574298834,37
1336,86,38,48,15,6.392497095701149,23
1337,33,13,96,7,6.392035038140804,6
1338,16,118,87,47,6.383634199315314,71
1339,28,16,27,5,6.382931621067466,11
1340,70,20,98,7,6.375551069484688,13
1341,72,18,17,7,6.374145428769875,11
1342,33,15,102,6,6.371524301983967,9
1343,56,10,37,4,6.3674406628794715,6
1344,7,24,46,8,6.3620461131037525,16
1345,92,13,27,6,6.356396578041118,7
1346,85,17,96,5,6.345069391274805,12
1347,15,15,75,5,6.343731652265016,10
1348,28,43,9,19,6.342362216975373,24
1349,15,16,91,8,6.341064031534598,8
1350,28,34,7,13,6.33926057444583,21
1351,89,12,55,5,6.335775873531133,7
1352,77,37,51,16,6.3237027482982455,21
1353,48,41,107,17,6.323493383217477,24
1354,49,35,60,14,6.302798279430961,21
1355,3,19,50,8,6.302491398681792,11
1356,107,48,53,19,6.300738049492767,29
1357,86,55,97,23,6.295568946747489,32
1358,28,36,102,15,6.294379170221607,21
1359,100,18,84,6,6.292769168431847,12
1360,40,68,68,26,6.288399173895761,42
1361,12,15,4,5,6.2855790295334035,10
1362,29,14,93,6,6.281843189307094,8
1363,86,21,4,8,6.279484499549702,13
1364,55,24,70,10,6.272647161931926,14
1365,20,45,5,17,6.2703736334427855,28
1366,43,17,103,6,6.266249297468395,11
1367,15,12,95,5,6.265255655621168,7
1368,107,65,55,27,6.2629651896189,38
1369,48,10,46,4,6.2577441282220505,6
1370,38,15,57,7,6.244977724558426,8
1371,37,49,63,19,6.239339617220506,30
1372,114,48,5,20,6.2376335334787205,28
1373,95,10,94,5,6.229015093991729,5
1374,28,37,70,15,6.2149266559981875,22
1375,114,24,70,9,6.214622620602992,15
1376,35,15,84,6,6.209299301194259,9
1377,108,26,88,10,6.206778138596414,16
1378,50,30,71,13,6.204695227712774,17
1379,74,28,70,13,6.203999405338759,15
1380,63,28,2,12,6.2000184918514885,16
1381,90,21,63,9,6.196182582339524,12
1382,13,73,40,31,6.184837754544506,42
1383,47,17,28,7,6.182374184386464,10
1384,80,10,93,5,6.175234905241023,5
1385,13,47,36,18,6.167141158071527,29
1386,104,58,28,24,6.161167829833448,34
1387,23,25,100,10,6.160200190912252,15
1388,50,11,81,5,6.158903696641053,6
1389,100,32,7,13,6.153012622391108,19
1390,114,48,68,20,6.151577271829131,28
1391,73,24,74,9,6.15033234594065,15
1392,23,15,43,6,6.148918923918834,9
1393,76,17,48,6,6.130488708954145,11
1394,63,18,66,7,6.119936177330313,11
1395,81,13,31,4,6.1171597913254,9
1396,107,24,66,10,6.115910396231512,14
1397,10,13,48,5,6.110914502877383,8
1398,90,12,7,5,6.108519045195328,7
1399,98,30,76,12,6.108080609901331,18
1400,84,12,15,5,6.098921486728436,7
1401,62,16,69,7,6.098141811871047,9
1402,54,11,47,5,6.095812400128515,6
1403,96,14,108,6,6.092516088942797,8
1404,9,26,84,11,6.089357364465301,15
1405,60,33,15,14,6.08275874538289,19
1406,23,13,102,6,6.080684731147933,7
1407,3,11,90,5,6.078153120016463,6
1408,55,22,77,9,6.0702404998734645,13
1409,98,22,84,8,6.0610062755899206,14
1410,41,22,28,9,6.053005216366935,13
1411,20,22,68,10,6.05097914081471,12
1412,63,24,18,9,6.046455003215185,15
1413,62,30,51,12,6.046321991251018,18
1414,93,15,109,6,6.044548294291569,9
1415,8,62,63,27,6.040704829296191,35
1416,104,41,55,17,6.036207114699971,24
1417,7,24,98,9,6.033686003781979,15
1418,26,10,68,4,6.030745942778483,6
1419,16,132,107,50,6.020709478551167,82
1420,29,15,48,6,6.020141509256065,9
1421,27,18,35,7,6.016767935838183,11
1422,16,37,53,14,6.0109581007292086,23
1423,107,69,104,28,6.010771127855349,41
1424,65,51,9,20,6.006217714596818,31
1425,106,47,5,18,6.005839560090041,29
1426,57,26,63,12,6.001123193099421,14
1427,94,21,54,9,6.000772945562414,12
1428,68,62,87,25,5.999176916704001,37
1429,28,18,29,8,5.991947603875371,10
1430,114,25,31,11,5.991876520395493,14
1431,27,57,86,23,5.9916581904627915,34
1432,87,28,97,10,5.983886061129735,18
1433,94,17,37,7,5.9815536162143665,10
1434,30,15,72,6,5.981031131976352,9
1435,71,13,109,5,5.977466642753509,8
1436,16,52,3,20,5.976983247695229,32
1437,64,20,18,8,5.974775055211903,12
1438,78,30,8,12,5.971195592839112,18
1439,47,16,81,6,5.96783503011096,10
1440,97,18,40,7,5.96691841614039,11
1441,39,34,29,16,5.9660900499545715,18
1442,104,46,50,18,5.958647190439788,28
1443,97,12,10,6,5.950831581917697,6
1444,27,56,65,22,5.9505220277082325,34
1445,28,15,53,6,5.945744364633269,9
1446,16,48,17,17,5.940232340982307,31
1447,53,26,104,11,5.936620222245529,15
1448,73,20,114,8,5.924435121305104,12
1449,61,18,60,8,5.922750219418491,10
1450,78,23,7,11,5.919551023484508,12
1451,54,84,88,34,5.915269494128592,50
1452,90,15,80,5,5.915216102688404,10
1453,37,22,110,10,5.913666685850416,12
1454,54,18,3,8,5.900167075724968,10
1455,38,10,98,4,5.899897776783364,6
1456,75,45,9,18,5.89399328159944,27
1457,101,15,68,5,5.891939886749792,10
1458,65,52,40,22,5.89106233992842,30
1459,37,11,3,5,5.8897383384754045,6
1460,17,16,43,7,5.8888013330711,9
1461,10,15,57,5,5.8872808270615,10
1462,75,17,108,7,5.88550634585497,10
1463,46,12,36,5,5.882094180819337,7
1464,28,12,31,5,5.876337878232255,7
1465,51,19,91,7,5.873980399232273,12
1466,94,18,109,8,5.873110590864872,10
1467,55,18,98,7,5.870446924304782,11
1468,54,36,95,16,5.865979569344116,20
1469,18,31,8,11,5.865710785121709,20
1470,34,17,7,7,5.86350495140184,10
1471,7,21,112,8,5.863389950487476,13
1472,104,52,51,19,5.856995324327739,33
1473,75,16,93,7,5.854064268882733,9
1474,80,12,79,6,5.851472407179259,6
1475,65,17,14,8,5.850273562995321,9
1476,13,40,69,16,5.843363292908417,24
1477,16,23,93,11,5.842811946264205,12
1478,54,29,49,12,5.8414712309316155,17
1479,88,13,66,5,5.838752373213262,8
1480,8,34,57,13,5.837314748465126,21
1481,63,40,13,17,5.836981602703613,23
1482,13,49,25,22,5.827601447712149,27
1483,8,37,93,16,5.8241714732303524,21
1484,86,32,103,12,5.822946833329548,20
1485,86,56,75,25,5.819454003755878,31
1486,79,13,20,5,5.810117746469002,8
1487,73,20,109,8,5.807578339260896,12
1488,8,19,98,7,5.806615359942182,12
1489,87,65,37,27,5.805092251858701,38
1490,10,11,106,3,5.803672894932928,8
1491,91,19,31,7,5.801858258461762,12
1492,11,21,17,9,5.800640520347571,12
1493,62,19,11,8,5.789369247630062,11
1494,34,21,48,9,5.788285695597517,12
1495,17,21,9,9,5.788074839959892,12
1496,104,16,81,8,5.786821230718973,8
1497,15,18,50,7,5.776077652807674,11
1498,23,45,60,18,5.772794691627653,27
1499,58,25,87,10,5.7682346867020975,15
1500,61,10,54,4,5.763750710129661,6
1501,87,43,49,20,5.762852743279541,23
1502,80,15,68,6,5.759836210772856,9
1503,64,32,63,14,5.757572899301187,18
1504,58,13,53,7,5.7565593826386765,6
1505,11,34,19,13,5.756316664639484,21
1506,36,12,77,5,5.751140829309577,7
1507,50,25,18,11,5.745370532916838,14
1508,100,25,114,10,5.743860264273013,15
1509,103,22,57,9,5.739096182156348,13
1510,25,42,106,16,5.737688222420903,26
1511,94,37,87,16,5.733861435476388,21
1512,13,50,64,23,5.733384315133941,27
1513,107,31,47,13,5.730039668040248,18
1514,55,40,54,18,5.729162102948165,22
1515,45,14,9,5,5.727853500458992,9
1516,8,75,87,31,5.726611414139773,44
1517,25,26,51,11,5.726135112848954,15
1518,93,11,9,4,5.723540166631908,7
1519,69,16,12,8,5.715951067980107,8
1520,54,23,72,9,5.711828677342122,14
1521,53,17,62,7,5.701449545318571,10
1522,70,10,32,5,5.692479372096221,5
1523,35,21,40,8,5.68914021357686,13
1524,76,17,114,6,5.686109810518634,11
1525,102,10,95,4,5.685319962340827,6
1526,87,55,19,22,5.685217473862323,33
1527,94,10,25,5,5.671887186214522,5
1528,16,31,99,13,5.665818337043016,18
1529,54,11,82,4,5.664278302313932,7
1530,16,37,84,15,5.660913981238355,22
1531,25,36,88,13,5.660869431868405,23
1532,30,13,2,6,5.655225265692614,7
1533,46,31,75,13,5.65470539949331,18
1534,20,44,16,16,5.653886889078915,28
1535,4,10,97,4,5.649870700339142,6
1536,39,13,97,5,5.649731064357224,8
1537,29,37,19,14,5.646461013632089,23
1538,108,13,38,5,5.644414418783651,8
1539,62,18,104,6,5.643310295152116,12
1540,78,47,51,22,5.638766096914629,25
1541,109,16,46,7,5.636528034552761,9
1542,64,43,86,18,5.632716173751325,25
1543,78,16,20,7,5.629467930549495,9
1544,19,10,5,4,5.623378775596124,6
1545,95,26,50,11,5.619957219349118,15
1546,68,26,91,12,5.619466372772095,14
1547,102,16,98,7,5.616900846312717,9
1548,23,11,10,5,5.611414438981723,6
1549,80,17,64,8,5.593698551425533,9
1550,20,38,96,15,5.591064360306498,23
1551,69,38,86,16,5.577802432439769,22
1552,20,22,44,9,5.576158683247873,13
1553,7,23,38,10,5.575438881033765,13
1554,72,11,9,5,5.567587328744071,6
1555,86,98,88,41,5.562390170991595,57
1556,107,63,20,27,5.562332766197248,36
1557,31,10,95,4,5.558189159340279,6
1558,13,30,95,13,5.5569838085167085,17
1559,46,11,4,5,5.5562218746456535,6
1560,104,86,65,37,5.554661796165203,49
1561,8,44,46,20,5.5530537260963095,24
1562,69,16,54,7,5.552096999235809,9
1563,8,41,25,16,5.550067480025429,25
1564,36,53,31,23,5.5485644604686595,30
1565,25,18,84,7,5.546687618128964,11
1566,18,42,75,18,5.546579166688547,24
1567,44,11,70,5,5.543204446478317,6
1568,8,11,85,4,5.538404103047142,7
1569,16,22,14,9,5.533520092369791,13
1570,64,11,102,4,5.525256448935211,7
1571,74,15,77,6,5.523098396212754,9
1572,89,10,84,5,5.518590211576737,5
1573,45,23,65,11,5.510611418282089,12
1574,95,19,83,7,5.510188596504651,12
1575,80,10,81,5,5.509744831821596,5
1576,39,32,38,13,5.50941856941641,19
1577,32,13,109,6,5.508051897308613,7
1578,2,13,40,5,5.504797437287725,8
1579,5,10,111,4,5.501968622126493,6
1580,58,28,69,13,5.500786187625181,15
1581,67,10,102,4,5.497246561771851,6
1582,111,27,55,11,5.492663797248297,16
1583,108,15,15,6,5.486650476336331,9
1584,13,46,54,19,5.47948770363916,27
1585,100,22,25,10,5.476003695191374,12
1586,57,14,98,6,5.474149624282838,8
1587,28,31,17,13,5.468605078583842,18
1588,31,13,74,5,5.468299370651388,8
1589,57,13,50,5,5.46070428512311,8
1590,8,19,38,8,5.45571555055501,11
1591,13,38,37,16,5.444485826742332,22
1592,107,24,102,11,5.4429592421544415,13
1593,65,50,20,19,5.436416455030899,31
1594,71,29,68,11,5.435653336862239,18
1595,42,13,69,6,5.432900919803655,7
1596,104,38,25,17,5.42238345531962,21
1597,100,51,27,22,5.416295940725653,29
1598,2,26,106,11,5.4140126266560475,15
1599,4,11,58,4,5.405037105567138,7
1600,8,20,33,8,5.397787705463006,12
1601,6,14,106,6,5.390411966564587,8
1602,54,38,68,15,5.382447112107091,23
1603,100,22,109,8,5.379853421224188,14
1604,65,16,103,6,5.377768524309904,10
1605,76,20,29,10,5.371211242445575,10
1606,15,25,18,10,5.370261713586336,15
1607,84,36,39,16,5.369674486814979,20
1608,7,35,97,16,5.356987360153854,19
1609,15,12,96,5,5.353611172107388,7
1610,17,31,49,15,5.3513656262489135,16
1611,13,22,48,9,5.345621103460163,13
1612,78,18,50,7,5.342630350789609,11
1613,68,53,53,22,5.342360173932808,31
1614,97,14,102,5,5.335160623731833,9
1615,5,33,51,12,5.328986421528186,21
1616,54,36,90,15,5.316089112252218,21
1617,7,40,3,16,5.315954351050264,24
1618,12,21,34,9,5.31592171902971,12
1619,38,19,19,6,5.315551758815005,13
1620,86,15,61,6,5.314125600249345,9
1621,58,13,47,5,5.305481766967035,8
1622,73,19,87,6,5.303982369774461,13
1623,77,14,81,6,5.303602497121728,8
1624,57,13,53,6,5.2956689882177095,7
1625,57,53,15,23,5.293604507571547,30
1626,43,17,8,8,5.292622247234721,9
1627,99,21,86,8,5.291638236148403,13
1628,28,12,92,4,5.284547759707862,8
1629,62,13,109,7,5.284405260681897,6
1630,13,23,62,10,5.279557581763115,13
1631,88,20,6,8,5.272285617199486,12
1632,11,26,102,12,5.269694308768165,14
1633,34,11,1,3,5.259854618241466,8
1634,107,29,35,11,5.259758635892075,18
1635,16,80,100,32,5.259335703188094,48
1636,35,11,31,5,5.255104723881268,6
1637,25,26,40,11,5.242222631716464,15
1638,78,23,77,10,5.238454313487661,13
1639,91,21,25,9,5.236778929543698,12
1640,75,60,107,21,5.231874163862643,39
1641,35,11,5,5,5.226534281744125,6
1642,92,23,39,11,5.223931097826436,12
1643,54,54,106,25,5.222938310920245,29
1644,7,101,88,43,5.220134457500585,58
1645,10,20,86,9,5.219152465496855,11
1646,19,17,81,7,5.218113087589113,10
1647,33,12,91,6,5.213867650447784,6
1648,50,22,109,9,5.207842202449346,13
1649,63,21,43,9,5.207688448634705,12
1650,78,27,49,12,5.198224201350136,15
1651,46,25,39,13,5.196853389468726,12
1652,104,18,80,8,5.194103195079235,10
1653,40,13,113,5,5.1937263926866155,8
1654,6,10,71,4,5.19369227829273,6
1655,89,11,103,5,5.183864624868911,6
1656,75,17,97,7,5.1834390154874335,10
1657,91,12,48,6,5.179665478095687,6
1658,11,19,32,9,5.1696009211826786,10
1659,31,11,54,5,5.168002033532433,6
1660,65,29,96,13,5.165027076154164,16
1661,67,12,5,5,5.159840528973079,7
1662,35,16,28,8,5.153123660542294,8
1663,39,57,60,25,5.152802282703843,32
1664,106,24,9,10,5.150083731218856,14
1665,11,13,97,6,5.149154391162877,7
1666,13,17,70,7,5.142156998200086,10
1667,27,48,49,20,5.142147981794254,28
1668,70,15,71,7,5.1409333575718525,8
1669,72,17,8,8,5.137819960649828,9
1670,36,21,3,8,5.136055944816984,13
1671,107,25,77,11,5.133888332698846,14
1672,40,30,58,14,5.133397385337806,16
1673,64,14,33,5,5.132334361355241,9
1674,103,20,12,10,5.129139372345028,10
1675,78,17,103,5,5.128778719706272,12
1676,64,10,76,5,5.126258276838511,5
1677,30,10,1,4,5.107240382060615,6
1678,16,100,8,41,5.0989375382547015,59
1679,49,14,33,5,5.095253781724572,9
1680,34,24,30,10,5.093231704876005,14
1681,69,18,39,8,5.092034225030051,10
1682,34,15,5,5,5.091205514677904,10
1683,15,28,30,12,5.0836642167601935,16
1684,32,10,20,3,5.082163415292113,7
1685,3,23,64,10,5.0798483629114175,13
1686,104,38,100,16,5.07592182790552,22
1687,41,10,61,4,5.060781095904457,6
1688,7,16,10,7,5.0604070656519635,9
1689,100,27,55,13,5.057275002393836,14
1690,16,23,35,9,5.053981282073499,14
1691,95,20,75,8,5.05026015248493,12
1692,20,23,2,10,5.048117889239678,13
1693,34,34,8,14,5.045872609442448,20
1694,30,18,108,7,5.041583987630236,11
1695,40,16,91,7,5.034652795604085,9
1696,74,26,93,12,5.031462008142043,14
1697,112,12,34,5,5.029259987635679,7
1698,47,25,86,10,5.026594655071246,15
1699,109,20,38,7,5.020675554109465,13
1700,30,50,60,18,5.0177790498163715,32
1701,108,30,51,13,5.016985241457158,17
1702,55,19,18,9,5.012210431301632,10
1703,93,12,63,5,5.011120266810436,7
1704,112,17,94,6,5.010192110959227,11
1705,39,35,43,16,5.006459842543767,19
1706,85,24,72,9,5.005644721261361,15
1707,102,13,83,5,5.00532757458449,8
1708,93,26,5,10,5.00446052682132,16
1709,100,25,34,12,5.004456878240623,13
1710,7,41,106,20,5.003800212982274,21
1711,51,23,96,10,5.001175453325252,13
1712,3,26,77,12,4.9989738181650925,14
1713,50,23,31,10,4.99199978599778,13
1714,63,19,94,8,4.988953899876627,11
1715,80,34,55,16,4.987967529735274,18
1716,37,73,86,32,4.980857284592114,41
1717,80,10,44,5,4.973541413806906,5
1718,98,11,23,5,4.9699651611390046,6
1719,27,21,114,9,4.967571693509975,12
1720,96,23,90,9,4.963939687748074,14
1721,85,10,64,4,4.96270118497494,6
1722,97,38,16,17,4.9536962755291185,21
1723,64,33,41,13,4.951397157092098,20
1724,20,12,100,5,4.948684351907279,7
1725,56,19,68,9,4.948132166753329,10
1726,80,29,106,12,4.946009667025369,17
1727,39,23,81,9,4.943832581007462,14
1728,40,15,78,5,4.942465399220725,10
1729,28,14,32,6,4.94214857785708,8
1730,49,11,71,5,4.940945789460408,6
1731,98,26,37,11,4.940519420053038,15
1732,100,72,51,34,4.9400020259394655,38
1733,63,17,85,8,4.93137224468223,9
1734,104,10,103,5,4.929333969571576,5
1735,86,40,36,17,4.92743325124,23
1736,108,17,63,7,4.925158043652065,10
1737,74,56,106,24,4.924754963776783,32
1738,34,13,15,5,4.917498933434509,8
1739,47,13,30,7,4.910819083779561,6
1740,18,11,29,4,4.907291190161112,7
1741,38,12,28,6,4.907164394244709,6
1742,13,43,77,18,4.906794574928387,25
1743,39,10,101,4,4.88974127810336,6
1744,27,11,46,4,4.887638683251713,7
1745,29,12,108,5,4.887109798889699,7
1746,20,12,72,5,4.886775559464283,7
1747,94,12,18,5,4.884425557504234,7
1748,69,11,95,4,4.882909765417967,7
1749,63,20,79,8,4.882182316485546,12
1750,23,42,87,17,4.879954184264544,25
1751,88,26,57,12,4.870812248870149,14
1752,11,88,86,38,4.868403647954056,50
1753,29,11,1,4,4.866934575588788,7
1754,95,10,64,5,4.863376640358334,5
1755,5,10,89,3,4.862465640901744,7
1756,49,33,51,14,4.860731289374451,19
1757,81,24,3,10,4.860040341211914,14
1758,100,31,112,14,4.858414274039207,17
1759,58,38,107,15,4.857008495705358,23
1760,23,46,88,18,4.856004139813016,28
1761,77,11,114,5,4.854209160918305,6
1762,97,12,32,5,4.8514593495768255,7
1763,78,34,60,15,4.85034428415885,19
1764,30,31,94,14,4.848071493453302,17
1765,39,22,96,8,4.8469385601006945,14
1766,39,17,83,7,4.8453860426526845,10
1767,83,20,64,9,4.840996077098241,11
1768,8,15,67,6,4.831909846155588,9
1769,90,25,65,12,4.825235861891514,13
1770,31,19,25,9,4.8238393010997695,10
1771,14,15,54,5,4.820525855929134,10
1772,16,112,65,48,4.817496389223386,64
1773,74,11,85,5,4.812388004493801,6
1774,13,23,79,9,4.81127521378253,14
1775,104,34,63,15,4.811269466320185,19
1776,30,75,16,30,4.810756321281799,45
1777,89,14,68,6,4.806077051288233,8
1778,1,16,12,7,4.804302234326604,9
1779,75,22,96,7,4.801381492311929,15
1780,41,22,97,10,4.799957538599524,12
1781,34,14,88,6,4.799596567728279,8
1782,111,11,25,5,4.797175922879401,6
1783,52,13,20,5,4.795236183864799,8
1784,26,10,89,4,4.793448655016913,6
1785,5,12,10,6,4.788462999241516,6
1786,15,25,81,11,4.783657780343265,14
1787,72,28,87,13,4.781032329128517,15
1788,50,28,30,12,4.780811288699288,16
1789,34,10,98,5,4.779193341125504,5
1790,9,12,5,5,4.777710715122406,7
1791,33,14,23,6,4.772846471482117,8
1792,90,13,70,6,4.771084444295363,7
1793,12,15,31,7,4.7706324645211815,8
1794,18,15,98,8,4.768289045671959,7
1795,55,16,94,7,4.767452995148847,9
1796,13,28,84,11,4.762106527456084,17
1797,106,14,62,6,4.759729251582843,8
1798,18,40,87,17,4.756693590622039,23
1799,7,23,50,10,4.754905099968973,13
1800,25,16,77,7,4.745845616411634,9
1801,16,107,7,47,4.744562074788691,60
1802,76,46,107,17,4.736244325803578,29
1803,25,13,108,5,4.7274242554223145,8
1804,41,34,104,16,4.726865305600903,18
1805,75,32,31,15,4.721982750346428,17
1806,30,11,45,4,4.71768267651097,7
1807,20,23,46,8,4.7087130702664775,15
1808,41,22,37,9,4.708031554461574,13
1809,111,13,106,4,4.703726078810505,9
1810,65,73,88,29,4.702916833614272,44
1811,88,27,38,10,4.6957798952347884,17
1812,40,51,39,21,4.685059105758992,30
1813,75,10,92,4,4.670779177266828,6
1814,11,26,98,12,4.667493378770945,14
1815,89,13,87,5,4.661119949921154,8
1816,107,54,23,24,4.6572217064632255,30
1817,25,15,47,7,4.65539023183265,8
1818,27,13,79,6,4.651583262533679,7
1819,15,16,1,6,4.649350840919032,10
1820,63,39,96,15,4.649023449526141,24
1821,80,11,69,5,4.638884395252672,6
1822,60,22,25,10,4.636282806493919,12
1823,106,15,110,7,4.633960085739291,8
1824,102,16,91,7,4.632859199025978,9
1825,65,13,89,6,4.632113459581725,7
1826,100,37,88,15,4.625717286575204,22
1827,51,44,109,16,4.624306959512695,28
1828,62,26,19,10,4.622905769372408,16
1829,72,10,40,4,4.616108231770902,6
1830,85,20,68,7,4.615895850726344,13
1831,74,11,57,5,4.613445177041246,6
1832,49,31,77,12,4.6107441465356995,19
1833,75,40,37,15,4.608119905928104,25
1834,13,21,96,9,4.6080585972764805,12
1835,38,15,18,7,4.607415756411174,8
1836,108,19,60,8,4.601423271346147,11
1837,80,18,39,8,4.600479594629686,10
1838,27,11,58,5,4.599497662673681,6
1839,13,45,78,19,4.597389344309831,26
1840,50,32,96,14,4.592653394244439,18
1841,78,26,54,11,4.592600537057525,15
1842,9,15,37,7,4.590013554185222,8
1843,99,16,65,7,4.579704538683154,9
1844,7,23,58,11,4.575034525669341,12
1845,99,14,95,6,4.572737764013049,8
1846,99,16,104,8,4.5627492392393005,8
1847,74,23,109,9,4.56252527772352,14
1848,62,17,15,8,4.561003044831275,9
1849,43,18,5,8,4.559277543830878,10
1850,70,15,23,7,4.554568026577774,8
1851,95,40,87,18,4.55278567672085,22
1852,83,15,46,7,4.551826612706294,8
1853,99,18,15,7,4.5514613106187225,11
1854,76,39,87,16,4.541391120932388,23
1855,93,29,28,11,4.540056078542574,18
1856,106,23,75,11,4.532198108241351,12
1857,52,10,55,4,4.531437489197339,6
1858,55,44,28,18,4.526943972884062,26
1859,74,23,50,10,4.520207268757788,13
1860,49,18,112,8,4.517911222226071,10
1861,63,64,54,27,4.513765725874224,37
1862,64,28,8,11,4.503057942170461,17
1863,13,68,46,28,4.497540419141798,40
1864,55,47,60,21,4.496007919155317,26
1865,58,21,39,9,4.494576390875354,12
1866,87,43,41,19,4.493818686537543,24
1867,75,44,71,17,4.485645835804012,27
1868,7,46,64,21,4.481240056988839,25
1869,72,18,103,8,4.478916130706033,10
1870,96,31,25,14,4.472832877552797,17
1871,108,11,94,5,4.472725388082187,6
1872,51,47,11,19,4.4722120482097765,28
1873,37,18,32,8,4.466542082918524,10
1874,79,15,54,6,4.462814449138745,9
1875,96,11,49,5,4.460220810874951,6
1876,19,14,85,6,4.456802611003388,8
1877,77,11,97,4,4.454901155383994,7
1878,41,29,3,10,4.4497597456397395,19
1879,50,14,19,6,4.445333605009822,8
1880,95,15,109,6,4.444131433700791,9
1881,100,78,107,37,4.436649878456104,41
1882,37,39,70,16,4.433263990915909,23
1883,65,35,3,14,4.429509708162627,21
1884,23,14,20,6,4.427778675436007,8
1885,99,30,13,13,4.4209668288342625,17
1886,29,17,23,8,4.418393467914161,9
1887,84,30,70,13,4.416286467774103,17
1888,7,64,53,28,4.4162137369106675,36
1889,50,24,64,11,4.415510499418937,13
1890,86,118,5,51,4.415256493878053,67
1891,16,55,50,23,4.4137196395395515,32
1892,86,36,81,13,4.41370209716057,23
1893,47,21,15,10,4.413268254147364,11
1894,71,14,108,6,4.402422140240555,8
1895,20,53,28,23,4.401187083369335,30
1896,76,35,5,15,4.400670357773005,20
1897,99,10,54,4,4.379722874612374,6
1898,87,33,25,15,4.379098196808539,18
1899,50,17,72,7,4.375655689739112,10
1900,55,13,58,6,4.369004483506257,7
1901,40,23,23,10,4.3684233268033035,13
1902,74,15,9,6,4.367415226980933,9
1903,27,60,3,26,4.3667900702206,34
1904,49,17,70,8,4.364791676107706,9
1905,95,20,23,9,4.361896262769256,11
1906,64,31,71,12,4.3594731378011655,19
1907,19,11,83,5,4.359398192701059,6
1908,65,16,6,7,4.346168811124805,9
1909,70,29,65,11,4.343984179663613,18
1910,12,40,13,14,4.341371143569527,26
1911,11,29,3,12,4.3360878284927775,17
1912,60,12,22,5,4.334241842742773,7
1913,95,19,41,8,4.332143979792181,11
1914,112,15,77,5,4.331879954372317,10
1915,4,22,40,10,4.316643149060887,12
1916,11,53,88,22,4.31528891426651,31
1917,97,23,17,10,4.313428551304965,13
1918,100,29,78,12,4.306504123439816,17
1919,106,27,53,13,4.3023196001359025,14
1920,37,45,55,21,4.3010010805888355,24
1921,30,15,52,6,4.285939641259887,9
1922,114,20,15,9,4.283176268910454,11
1923,100,47,19,20,4.2743432080986326,27
1924,50,20,49,9,4.263153819097887,11
1925,37,55,106,26,4.262507559544696,29
1926,108,29,87,13,4.255919125935356,16
1927,86,62,104,27,4.250245918123389,35
1928,6,10,72,5,4.2485701532137155,5
1929,106,14,34,7,4.243674039664676,7
1930,16,44,71,18,4.24180487871631,26
1931,71,31,87,14,4.240167636343153,17
1932,12,14,58,6,4.239755277925304,8
1933,49,32,65,14,4.23543755941813,18
1934,29,11,104,5,4.232469176091443,6
1935,41,59,107,23,4.232356930880344,36
1936,17,12,62,5,4.230180767198623,7
1937,9,21,38,9,4.22415659668818,12
1938,71,11,44,5,4.2235243488394545,6
1939,62,18,102,8,4.223468853406059,10
1940,28,29,100,12,4.22112967447295,17
1941,4,19,18,8,4.220670692754495,11
1942,17,20,63,9,4.21709530073227,11
1943,43,19,84,9,4.214619850887415,10
1944,52,10,48,4,4.211289472665269,6
1945,65,56,36,24,4.205692860728478,32
1946,103,18,3,9,4.204198112236471,9
1947,51,26,29,12,4.200611882951566,14
1948,112,12,103,5,4.192929666832575,7
1949,107,39,38,16,4.19085189067167,23
1950,13,36,1,14,4.187998461115461,22
1951,64,22,23,10,4.1871371231111585,12
1952,93,11,43,5,4.184906166012258,6
1953,23,27,25,12,4.182190113226041,15
1954,18,13,103,5,4.1752141807255745,8
1955,51,51,46,22,4.174462162624302,29
1956,60,24,96,8,4.164982345638217,16
1957,83,40,5,19,4.163709904424498,21
1958,49,50,86,24,4.160999894397798,26
1959,19,10,2,5,4.15617878328422,5
1960,27,24,84,11,4.15605922191636,13
1961,99,12,17,5,4.148375833376951,7
1962,15,17,103,8,4.148119256013827,9
1963,50,77,28,33,4.143924434349459,44
1964,100,12,95,6,4.142851413596654,6
1965,53,47,71,20,4.141303557057989,27
1966,95,45,16,21,4.139884598584295,24
1967,30,28,64,12,4.139822872969585,16
1968,71,11,20,4,4.1364305573939655,7
1969,74,13,30,6,4.132114674773076,7
1970,83,15,50,8,4.131296712002355,7
1971,18,57,53,26,4.124925801617175,31
1972,60,35,41,17,4.124791635334078,18
1973,7,12,2,5,4.115660194227726,7
1974,97,30,63,13,4.107378727934814,17
1975,75,48,51,22,4.10605342104463,26
1976,83,20,93,9,4.100880722204595,11
1977,20,24,35,10,4.098728722002916,14
1978,111,15,8,7,4.091375789332372,8
1979,86,27,93,12,4.090249999306011,15
1980,17,51,51,24,4.088673144397254,27
1981,36,11,19,5,4.088590218421681,6
1982,78,17,98,8,4.084899624702052,9
1983,91,21,75,13,4.084376386784757,8
1984,16,48,109,20,4.074520158198362,28
1985,95,21,46,9,4.071848693893571,12
1986,7,68,31,30,4.069172309295859,38
1987,65,19,73,8,4.067312461469672,11
1988,20,12,38,4,4.067291998076448,8
1989,43,10,95,4,4.063398320607962,6
1990,56,11,39,6,4.061429150921742,5
1991,14,10,20,4,4.051966837258039,6
1992,32,10,40,5,4.050021677419865,5
1993,8,58,51,26,4.0480191369019005,32
1994,84,12,69,5,4.046782427990891,7
1995,1,10,43,5,4.0389767157587135,5
1996,63,41,114,15,4.037972989054357,26
1997,60,42,114,22,4.029174933224299,20
1998,16,154,86,64,4.027183016832997,90
1999,7,31,47,13,4.025431088719286,18
2000,28,25,19,10,4.019180575644085,15
2001,34,17,67,9,4.015594495513433,8
2002,8,20,110,8,4.013172679497399,12
2003,5,18,77,8,4.010067732208506,10
2004,107,42,64,19,4.007940956634881,23
2005,31,16,112,6,4.001730552260444,10
2006,76,24,60,9,4.000770681345,15
2007,9,18,100,7,3.9953268600169216,11
2008,104,16,112,7,3.9943402412730644,9
2009,112,12,14,6,3.993235963114864,6
2010,51,85,65,37,3.990986526211724,48
2011,50,15,29,7,3.9901096227477506,8
2012,45,16,87,7,3.9869877249578156,9
2013,106,12,3,5,3.9869286680549902,7
2014,78,40,19,16,3.986269843175627,24
2015,60,18,97,9,3.9792005525226397,9
2016,83,10,76,4,3.9791717561004964,6
2017,96,58,54,28,3.976827697325717,30
2018,96,12,14,5,3.975747798085741,7
2019,8,60,65,27,3.971547797186142,33
2020,84,11,94,5,3.968156665744439,6
2021,78,15,96,6,3.961613354196052,9
2022,10,21,84,9,3.9602546020658425,12
2023,40,23,37,11,3.9558411724945226,12
2024,9,15,91,7,3.9508212932565088,8
2025,67,11,104,5,3.95056976239549,6
2026,16,23,2,10,3.948584482321736,13
2027,35,19,43,9,3.946831407739411,10
2028,6,11,40,5,3.9442678680230885,6
2029,9,31,54,14,3.942845641758712,17
2030,84,22,76,10,3.938973343504664,12
2031,18,15,20,6,3.930360704025332,9
2032,5,28,2,12,3.9232778253201652,16
2033,16,51,62,20,3.918066009623022,31
2034,83,24,87,11,3.916710407315815,13
2035,75,29,64,13,3.9160007140392388,16
2036,55,30,63,14,3.9003771949656936,16
2037,107,44,3,21,3.8998073957748334,23
2038,77,13,58,6,3.8981506835692445,7
2039,1,25,54,11,3.8929886538978153,14
2040,27,18,48,7,3.8925796052199804,11
2041,40,17,5,8,3.8914877974226934,9
2042,3,22,112,11,3.881829625852149,11
2043,65,86,41,35,3.8730812369047185,51
2044,41,21,29,9,3.868637237264429,12
2045,86,44,78,20,3.867468382132848,24
2046,43,27,109,11,3.867241547838042,16
2047,57,16,48,7,3.8589473829739176,9
2048,86,33,62,15,3.8579815466758753,18
2049,40,50,107,20,3.8570605527160113,30
2050,85,17,17,7,3.8507511089593,10
2051,28,39,76,18,3.848512689408892,21
2052,76,37,49,16,3.8482642836319476,21
2053,100,33,63,16,3.8476705598955556,17
2054,48,42,87,17,3.847040308559715,25
2055,41,22,50,9,3.845767300582984,13
2056,18,23,31,11,3.8430258307678673,12
2057,47,11,12,5,3.8390154161535532,6
2058,65,22,34,9,3.8388096634466446,13
2059,3,22,18,9,3.8346712095468676,13
2060,38,13,46,5,3.8338597693432206,8
2061,11,45,54,20,3.830761670343523,25
2062,74,84,86,39,3.830438067887497,45
2063,98,33,107,15,3.8262612451674287,18
2064,4,11,3,5,3.8250463920918434,6
2065,48,12,75,5,3.823943527087417,7
2066,5,28,91,11,3.8146250930665184,17
2067,110,16,5,7,3.8138584796050914,9
2068,28,27,71,11,3.8126316435493948,16
2069,17,13,80,5,3.803939831522535,8
2070,89,14,53,7,3.799040779312777,7
2071,6,11,39,5,3.7966207547038127,6
2072,90,25,50,11,3.7900343777578605,14
2073,25,29,54,13,3.788520356553666,16
2074,57,24,37,11,3.7883373383566465,13
2075,106,52,51,23,3.7850976424308236,29
2076,104,28,98,15,3.783243181516933,13
2077,29,39,87,16,3.78222935471684,23
2078,7,10,93,5,3.780231549016956,5
2079,114,47,13,24,3.775914918731173,23
2080,87,21,17,9,3.7733166042192914,12
2081,55,27,9,11,3.772633679119087,16
2082,88,87,51,42,3.772351956328509,45
2083,18,29,30,13,3.771793322983948,16
2084,102,14,17,6,3.765627490194506,8
2085,52,13,107,5,3.753558475982526,8
2086,53,42,40,19,3.7429391558119973,23
2087,28,58,54,25,3.7427833536169195,33
2088,51,55,84,24,3.742451182902999,31
2089,15,31,7,16,3.741081293807919,15
2090,1,13,4,5,3.736039087851971,8
2091,13,84,55,37,3.7352248820559995,47
2092,60,59,40,26,3.735016412978284,33
2093,90,31,5,13,3.729228130116929,18
2094,15,13,40,6,3.725578311667862,7
2095,87,52,20,24,3.725119508640054,28
2096,16,68,49,29,3.724084723946154,39
2097,20,25,41,12,3.722699653504378,13
2098,15,21,5,8,3.7147342263498166,13
2099,1,21,64,10,3.714096825641645,11
2100,112,10,35,5,3.7046440124812365,5
2101,16,62,5,25,3.7016615680953477,37
2102,23,19,28,9,3.6970356039584327,10
2103,80,16,38,8,3.695780114212427,8
2104,72,24,78,12,3.687490807799237,12
2105,65,23,109,12,3.6820630235649334,11
2106,89,13,49,6,3.6780362206368418,7
2107,38,21,84,10,3.669980206703245,11
2108,60,55,86,24,3.6676135242361485,31
2109,28,20,85,9,3.6675135147560156,11
2110,39,24,31,10,3.6610558433956144,14
2111,90,10,71,5,3.6561036030201173,5
2112,107,21,32,10,3.6546977761524615,11
2113,62,11,20,5,3.6532443670061325,6
2114,97,17,29,7,3.6527966127132636,10
2115,17,11,18,6,3.651905683853184,5
2116,74,50,65,23,3.6492230502429246,27
2117,9,13,23,6,3.6475995665029006,7
2118,14,10,70,5,3.647042134114854,5
2119,34,18,43,8,3.6439583345872713,10
2120,104,38,109,17,3.6425601551139146,21
2121,3,32,29,14,3.640968061507456,18
2122,6,15,86,6,3.637615954610379,9
2123,72,22,100,9,3.629040135098469,13
2124,55,51,5,22,3.6280461911141377,29
2125,43,19,18,10,3.6267699505365094,9
2126,80,26,28,12,3.6230809501897743,14
2127,112,15,79,7,3.621796379179409,8
2128,13,21,61,8,3.6146533376867587,13
2129,1,36,88,17,3.612486249864132,19
2130,86,24,32,11,3.600337352350485,13
2131,34,23,79,9,3.5987779482770503,14
2132,75,57,16,26,3.5952902080350215,31
2133,106,14,57,7,3.593618983726931,7
2134,104,61,5,28,3.5931408944870395,33
2135,7,22,11,9,3.5909071733141316,13
2136,97,10,95,4,3.589432471334791,6
2137,14,18,11,7,3.5868100547047623,11
2138,87,121,107,54,3.583674888744438,67
2139,88,62,5,29,3.583030843412137,33
2140,102,22,51,10,3.5799509862134142,12
2141,91,38,86,17,3.5760441594388466,21
2142,14,22,87,9,3.574657228905804,13
2143,25,19,43,7,3.573077352948072,12
2144,16,56,23,25,3.5704087987012967,31
2145,62,13,84,6,3.5672380956620375,7
2146,6,28,7,15,3.5631855242339134,13
2147,30,62,65,27,3.561917600098948,35
2148,60,12,79,5,3.555370933230572,7
2149,28,19,36,9,3.554999615354129,10
2150,34,17,104,7,3.5506468783547804,10
2151,63,94,86,39,3.5494783654033975,55
2152,41,28,109,11,3.5487793479544,17
2153,114,17,49,9,3.548728211191125,8
2154,40,16,19,6,3.5456118713031146,10
2155,33,11,70,5,3.5452850377562246,6
2156,13,31,19,13,3.5440871663273827,18
2157,47,29,27,13,3.543966431934925,16
2158,69,27,43,12,3.5430834421314668,15
2159,40,65,36,28,3.54008292473436,37
2160,28,32,30,15,3.539926425473853,17
2161,44,15,7,7,3.5352660207554565,8
2162,85,26,84,10,3.5349178606931724,16
2163,6,10,62,4,3.534555615892036,6
2164,62,24,8,10,3.532603268082999,14
2165,93,17,25,8,3.5300397889756283,9
2166,37,55,50,26,3.5287986061002155,29
2167,17,11,57,4,3.5231240907929307,7
2168,27,19,98,9,3.521955911173927,10
2169,28,17,15,8,3.521005718300717,9
2170,53,14,100,6,3.5195197890566727,8
2171,8,32,27,15,3.515211617722362,17
2172,74,16,23,7,3.505315761927062,9
2173,25,27,109,12,3.5041369262347244,15
2174,73,17,98,8,3.503959852428817,9
2175,37,19,109,8,3.503844054679794,11
2176,39,14,102,6,3.5024293607442263,8
2177,38,15,54,7,3.502268170966973,8
2178,37,13,108,6,3.5019197237718505,7
2179,114,39,51,19,3.4973322349486455,20
2180,97,36,114,16,3.494809729950692,20
2181,20,26,109,10,3.4929177397438647,16
2182,6,10,54,5,3.4921987314309866,5
2183,14,16,5,6,3.490369625649153,10
2184,62,13,36,6,3.4895283270523723,7
2185,36,30,51,14,3.487460022502504,16
2186,41,16,45,6,3.485066668867455,10
2187,25,20,70,9,3.4845181159437417,11
2188,74,60,5,28,3.4699961467083478,32
2189,52,15,16,7,3.4595240857912484,8
2190,33,23,5,11,3.4543275091771948,12
2191,76,27,27,11,3.4531012420920075,16
2192,37,21,23,10,3.4530437057487378,11
2193,112,14,114,7,3.4529529803290564,7
2194,7,94,86,40,3.4487912180291196,54
2195,86,63,46,26,3.447367416883425,37
2196,11,35,60,15,3.4471724802633115,20
2197,81,17,65,7,3.4470499311553464,10
2198,16,30,12,13,3.4325288291725853,17
2199,78,11,81,6,3.4320246992935286,5
2200,7,52,27,24,3.4308990471010516,28
2201,54,69,51,31,3.4308531323018583,38
2202,87,57,50,27,3.427638697835965,30
2203,4,12,37,5,3.4218717037755013,7
2204,28,18,78,9,3.417711658801108,9
2205,17,11,36,6,3.417273645156761,5
2206,79,22,11,9,3.411899322441769,13
2207,76,24,19,10,3.4114547768841037,14
2208,43,35,7,14,3.4056925239293445,21
2209,49,44,19,20,3.3946963082952384,24
2210,4,13,28,6,3.394082491248691,7
2211,73,10,104,4,3.3914910994647243,6
2212,88,82,107,35,3.388308151629917,47
2213,36,28,55,13,3.3833365772573503,15
2214,39,48,3,23,3.380759841466555,25
2215,70,20,75,10,3.379349863200628,10
2216,64,40,39,18,3.377216491809084,22
2217,13,78,60,33,3.3770875938219187,45
2218,72,23,11,11,3.3761818275237743,12
2219,73,18,96,8,3.3726024221333364,10
2220,37,22,100,9,3.3718369789109697,13
2221,91,31,107,13,3.3692392206395296,18
2222,13,56,28,26,3.3671896375902834,30
2223,69,27,57,11,3.367166221655226,16
2224,40,17,20,7,3.3649339637959685,10
2225,54,25,97,12,3.3648153427656786,13
2226,14,23,8,10,3.3634201583462153,13
2227,9,14,61,6,3.362078776884604,8
2228,14,17,106,7,3.360059412826618,10
2229,83,10,20,5,3.3478898251644154,5
2230,94,20,65,10,3.3472699488499056,10
2231,15,19,20,8,3.345564249700581,11
2232,13,42,11,18,3.34278030791396,24
2233,54,20,98,9,3.341408257498299,11
2234,68,13,5,6,3.3380294056441113,7
2235,80,17,48,7,3.3356230533911297,10
2236,60,23,38,11,3.3201484252433606,12
2237,98,14,97,7,3.3185319117606134,7
2238,97,16,84,6,3.3164282058099306,10
2239,60,31,75,14,3.313915862803686,17
2240,86,66,25,31,3.3097455853588773,35
2241,41,14,96,5,3.3088942892360294,9
2242,19,41,107,17,3.307359072836679,24
2243,114,21,64,9,3.3046667254482807,12
2244,47,13,61,6,3.3043540506366393,7
2245,76,17,79,7,3.2930359935936755,10
2246,34,45,107,19,3.2909922405162497,26
2247,55,15,35,7,3.2899027901624844,8
2248,68,31,78,14,3.285372327961684,17
2249,8,25,3,13,3.2773896333319046,12
2250,39,50,53,22,3.2771617260881887,28
2251,114,13,67,6,3.2746706512348394,7
2252,7,24,74,9,3.2574931437928867,15
2253,114,47,25,20,3.2540864225169726,27
2254,76,27,39,10,3.2536053252622477,17
2255,100,38,15,17,3.252832450403916,21
2256,43,12,48,6,3.2474165098505914,6
2257,64,10,96,4,3.2470341038418864,6
2258,60,83,16,38,3.2452233159929404,45
2259,23,12,81,5,3.2407035870769985,7
2260,30,46,49,20,3.2399113520088854,26
2261,99,25,60,11,3.238194459102711,14
2262,107,49,36,23,3.2348387046482587,26
2263,3,14,97,7,3.230803945654674,7
2264,23,50,65,24,3.229242004811313,26
2265,39,41,19,16,3.2239918770477396,25
2266,23,55,7,25,3.2229283053761706,30
2267,19,21,12,11,3.2219445095429298,10
2268,100,10,80,4,3.221630002984554,6
2269,17,16,74,7,3.211770551027834,9
2270,50,19,97,8,3.210625734622635,11
2271,72,22,65,10,3.2103844839596927,12
2272,60,47,31,24,3.209470727487928,23
2273,56,12,97,6,3.2085312435870676,6
2274,106,28,17,11,3.2039846830051175,17
2275,23,15,30,7,3.2022910560317883,8
2276,36,41,39,18,3.1998605067578247,23
2277,52,11,13,5,3.198313935058208,6
2278,69,15,8,7,3.191300471105285,8
2279,17,22,90,9,3.1908484224220683,13
2280,11,10,58,4,3.1884299720547125,6
2281,54,31,114,15,3.18479213160143,16
2282,100,21,50,9,3.182484639829969,12
2283,103,16,69,8,3.178595710406121,8
2284,86,134,87,64,3.178216540119954,70
2285,16,34,47,15,3.1778605747552726,19
2286,106,25,60,10,3.1712615038081853,15
2287,74,17,12,7,3.170371170202151,10
2288,86,15,113,6,3.169695932976229,9
2289,41,30,69,12,3.1671568486745967,18
2290,75,19,4,8,3.1591429263358246,11
2291,86,21,82,9,3.158656091984634,12
2292,104,51,7,23,3.158219418007501,28
2293,3,18,76,8,3.150422222688238,10
2294,75,23,23,12,3.1487336010920157,11
2295,100,65,13,30,3.1478251869099063,35
2296,112,12,45,6,3.146093665017745,6
2297,114,23,9,8,3.1400252375404265,15
2298,76,15,2,6,3.135016863493124,9
2299,6,11,28,5,3.131247568187587,6
2300,30,55,19,24,3.125484844850005,31
2301,51,15,61,5,3.123205657151163,10
2302,23,36,8,16,3.1207627844807817,20
2303,28,36,48,16,3.118969087107223,20
2304,36,11,80,5,3.1158574211756562,6
2305,25,25,17,11,3.1106502600539123,14
2306,50,24,4,12,3.1105592371369686,12
2307,111,21,86,9,3.1037611827633476,12
2308,86,38,77,17,3.1019167430803836,21
2309,92,15,60,6,3.101629065738577,9
2310,99,14,68,6,3.1001036150844774,8
2311,88,16,74,6,3.1000151762465453,10
2312,64,10,91,4,3.099347902087069,6
2313,104,34,54,16,3.0987784259955395,18
2314,6,20,87,9,3.097245674861366,11
2315,85,10,109,3,3.0954068823106935,7
2316,6,17,27,8,3.0947871865212933,9
2317,103,19,76,10,3.0940274843843967,9
2318,93,17,50,7,3.089216846430406,10
2319,107,59,37,27,3.087858660035621,32
2320,66,12,28,6,3.0826665795427424,6
2321,12,13,76,7,3.082319725605148,6
2322,55,16,62,7,3.0797392954165557,9
2323,97,23,104,11,3.078979141926911,12
2324,19,29,60,14,3.0741844930514635,15
2325,75,30,25,13,3.0695517335408993,17
2326,71,18,25,8,3.0644100067848137,10
2327,57,41,51,19,3.0641529465856614,22
2328,6,11,57,5,3.0567504666964656,6
2329,7,45,55,19,3.054761469393279,26
2330,12,40,3,17,3.043232035591344,23
2331,38,13,96,6,3.0422152322461717,7
2332,68,30,12,14,3.041358769608477,16
2333,30,22,79,9,3.0387025691085756,13
2334,25,39,65,16,3.0368934823131166,23
2335,39,11,89,4,3.03506944189561,7
2336,39,13,98,5,3.0332323169773585,8
2337,89,10,114,5,3.026921822427984,5
2338,40,17,33,6,3.0217035797006977,11
2339,47,29,88,14,3.0208806441241447,15
2340,9,43,39,21,3.0121485145406113,22
2341,74,42,63,20,3.0096162132471513,22
2342,48,14,19,7,3.0072884640806787,7
2343,50,20,108,10,3.0061866874624097,10
2344,16,58,37,27,3.0025107191283236,31
2345,96,14,34,6,3.001763014782561,8
2346,4,11,69,5,2.99948417666171,6
2347,39,56,27,24,2.997546423490314,32
2348,86,47,90,20,2.997206734082276,27
2349,76,19,95,9,2.9928718677450834,10
2350,114,11,34,6,2.988482941118176,5
2351,85,23,13,9,2.985985548040522,14
2352,46,13,1,7,2.9771068452784517,6
2353,84,36,106,18,2.975473960825013,18
2354,36,32,4,13,2.9739066740354216,19
2355,114,64,88,30,2.9736929918128037,34
2356,2,21,37,10,2.96975801126945,11
2357,73,16,63,8,2.966556049159884,8
2358,25,18,57,8,2.9649349505538733,10
2359,91,27,13,13,2.96394682527563,14
2360,114,23,46,10,2.963143531607224,13
2361,13,106,51,51,2.9562967878148285,55
2362,15,33,3,15,2.9522579457276636,18
2363,54,19,29,8,2.949914447875304,11
2364,52,15,12,7,2.9481231325534893,8
2365,71,18,46,9,2.9448527741935377,9
2366,60,39,8,19,2.9438347563437417,20
2367,9,18,1,10,2.9438107743951836,8
2368,83,27,65,13,2.938404758323202,14
2369,68,27,49,12,2.9363199373933013,15
2370,36,20,87,8,2.93557325089767,12
2371,66,16,86,7,2.9349279516020905,9
2372,78,20,94,9,2.934032764236852,11
2373,33,21,28,11,2.934003356051797,10
2374,12,18,40,9,2.93028970370934,9
2375,3,10,33,4,2.927658221464771,6
2376,1,14,62,7,2.921521583990398,7
2377,102,19,106,10,2.9207255392565106,9
2378,29,10,47,4,2.9199833749969137,6
2379,109,17,9,9,2.91854195196147,8
2380,55,11,31,5,2.9183781753906346,6
2381,37,10,33,4,2.9157377490462264,6
2382,47,22,41,11,2.9126189727076195,11
2383,60,23,58,11,2.9117712245785903,12
2384,80,36,54,18,2.9116630961094714,18
2385,104,12,10,6,2.9113530030237116,6
2386,62,19,9,9,2.9069158954391607,10
2387,16,33,79,14,2.9049583801159358,19
2388,30,34,71,16,2.8915964337712703,18
2389,27,58,88,28,2.8900429056834263,30
2390,17,25,46,11,2.875672610475698,14
2391,106,14,77,7,2.875589368126161,7
2392,75,21,30,10,2.874328227945732,11
2393,12,17,43,7,2.8740234479238573,10
2394,108,10,2,4,2.873465048153021,6
2395,112,14,1,5,2.872325056767921,9
2396,88,69,68,31,2.8695211003313754,38
2397,88,10,17,6,2.869337502995369,4
2398,49,30,15,15,2.8685226909597246,15
2399,46,23,63,12,2.8672418698963504,11
2400,28,70,84,31,2.8670003890442093,39
2401,72,14,88,6,2.8660882603566407,8
2402,55,50,11,21,2.8656348858368936,29
2403,69,25,28,12,2.861912956405139,13
2404,88,15,94,8,2.8588031686479485,7
2405,74,13,112,6,2.8550316834984484,7
2406,16,96,28,43,2.854985092700266,53
2407,97,13,33,6,2.848649622206162,7
2408,23,17,77,8,2.8478749291570455,9
2409,86,31,72,14,2.8473580393738387,17
2410,95,33,39,15,2.8414955259541013,18
2411,4,25,16,13,2.8411046840521457,12
2412,107,51,106,24,2.8408623146416336,27
2413,104,73,16,33,2.8388907836839916,40
2414,86,104,28,46,2.8374089851944673,58
2415,39,11,35,5,2.8361547619317555,6
2416,30,18,102,9,2.835829624332191,9
2417,53,23,81,10,2.8322690458402344,13
2418,114,61,86,29,2.8307983943039834,32
2419,15,39,107,15,2.8291612991129442,24
2420,75,21,112,9,2.8242194050340816,12
2421,54,18,62,8,2.824080555827825,10
2422,18,13,71,6,2.821320109059585,7
2423,68,14,48,7,2.8206443314688054,7
2424,97,26,76,12,2.8180456861896697,14
2425,9,48,40,21,2.81743847104381,27
2426,1,32,36,16,2.809530345293069,16
2427,99,15,41,7,2.8081672918617295,8
2428,65,42,71,18,2.8056942435602363,24
2429,106,14,112,7,2.805082024542774,7
2430,12,42,27,18,2.8046964318602283,24
2431,20,66,54,33,2.798936654496461,33
2432,83,32,8,16,2.795775595052069,16
2433,68,14,44,7,2.7953277213928227,7
2434,7,26,1,12,2.793205495238505,14
2435,100,13,36,6,2.7923934619121074,7
2436,18,10,57,4,2.7910504415885566,6
2437,70,12,102,7,2.7906887378625385,5
2438,85,14,112,6,2.788857070839814,8
2439,51,58,41,27,2.7880359032469952,31
2440,17,36,107,17,2.78728948647837,19
2441,18,30,40,12,2.780722164544755,18
2442,10,17,87,8,2.7770692343126595,9
2443,16,36,80,15,2.7654656327688585,21
2444,72,16,12,6,2.765048148513882,10
2445,87,40,57,18,2.7647177044445956,22
2446,1,17,94,9,2.7623810098011936,8
2447,88,23,35,11,2.7598010038488723,12
2448,97,34,96,17,2.7556888339056833,17
2449,70,14,43,6,2.753352748891413,8
2450,43,36,65,18,2.7525986025329385,18
2451,30,31,104,15,2.7504108450647493,16
2452,71,26,51,12,2.748484052918404,14
2453,69,31,68,14,2.743936079051882,17
2454,43,44,94,20,2.738284089480833,24
2455,99,12,63,6,2.737725340993938,6
2456,39,30,62,13,2.7367319129051215,17
2457,15,25,54,13,2.735147263925594,12
2458,60,26,46,12,2.733085524905183,14
2459,49,11,5,5,2.7256599500520577,6
2460,44,16,88,8,2.7255415222047095,8
2461,37,30,84,14,2.7240272709777176,16
2462,58,17,51,8,2.7220403540386506,9
2463,63,20,4,9,2.7170319642618375,11
2464,88,61,49,27,2.7144625519502794,34
2465,86,89,84,44,2.7122592129849856,45
2466,90,14,33,6,2.708622984963186,8
2467,2,46,50,21,2.7076882491876733,25
2468,39,11,79,4,2.703936570933463,7
2469,20,27,7,13,2.7023319306021247,14
2470,47,27,68,12,2.7008094429751055,15
2471,8,63,11,29,2.698721990639596,34
2472,39,22,48,9,2.697481925191404,13
2473,10,11,65,5,2.691616036034299,6
2474,87,23,31,11,2.6915087275033063,12
2475,7,21,30,11,2.691476247459028,10
2476,11,29,43,14,2.690595886408949,15
2477,13,20,102,8,2.68911865765018,12
2478,74,13,43,7,2.6848796666350316,6
2479,43,14,58,6,2.6806335210315986,8
2480,39,25,5,12,2.6791322172692817,13
2481,54,79,16,37,2.6768906219105006,42
2482,48,10,12,4,2.675775448389384,6
2483,25,17,44,8,2.67353547628176,9
2484,13,118,7,55,2.6708973171944725,63
2485,37,67,104,30,2.6697156594454787,37
2486,71,17,5,8,2.668348512437488,9
2487,51,62,60,25,2.6680912544453945,37
2488,87,92,65,42,2.6637454399121974,50
2489,107,54,9,27,2.659934690345264,27
2490,11,33,20,14,2.658025854837765,19
2491,40,24,27,13,2.6563176029466624,11
2492,19,32,68,14,2.6559298105207456,18
2493,20,14,73,6,2.6543798385197754,8
2494,57,13,36,5,2.6531160901053727,8
2495,16,145,51,69,2.648282058606672,76
2496,19,20,20,10,2.646933293157403,10
2497,100,24,69,11,2.641711217702835,13
2498,110,13,54,6,2.635884902993451,7
2499,51,12,22,5,2.6349206585516356,7
2500,95,34,107,16,2.633836762476072,18
2501,27,70,107,31,2.6286062134104733,39
2502,39,51,54,24,2.6240157360627983,27
2503,39,42,28,20,2.6233394077803616,22
2504,9,20,34,9,2.6185115894413817,11
2505,94,33,107,13,2.6133702151384584,20
2506,40,29,1,13,2.6081027273161883,16
2507,36,23,91,10,2.600483205457642,13
2508,20,10,89,5,2.5989355295603778,5
2509,65,32,80,15,2.5986356922004026,17
2510,13,94,107,44,2.5978950195498487,50
2511,20,48,37,23,2.5936827651590773,25
2512,102,27,37,12,2.5931875377695404,15
2513,1,10,109,5,2.5929606771402334,5
2514,19,35,94,17,2.5924300471605743,18
2515,28,71,65,31,2.5907378992374,40
2516,33,15,88,6,2.581178022844097,9
2517,63,16,45,7,2.5799907481308075,9
2518,50,22,112,9,2.578275791966451,13
2519,81,14,108,7,2.5758573743146345,7
2520,1,29,51,14,2.574119304918465,15
2521,48,14,25,7,2.5710538086168517,7
2522,86,14,14,7,2.5565201304900285,7
2523,16,75,68,33,2.555368429487557,42
2524,73,19,1,8,2.5534291003907317,11
2525,71,14,47,7,2.5504632262813383,7
2526,44,14,76,6,2.5504141931433417,8
2527,7,74,36,34,2.54935875079736,40
2528,77,14,95,7,2.541033558735234,7
2529,97,35,65,16,2.539739428020559,19
2530,70,22,9,9,2.5390649499197586,13
2531,43,41,60,19,2.5388407147488183,22
2532,54,34,102,16,2.5372297090094844,18
2533,43,14,72,7,2.536394554509492,7
2534,29,27,78,12,2.535777744244046,15
2535,40,60,88,27,2.532837544735202,33
2536,7,29,17,13,2.532089441361393,16
2537,44,15,107,7,2.530544567099409,8
2538,99,19,30,8,2.530388293684778,11
2539,36,33,9,15,2.527924078037464,18
2540,39,18,4,8,2.5267698999647306,10
2541,68,27,46,12,2.520930145642669,15
2542,12,15,36,7,2.516319942513756,8
2543,29,35,27,15,2.5139766493292597,20
2544,16,39,90,19,2.512640296874732,20
2545,50,54,107,26,2.5099686972292012,28
2546,87,15,92,7,2.5078466479835897,8
2547,84,13,67,7,2.500709874534178,6
2548,65,38,111,16,2.4964278491140734,22
2549,64,21,11,8,2.4904938630540925,13
2550,39,76,107,36,2.488662143008563,40
2551,27,34,43,16,2.4874868991786303,18
2552,71,27,9,12,2.485839871550415,15
2553,28,25,79,12,2.485405030035431,13
2554,88,45,109,19,2.4817016474099605,26
2555,87,58,28,28,2.477822962643624,30
2556,17,20,20,9,2.4759550702480673,11
2557,30,17,103,7,2.4703689712282224,10
2558,4,17,81,7,2.4678124777063224,10
2559,74,17,69,9,2.466497282082459,8
2560,103,10,37,6,2.4659405881754024,4
2561,13,31,34,15,2.4629355156987685,16
2562,17,17,1,8,2.462761073509875,9
2563,102,32,25,15,2.460889696925051,17
2564,110,17,86,8,2.459712460283758,9
2565,40,10,84,5,2.4542210673969374,5
2566,63,15,61,6,2.445410080263457,9
2567,32,10,50,6,2.4440541907162885,4
2568,64,15,47,6,2.441201731533324,9
2569,109,24,102,11,2.4374588964673856,13
2570,14,19,51,7,2.433844123091522,12
2571,3,17,96,8,2.432078371197565,9
2572,93,17,37,7,2.4227477033995664,10
2573,103,25,51,12,2.422501148647578,13
2574,109,28,34,13,2.4224825666242897,15
2575,109,11,99,5,2.4195174025010506,6
2576,28,19,94,8,2.4149604753175544,11
2577,107,24,81,11,2.4141594134658915,13
2578,34,23,50,11,2.4065274329929407,12
2579,88,57,104,25,2.406185933878753,32
2580,86,21,33,9,2.4046138870938174,12
2581,20,26,80,12,2.4033351571638515,14
2582,100,27,94,10,2.400243221659601,17
2583,114,15,98,7,2.3992721750256822,8
2584,46,38,28,16,2.3990178798165616,22
2585,97,21,109,10,2.398141101921517,11
2586,53,50,65,24,2.397002822057666,26
2587,16,22,45,9,2.3925466679441394,13
2588,23,13,48,6,2.3894452247322233,7
2589,104,40,95,18,2.3890342183876068,22
2590,4,21,71,8,2.387175011736595,13
2591,96,25,104,11,2.386641983915838,14
2592,75,13,56,5,2.3840139649043484,8
2593,8,14,112,6,2.3798297239108375,8
2594,71,40,107,17,2.376060967609246,23
2595,49,29,12,17,2.3757535970577646,12
2596,39,44,104,20,2.3751154073426797,24
2597,90,19,84,9,2.374748457023267,10
2598,53,31,55,14,2.3720895326624136,17
2599,25,32,63,16,2.3688265373602633,16
2600,40,24,50,10,2.367144047455048,14
2601,22,10,87,6,2.365823638651169,4
2602,99,23,5,11,2.36162190226428,12
2603,70,34,76,16,2.358420872168424,18
2604,100,14,97,6,2.358325970901081,8
2605,53,44,64,20,2.3578163734178164,24
2606,96,14,109,6,2.3566759619593634,8
2607,8,27,17,13,2.354578898260205,14
2608,99,12,33,5,2.354570382478152,7
2609,4,36,31,15,2.353535596679466,21
2610,79,10,96,5,2.351992111457352,5
2611,11,18,33,7,2.349854916623711,11
2612,29,24,11,11,2.3496813327430064,13
2613,76,29,109,12,2.3483387187433786,17
2614,78,10,45,5,2.343791897433706,5
2615,25,28,53,14,2.3301510854690863,14
2616,109,51,5,25,2.3285813949081624,26
2617,72,10,42,4,2.3285230567907247,6
2618,84,35,50,17,2.3257021134383256,18
2619,8,10,103,4,2.3245085117289825,6
2620,104,21,102,11,2.3206272974702777,10
2621,111,18,87,8,2.316389144833365,10
2622,88,32,91,15,2.315767764685106,17
2623,8,58,96,27,2.313991189820113,31
2624,71,31,63,14,2.311262987331468,17
2625,63,28,70,13,2.309911464577443,15
2626,76,13,69,5,2.308555624427584,8
2627,35,13,70,7,2.3047047876076423,6
2628,60,26,95,12,2.300035058084818,14
2629,50,34,76,18,2.298946803227753,16
2630,80,20,7,9,2.2986689861273377,11
2631,63,42,50,19,2.2950983829965117,23
2632,100,24,5,11,2.293242743404467,13
2633,106,13,4,7,2.287883468044358,6
2634,8,76,28,35,2.28759259007733,41
2635,73,16,16,8,2.286947763730408,8
2636,81,26,88,12,2.2857834835265316,14
2637,107,36,112,18,2.28568932916869,18
2638,38,10,81,5,2.2819621266449914,5
2639,77,12,69,6,2.2797993708458937,6
2640,11,60,46,28,2.27863758150919,32
2641,65,14,92,7,2.2769844774151653,7
2642,50,47,11,22,2.276023953743783,25
2643,40,14,74,6,2.2751378053719047,8
2644,57,12,77,6,2.2739735076992793,6
2645,7,108,68,50,2.2702884441480418,58
2646,61,10,31,5,2.2696136748473625,5
2647,28,66,96,31,2.2674069446039304,35
2648,85,12,7,5,2.267272935114745,7
2649,87,11,42,5,2.267067713255764,6
2650,109,23,3,11,2.262800410189064,12
2651,87,62,106,30,2.262204101784011,32
2652,98,16,17,8,2.2572460925395315,8
2653,74,13,41,7,2.2545650248033358,6
2654,95,30,25,14,2.253973143655666,16
2655,63,11,83,4,2.2518527555221,7
2656,8,17,19,8,2.250211187456416,9
2657,16,52,70,23,2.2486906290153845,29
2658,70,10,27,5,2.2432632584575636,5
2659,104,65,13,30,2.242803874148522,35
2660,72,26,15,13,2.2419909640786244,13
2661,64,21,49,9,2.241601060238613,12
2662,68,61,107,30,2.239285821874588,31
2663,77,13,103,6,2.2366700053173294,7
2664,108,11,65,6,2.2352573569912666,5
2665,4,26,114,13,2.2345648368573663,13
2666,46,18,65,7,2.232998478058108,11
2667,12,26,11,13,2.231267105865383,13
2668,62,29,71,14,2.2274966883750613,15
2669,90,16,25,7,2.2261576936837093,9
2670,3,32,43,14,2.225155663534229,18
2671,112,11,12,6,2.2247336886150633,5
2672,98,13,99,7,2.2212581677933705,6
2673,17,32,50,16,2.2211240849487943,16
2674,75,23,84,11,2.2186834285684545,12
2675,5,50,96,22,2.21142719225076,28
2676,13,32,72,16,2.2040070476145748,16
2677,75,27,27,12,2.2036511265370837,15
2678,17,14,91,6,2.2013317711286335,8
2679,91,12,56,6,2.199268647174773,6
2680,7,75,40,33,2.195752128306479,42
2681,68,35,106,16,2.193685806982791,19
2682,34,36,27,17,2.186049556860647,19
2683,30,62,107,28,2.1838692632585697,34
2684,52,10,100,4,2.1822522154052884,6
2685,16,44,48,22,2.1794750987576794,22
2686,41,46,68,22,2.171804807510055,24
2687,60,67,88,30,2.1715375199885685,37
2688,77,27,87,12,2.167010834166322,15
2689,23,13,53,6,2.1639220781507693,7
2690,108,21,27,9,2.1597743110088845,12
2691,62,27,3,12,2.154788303981498,15
2692,90,30,87,14,2.14819728806728,16
2693,10,21,8,9,2.147315002146761,12
2694,55,11,69,5,2.141856565606561,6
2695,71,39,39,18,2.1402119009407667,21
2696,102,22,74,10,2.1384304011801003,12
2697,81,17,68,8,2.1370452313390325,9
2698,3,64,51,32,2.1369691563906206,32
2699,66,13,31,6,2.1367157981218847,7
2700,8,26,102,13,2.1358165667375633,13
2701,11,30,74,14,2.1347610080309,16
2702,2,12,61,5,2.133108515807604,7
2703,54,77,8,33,2.1325516335637458,44
2704,98,10,43,4,2.1302778964437667,6
2705,102,32,114,14,2.1240842876015136,18
2706,7,62,9,31,2.12190310948229,31
2707,49,24,63,12,2.1212323385530256,12
2708,53,11,70,5,2.1174802085363624,6
2709,69,11,25,5,2.112059751085251,6
2710,57,38,13,19,2.1070868819342965,19
2711,68,28,94,13,2.106511062546953,15
2712,112,19,23,8,2.101852765262114,11
2713,76,30,55,13,2.1010477361103184,17
2714,65,26,78,11,2.1002855683398605,15
2715,83,34,55,17,2.0962093979720247,17
2716,97,22,8,11,2.094799206270942,11
2717,108,30,86,13,2.0910937309013526,17
2718,40,18,11,9,2.0894421004610075,9
2719,64,43,68,18,2.0864244028015833,25
2720,66,14,72,6,2.0852128177023035,8
2721,44,14,51,5,2.0848742289559725,9
2722,15,37,11,17,2.0760592851234287,20
2723,57,22,30,11,2.0742110648973373,11
2724,27,20,23,10,2.0722628371370155,10
2725,94,12,50,5,2.067325915186851,7
2726,84,30,34,14,2.067010635537676,16
2727,107,44,70,22,2.066718062800076,22
2728,76,22,88,11,2.06206527213327,11
2729,62,20,60,10,2.0597588787986405,10
2730,9,19,57,9,2.058380213538902,10
2731,48,25,65,13,2.057937129130549,12
2732,8,54,39,27,2.046441886882738,27
2733,12,14,7,7,2.0405365521973633,7
2734,11,18,93,10,2.0391902780828315,8
2735,80,16,60,8,2.038549414490356,8
2736,33,25,13,12,2.031483396821486,13
2737,91,14,114,7,2.031242634143403,7
2738,32,11,13,5,2.0261815070275424,6
2739,28,52,51,26,2.025017303726126,26
2740,90,26,60,11,2.0244178494313427,15
2741,76,15,90,6,2.0241498295019933,9
2742,114,27,17,11,2.021159075364864,16
2743,8,37,90,16,2.0194647820717773,21
2744,111,10,10,4,2.0194606727691027,6
2745,93,11,60,4,2.018629631632228,7
2746,69,14,37,7,2.0155128499001473,7
2747,41,46,27,20,2.0152493875384563,26
2748,68,29,70,14,2.015118158104632,15
2749,39,35,12,16,2.011891168245126,19
2750,62,20,37,8,2.01074071282815,12
2751,60,73,77,35,2.0085290730636887,38
2752,83,22,97,12,2.0076368732075736,10
2753,8,39,50,17,1.9997739229036222,22
2754,66,11,27,5,1.999266452067432,6
2755,114,26,74,13,1.9975972531686852,13
2756,8,92,55,46,1.9945813817420799,46
2757,53,19,4,9,1.9876947928926743,10
2758,100,12,79,5,1.9822381822120898,7
2759,95,28,53,11,1.9769373995573165,17
2760,88,32,70,15,1.9762934359596307,17
2761,55,31,84,15,1.9725581442910776,16
2762,54,10,35,4,1.970607603878345,6
2763,23,22,3,10,1.9704853033748797,12
2764,49,24,62,10,1.968372507575581,14
2765,57,14,49,6,1.9666920234512804,8
2766,19,31,65,15,1.9655134440486957,16
2767,28,33,91,15,1.9649527402335243,18
2768,41,24,112,11,1.9642201479007209,13
2769,80,11,97,5,1.9631828964682283,6
2770,39,14,33,7,1.960095595226131,7
2771,50,11,35,5,1.9581460146246819,6
2772,19,30,86,15,1.9572349198961296,15
2773,27,34,57,17,1.9534766566361856,17
2774,36,34,64,17,1.9485056781764578,17
2775,25,20,55,9,1.9429576796619987,11
2776,23,14,31,6,1.9392936999416412,8
2777,110,13,104,5,1.938847445081051,8
2778,71,49,7,25,1.9387153694352726,24
2779,32,10,98,5,1.938005226383161,5
2780,23,14,97,7,1.9330528734436583,7
2781,30,33,11,15,1.9323653860964833,18
2782,65,30,84,14,1.928864673268391,16
2783,70,19,40,8,1.9276789997691242,11
2784,17,28,54,14,1.925973647351252,14
2785,114,21,18,10,1.9235772497574426,11
2786,89,10,8,5,1.9209941773029187,5
2787,99,11,76,6,1.9173589523208294,5
2788,97,32,106,16,1.9159665785715103,16
2789,110,11,17,5,1.9155371371930712,6
2790,8,65,74,29,1.9128656065638743,36
2791,68,38,1,18,1.9099752765436635,20
2792,65,51,106,24,1.9069424806899138,27
2793,55,27,99,12,1.895072402151854,15
2794,85,12,98,5,1.892963761582925,7
2795,51,54,37,23,1.892799917988142,31
2796,20,35,106,16,1.8905905914286998,19
2797,71,44,86,22,1.8883807510456327,22
2798,27,14,18,7,1.8878641320648082,7
2799,25,23,64,11,1.8857238852847764,12
2800,96,16,30,7,1.8850748786904798,9
2801,68,108,13,51,1.8849483625328212,57
2802,2,41,8,20,1.8848654476169666,21
2803,87,66,54,30,1.8710926114506883,36
2804,60,19,48,9,1.868377497336707,10
2805,53,13,47,6,1.867452050486345,7
2806,60,13,33,5,1.8644268792007332,8
2807,93,21,97,10,1.8583722279909525,11
2808,53,22,97,10,1.8492466822191047,12
2809,19,25,88,13,1.8450287055712755,12
2810,50,13,73,5,1.8439270323254195,8
2811,87,69,30,33,1.8435085087904723,36
2812,12,18,85,9,1.8411131730635333,9
2813,114,30,20,14,1.8395405662544684,16
2814,8,41,100,19,1.838178294028023,22
2815,92,30,88,14,1.8365360092779848,16
2816,84,38,96,19,1.8356486827006806,19
2817,88,23,90,10,1.8344778390431964,13
2818,74,29,13,14,1.8278354237299024,15
2819,11,15,114,8,1.8276036019184327,7
2820,44,13,114,6,1.8263733365516688,7
2821,13,44,75,20,1.82625422828726,24
2822,86,37,79,17,1.8233812794868036,20
2823,102,13,99,6,1.821289341303691,7
2824,40,18,111,9,1.8104998545748747,9
2825,87,51,60,26,1.8079849879363554,25
2826,36,22,25,11,1.807144013826855,11
2827,70,57,86,26,1.80463722039498,31
2828,51,34,31,14,1.8036645224364263,20
2829,112,50,16,24,1.7995643538534876,26
2830,63,10,103,4,1.7993918081481381,6
2831,38,15,78,7,1.7991413148724158,8
2832,8,40,30,20,1.7986527143277458,20
2833,66,11,15,5,1.795076326934553,6
2834,114,35,39,18,1.7909993968165154,17
2835,20,19,48,8,1.7888857426975104,11
2836,97,27,46,13,1.7888516310767923,14
2837,12,35,87,16,1.785726887217587,19
2838,65,27,77,12,1.7824305156446967,15
2839,37,25,90,12,1.7816453937181727,13
2840,15,39,68,17,1.7799026131571731,22
2841,50,21,69,11,1.7758250016074677,10
2842,9,19,30,8,1.7725720850396782,11
2843,60,28,109,13,1.770350118894974,15
2844,103,39,16,20,1.765131463561878,19
2845,88,11,110,6,1.764222812142971,5
2846,64,47,88,21,1.7611807290570651,26
2847,15,51,86,24,1.7608808194903893,27
2848,37,98,5,47,1.7580752219846099,51
2849,88,37,18,18,1.7539193639392456,19
2850,104,21,43,9,1.750605109142025,12
2851,79,23,107,10,1.7474071801332398,13
2852,60,33,36,16,1.7416473627060738,17
2853,18,11,6,5,1.7414584600944842,6
2854,65,41,17,17,1.7406554308740467,24
2855,36,37,88,16,1.7392851936744356,21
2856,51,14,66,7,1.7380363030144774,7
2857,9,23,112,10,1.7370284161007252,13
2858,111,16,9,7,1.7347101097492736,9
2859,16,27,44,12,1.7334648777380284,15
2860,106,38,96,17,1.7318320126651967,21
2861,32,13,68,5,1.7311662598089266,8
2862,60,24,1,11,1.730552170717301,13
2863,109,20,77,10,1.727976391358886,10
2864,77,10,28,5,1.7274479044716262,5
2865,57,60,86,29,1.7214648622224287,31
2866,77,19,11,9,1.7198753848877157,10
2867,104,24,83,10,1.7171480590838881,14
2868,5,51,54,23,1.7127518345022985,28
2869,88,62,28,29,1.7102908597256317,33
2870,50,34,51,17,1.7082975555891384,17
2871,86,67,55,31,1.7078571022769586,36
2872,85,15,57,7,1.703449553409084,8
2873,20,16,102,8,1.6989391239814888,8
2874,65,92,107,44,1.6976830026187897,48
2875,36,15,23,9,1.697287527418564,6
2876,63,17,95,8,1.6923751834394967,9
2877,73,20,28,10,1.687006788072292,10
2878,55,40,106,18,1.6835382667235024,22
2879,39,75,13,35,1.6833252409730617,40
2880,55,25,20,12,1.682789944223458,13
2881,8,83,88,40,1.6811669912632214,43
2882,65,31,50,15,1.6801621867417356,16
2883,17,18,64,8,1.6742261514283467,10
2884,23,14,50,5,1.673947609647618,9
2885,63,45,7,18,1.673573876629926,27
2886,48,14,104,6,1.673511883025235,8
2887,87,45,84,20,1.6712785926609632,25
2888,68,46,3,23,1.6711554440218455,23
2889,45,28,31,13,1.6710870406691025,15
2890,17,17,112,8,1.670998049379022,9
2891,34,27,11,12,1.6687741736292339,15
2892,54,19,33,8,1.6683853925492595,11
2893,16,51,43,23,1.6637284501840413,28
2894,8,95,107,48,1.6636951263902326,47
2895,37,47,74,23,1.66281633297112,24
2896,63,24,47,10,1.6623324282821739,14
2897,41,30,1,13,1.6558361653082903,17
2898,36,23,68,11,1.651168634820273,12
2899,30,41,68,20,1.6397998764136308,21
2900,41,60,88,27,1.6397874376242172,33
2901,102,10,49,4,1.6394569107680652,6
2902,104,26,18,11,1.6361581237581893,15
2903,6,18,68,10,1.6346986227731617,8
2904,35,28,86,12,1.630292710908606,16
2905,18,37,51,19,1.6280086279913597,18
2906,64,12,84,7,1.6272082249846804,5
2907,106,46,88,20,1.6248459493396556,26
2908,44,17,87,8,1.6239279411647956,9
2909,23,23,15,11,1.6229585941030178,12
2910,38,32,13,17,1.614314899085529,15
2911,30,29,69,14,1.6139022710932394,15
2912,76,17,18,8,1.601109520179619,9
2913,12,11,57,5,1.597190174870237,6
2914,14,11,75,5,1.594721022285634,6
2915,34,43,16,19,1.5938069518093538,24
2916,57,38,39,19,1.5884848488756722,19
2917,2,15,25,8,1.5845186001024,7
2918,88,20,61,8,1.5819478875432638,12
2919,58,12,100,6,1.5819008855655083,6
2920,2,34,97,16,1.581483466739766,18
2921,55,22,90,12,1.578656952498875,10
2922,96,34,88,17,1.5755489762598094,17
2923,30,27,78,13,1.5696074585617392,14
2924,4,61,13,28,1.56876063127331,33
2925,43,45,19,21,1.5593819040435108,24
2926,80,20,11,10,1.5532652275466894,10
2927,57,25,102,12,1.5483760769806807,13
2928,63,30,27,13,1.5482939869847638,17
2929,60,32,9,14,1.541763907829675,18
2930,22,10,86,5,1.5381482899799122,5
2931,94,21,11,11,1.5369194320927209,10
2932,98,13,79,6,1.5335435073226167,7
2933,29,13,53,5,1.53176700286447,8
2934,64,15,81,7,1.5315551836921608,8
2935,114,20,84,9,1.5282826629009736,11
2936,13,66,27,32,1.5277775268373557,34
2937,35,14,37,7,1.523131742310598,7
2938,3,22,61,8,1.5200379980927694,14
2939,107,124,86,59,1.5170757261632717,65
2940,46,12,55,5,1.514859018089967,7
2941,64,29,27,14,1.506656484827703,15
2942,41,24,76,13,1.5059213967551945,11
2943,27,25,50,10,1.5040884605682736,15
2944,54,10,89,4,1.503765809030216,6
2945,87,64,3,30,1.5024262132812511,34
2946,63,22,15,10,1.4989595234613098,12
2947,19,15,102,6,1.4975662366291813,9
2948,46,52,5,24,1.4974094901037533,28
2949,107,47,25,23,1.4967278623744338,24
2950,112,16,11,8,1.4950492246382474,8
2951,2,23,74,10,1.4920197761473226,13
2952,49,33,7,15,1.4907855360930005,18
2953,60,74,71,35,1.4843115108657066,39
2954,37,38,17,16,1.479924510472103,22
2955,68,10,84,4,1.4788993773509214,6
2956,109,20,69,10,1.476902335560545,10
2957,103,17,79,8,1.4762996181953671,9
2958,106,50,11,21,1.4751786277994416,29
2959,35,24,7,12,1.4676220715119486,12
2960,6,13,69,7,1.4672562795661197,6
2961,71,24,3,11,1.4668209780059522,13
2962,40,64,51,31,1.4624658901194083,33
2963,31,21,47,10,1.4606130980712677,11
2964,25,23,83,10,1.459720188055504,13
2965,108,37,107,18,1.4524982900970553,19
2966,62,28,65,14,1.4496341901836953,14
2967,106,55,63,27,1.448556681809942,28
2968,75,44,39,23,1.4473715172929777,21
2969,65,33,69,16,1.4425642416495112,17
2970,20,21,97,11,1.4395279608818752,10
2971,50,28,25,14,1.4391705454909005,14
2972,34,21,39,10,1.4278801146393896,11
2973,36,35,45,19,1.423273124508118,16
2974,1,11,53,5,1.4196819324858239,6
2975,80,36,86,17,1.4162310289001794,19
2976,15,41,65,19,1.4119875326523994,22
2977,100,29,62,15,1.4095954922785325,14
2978,12,20,71,10,1.4059148964814137,10
2979,46,25,9,13,1.4052752923291445,12
2980,70,17,95,9,1.4011695857654891,8
2981,48,28,11,13,1.3960534557902764,15
2982,74,12,98,6,1.394136813126094,6
2983,63,44,41,21,1.393059609593735,23
2984,95,12,80,6,1.3888115326852126,6
2985,86,87,8,45,1.3887471294184057,42
2986,12,13,64,6,1.3883647817413076,7
2987,89,25,16,12,1.3865919033211425,13
2988,36,11,29,6,1.3837445576600509,5
2989,102,18,3,8,1.3811952404449805,10
2990,106,30,41,15,1.3806292559177726,15
2991,39,52,41,27,1.3725005678823738,25
2992,16,64,19,28,1.3677297158037256,36
2993,25,26,30,14,1.363384718034573,12
2994,41,35,40,18,1.358626645359705,17
2995,104,33,70,16,1.3582302540990812,17
2996,29,40,107,16,1.3557283794699355,24
2997,87,40,64,20,1.3537393986822601,20
2998,30,14,81,7,1.3508923221630391,7
2999,97,37,88,18,1.3490743629309014,19
3000,108,17,40,9,1.3479697301696891,8
3001,52,19,87,8,1.3439420173712888,11
3002,8,44,104,21,1.3410693202324964,23
3003,6,10,23,5,1.3385415186806267,5
3004,77,12,94,5,1.3353290162205556,7
3005,50,20,98,9,1.335287430553141,11
3006,30,83,86,38,1.3293231443644227,45
3007,30,21,48,9,1.3239953886043165,12
3008,84,36,54,17,1.3202943615638323,19
3009,74,18,80,9,1.319966132866856,9
3010,65,111,63,53,1.3193232513653719,58
3011,55,57,88,25,1.3163784693707288,32
3012,54,21,23,10,1.3133138976413523,11
3013,94,11,40,5,1.3131730085845268,6
3014,112,32,65,16,1.3122977163439495,16
3015,68,52,9,25,1.3104638696206712,27
3016,9,28,58,13,1.310268135821897,15
3017,89,20,107,9,1.3096086727301652,11
3018,32,14,51,7,1.3093866254236395,7
3019,41,28,114,14,1.307338108043566,14
3020,60,79,7,38,1.304264843873566,41
3021,38,16,17,8,1.3036206431746913,8
3022,5,44,13,21,1.3023509853743034,23
3023,78,16,109,8,1.3015742746802685,8
3024,11,84,16,36,1.2989161080505247,48
3025,7,22,8,10,1.2952715014492373,12
3026,88,39,4,19,1.294921220761057,20
3027,41,19,78,8,1.2892335099283343,11
3028,51,19,99,10,1.2892082407104484,9
3029,89,17,88,9,1.288899774963521,8
3030,96,59,107,27,1.2779661064945878,32
3031,46,57,54,28,1.2778066019254952,29
3032,34,10,91,5,1.2767116469837227,5
3033,71,11,1,6,1.2732152302328021,5
3034,60,29,28,16,1.272111001147211,13
3035,62,11,47,5,1.265526998129847,6
3036,52,15,65,8,1.262826215370322,7
3037,92,12,107,5,1.2625916923530776,7
3038,57,24,55,13,1.2620925157379805,11
3039,81,20,18,10,1.2612198373935404,10
3040,93,10,79,5,1.2606355667564615,5
3041,86,39,112,18,1.2594712193458382,21
3042,9,37,63,18,1.2589023707877973,19
3043,17,42,13,21,1.2570532505054286,21
3044,41,74,13,36,1.251763682954913,38
3045,13,61,9,28,1.2504419702657084,33
3046,16,38,29,19,1.244834998200107,19
3047,108,16,55,7,1.2425126869095378,9
3048,91,20,37,10,1.2413018923540677,10
3049,70,32,51,16,1.2403340780472845,16
3050,71,25,31,12,1.2380158081615484,13
3051,28,39,25,17,1.2338977751460145,22
3052,51,88,107,38,1.233524626679821,50
3053,64,18,108,9,1.231630129497269,9
3054,55,17,41,8,1.220974525083998,9
3055,71,37,88,16,1.218508421155273,21
3056,54,25,18,12,1.2139969956731949,13
3057,17,35,34,18,1.212836226783514,17
3058,58,16,63,9,1.2116740819179406,7
3059,25,33,97,16,1.2112097532933517,17
3060,47,12,76,8,1.2091645579998245,4
3061,3,15,46,8,1.2064770707138577,7
3062,28,65,5,32,1.2040234196998174,33
3063,20,20,76,11,1.195513412586339,9
3064,25,67,16,32,1.1932865297100734,35
3065,68,18,74,7,1.1930607364890244,11
3066,60,52,65,28,1.188933451233345,24
3067,98,15,60,7,1.188577253485572,8
3068,87,16,110,7,1.1878037867151132,9
3069,76,31,96,14,1.1853039288193863,17
3070,29,21,8,9,1.1835149699783736,12
3071,89,16,104,8,1.1768798083300285,8
3072,33,12,77,6,1.1756675735500741,6
3073,63,51,11,22,1.1727104947557743,29
3074,44,13,75,7,1.169380882277211,6
3075,108,19,74,8,1.1664859423669782,11
3076,16,56,41,26,1.164409244395375,30
3077,16,33,108,15,1.163747925816394,18
3078,86,36,18,16,1.16255605324444,20
3079,77,30,18,13,1.157226861340675,17
3080,111,32,16,16,1.1556733242940576,16
3081,79,17,7,8,1.150116600366683,9
3082,107,42,97,20,1.1486858251368084,22
3083,17,10,33,5,1.1464162819529016,5
3084,23,48,86,23,1.1432023432243956,25
3085,64,20,45,9,1.1431500338693177,11
3086,8,14,56,7,1.138262181129431,7
3087,13,57,53,26,1.137975375986167,31
3088,107,43,18,23,1.1371611267925203,20
3089,36,26,106,13,1.1307287364062795,13
3090,3,26,31,14,1.1304098830558913,12
3091,47,14,109,7,1.125259599170716,7
3092,79,17,88,8,1.1249704502892566,9
3093,69,28,19,13,1.12274464710603,15
3094,28,25,57,12,1.1208866402447313,13
3095,50,69,54,34,1.1176760529666152,35
3096,29,19,7,7,1.117067463392933,12
3097,100,14,61,7,1.1138239851805005,7
3098,40,16,109,7,1.112646763896167,9
3099,73,13,55,6,1.1082443575059628,7
3100,91,12,47,6,1.1047106963660323,6
3101,40,19,45,9,1.104353122593122,10
3102,96,18,2,9,1.1039761816908875,9
3103,70,39,106,20,1.1024614638047314,19
3104,18,35,41,18,1.098384167284529,17
3105,54,41,19,18,1.0951937907986231,23
3106,87,35,75,17,1.0859483979409972,18
3107,15,15,17,8,1.0855800690980384,7
3108,60,31,81,15,1.0765050885349574,16
3109,19,30,57,15,1.0764867469339017,15
3110,75,27,74,12,1.0761366724331511,15
3111,64,19,97,9,1.0748997556853976,10
3112,28,61,109,28,1.0738097371372834,33
3113,9,16,97,9,1.0715415510849877,7
3114,67,20,37,9,1.070770052763525,11
3115,58,14,71,7,1.0679524363994424,7
3116,104,14,92,8,1.0650896272942483,6
3117,88,32,3,15,1.0621797128272272,17
3118,100,14,44,7,1.0590413147864144,7
3119,13,16,89,7,1.0581999047075505,9
3120,71,18,45,10,1.0500246166344471,8
3121,107,73,63,39,1.0499479505653528,34
3122,104,16,33,7,1.0375486456158094,9
3123,45,14,3,7,1.0349134798027042,7
3124,104,38,74,17,1.0321539192468763,21
3125,87,44,109,20,1.0302241666569765,24
3126,78,45,107,21,1.0299764540806504,24
3127,63,20,44,9,1.0233184771026445,11
3128,64,12,90,6,1.0226762518657313,6
3129,79,13,9,7,1.0203716742776936,6
3130,86,72,3,35,1.0184654674384126,37
3131,12,24,23,12,1.0126038475678378,12
3132,51,69,87,33,1.0120244136494763,36
3133,20,17,85,8,1.0120202947249686,9
3134,91,20,18,9,1.0069076377111847,11
3135,45,12,88,5,1.005819520359159,7
3136,114,11,93,6,1.0049906589581667,5
3137,57,34,41,17,1.00006887405222,17
3138,68,29,38,13,0.9956485324900232,16
3139,43,33,88,15,0.9947945347929822,18
3140,3,42,60,20,0.9913631554114472,22
3141,20,13,27,6,0.9871413726704082,7
3142,69,32,107,15,0.9867318989974718,17
3143,54,19,112,9,0.9843355592348286,10
3144,16,125,13,58,0.9826353825245314,67
3145,7,81,41,40,0.9794700083084562,41
3146,93,19,84,8,0.9776365381665071,11
3147,68,15,102,7,0.9774478191416416,8
3148,87,76,88,39,0.9771805164055242,37
3149,107,65,5,32,0.9748363761521168,33
3150,70,10,62,5,0.9747108971050832,5
3151,78,12,9,6,0.9745877106891233,6
3152,63,52,87,24,0.9694664805604988,28
3153,64,15,57,7,0.9686108755747885,8
3154,41,21,94,9,0.9669375303013759,12
3155,71,34,8,17,0.9628252268322728,17
3156,104,38,106,19,0.9604760273979267,19
3157,47,10,94,5,0.9596390773110727,5
3158,106,11,103,6,0.9583580547252463,5
3159,63,23,53,11,0.9461903574639025,12
3160,18,34,60,17,0.9344074833355396,17
3161,16,40,72,20,0.9283059904790143,20
3162,3,30,9,15,0.9265694640511716,15
3163,55,24,4,12,0.9256101911535765,12
3164,95,32,7,15,0.9236786450564196,17
3165,29,17,9,9,0.919777650807688,8
3166,29,16,43,8,0.9196986818795099,8
3167,75,27,114,13,0.9181862737012535,14
3168,39,14,1,5,0.9120351629887123,9
3169,64,17,46,8,0.9119833053856681,9
3170,34,20,3,9,0.9113037225897234,11
3171,36,35,75,19,0.9076169876586814,16
3172,76,28,102,13,0.9068567870201522,15
3173,29,12,12,6,0.9066091071417807,6
3174,6,14,50,7,0.9048960894988062,7
3175,60,12,111,7,0.901998030050083,5
3176,62,14,50,6,0.9017457082495477,8
3177,78,17,55,9,0.9002458878614119,8
3178,30,52,27,26,0.8997232050548485,26
3179,107,91,28,43,0.8970764795683025,48
3180,39,24,70,11,0.8958543413772162,13
3181,106,71,28,34,0.8945808420172994,37
3182,39,54,55,25,0.8915312651875593,29
3183,27,63,51,30,0.888138361606474,33
3184,9,19,69,9,0.8879210172039291,10
3185,27,48,11,23,0.8856386812161117,25
3186,93,13,3,5,0.8808947328421434,8
3187,83,21,88,11,0.8798897555023121,10
3188,13,47,15,24,0.8757286594591273,23
3189,41,15,48,7,0.8735829617761527,8
3190,27,15,1,6,0.8721383199452204,9
3191,57,22,68,10,0.871674240734193,12
3192,60,17,84,10,0.8716143564890761,7
3193,46,34,87,15,0.8711353256142379,19
3194,54,111,65,54,0.8660420311677451,57
3195,58,19,3,8,0.865079685560992,11
3196,41,25,43,12,0.864027427303756,13
3197,10,10,114,4,0.8617397018011357,6
3198,77,14,64,8,0.855042195937581,6
3199,41,12,38,5,0.8514389884122157,7
3200,33,15,95,7,0.8491128905949068,8
3201,8,31,48,15,0.8434410970737376,16
3202,79,23,84,11,0.8428978656974995,12
3203,19,24,77,12,0.8379851134542081,12
3204,2,16,46,8,0.8285194662826778,8
3205,29,12,106,6,0.8264692442725412,6
3206,84,15,95,7,0.8218033746912392,8
3207,114,19,45,9,0.820568913201756,10
3208,57,18,20,9,0.8178941572060074,9
3209,86,38,12,18,0.8156441062566462,20
3210,87,38,69,17,0.8127923322049366,21
3211,56,14,40,7,0.8062835825274118,7
3212,30,26,40,13,0.8045580871786273,13
3213,86,85,20,41,0.8016884889387337,44
3214,43,26,78,13,0.8005863278065609,13
3215,98,11,62,5,0.7995773049352709,6
3216,2,22,88,11,0.7956469041111253,11
3217,1,36,107,18,0.792741418555241,18
3218,28,16,89,7,0.7901986413516666,9
3219,75,14,33,6,0.7900898585820573,8
3220,41,21,46,11,0.7882087764921283,10
3221,4,18,104,10,0.7872554057904755,8
3222,48,20,109,9,0.7860713609857853,11
3223,43,20,68,9,0.7807661871695073,11
3224,87,73,39,35,0.780052234907527,38
3225,87,22,99,10,0.7762165713325079,12
3226,88,32,69,15,0.7753807063240763,17
3227,58,15,50,8,0.7660630045931233,7
3228,47,27,65,13,0.7649117411143579,14
3229,107,20,72,10,0.7554109299536205,10
3230,57,14,91,6,0.7523919124216624,8
3231,8,68,37,34,0.7513899671656665,34
3232,14,15,13,6,0.751185424264851,9
3233,98,22,100,10,0.7471432837189802,12
3234,46,24,84,11,0.7446057703540031,13
3235,36,13,74,5,0.7437175733038418,8
3236,109,27,106,14,0.7430675694349274,13
3237,38,22,64,11,0.7416758999099181,11
3238,94,24,86,12,0.7404864736135068,12
3239,7,12,108,5,0.7404080910313966,7
3240,25,24,15,13,0.7394428200536313,11
3241,88,24,77,11,0.7378048830896938,13
3242,40,77,86,36,0.735275767181436,41
3243,28,57,11,27,0.733863128330741,30
3244,95,41,5,21,0.7316066534315495,20
3245,33,13,27,6,0.7289108112107268,7
3246,27,13,99,7,0.7284055341482011,6
3247,71,10,96,5,0.7278695572627853,5
3248,57,10,4,4,0.7276499847388465,6
3249,49,20,109,10,0.7270267076148561,10
3250,81,19,27,9,0.7248890061971007,10
3251,15,21,64,9,0.7194942356138029,12
3252,51,38,43,20,0.7192859319153487,18
3253,37,51,28,24,0.7168710662114339,27
3254,61,18,40,9,0.715489570683085,9
3255,51,19,48,8,0.7142524379704616,11
3256,8,72,106,37,0.7133251026811394,35
3257,43,18,71,10,0.7122285277146779,8
3258,51,37,12,18,0.7101916786560039,19
3259,106,18,27,7,0.7074485049679642,11
3260,68,71,86,36,0.7070864651977483,35
3261,41,20,54,10,0.7052079558025968,10
3262,91,10,49,5,0.7029955830398265,5
3263,38,11,91,5,0.700382291127082,6
3264,87,65,11,30,0.6993966174530624,35
3265,61,11,39,6,0.6964131355147368,5
3266,90,15,74,6,0.6948431634826372,9
3267,7,90,65,47,0.6945220468207863,43
3268,50,29,9,14,0.6932669196756267,15
3269,100,19,85,9,0.692145009111035,10
3270,69,27,11,14,0.6919460086860773,13
3271,88,17,48,7,0.6890250559346728,10
3272,51,23,98,11,0.6875823408827684,12
3273,68,75,27,36,0.6873238062883651,39
3274,78,29,84,15,0.6870815538251351,14
3275,18,19,25,10,0.6816652439852796,9
3276,109,14,23,7,0.6795387556597839,7
3277,79,16,3,9,0.6788187325928862,7
3278,66,15,9,7,0.6778609704226946,8
3279,88,26,78,12,0.6778357578813761,14
3280,29,13,79,5,0.6757838864896741,8
3281,50,10,38,4,0.6752935140977933,6
3282,71,24,55,13,0.6670673084821276,11
3283,87,44,74,21,0.6669497609047663,23
3284,15,37,87,19,0.6658816285471504,18
3285,39,65,65,34,0.6541315550544965,31
3286,63,32,78,15,0.6511427448806575,17
3287,75,50,88,24,0.6490595256191717,26
3288,2,10,109,5,0.6444253237530845,5
3289,72,12,62,6,0.6413947117031077,6
3290,85,15,69,7,0.6408165415497196,8
3291,25,25,41,14,0.6394054706376694,11
3292,6,18,51,10,0.6381605805799537,8
3293,111,17,36,8,0.6365354853619519,9
3294,33,29,16,16,0.6325119131101442,13
3295,13,34,20,16,0.6324978295967632,18
3296,4,28,64,13,0.6316212138641669,15
3297,38,20,29,10,0.6286324723530292,10
3298,109,30,84,14,0.6283430275726476,16
3299,36,33,71,17,0.6241330409639588,16
3300,47,34,87,16,0.6236835390952602,18
3301,9,17,81,8,0.6212818094890723,9
3302,40,12,38,5,0.617907919478443,7
3303,31,22,58,11,0.616855370373501,11
3304,86,35,38,17,0.6102764909095695,18
3305,51,42,69,20,0.6101979768399988,22
3306,91,16,70,7,0.6063303701253766,9
3307,30,51,100,26,0.6041121088815675,25
3308,86,56,9,29,0.6017557404930524,27
3309,63,15,34,7,0.6010869874219991,8
3310,71,32,106,15,0.6009609652453838,17
3311,111,10,12,6,0.6003907747378712,4
3312,71,10,23,4,0.6000287508458293,6
3313,69,32,3,14,0.597861262529489,18
3314,79,22,8,10,0.596047638444006,12
3315,55,24,3,12,0.5910345457593124,12
3316,87,25,112,13,0.5908646302689579,12
3317,76,13,36,4,0.5885035889042637,9
3318,68,35,77,16,0.5847877126510238,19
3319,63,28,112,14,0.5834223269951258,14
3320,47,30,51,16,0.5820326521668331,14
3321,89,18,60,10,0.5806665921299642,8
3322,28,26,98,11,0.5775231479620817,15
3323,88,60,9,29,0.5756732724314684,31
3324,41,32,75,17,0.57538170131953,15
3325,114,40,7,19,0.5741553045041325,21
3326,69,15,71,8,0.5724150990318982,7
3327,71,13,78,6,0.56619632387446,7
3328,37,16,43,7,0.5623554718266413,9
3329,83,10,2,5,0.5594397265150789,5
3330,68,74,65,37,0.550600184176375,37
3331,92,17,7,7,0.5480230211986085,10
3332,23,32,51,16,0.547309759048545,16
3333,64,29,54,15,0.5456745481805175,14
3334,35,14,13,7,0.5410242166059803,7
3335,106,10,1,5,0.5396528610114324,5
3336,6,22,107,11,0.5355439544398269,11
3337,41,18,103,8,0.5269053363965305,10
3338,16,66,57,31,0.524945777726898,35
3339,4,24,77,12,0.5234491201479384,12
3340,74,14,27,8,0.5219215520059601,6
3341,60,18,83,9,0.5212906629660267,9
3342,30,22,106,11,0.5189588569615469,11
3343,112,10,66,4,0.5146742754382652,6
3344,112,20,51,10,0.5141422831615046,10
3345,4,18,9,9,0.5118055197130298,9
3346,54,41,7,20,0.5072416292031929,21
3347,111,51,68,26,0.5032623987049997,25
3348,90,13,91,6,0.5003235284827334,7
3349,88,35,31,18,0.4999807976090581,17
3350,74,22,18,12,0.4929022250899433,10
3351,39,46,47,22,0.492304337936158,24
3352,38,13,114,6,0.49067913419821746,7
3353,62,12,97,6,0.490051403125013,6
3354,19,16,58,8,0.4895753929310045,8
3355,84,80,107,39,0.48662393295564865,41
3356,88,40,20,21,0.4827222531499379,19
3357,109,46,13,22,0.482033722868293,24
3358,7,19,48,10,0.48075396413828586,9
3359,95,28,74,13,0.4784255086028103,15
3360,76,18,62,9,0.4784217833711707,9
3361,68,86,51,40,0.4769765034056838,46
3362,25,51,39,26,0.47594650511842773,25
3363,7,60,18,31,0.4748651156903118,29
3364,63,42,5,18,0.4718441296207792,24
3365,65,54,31,26,0.4691388746969232,28
3366,5,10,78,6,0.46671252280804226,4
3367,12,18,50,7,0.46586470667488683,11
3368,106,101,86,50,0.4658315283344795,51
3369,86,81,54,41,0.46582318117547167,40
3370,104,38,76,20,0.4636043507636282,18
3371,65,58,12,30,0.46281952828017164,28
3372,65,11,21,6,0.46273082007848293,5
3373,107,36,46,19,0.458246310756249,17
3374,106,45,50,21,0.450853387486715,24
3375,13,33,112,17,0.44654566712440297,16
3376,30,37,54,18,0.4460275388884087,19
3377,7,78,39,40,0.44566273518626937,38
3378,80,11,9,7,0.4439834453330443,4
3379,90,15,11,7,0.4409004522210786,8
3380,107,67,60,34,0.4399094716611669,33
3381,109,76,86,38,0.4382040730178596,38
3382,40,49,63,25,0.43519783962840436,24
3383,40,43,31,22,0.4296271974626762,21
3384,107,32,85,16,0.42684494255397554,16
3385,106,21,43,11,0.42530171348423335,10
3386,27,15,61,8,0.4250644477983035,7
3387,95,13,57,8,0.42117305158203777,5
3388,112,18,69,10,0.4198013383725023,8
3389,5,14,38,7,0.41683785462955975,7
3390,20,16,69,8,0.4110151707783516,8
3391,31,33,86,17,0.41076921803924654,16
3392,96,39,55,20,0.40999901205957556,19
3393,50,18,79,9,0.40910464935228613,9
3394,74,55,16,28,0.4074421879861471,27
3395,16,45,114,21,0.4068130302568868,24
3396,17,11,26,5,0.4065653808604262,6
3397,35,16,30,8,0.40164153194297303,8
3398,37,41,65,19,0.3990326963086119,22
3399,7,18,72,9,0.3988238585283883,9
3400,15,56,16,29,0.3986223889785882,27
3401,104,15,20,8,0.39743988488785525,7
3402,20,21,95,10,0.3956021347010563,11
3403,61,16,65,9,0.3950505274193439,7
3404,13,88,49,39,0.39370050097638604,49
3405,102,14,84,7,0.3912018744364834,7
3406,8,13,44,6,0.3904420875790021,7
3407,16,53,78,26,0.38978294593785207,27
3408,50,19,89,9,0.3889433495588358,10
3409,69,30,36,15,0.38598798110098687,15
3410,79,12,78,6,0.38583207842589995,6
3411,11,65,107,31,0.3805355395730365,34
3412,114,28,71,14,0.3795577437704564,14
3413,37,13,48,6,0.3793970201456422,7
3414,70,22,97,12,0.3783758219642569,10
3415,14,18,84,8,0.3778390349649412,10
3416,63,27,60,13,0.37326617266532824,14
3417,103,14,54,8,0.3711572343700788,6
3418,51,40,30,20,0.3690727556562843,20
3419,40,21,75,10,0.3686371386700514,11
3420,95,26,28,12,0.36814720179538235,14
3421,8,32,76,15,0.36631050299304696,17
3422,54,83,107,42,0.3655524627632432,41
3423,92,18,13,7,0.36521745881562023,11
3424,43,11,90,5,0.3643101985935386,6
3425,28,14,44,8,0.3571298728778931,6
3426,34,13,75,6,0.35287672494659683,7
3427,108,11,69,7,0.3504283321129652,4
3428,63,11,82,5,0.34593533956848593,6
3429,53,41,51,21,0.34398118429468505,20
3430,94,16,33,8,0.34380946136701285,8
3431,111,12,18,6,0.34349474631160665,6
3432,106,14,66,6,0.34287379392296863,8
3433,17,12,69,6,0.3399205773020941,6
3434,84,19,91,9,0.338597737579075,10
3435,109,13,4,6,0.33809070228925237,7
3436,5,61,87,30,0.3370261398348081,31
3437,39,40,50,20,0.3358837847035394,20
3438,55,65,51,32,0.3317862409811213,33
3439,83,20,106,11,0.3316445649094074,9
3440,8,57,70,28,0.32660941887077904,29
3441,87,26,2,13,0.32619162405938884,13
3442,80,17,71,9,0.3237123360021252,8
3443,18,46,28,22,0.32313224084926334,24
3444,83,25,28,14,0.31931308670237557,11
3445,50,46,13,23,0.3183740832997801,23
3446,114,22,69,10,0.3170624988990175,12
3447,15,52,39,24,0.3163780458315475,28
3448,107,39,90,20,0.3131139201836661,19
3449,16,41,40,20,0.3129456302783174,21
3450,60,48,53,25,0.3118269913878406,23
3451,96,51,87,26,0.31095451157976556,25
3452,64,12,28,6,0.3078927557568371,6
3453,23,19,111,11,0.30722018824926817,8
3454,51,17,38,8,0.30308488501942854,9
3455,85,34,86,16,0.30043079848706666,18
3456,57,18,60,9,0.29997989841242795,9
3457,88,16,85,8,0.29964355304249035,8
3458,87,45,104,24,0.2989430528005182,21
3459,46,28,76,14,0.2977453961949545,14
3460,95,54,86,25,0.2936051982256425,29
3461,98,16,19,7,0.29311592538168885,9
3462,27,17,25,9,0.2912949474117434,8
3463,87,18,33,9,0.28990718970381224,9
3464,68,63,60,33,0.2853879784305839,30
3465,90,10,98,5,0.2818861887378333,5
3466,67,12,25,6,0.2816428039469052,6
3467,96,12,67,7,0.2799650125910983,5
3468,7,20,70,8,0.27895885562123496,12
3469,94,24,29,12,0.2789341126845451,12
3470,53,18,5,8,0.2778213329671466,10
3471,97,14,49,8,0.276775832531503,6
3472,12,21,8,10,0.2751918616544977,11
3473,51,54,9,26,0.2700079238709996,28
3474,36,11,38,4,0.2667921507986764,7
3475,22,16,109,8,0.26617483465115477,8
3476,43,22,114,12,0.26405625020379975,10
3477,37,22,76,12,0.2606095394442805,10
3478,104,22,17,11,0.2597220823510658,11
3479,16,20,85,11,0.25737423659678205,9
3480,4,32,68,16,0.2573095525279982,16
3481,4,16,30,8,0.2549680926160687,8
3482,17,11,108,5,0.25064673927891207,6
3483,40,25,47,14,0.24655985846699083,11
3484,39,11,93,6,0.24650819188031292,5
3485,88,25,93,14,0.2346836303137904,11
3486,93,13,51,7,0.23291171077771639,6
3487,8,30,49,16,0.23097106110372773,14
3488,65,10,101,5,0.22906131925900258,5
3489,79,31,48,16,0.22311337916674606,15
3490,50,61,86,32,0.2216523965537408,29
3491,12,29,18,14,0.2214557983313134,15
3492,86,79,39,41,0.22073155107485032,38
3493,82,15,28,8,0.2205286984952181,7
3494,37,38,88,19,0.21837047991817124,19
3495,17,21,84,10,0.21599839278237065,11
3496,7,99,107,54,0.2137364856426741,45
3497,53,21,44,9,0.21221133134211373,12
3498,2,37,86,17,0.21062883056177345,20
3499,6,11,100,6,0.20965402679156367,5
3500,43,21,50,9,0.20889556585366265,12
3501,33,13,74,6,0.2046546758624042,7
3502,106,20,48,10,0.20449983406695527,10
3503,107,61,74,29,0.19420996588142067,32
3504,112,18,72,9,0.19365171750841212,9
3505,19,21,112,11,0.19051106403814208,10
3506,104,17,23,10,0.18692044107224143,7
3507,44,15,65,6,0.18351226600641293,9
3508,51,40,20,18,0.18130039081952756,22
3509,50,25,114,12,0.18060110833647136,13
3510,70,23,41,13,0.17939581625615586,10
3511,78,33,11,15,0.17686665327079393,18
3512,20,48,8,24,0.17245365752257427,24
3513,76,28,30,15,0.16826557910019804,13
3514,106,28,100,13,0.1677556244233467,15
3515,107,31,4,16,0.16653385204254045,15
3516,13,80,86,38,0.16497427756503827,42
3517,75,57,65,29,0.16394853878537058,28
3518,86,21,89,9,0.16236612933606814,12
3519,17,29,68,15,0.16206629975870687,14
3520,7,51,4,26,0.16136746029798288,25
3521,7,16,83,7,0.15765677447455673,9
3522,79,14,55,7,0.15414527044248416,7
3523,68,51,63,25,0.14938742389458298,26
3524,68,41,104,21,0.14920589858094652,20
3525,51,17,85,8,0.1485089203425515,9
3526,55,17,29,9,0.14628936106624899,8
3527,37,41,114,19,0.14487606275647452,22
3528,100,51,39,26,0.1436082500357994,25
3529,49,27,9,15,0.1403485015412945,12
3530,86,95,65,50,0.1328835867340733,45
3531,73,10,25,5,0.13287312364388484,5
3532,33,16,114,9,0.1306594611288726,7
3533,69,25,7,13,0.12779683769017072,12
3534,88,65,46,31,0.12160552196414671,34
3535,11,68,39,35,0.11779483587364575,33
3536,80,23,84,12,0.11286096846693006,11
3537,68,10,79,4,0.11002938828097016,6
3538,17,34,39,16,0.10903300833788604,18
3539,103,22,29,12,0.10854405086209162,10
3540,62,28,27,13,0.10851630079450583,15
3541,54,15,12,8,0.10677371542804602,7
3542,97,10,94,6,0.10576953599255426,4
3543,11,10,73,5,0.1054273387277771,5
3544,64,24,100,11,0.1053276394727547,13
3545,2,18,84,9,0.10504403066305122,9
3546,87,59,55,30,0.10393392000771386,29
3547,15,26,104,13,0.10344391765702249,13
3548,100,19,17,8,0.1033034771886362,11
3549,22,15,34,8,0.10029535793818667,7
3550,13,24,45,12,0.09910833731151314,12
3551,26,12,87,6,0.09714980507366633,6
3552,86,30,53,13,0.09593092236921533,17
3553,74,39,25,20,0.09563368284675952,19
3554,114,29,36,13,0.0921312858778607,16
3555,15,46,19,23,0.09190535153055165,23
3556,114,48,104,25,0.08363522002227851,23
3557,84,37,88,17,0.08333477514829642,20
3558,47,14,19,7,0.08237732780024944,7
3559,16,29,98,15,0.08177859450323165,14
3560,62,10,95,5,0.0814782186148065,5
3561,97,36,74,17,0.07931920932357457,19
3562,74,43,54,21,0.07806324953233126,22
3563,11,41,76,21,0.07237636421867902,20
3564,106,21,40,10,0.0680825308022658,11
3565,107,71,114,36,0.06336114924955752,35
3566,57,15,104,6,0.0631456146283403,9
3567,39,52,63,30,0.0630675230274347,22
3568,75,46,55,21,0.06023477871620806,25
3569,73,16,106,8,0.047003862193632395,8
3570,83,17,51,10,0.04607341431682118,7
3571,31,11,97,5,0.04256244744109594,6
3572,9,10,73,5,0.04170228259349536,5
3573,57,49,78,25,0.035769009908324774,24
3574,72,17,47,10,0.03554514182185788,7
3575,87,37,62,18,0.03446645815962748,19
3576,31,11,8,5,0.02937900525924807,6
3577,77,25,29,12,0.024466029711668325,13
3578,65,39,11,20,0.02225019372157458,19
3579,103,30,87,14,0.01909949332333311,16
3580,13,111,65,54,0.01458893693313318,57
3581,80,18,8,10,0.01264063172158774,8
3582,109,17,83,7,0.009729329647016893,10
3583,85,15,11,7,0.009683215318296827,8
3584,106,47,76,26,-0.009505075346388465,21
3585,11,15,85,8,-0.009683215318296353,7
3586,83,17,109,10,-0.009729329647015561,7
3587,8,18,80,8,-0.012640631721588136,10
3588,65,111,13,57,-0.014588936933132663,54
3589,87,30,103,16,-0.019099493323333643,14
3590,11,39,65,19,-0.022250193721574954,20
3591,29,25,77,13,-0.02446602971166854,12
3592,8,11,31,6,-0.02937900525924678,5
3593,62,37,87,19,-0.03446645815962768,18
3594,47,17,72,7,-0.035545141821858924,10
3595,78,49,57,24,-0.03576900990832448,25
3596,73,10,9,5,-0.04170228259349358,5
3597,97,11,31,6,-0.04256244744109594,5
3598,51,17,83,7,-0.04607341431682181,10
3599,106,16,73,8,-0.04700386219363217,8
3600,55,46,75,25,-0.060234778716207416,21
3601,63,52,39,22,-0.06306752302743374,30
3602,104,15,57,9,-0.06314561462833927,6
3603,114,71,107,35,-0.06336114924955756,36
3604,40,21,106,11,-0.06808253080226648,10
3605,54,43,74,22,-0.0780632495323316,21
3606,74,36,97,19,-0.07931920932357497,17
3607,95,10,62,5,-0.08147821861480545,5
3608,98,29,16,14,-0.08177859450323123,15
3609,19,14,47,7,-0.08237732780024842,7
3610,88,37,84,20,-0.08333477514829642,17
3611,104,48,114,23,-0.08363522002227874,25
3612,19,46,15,23,-0.09190535153055271,23
3613,36,29,114,16,-0.09213128587785951,13
3614,25,39,74,19,-0.09563368284675924,20
3615,53,30,86,17,-0.09593092236921522,13
3616,87,12,26,6,-0.09714980507366781,6
3617,45,24,13,12,-0.09910833731151285,12
3618,34,15,22,7,-0.10029535793818692,8
3619,17,19,100,11,-0.10330347718863582,8
3620,104,26,15,13,-0.1034439176570201,13
3621,55,59,87,29,-0.10393392000771247,30
3622,84,18,2,9,-0.10504403066305122,9
3623,100,24,64,13,-0.10532763947275307,11
3624,73,10,11,5,-0.10542733872777674,5
3625,94,10,97,4,-0.10576953599255319,6
3626,12,15,54,7,-0.10677371542804602,8
3627,27,28,62,15,-0.10851630079450558,13
3628,29,22,103,10,-0.10854405086209194,12
3629,39,34,17,18,-0.10903300833788687,16
3630,79,10,68,6,-0.11002938828097086,4
3631,84,23,80,11,-0.11286096846693021,12
3632,39,68,11,33,-0.11779483587364424,35
3633,46,65,88,34,-0.12160552196414537,31
3634,7,25,69,12,-0.12779683769017072,13
3635,114,16,33,7,-0.13065946112887206,9
3636,25,10,73,5,-0.13287312364388448,5
3637,65,95,86,45,-0.1328835867340757,50
3638,9,27,49,12,-0.1403485015412958,15
3639,39,51,100,25,-0.1436082500357988,26
3640,114,41,37,22,-0.14487606275647522,19
3641,29,17,55,8,-0.14628936106624899,9
3642,85,17,51,9,-0.14850892034255025,8
3643,104,41,68,20,-0.14920589858094577,21
3644,63,51,68,26,-0.14938742389458398,25
3645,55,14,79,7,-0.1541452704424852,7
3646,83,16,7,9,-0.15765677447455717,7
3647,4,51,7,25,-0.16136746029798252,26
3648,68,29,17,14,-0.16206629975870612,15
3649,89,21,86,12,-0.1623661293360683,9
3650,65,57,75,28,-0.16394853878537097,29
3651,86,80,13,42,-0.16497427756503852,38
3652,4,31,107,15,-0.1665338520425416,16
3653,100,28,106,15,-0.1677556244233485,13
3654,30,28,76,13,-0.16826557910019702,15
3655,8,48,20,24,-0.17245365752257383,24
3656,11,33,78,18,-0.17686665327079298,15
3657,41,23,70,10,-0.17939581625615697,13
3658,114,25,50,13,-0.18060110833647136,12
3659,20,40,51,22,-0.18130039081952506,18
3660,65,15,44,9,-0.18351226600641318,6
3661,23,17,104,7,-0.186920441072241,10
3662,112,21,19,10,-0.19051106403814258,11
3663,72,18,112,9,-0.1936517175084127,9
3664,74,13,33,7,-0.2046546758624053,6
3665,50,21,43,12,-0.20889556585365976,9
3666,100,11,6,5,-0.20965402679156336,6
3667,86,37,2,20,-0.21062883056177364,17
3668,44,21,53,12,-0.2122113313421144,9
3669,107,99,7,45,-0.21373648564267406,54
3670,84,21,17,11,-0.21599839278237148,10
3671,88,38,37,19,-0.21837047991817116,19
3672,28,15,82,7,-0.2205286984952181,8
3673,39,79,86,38,-0.22073155107485068,41
3674,18,29,12,15,-0.22145579833131304,14
3675,86,61,50,29,-0.22165239655374097,32
3676,48,31,79,15,-0.22311337916674676,16
3677,101,10,65,5,-0.22906131925900355,5
3678,49,30,8,14,-0.23097106110372798,16
3679,51,13,93,6,-0.2329117107777153,7
3680,93,25,88,11,-0.23468363031378975,14
3681,93,11,39,5,-0.24650819188031328,6
3682,47,25,40,11,-0.2465598584669911,14
3683,108,11,17,6,-0.2506467392789125,5
3684,30,16,4,8,-0.25496809261606845,8
3685,68,32,4,16,-0.25730955252800053,16
3686,85,20,16,9,-0.25737423659678205,11
3687,17,22,104,11,-0.2597220823510663,11
3688,76,22,37,10,-0.2606095394442805,12
3689,114,22,43,10,-0.2640562502037996,12
3690,109,16,22,8,-0.2661748346511539,8
3691,38,11,36,7,-0.26679215079867674,4
3692,9,54,51,28,-0.2700079238710004,26
3693,8,21,12,11,-0.27519186165449905,10
3694,49,14,97,6,-0.27677583253150245,8
3695,5,18,53,10,-0.27782133296714684,8
3696,29,24,94,12,-0.2789341126845448,12
3697,70,20,7,12,-0.2789588556212364,8
3698,67,12,96,5,-0.2799650125910977,7
3699,25,12,67,6,-0.2816428039469052,6
3700,98,10,90,5,-0.2818861887378329,5
3701,60,63,68,30,-0.2853879784305837,33
3702,33,18,87,9,-0.28990718970381263,9
3703,25,17,27,8,-0.29129494741174317,9
3704,19,16,98,9,-0.29311592538168973,7
3705,86,54,95,29,-0.2936051982256425,25
3706,76,28,46,14,-0.297745396194955,14
3707,104,45,87,21,-0.2989430528005174,24
3708,85,16,88,8,-0.2996435530424907,8
3709,60,18,57,9,-0.29997989841242956,9
3710,86,34,85,18,-0.30043079848706633,16
3711,38,17,51,9,-0.303084885019429,8
3712,111,19,23,8,-0.3072201882492683,11
3713,28,12,64,6,-0.3078927557568362,6
3714,87,51,96,25,-0.3109545115797648,26
3715,53,48,60,23,-0.3118269913878415,25
3716,40,41,16,21,-0.3129456302783173,20
3717,39,52,15,28,-0.3163780458315467,24
3718,69,22,114,12,-0.3170624988990179,10
3719,13,46,50,23,-0.31837408329978034,23
3720,28,25,83,11,-0.31931308670237585,14
3721,28,46,18,24,-0.3231322408492643,22
3722,71,17,80,8,-0.32371233600212634,9
3723,2,26,87,13,-0.326191624059389,13
3724,70,57,8,29,-0.32660941887077916,28
3725,106,20,83,9,-0.33164456490940797,11
3726,51,65,55,33,-0.3317862409811193,32
3727,50,40,39,20,-0.3358837847035414,20
3728,87,61,5,31,-0.3370261398348085,30
3729,4,13,109,7,-0.33809070228925137,6
3730,91,19,84,10,-0.33859773757907446,9
3731,69,12,17,6,-0.3399205773020955,6
3732,66,14,106,8,-0.34287379392296813,6
3733,18,12,111,6,-0.3434947463116063,6
3734,33,16,94,8,-0.3438094613670113,8
3735,51,41,53,20,-0.34398118429468527,21
3736,82,11,63,6,-0.3459353395684866,5
3737,69,11,108,4,-0.3504283321129657,7
3738,75,13,34,7,-0.35287672494659683,6
3739,44,14,28,6,-0.35712987287789527,8
3740,90,11,43,6,-0.3643101985935379,5
3741,13,18,92,11,-0.3652174588156216,7
3742,107,83,54,41,-0.36555246276324344,42
3743,76,32,8,17,-0.3663105029930477,15
3744,28,26,95,14,-0.3681472017953835,12
3745,75,21,40,11,-0.36863713867005155,10
3746,30,40,51,20,-0.369072755656284,20
3747,54,14,103,6,-0.37115723437007936,8
3748,60,27,63,14,-0.3732661726653274,13
3749,84,18,14,10,-0.37783903496494214,8
3750,16,29,102,15,-0.37795834144692964,14
3751,97,22,70,10,-0.37837582196425723,12
3752,48,13,37,7,-0.3793970201456411,6
3753,71,28,114,14,-0.3795577437704577,14
3754,78,12,79,6,-0.3858320784259002,6
3755,36,30,69,15,-0.38598798110098714,15
3756,89,19,50,10,-0.3889433495588358,9
3757,78,53,16,27,-0.3897829459378538,26
3758,44,13,8,7,-0.39044208757900134,6
3759,84,14,102,7,-0.39120187443648163,7
3760,49,88,13,49,-0.3937005009763855,39
3761,65,16,61,7,-0.3950505274193441,9
3762,95,21,20,11,-0.39560213470105715,10
3763,20,15,104,7,-0.3974398848878548,8
3764,16,56,15,27,-0.3986223889785874,29
3765,72,18,7,9,-0.39882385852838764,9
3766,65,41,37,22,-0.3990326963086111,19
3767,30,16,35,8,-0.401641531942974,8
3768,26,11,17,6,-0.4065653808604267,5
3769,114,45,16,24,-0.4068130302568868,21
3770,16,55,74,27,-0.40744218798614557,28
3771,79,18,50,9,-0.40910464935228674,9
3772,55,39,96,19,-0.4099990120595754,20
3773,86,33,31,16,-0.4107692180392456,17
3774,69,16,20,8,-0.4110151707783507,8
3775,38,14,5,7,-0.41683785462955825,7
3776,69,18,112,8,-0.4198013383725037,10
3777,57,13,95,5,-0.4211730515820383,8
3778,61,15,27,7,-0.42506444779830493,8
3779,43,21,106,10,-0.4253017134842326,11
3780,85,32,107,16,-0.4268449425539753,16
3781,31,43,40,21,-0.4296271974626759,22
3782,63,49,40,24,-0.4351978396284048,25
3783,86,76,109,38,-0.4382040730178593,38
3784,60,67,107,33,-0.4399094716611665,34
3785,11,15,90,8,-0.4409004522210788,7
3786,9,11,80,4,-0.4439834453330441,7
3787,39,78,7,38,-0.44566273518626787,40
3788,54,37,30,19,-0.44602753888841007,18
3789,112,33,13,16,-0.44654566712440186,17
3790,50,45,106,24,-0.45085338748671533,21
3791,46,36,107,17,-0.4582463107562494,19
3792,21,11,65,5,-0.4627308200784832,6
3793,12,58,65,28,-0.46281952828017253,30
3794,76,38,104,18,-0.46360435076362777,20
3795,54,81,86,40,-0.46582318117547183,41
3796,50,18,12,11,-0.46586470667488794,7
3797,78,10,5,4,-0.466712522808043,6
3798,31,54,65,28,-0.46913887469692556,26
3799,5,42,63,24,-0.4718441296207794,18
3800,18,60,7,29,-0.47486511569031375,31
3801,39,51,25,25,-0.47594650511842646,26
3802,20,23,30,12,-0.47661390204255377,11
3803,51,86,68,46,-0.4769765034056835,40
3804,62,18,76,9,-0.47842178337117147,9
3805,74,28,95,15,-0.47842550860281247,13
3806,48,19,7,9,-0.48075396413828564,10
3807,13,46,109,24,-0.48203372286829366,22
3808,107,80,84,41,-0.4866239329556469,39
3809,58,16,19,8,-0.4895753929310065,8
3810,97,12,62,6,-0.490051403125013,6
3811,114,13,38,7,-0.4906791341982179,6
3812,47,46,39,24,-0.49230433793615863,22
3813,18,22,74,10,-0.4929022250899433,12
3814,31,35,88,17,-0.49998079760905945,18
3815,91,13,90,7,-0.500323528482734,6
3816,68,51,111,25,-0.5032623987049999,26
3817,7,41,54,21,-0.507241629203192,20
3818,9,18,4,9,-0.5118055197130301,9
3819,51,20,112,10,-0.5141422831615037,10
3820,66,10,112,6,-0.514674275438265,4
3821,106,22,30,11,-0.5189588569615463,11
3822,83,18,60,9,-0.521290662966027,9
3823,27,14,74,6,-0.5219215520059618,8
3824,77,24,4,12,-0.5234491201479363,12
3825,57,66,16,35,-0.5249457777268965,31
3826,103,18,41,10,-0.5269053363965305,8
3827,107,22,6,11,-0.5355439544398289,11
3828,1,10,106,5,-0.5396528610114331,5
3829,13,14,35,7,-0.5410242166059793,7
3830,54,29,64,14,-0.545674548180516,15
3831,51,32,23,16,-0.5473097590485455,16
3832,7,17,92,10,-0.5480230211986078,7
3833,65,74,68,37,-0.5506001841763752,37
3834,2,10,83,5,-0.5594397265150782,5
3835,43,16,37,9,-0.562355471826641,7
3836,78,13,71,7,-0.5661963238744604,6
3837,71,15,69,7,-0.5724150990318982,8
3838,7,40,114,21,-0.5741553045041332,19
3839,75,32,41,15,-0.57538170131953,17
3840,9,60,88,31,-0.575673272431468,29
3841,98,26,28,15,-0.5775231479620817,11
3842,60,18,89,8,-0.5806665921299639,10
3843,51,30,47,14,-0.5820326521668323,16
3844,112,28,63,14,-0.5834223269951251,14
3845,77,35,68,19,-0.5847877126510233,16
3846,20,29,74,14,-0.5870486229107592,15
3847,36,13,76,9,-0.5885035889042627,4
3848,112,25,87,12,-0.5908646302689567,13
3849,3,24,55,12,-0.5910345457593116,12
3850,8,22,79,12,-0.5960476384440053,10
3851,3,32,69,18,-0.5978612625294901,14
3852,23,10,71,6,-0.6000287508458285,4
3853,12,10,111,4,-0.6003907747378694,6
3854,106,32,71,17,-0.6009609652453864,15
3855,34,15,63,8,-0.6010869874220004,7
3856,9,56,86,27,-0.6017557404930514,29
3857,100,51,30,25,-0.604112108881567,26
3858,70,16,91,9,-0.6063303701253768,7
3859,69,42,51,22,-0.6101979768399989,20
3860,38,35,86,18,-0.6102764909095699,17
3861,58,22,31,11,-0.6168553703734997,11
3862,38,12,40,7,-0.6179079194784425,5
3863,81,17,9,9,-0.6212818094890713,8
3864,87,34,47,18,-0.6236835390952605,16
3865,71,33,36,16,-0.6241330409639583,17
3866,84,30,109,16,-0.6283430275726473,14
3867,29,20,38,10,-0.6286324723530287,10
3868,64,28,4,15,-0.6316212138641667,13
3869,20,34,13,18,-0.6324978295967627,16
3870,16,29,33,13,-0.6325119131101443,16
3871,20,16,93,9,-0.6327174645108355,7
3872,36,17,111,9,-0.6365354853619519,8
3873,51,18,6,8,-0.6381605805799541,10
3874,41,25,25,11,-0.6394054706376703,14
3875,69,15,85,8,-0.6408165415497192,7
3876,62,12,72,6,-0.6413947117031077,6
3877,109,10,2,5,-0.6444253237530845,5
3878,88,50,75,26,-0.6490595256191716,24
3879,78,32,63,17,-0.6511427448806584,15
3880,65,65,39,31,-0.654131555054497,34
3881,87,37,15,18,-0.6658816285471504,19
3882,74,44,87,23,-0.6669497609047667,21
3883,55,24,71,11,-0.6670673084821287,13
3884,38,10,50,6,-0.6752935140977925,4
3885,79,13,29,8,-0.6757838864896738,5
3886,78,26,88,14,-0.677835757881376,12
3887,9,15,66,8,-0.6778609704226952,7
3888,3,16,79,7,-0.6788187325928865,9
3889,23,14,109,7,-0.6795387556597839,7
3890,25,19,18,9,-0.6816652439852798,10
3891,84,29,78,14,-0.6870815538251354,15
3892,27,75,68,39,-0.6873238062883658,36
3893,98,23,51,12,-0.6875823408827685,11
3894,48,17,88,10,-0.6890250559346737,7
3895,11,27,69,13,-0.6919460086860769,14
3896,85,19,100,10,-0.6921450091110348,9
3897,9,29,50,15,-0.6932669196756251,14
3898,65,90,7,43,-0.6945220468207879,47
3899,74,15,90,9,-0.6948431634826367,6
3900,39,11,61,5,-0.6964131355147355,6
3901,11,65,87,35,-0.6993966174530637,30
3902,91,11,38,6,-0.7003822911270813,5
3903,49,10,91,5,-0.7029955830398261,5
3904,54,20,41,10,-0.7052079558025973,10
3905,86,71,68,35,-0.7070864651977475,36
3906,27,18,106,11,-0.7074485049679631,7
3907,12,37,51,19,-0.7101916786560047,18
3908,71,18,43,8,-0.7122285277146747,10
3909,106,72,8,35,-0.7133251026811389,37
3910,48,19,51,11,-0.7142524379704612,8
3911,40,18,61,9,-0.7154895706830842,9
3912,28,51,37,27,-0.7168710662114356,24
3913,43,38,51,18,-0.7192859319153498,20
3914,64,21,15,12,-0.7194942356138038,9
3915,27,19,81,10,-0.724889006197101,9
3916,109,20,49,10,-0.7270267076148553,10
3917,4,10,57,6,-0.7276499847388429,4
3918,96,10,71,5,-0.7278695572627853,5
3919,99,13,27,6,-0.7284055341482,7
3920,27,13,33,7,-0.7289108112107292,6
3921,5,41,95,20,-0.7316066534315485,21
3922,11,57,28,30,-0.7338631283307411,27
3923,86,77,40,41,-0.7352757671814358,36
3924,77,24,88,13,-0.7378048830896929,11
3925,15,24,25,11,-0.7394428200536325,13
3926,108,12,7,7,-0.7404080910313966,5
3927,86,24,94,12,-0.7404864736135073,12
3928,64,22,38,11,-0.7416758999099166,11
3929,106,27,109,13,-0.7430675694349284,14
3930,74,13,36,8,-0.743717573303843,5
3931,84,24,46,13,-0.7446057703540044,11
3932,100,22,98,12,-0.7471432837189799,10
3933,13,15,14,9,-0.7511854242648529,6
3934,37,68,8,34,-0.7513899671656677,34
3935,91,14,57,8,-0.7523919124216641,6
3936,72,20,107,10,-0.7554109299536205,10
3937,65,27,47,14,-0.7649117411143566,13
3938,50,15,58,7,-0.7660630045931237,8
3939,69,32,88,17,-0.7753807063240763,15
3940,99,22,87,12,-0.7762165713325068,10
3941,39,73,87,38,-0.7800522349075261,35
3942,68,20,43,11,-0.7807661871695073,9
3943,109,20,48,11,-0.7860713609857849,9
3944,104,18,4,8,-0.7872554057904768,10
3945,46,21,41,10,-0.7882087764921283,11
3946,33,14,75,8,-0.7900898585820583,6
3947,89,16,28,9,-0.790198641351668,7
3948,107,36,1,18,-0.7927414185552435,18
3949,88,22,2,11,-0.7956469041111253,11
3950,62,11,98,6,-0.7995773049352699,5
3951,78,26,43,13,-0.8005863278065605,13
3952,20,85,86,44,-0.801688488938734,41
3953,40,26,30,13,-0.804558087178627,13
3954,40,14,56,7,-0.8062835825274137,7
3955,69,38,87,21,-0.8127923322049341,17
3956,12,38,86,20,-0.8156441062566451,18
3957,20,18,57,9,-0.8178941572060072,9
3958,45,19,114,10,-0.8205689132017555,9
3959,95,15,84,8,-0.8218033746912397,7
3960,106,12,29,6,-0.8264692442725412,6
3961,46,16,2,8,-0.8285194662826783,8
3962,77,24,19,12,-0.837985113454208,12
3963,84,23,79,12,-0.8428978656974985,11
3964,48,31,8,16,-0.8434410970737373,15
3965,95,15,33,8,-0.8491128905949085,7
3966,38,12,41,7,-0.851438988412215,5
3967,64,14,77,6,-0.855042195937583,8
3968,114,10,10,6,-0.8617397018011352,4
3969,43,25,41,13,-0.8640274273037558,12
3970,3,19,58,11,-0.8650796855609917,8
3971,65,111,54,57,-0.8660420311677455,54
3972,87,34,46,19,-0.8711353256142382,15
3973,84,17,60,7,-0.8716143564890748,10
3974,68,22,57,12,-0.8716742407341933,10
3975,1,15,27,9,-0.87213831994522,6
3976,48,15,41,8,-0.8735829617761531,7
3977,15,47,13,23,-0.8757286594591266,24
3978,88,21,83,10,-0.8798897555023121,11
3979,3,13,93,8,-0.8808947328421445,5
3980,11,48,27,25,-0.8856386812161113,23
3981,69,19,9,10,-0.887921017203931,9
3982,51,63,27,33,-0.8881383616064742,30
3983,55,54,39,29,-0.89153126518756,25
3984,28,71,106,37,-0.8945808420172991,34
3985,70,24,39,13,-0.8958543413772138,11
3986,28,91,107,48,-0.897076479568304,43
3987,27,52,30,26,-0.8997232050548477,26
3988,55,17,78,8,-0.9002458878614126,9
3989,50,14,62,8,-0.9017457082495483,6
3990,111,12,60,5,-0.9019980300500823,7
3991,50,14,6,7,-0.9048960894988056,7
3992,12,12,29,6,-0.9066091071417803,6
3993,75,35,36,16,-0.9076169876586808,19
3994,3,20,34,11,-0.9113037225897213,9
3995,46,17,64,9,-0.9119833053856672,8
3996,1,14,39,9,-0.9120351629887133,5
3997,114,27,75,14,-0.9181862737012525,13
3998,43,16,29,8,-0.9196986818795114,8
3999,9,17,29,8,-0.9197776508076894,9
4000,7,32,95,17,-0.9236786450564201,15
4001,4,24,55,12,-0.9256101911535772,12
4002,9,30,3,15,-0.9265694640511721,15
4003,72,40,16,20,-0.9283059904790143,20
4004,60,34,18,17,-0.934407483335539,17
4005,53,23,63,12,-0.9461903574639031,11
4006,103,11,106,5,-0.9583580547252478,6
4007,94,10,47,5,-0.959639077311073,5
4008,106,38,104,19,-0.960476027397927,19
4009,8,34,71,17,-0.9628252268322751,17
4010,94,21,41,12,-0.9669375303013764,9
4011,57,15,64,8,-0.96861087557479,7
4012,87,52,63,28,-0.9694664805604988,24
4013,9,12,78,6,-0.9745877106891233,6
4014,62,10,70,5,-0.9747108971050835,5
4015,5,65,107,33,-0.9748363761521173,32
4016,88,76,87,37,-0.9771805164055255,39
4017,102,15,68,8,-0.9774478191416431,7
4018,84,19,93,11,-0.9776365381665065,8
4019,41,81,7,41,-0.9794700083084553,40
4020,13,125,16,67,-0.9826353825245314,58
4021,112,19,54,10,-0.9843355592348288,9
4022,107,32,69,17,-0.9867318989974727,15
4023,27,13,20,7,-0.9871413726704095,6
4024,60,42,3,22,-0.9913631554114459,20
4025,88,33,43,18,-0.9947945347929819,15
4026,38,29,68,16,-0.9956485324900239,13
4027,41,34,57,17,-1.00006887405222,17
4028,93,11,114,5,-1.0049906589581687,6
4029,88,12,45,7,-1.0058195203591593,5
4030,18,20,91,11,-1.0069076377111847,9
4031,85,17,20,9,-1.0120202947249695,8
4032,87,69,51,36,-1.0120244136494765,33
4033,23,24,12,12,-1.0126038475678387,12
4034,3,72,86,37,-1.0184654674384122,35
4035,9,13,79,6,-1.0203716742776934,7
4036,90,12,64,6,-1.0226762518657317,6
4037,44,20,63,11,-1.023318477102645,9
4038,107,45,78,24,-1.029976454080651,21
4039,109,44,87,24,-1.0302241666569762,20
4040,74,38,104,21,-1.0321539192468763,17
4041,3,14,45,7,-1.0349134798027042,7
4042,33,16,104,9,-1.0375486456158098,7
4043,63,73,107,34,-1.0499479505653528,39
4044,45,18,71,8,-1.050024616634447,10
4045,89,16,13,9,-1.05819990470755,7
4046,44,14,100,7,-1.0590413147864146,7
4047,3,32,88,17,-1.062179712827227,15
4048,92,14,104,6,-1.0650896272942478,8
4049,71,14,58,7,-1.0679524363994422,7
4050,37,20,67,11,-1.0707700527635227,9
4051,97,16,9,7,-1.0715415510849884,9
4052,109,61,28,33,-1.0738097371372815,28
4053,97,19,64,10,-1.0748997556853979,9
4054,74,27,75,15,-1.0761366724331527,12
4055,57,30,19,15,-1.0764867469339023,15
4056,81,31,60,16,-1.0765050885349574,15
4057,17,15,15,7,-1.085580069098038,8
4058,75,35,87,18,-1.0859483979409976,17
4059,19,41,54,23,-1.095193790798622,18
4060,41,35,18,17,-1.0983841672845305,18
4061,106,39,70,19,-1.1024614638047314,20
4062,2,18,96,9,-1.1039761816908868,9
4063,45,19,40,10,-1.1043531225931211,9
4064,47,12,91,6,-1.1047106963660316,6
4065,55,13,73,7,-1.1082443575059626,6
4066,86,101,106,52,-1.11125626745342,49
4067,109,16,40,9,-1.1126467638961661,7
4068,61,14,100,7,-1.113823985180499,7
4069,7,19,29,12,-1.1170674633929336,7
4070,54,69,50,35,-1.117676052966614,34
4071,57,25,28,13,-1.1208866402447324,12
4072,19,28,69,15,-1.1227446471060296,13
4073,88,17,79,9,-1.1249704502892561,8
4074,109,14,47,7,-1.1252595991707166,7
4075,31,26,3,12,-1.130409883055891,14
4076,106,26,36,13,-1.1307287364062797,13
4077,18,43,107,20,-1.13716112679252,23
4078,53,57,13,31,-1.1379753759861668,26
4079,56,14,8,7,-1.138262181129433,7
4080,45,20,64,11,-1.143150033869317,9
4081,86,48,23,25,-1.143202343224395,23
4082,33,10,17,5,-1.1464162819529,5
4083,97,42,107,22,-1.1486858251368084,20
4084,7,17,79,9,-1.1501166003666843,8
4085,16,32,111,16,-1.1556733242940573,16
4086,18,30,77,17,-1.157226861340676,13
4087,18,36,86,20,-1.1625560532444394,16
4088,108,33,16,18,-1.163747925816395,15
4089,41,56,16,30,-1.164409244395375,26
4090,74,19,108,11,-1.1664859423669791,8
4091,75,13,44,6,-1.169380882277211,7
4092,11,51,63,29,-1.1727104947557743,22
4093,77,12,33,6,-1.1756675735500741,6
4094,104,16,89,8,-1.1768798083300274,8
4095,8,21,29,12,-1.1835149699783738,9
4096,96,31,76,17,-1.185303928819388,14
4097,110,16,87,9,-1.1878037867151126,7
4098,60,15,98,8,-1.1885772534855719,7
4099,65,52,60,24,-1.1889334512333447,28
4100,74,18,68,11,-1.1930607364890227,7
4101,16,67,25,35,-1.1932865297100739,32
4102,76,20,20,9,-1.195513412586338,11
4103,5,65,28,33,-1.204023419699817,32
4104,46,15,3,7,-1.2064770707138572,8
4105,76,12,47,4,-1.209164557999826,8
4106,97,33,25,17,-1.2112097532933537,16
4107,63,16,58,7,-1.2116740819179412,9
4108,34,35,17,17,-1.2128362267835149,18
4109,18,25,54,13,-1.2139969956731949,12
4110,88,37,71,21,-1.2185084211552721,16
4111,41,17,55,9,-1.2209745250839978,8
4112,108,18,64,9,-1.2316301294972696,9
4113,107,88,51,50,-1.2335246266798214,38
4114,25,39,28,22,-1.2338977751460154,17
4115,93,21,107,10,-1.2375139728583175,11
4116,31,25,71,13,-1.2380158081615487,12
4117,51,32,70,16,-1.2403340780472845,16
4118,37,20,91,10,-1.2413018923540673,10
4119,55,16,108,9,-1.242512686909538,7
4120,29,38,16,19,-1.2448349982001063,19
4121,9,61,13,33,-1.2504419702657081,28
4122,13,74,41,38,-1.251763682954914,36
4123,13,42,17,21,-1.2570532505054302,21
4124,63,37,9,19,-1.258902370787797,18
4125,112,39,86,21,-1.2594712193458395,18
4126,79,10,93,5,-1.2606355667564606,5
4127,18,20,81,10,-1.2612198373935393,10
4128,55,24,57,11,-1.2620925157379828,13
4129,14,15,107,7,-1.2621804963006722,8
4130,107,12,92,7,-1.2625916923530782,5
4131,65,15,52,7,-1.2628262153703227,8
4132,47,11,62,6,-1.2655269981298467,5
4133,28,29,60,13,-1.2721110011472117,16
4134,1,11,71,5,-1.2732152302328026,6
4135,91,10,34,5,-1.2767116469837234,5
4136,54,57,46,29,-1.2778066019254957,28
4137,107,59,96,32,-1.2779661064945875,27
4138,88,17,89,8,-1.2888997749635214,9
4139,99,19,51,9,-1.289208240710447,10
4140,78,19,41,11,-1.2892335099283336,8
4141,4,39,88,20,-1.2949212207610556,19
4142,8,22,7,12,-1.2952715014492375,10
4143,109,16,78,8,-1.301574274680268,8
4144,13,44,5,23,-1.3023509853743045,21
4145,17,16,38,8,-1.3036206431746913,8
4146,7,79,60,41,-1.3042648438735662,38
4147,114,28,41,14,-1.3073381080435666,14
4148,51,14,32,7,-1.3093866254236384,7
4149,107,20,89,11,-1.3096086727301648,9
4150,58,28,9,15,-1.3102681358218982,13
4151,9,52,68,27,-1.3104638696206719,25
4152,65,32,112,16,-1.312297716343949,16
4153,40,11,94,6,-1.3131730085845275,5
4154,23,21,54,11,-1.3133138976413512,10
4155,88,57,55,32,-1.3163784693707288,25
4156,63,111,65,58,-1.3193232513653719,53
4157,80,18,74,9,-1.3199661328668553,9
4158,54,36,84,19,-1.3202943615638323,17
4159,48,21,30,12,-1.323995388604317,9
4160,86,83,30,45,-1.3293231443644218,38
4161,98,20,50,11,-1.3352874305531426,9
4162,94,12,77,7,-1.3353290162205556,5
4163,23,10,6,5,-1.3385415186806273,5
4164,104,44,8,23,-1.3410693202324977,21
4165,87,19,52,11,-1.3439420173712868,8
4166,40,17,108,8,-1.3479697301696891,9
4167,88,37,97,19,-1.3490743629309023,18
4168,81,14,30,7,-1.3508923221630396,7
4169,64,40,87,20,-1.3537393986822601,20
4170,107,40,29,24,-1.3557283794699353,16
4171,70,33,104,17,-1.3582302540990816,16
4172,40,35,41,17,-1.3586266453597045,18
4173,30,26,25,12,-1.3633847180345748,14
4174,76,47,106,22,-1.3637390504385927,25
4175,19,64,16,36,-1.3677297158037247,28
4176,41,52,39,25,-1.3725005678823738,27
4177,41,30,106,15,-1.3806292559177735,15
4178,3,18,102,10,-1.3811952404449805,8
4179,29,11,36,5,-1.3837445576600507,6
4180,16,25,89,13,-1.386591903321143,12
4181,64,13,12,7,-1.3883647817413072,6
4182,8,87,86,42,-1.3887471294184068,45
4183,80,12,95,6,-1.3888115326852122,6
4184,107,65,11,35,-1.389011694446381,30
4185,41,44,63,23,-1.393059609593735,21
4186,98,12,74,6,-1.3941368131260956,6
4187,95,17,70,8,-1.4011695857654893,9
4188,9,25,46,12,-1.4052752923291463,13
4189,71,20,12,10,-1.4059148964814134,10
4190,62,29,100,14,-1.409595492278533,15
4191,65,41,15,22,-1.4119875326523994,19
4192,86,36,80,19,-1.4162310289001792,17
4193,53,11,1,6,-1.4196819324858234,5
4194,45,35,36,16,-1.423273124508117,19
4195,39,21,34,11,-1.4278801146393896,10
4196,25,28,50,14,-1.4391705454909005,14
4197,97,21,20,10,-1.439527960881876,11
4198,69,33,65,17,-1.4425642416495132,16
4199,39,44,75,21,-1.4473715172929773,23
4200,63,55,106,28,-1.448556681809941,27
4201,65,28,62,14,-1.4496341901836953,14
4202,107,37,108,19,-1.4524982900970547,18
4203,83,23,25,13,-1.459720188055503,10
4204,47,21,31,11,-1.460613098071267,10
4205,51,64,40,33,-1.462465890119408,31
4206,3,24,71,13,-1.466820978005952,11
4207,69,13,6,6,-1.467256279566122,7
4208,7,24,35,12,-1.4676220715119488,12
4209,11,50,106,29,-1.475178627799442,21
4210,79,17,103,9,-1.476299618195366,8
4211,69,20,109,10,-1.4769023355605444,10
4212,84,10,68,6,-1.4788993773509216,4
4213,17,38,37,22,-1.4799245104721017,16
4214,71,74,60,39,-1.4843115108657063,35
4215,7,33,49,18,-1.490785536092999,15
4216,74,23,2,13,-1.4920197761473217,10
4217,11,16,112,8,-1.4950492246382474,8
4218,25,47,107,24,-1.4967278623744342,23
4219,5,52,46,28,-1.4974094901037531,24
4220,102,15,19,9,-1.4975662366291813,6
4221,15,22,63,12,-1.4989595234613105,10
4222,3,64,87,34,-1.5024262132812498,30
4223,89,10,54,6,-1.5037658090302162,4
4224,50,25,27,15,-1.504088460568275,10
4225,76,24,41,11,-1.505921396755194,13
4226,27,29,64,15,-1.506656484827703,14
4227,55,12,46,7,-1.5148590180899666,5
4228,86,124,107,65,-1.5170757261632712,59
4229,61,22,3,14,-1.5200379980927687,8
4230,37,14,35,7,-1.5231317423105963,7
4231,27,66,13,34,-1.5277775268373563,32
4232,84,20,114,11,-1.5282826629009745,9
4233,81,15,64,8,-1.5315551836921608,7
4234,53,13,29,8,-1.5317670028644699,5
4235,79,13,98,7,-1.5335435073226167,6
4236,11,21,94,10,-1.5369194320927215,11
4237,86,10,22,5,-1.5381482899799122,5
4238,9,32,60,18,-1.5417639078296765,14
4239,74,61,107,33,-1.5445233108407403,28
4240,27,30,63,17,-1.548293986984764,13
4241,102,25,57,13,-1.5483760769806825,12
4242,11,20,80,10,-1.5532652275466878,10
4243,19,45,43,24,-1.559381904043509,21
4244,13,61,4,33,-1.5687606312733104,28
4245,78,27,30,14,-1.56960745856174,13
4246,88,34,96,17,-1.5755489762598094,17
4247,90,22,55,10,-1.5786569524988743,12
4248,97,34,2,18,-1.581483466739766,16
4249,100,12,58,6,-1.581900885565509,6
4250,61,20,88,12,-1.5819478875432638,8
4251,25,15,2,7,-1.5845186001024003,8
4252,39,38,57,19,-1.5884848488756724,19
4253,16,43,34,24,-1.5938069518093543,19
4254,75,11,14,6,-1.594721022285634,5
4255,57,11,12,6,-1.5971901748702373,5
4256,18,17,76,9,-1.6011095201796195,8
4257,69,29,30,15,-1.6139022710932387,14
4258,13,32,38,15,-1.6143148990855287,17
4259,15,23,23,12,-1.6229585941030173,11
4260,87,17,44,9,-1.623927941164795,8
4261,88,46,106,26,-1.6248459493396543,20
4262,84,12,64,5,-1.627208224984681,7
4263,51,37,18,18,-1.6280086279913606,19
4264,86,28,35,16,-1.6302927109086052,12
4265,68,18,6,8,-1.6346986227731621,10
4266,18,26,104,15,-1.6361581237581888,11
4267,49,10,102,6,-1.6394569107680652,4
4268,88,60,41,33,-1.6397874376242183,27
4269,68,41,30,21,-1.6397998764136303,20
4270,76,41,11,21,-1.6465830449965855,20
4271,68,23,36,12,-1.6511686348202723,11
4272,1,30,41,17,-1.6558361653082898,13
4273,47,24,63,14,-1.6623324282821748,10
4274,74,47,37,24,-1.6628163329711194,23
4275,107,95,8,47,-1.6636951263902342,48
4276,43,51,16,28,-1.6637284501840417,23
4277,33,19,54,11,-1.6683853925492602,8
4278,11,27,34,15,-1.668774173629234,12
4279,112,17,17,9,-1.6709980493790215,8
4280,31,28,45,15,-1.671087040669103,13
4281,3,46,68,23,-1.671155444021846,23
4282,84,45,87,25,-1.6712785926609635,20
4283,104,14,48,8,-1.6735118830252353,6
4284,7,45,63,27,-1.6735738766299257,18
4285,50,14,23,9,-1.6739476096476191,5
4286,64,18,17,10,-1.6742261514283465,8
4287,50,31,65,16,-1.6801621867417365,15
4288,88,83,8,43,-1.6811669912632214,40
4289,20,25,55,13,-1.682789944223457,12
4290,13,75,39,40,-1.6833252409730635,35
4291,106,40,55,22,-1.6835382667235006,18
4292,28,20,73,10,-1.687006788072292,10
4293,95,17,63,9,-1.6923751834394962,8
4294,23,15,36,6,-1.697287527418564,9
4295,107,92,65,48,-1.69768300261879,44
4296,102,16,20,8,-1.698939123981487,8
4297,57,15,85,8,-1.7034495534090837,7
4298,55,67,86,36,-1.7078571022769593,31
4299,51,34,50,17,-1.708297555589138,17
4300,28,62,88,33,-1.710290859725632,29
4301,54,51,5,28,-1.712751834502299,23
4302,83,24,104,14,-1.7171480590838877,10
4303,11,19,77,10,-1.7198753848877157,9
4304,86,60,57,31,-1.7214648622224287,29
4305,28,10,77,5,-1.7274479044716256,5
4306,77,20,109,10,-1.7279763913588855,10
4307,1,24,60,13,-1.730552170717303,11
4308,68,13,32,8,-1.7311662598089272,5
4309,96,38,106,21,-1.7318320126651956,17
4310,44,27,16,15,-1.7334648777380282,12
4311,9,16,111,9,-1.7347101097492725,7
4312,112,23,9,13,-1.7370284161007248,10
4313,66,14,51,7,-1.7380363030144785,7
4314,88,37,36,21,-1.7392851936744365,16
4315,17,41,65,24,-1.7406554308740465,17
4316,6,11,18,6,-1.741458460094483,5
4317,36,33,60,17,-1.7416473627060736,16
4318,107,23,79,13,-1.7474071801332414,10
4319,43,21,104,12,-1.7506051091420238,9
4320,18,37,88,19,-1.753919363939246,18
4321,5,98,37,51,-1.758075221984611,47
4322,86,51,15,27,-1.76088081949039,24
4323,88,47,64,26,-1.7611807290570662,21
4324,110,11,88,5,-1.7642228121429715,6
4325,16,39,103,19,-1.7651314635618787,20
4326,109,28,60,15,-1.770350118894973,13
4327,30,19,9,11,-1.7725720850396791,8
4328,69,21,50,10,-1.7758250016074677,11
4329,68,39,15,22,-1.779902613157172,17
4330,90,25,37,13,-1.7816453937181718,12
4331,77,27,65,15,-1.7824305156446971,12
4332,87,35,12,19,-1.7857268872175887,16
4333,46,27,97,14,-1.7888516310767928,13
4334,48,19,20,11,-1.788885742697511,8
4335,39,35,114,17,-1.7909993968165168,18
4336,15,11,66,6,-1.795076326934553,5
4337,30,40,8,20,-1.7986527143277458,20
4338,78,15,38,8,-1.799141314872416,7
4339,103,10,63,6,-1.7993918081481381,4
4340,16,50,112,26,-1.7995643538534876,24
4341,31,34,51,20,-1.8036645224364254,14
4342,86,57,70,31,-1.8046372203949796,26
4343,25,22,36,11,-1.807144013826857,11
4344,60,51,87,25,-1.8079849879363554,26
4345,111,18,40,9,-1.8104998545748772,9
4346,99,13,102,7,-1.8212893413036917,6
4347,79,37,86,20,-1.8233812794868027,17
4348,75,44,13,24,-1.82625422828726,20
4349,114,13,44,7,-1.8263733365516681,6
4350,114,15,11,7,-1.8276036019184336,8
4351,13,29,74,15,-1.8278354237299026,14
4352,90,23,88,13,-1.8344778390431953,10
4353,96,38,84,19,-1.8356486827006808,19
4354,88,30,92,16,-1.8365360092779854,14
4355,100,41,8,22,-1.8381782940280218,19
4356,20,30,114,16,-1.839540566254469,14
4357,85,18,12,9,-1.8411131730635322,9
4358,30,69,87,36,-1.8435085087904726,33
4359,73,13,50,8,-1.8439270323254189,5
4360,88,25,19,12,-1.8450287055712744,13
4361,97,22,53,12,-1.8492466822191038,10
4362,97,21,93,11,-1.8583722279909514,10
4363,33,13,60,8,-1.8644268792007352,5
4364,47,13,53,7,-1.867452050486345,6
4365,48,19,60,10,-1.8683774973367067,9
4366,54,66,87,36,-1.8710926114506878,30
4367,8,41,2,21,-1.884865447616968,20
4368,13,108,68,57,-1.8849483625328207,51
4369,30,16,96,9,-1.885074878690478,7
4370,64,23,25,12,-1.885723885284777,11
4371,18,14,27,7,-1.887864132064807,7
4372,86,44,71,22,-1.8883807510456327,22
4373,106,35,20,19,-1.8905905914286998,16
4374,37,54,51,31,-1.8927999179881416,23
4375,98,12,85,7,-1.8929637615829242,5
4376,99,27,55,15,-1.895072402151854,12
4377,106,51,65,27,-1.9069424806899136,24
4378,88,21,12,11,-1.9079727374799846,10
4379,1,38,68,20,-1.9099752765436626,18
4380,74,65,8,36,-1.912865606563874,29
4381,17,11,110,6,-1.9155371371930692,5
4382,106,32,97,16,-1.9159665785715099,16
4383,76,11,99,5,-1.9173589523208294,6
4384,8,10,89,5,-1.9209941773029187,5
4385,18,21,114,11,-1.9235772497574435,10
4386,54,28,17,14,-1.9259736473512512,14
4387,40,19,70,11,-1.9276789997691235,8
4388,84,30,65,16,-1.9288646732683914,14
4389,11,33,30,18,-1.932365386096484,15
4390,97,14,23,7,-1.933052873443659,7
4391,98,10,32,5,-1.938005226383161,5
4392,7,49,71,24,-1.9387153694352721,25
4393,104,13,110,8,-1.938847445081051,5
4394,31,14,23,8,-1.9392936999416412,6
4395,55,20,25,11,-1.9429576796619983,9
4396,64,34,36,17,-1.9485056781764574,17
4397,57,34,27,17,-1.9534766566361852,17
4398,86,30,19,15,-1.9572349198961299,15
4399,35,11,50,6,-1.9581460146246799,5
4400,33,14,39,7,-1.9600955952261323,7
4401,97,11,80,6,-1.9631828964682283,5
4402,112,24,41,13,-1.9642201479007202,11
4403,91,33,28,18,-1.9649527402335243,15
4404,65,31,19,16,-1.9655134440486957,15
4405,49,14,57,8,-1.9666920234512817,6
4406,62,24,49,14,-1.9683725075755814,10
4407,3,22,23,12,-1.9704853033748797,10
4408,35,10,54,6,-1.970607603878344,4
4409,84,31,55,16,-1.972558144291078,15
4410,70,32,88,17,-1.97629343595963,15
4411,53,28,95,17,-1.9769373995573174,11
4412,79,12,100,7,-1.9822381822120907,5
4413,4,19,53,10,-1.9876947928926731,9
4414,55,92,8,46,-1.9945813817420808,46
4415,74,26,114,13,-1.9975972531686852,13
4416,27,11,66,6,-1.9992664520674324,5
4417,50,39,8,22,-1.9997739229036215,17
4418,97,22,83,10,-2.0076368732075736,12
4419,77,73,60,38,-2.0085290730636896,35
4420,37,20,62,12,-2.0107407128281514,8
4421,12,35,39,19,-2.011891168245126,16
4422,102,29,16,15,-2.01250365528989,14
4423,12,21,88,11,-2.014366026449469,10
4424,70,29,68,15,-2.0151181581046322,14
4425,27,46,41,26,-2.0152493875384563,20
4426,37,14,69,7,-2.0155128499001447,7
4427,60,11,93,7,-2.0186296316322276,4
4428,10,10,111,6,-2.019460672769103,4
4429,90,37,8,21,-2.019464782071777,16
4430,17,27,114,16,-2.0211590753648663,11
4431,90,15,76,9,-2.024149829501993,6
4432,60,26,90,15,-2.0244178494313423,11
4433,51,52,28,26,-2.0250173037261257,26
4434,13,11,32,6,-2.0261815070275415,5
4435,114,14,91,7,-2.031242634143404,7
4436,13,25,33,13,-2.0314833968214865,12
4437,60,16,80,8,-2.0385494144903564,8
4438,93,18,11,8,-2.03919027808283,10
4439,7,14,12,7,-2.0405365521973633,7
4440,39,54,8,27,-2.046441886882738,27
4441,65,25,48,12,-2.0579371291305484,13
4442,57,19,9,10,-2.058380213538902,9
4443,60,20,62,10,-2.0597588787986405,10
4444,88,22,76,11,-2.0620652721332697,11
4445,70,44,107,22,-2.066718062800075,22
4446,34,30,84,16,-2.067010635537675,14
4447,50,12,94,7,-2.0673259151868515,5
4448,23,20,27,10,-2.072262837137015,10
4449,30,22,57,11,-2.074211064897338,11
4450,11,37,15,20,-2.076059285123429,17
4451,51,14,44,9,-2.084874228955974,5
4452,72,14,66,8,-2.0852128177023075,6
4453,16,84,11,49,-2.0860194484394765,35
4454,68,43,64,25,-2.086424402801581,18
4455,11,18,40,9,-2.0894421004610075,9
4456,86,30,108,17,-2.0910937309013535,13
4457,8,22,97,11,-2.094799206270942,11
4458,55,34,83,17,-2.0962093979720233,17
4459,78,26,65,15,-2.10028556833986,11
4460,55,30,76,17,-2.101047736110318,13
4461,23,19,112,11,-2.1018527652621146,8
4462,94,28,68,15,-2.106511062546954,13
4463,13,38,57,19,-2.1070868819342947,19
4464,25,11,69,6,-2.1120597510852503,5
4465,70,11,53,6,-2.117480208536361,5
4466,63,24,49,12,-2.1212323385530256,12
4467,9,62,7,31,-2.12190310948229,31
4468,114,32,102,18,-2.1240842876015145,14
4469,43,10,98,6,-2.130277896443765,4
4470,8,77,54,44,-2.1325516335637458,33
4471,61,12,2,7,-2.1331085158076037,5
4472,74,30,11,16,-2.1347610080308996,14
4473,102,26,8,13,-2.1358165667375646,13
4474,31,13,66,7,-2.1367157981218847,6
4475,51,64,3,32,-2.136969156390622,32
4476,68,17,81,9,-2.1370452313390325,8
4477,39,39,71,21,-2.1402119009407663,18
4478,69,11,55,6,-2.141856565606561,5
4479,8,21,10,12,-2.1473150021467613,9
4480,87,30,90,16,-2.148197288067281,14
4481,3,27,62,15,-2.154788303981497,12
4482,27,21,108,12,-2.1597743110088845,9
4483,53,13,23,7,-2.1639220781507684,6
4484,87,27,77,15,-2.1670108341663212,12
4485,88,67,60,37,-2.1715375199885694,30
4486,68,46,41,24,-2.1718048075100542,22
4487,48,44,16,22,-2.179475098757679,22
4488,100,10,52,6,-2.1822522154052875,4
4489,27,36,34,19,-2.1860495568606466,17
4490,106,35,68,19,-2.1936858069827916,16
4491,40,75,7,42,-2.1957521283064794,33
4492,56,12,91,6,-2.1992686471747738,6
4493,91,14,17,8,-2.2013317711286327,6
4494,27,27,75,15,-2.203651126537083,12
4495,72,32,13,16,-2.2040070476145734,16
4496,96,50,5,28,-2.21142719225076,22
4497,84,23,75,12,-2.2186834285684554,11
4498,50,32,17,16,-2.221124084948795,16
4499,99,13,98,6,-2.221258167793369,7
4500,12,11,112,5,-2.2247336886150633,6
4501,43,32,3,18,-2.2251556635342298,14
4502,25,16,90,9,-2.2261576936837106,7
4503,71,29,62,15,-2.2274966883750613,14
4504,11,26,12,13,-2.231267105865384,13
4505,65,18,46,11,-2.2329984780581085,7
4506,114,26,4,13,-2.2345648368573663,13
4507,65,11,108,5,-2.235257356991268,6
4508,103,13,77,7,-2.236670005317329,6
4509,107,61,68,31,-2.2392858218745877,30
4510,49,21,64,12,-2.2416010602386134,9
4511,15,26,72,13,-2.2419909640786244,13
4512,13,65,104,35,-2.2428038741485223,30
4513,27,10,70,5,-2.2432632584575636,5
4514,70,52,16,29,-2.248690629015385,23
4515,19,17,8,9,-2.2502111874564155,8
4516,83,11,63,7,-2.2518527555220995,4
4517,74,29,20,16,-2.2532656544174667,13
4518,25,30,95,16,-2.253973143655665,14
4519,41,13,74,6,-2.2545650248033335,7
4520,17,16,98,8,-2.257246092539532,8
4521,106,62,87,32,-2.2622041017840124,30
4522,3,23,109,12,-2.262800410189064,11
4523,42,11,87,6,-2.2670677132557637,5
4524,7,12,85,7,-2.267272935114745,5
4525,96,66,28,35,-2.2674069446039304,31
4526,31,10,61,5,-2.2696136748473643,5
4527,68,108,7,58,-2.2702884441480418,50
4528,77,12,57,6,-2.2739735076992793,6
4529,74,14,40,8,-2.2751378053719047,6
4530,11,47,50,25,-2.276023953743783,22
4531,92,14,65,7,-2.2769844774151675,7
4532,46,60,11,32,-2.27863758150919,28
4533,69,12,77,6,-2.279799370845894,6
4534,81,10,38,5,-2.281962126644993,5
4535,112,36,107,18,-2.2856893291686897,18
4536,88,26,81,14,-2.2857834835265307,12
4537,16,16,73,8,-2.2869477637304083,8
4538,28,76,8,41,-2.287592590077328,35
4539,4,13,106,6,-2.2878834680443574,7
4540,5,24,100,13,-2.293242743404464,11
4541,50,42,63,23,-2.295098382996511,19
4542,7,20,80,11,-2.2986689861273364,9
4543,76,34,50,16,-2.298946803227752,18
4544,95,26,60,14,-2.300035058084819,12
4545,70,13,35,6,-2.304704787607643,7
4546,69,13,76,8,-2.308555624427584,5
4547,70,28,63,15,-2.309911464577443,13
4548,63,31,71,17,-2.3112629873314674,14
4549,96,58,8,31,-2.313991189820115,27
4550,91,32,88,17,-2.315767764685104,15
4551,87,18,111,10,-2.3163891448333644,8
4552,102,21,104,10,-2.3206272974702777,11
4553,103,10,8,6,-2.3245085117289825,4
4554,50,35,84,18,-2.3257021134383264,17
4555,42,10,72,6,-2.328523056790725,4
4556,5,51,109,26,-2.3285813949081633,25
4557,53,28,25,14,-2.330151085469087,14
4558,45,10,78,5,-2.343791897433706,5
4559,109,29,76,17,-2.348338718743378,12
4560,11,24,29,13,-2.349681332743006,11
4561,33,18,11,11,-2.3498549166237113,7
4562,96,10,79,5,-2.3519921114573528,5
4563,31,36,4,21,-2.353535596679466,15
4564,33,12,99,7,-2.354570382478151,5
4565,17,27,8,14,-2.3545788982602027,13
4566,109,14,96,8,-2.3566759619593642,6
4567,64,44,53,24,-2.357816373417817,20
4568,97,14,100,8,-2.358325970901079,6
4569,76,34,70,18,-2.358420872168422,16
4570,5,23,99,12,-2.361621902264283,11
4571,87,10,22,4,-2.3658236386511695,6
4572,50,24,40,14,-2.3671440474550494,10
4573,63,32,25,16,-2.3688265373602633,16
4574,55,31,53,17,-2.372089532662414,14
4575,84,19,90,10,-2.374748457023267,9
4576,104,44,39,24,-2.3751154073426806,20
4577,12,29,49,12,-2.3757535970577637,17
4578,107,40,71,23,-2.3760609676092463,17
4579,112,14,8,8,-2.379829723910838,6
4580,56,13,75,8,-2.3840139649043497,5
4581,104,25,96,14,-2.3866419839158373,11
4582,71,21,4,13,-2.387175011736595,8
4583,95,40,104,22,-2.389034218387607,18
4584,48,13,23,7,-2.389445224732223,6
4585,45,22,16,13,-2.3925466679441394,9
4586,65,50,53,26,-2.3970028220576673,24
4587,109,21,97,11,-2.3981411019215164,10
4588,28,38,46,22,-2.399017879816561,16
4589,98,15,114,8,-2.3992721750256814,7
4590,94,27,100,17,-2.4002432216595997,10
4591,80,26,20,14,-2.403335157163852,12
4592,33,21,86,12,-2.404613887093818,9
4593,104,57,88,32,-2.406185933878752,25
4594,50,23,34,12,-2.4065274329929416,11
4595,81,24,107,13,-2.414159413465892,11
4596,94,19,28,11,-2.4149604753175535,8
4597,99,11,109,6,-2.419517402501051,5
4598,34,28,109,15,-2.42248256662429,13
4599,51,25,103,13,-2.4225011486475783,12
4600,37,17,93,10,-2.422747703399567,7
4601,90,39,107,20,-2.4251424853764503,19
4602,96,17,3,9,-2.4320783711975644,8
4603,51,19,14,12,-2.433844123091522,7
4604,102,24,109,13,-2.437458896467386,11
4605,47,15,64,9,-2.441201731533323,6
4606,50,10,32,4,-2.4440541907162885,6
4607,61,15,63,9,-2.445410080263457,6
4608,84,10,40,5,-2.454221067396937,5
4609,86,17,110,9,-2.4597124602837575,8
4610,25,32,102,17,-2.460889696925049,15
4611,1,17,17,9,-2.462761073509874,8
4612,34,31,13,16,-2.4629355156987685,15
4613,37,10,103,4,-2.465940588175403,6
4614,69,17,74,8,-2.466497282082459,9
4615,81,17,4,10,-2.467812477706321,7
4616,103,17,30,10,-2.4703689712282237,7
4617,20,20,17,11,-2.4759550702480677,9
4618,28,58,87,30,-2.4778229626436263,28
4619,79,25,28,13,-2.4854050300354316,12
4620,9,27,71,15,-2.485839871550414,12
4621,43,34,27,18,-2.487486899178629,16
4622,107,76,39,40,-2.488662143008564,36
4623,11,21,64,13,-2.490493863054092,8
4624,111,38,65,22,-2.4964278491140734,16
4625,67,13,84,6,-2.500709874534178,7
4626,92,15,87,8,-2.5078466479835875,7
4627,107,54,50,28,-2.5099686972292012,26
4628,90,39,16,20,-2.512640296874733,19
4629,27,35,29,20,-2.5139766493292606,15
4630,36,15,12,8,-2.516319942513754,7
4631,46,27,68,15,-2.520930145642669,12
4632,4,18,39,10,-2.5267698999647306,8
4633,9,33,36,18,-2.527924078037464,15
4634,30,19,99,11,-2.530388293684777,8
4635,107,15,44,8,-2.5305445670994096,7
4636,17,29,7,16,-2.532089441361392,13
4637,88,60,40,33,-2.532837544735202,27
4638,78,27,29,15,-2.5357777442440455,12
4639,72,14,43,7,-2.536394554509492,7
4640,102,34,54,18,-2.537229709009487,16
4641,60,41,43,22,-2.5388407147488183,19
4642,9,22,70,13,-2.539064949919759,9
4643,65,35,97,19,-2.5397394280205594,16
4644,95,14,77,7,-2.5410335587352355,7
4645,20,40,88,20,-2.541950104212901,20
4646,36,74,7,40,-2.5493587507973596,34
4647,76,14,44,8,-2.5504141931433426,6
4648,47,14,71,7,-2.550463226281338,7
4649,1,19,73,11,-2.5534291003907312,8
4650,68,75,16,42,-2.5553684294875567,33
4651,25,14,48,7,-2.5710538086168517,7
4652,51,29,1,15,-2.5741193049184647,14
4653,108,14,81,7,-2.575857374314636,7
4654,112,22,50,13,-2.578275791966451,9
4655,45,16,63,9,-2.579990748130807,7
4656,88,15,33,9,-2.581178022844097,6
4657,65,71,28,40,-2.5907378992374013,31
4658,94,35,19,18,-2.592430047160573,17
4659,109,10,1,5,-2.5929606771402347,5
4660,37,27,102,15,-2.5931875377695413,12
4661,37,48,20,25,-2.593682765159078,23
4662,107,94,13,50,-2.59789501954985,44
4663,80,32,65,17,-2.5986356922004035,15
4664,89,10,20,5,-2.5989355295603778,5
4665,91,23,36,13,-2.6004832054576417,10
4666,1,29,40,16,-2.6081027273161874,13
4667,107,33,94,20,-2.6133702151384592,13
4668,34,20,9,11,-2.6185115894413826,9
4669,28,42,39,22,-2.6233394077803625,20
4670,54,51,39,27,-2.6240157360627983,24
4671,107,70,27,39,-2.628606213410472,31
4672,107,34,95,18,-2.633836762476073,16
4673,22,12,51,7,-2.634920658551637,5
4674,54,13,110,7,-2.6358849029934506,6
4675,69,24,100,13,-2.641711217702835,11
4676,20,20,19,10,-2.646933293157403,10
4677,51,145,16,76,-2.648282058606673,69
4678,36,13,57,8,-2.65311609010537,5
4679,73,14,20,8,-2.6543798385197737,6
4680,68,32,19,18,-2.6559298105207456,14
4681,27,24,40,11,-2.6563176029466633,13
4682,20,33,11,19,-2.6580258548377644,14
4683,9,54,107,27,-2.6599346903452616,27
4684,65,92,87,50,-2.663745439912196,42
4685,60,62,51,37,-2.668091254445394,25
4686,5,17,71,9,-2.668348512437487,8
4687,104,67,37,37,-2.6697156594454787,30
4688,7,118,13,63,-2.670897317194471,55
4689,44,17,25,9,-2.67353547628176,8
4690,12,10,48,6,-2.6757754483893836,4
4691,16,79,54,42,-2.676890621910499,37
4692,5,25,39,13,-2.679132217269281,12
4693,58,14,43,8,-2.6806335210315995,6
4694,107,21,93,12,-2.6848247910711347,9
4695,43,13,74,6,-2.6848796666350307,7
4696,102,20,13,12,-2.6891186576501824,8
4697,43,29,11,15,-2.690595886408949,14
4698,30,21,7,10,-2.691476247459028,11
4699,31,23,87,12,-2.691508727503307,11
4700,65,11,10,6,-2.6916160360342993,5
4701,48,22,39,13,-2.697481925191404,9
4702,11,63,8,34,-2.698721990639595,29
4703,68,27,47,15,-2.700809442975105,12
4704,7,27,20,14,-2.7023319306021247,13
4705,79,11,39,7,-2.7039365709334606,4
4706,50,46,2,25,-2.7076882491876737,21
4707,33,14,90,8,-2.7086229849631858,6
4708,84,89,86,45,-2.7122592129849847,44
4709,49,61,88,34,-2.7144625519502794,27
4710,4,20,63,11,-2.717031964261838,9
4711,51,17,58,9,-2.7220403540386506,8
4712,84,30,37,16,-2.724027270977717,14
4713,88,16,44,8,-2.725541522204711,8
4714,5,11,49,6,-2.7256599500520573,5
4715,46,26,60,14,-2.733085524905184,12
4716,54,25,15,12,-2.735147263925594,13
4717,62,30,39,17,-2.7367319129051215,13
4718,63,12,99,6,-2.7377253409939395,6
4719,94,44,43,24,-2.7382840894808322,20
4720,68,31,69,17,-2.743936079051881,14
4721,51,26,71,14,-2.7484840529184043,12
4722,104,31,30,16,-2.7504108450647484,15
4723,65,36,43,18,-2.7525986025329394,18
4724,43,14,70,8,-2.753352748891412,6
4725,96,34,97,17,-2.7556888339056824,17
4726,35,23,88,12,-2.7598010038488736,11
4727,94,17,1,8,-2.7623810098011927,9
4728,57,40,87,22,-2.764717704444597,18
4729,12,16,72,10,-2.765048148513882,6
4730,80,36,16,21,-2.76546563276886,15
4731,87,17,10,9,-2.7770692343126613,8
4732,40,30,18,18,-2.780722164544755,12
4733,107,36,17,19,-2.7872894864783673,17
4734,41,58,51,31,-2.788035903246999,27
4735,112,14,85,8,-2.7888570708398155,6
4736,102,12,70,5,-2.7906887378625385,7
4737,57,10,18,6,-2.791050441588557,4
4738,36,13,100,7,-2.7923934619121082,6
4739,1,26,7,14,-2.7932054952385057,12
4740,44,14,68,7,-2.795327721392822,7
4741,8,32,83,16,-2.795775595052068,16
4742,54,66,20,33,-2.7989366544964605,33
4743,27,42,12,24,-2.8046964318602283,18
4744,112,14,106,7,-2.805082024542775,7
4745,71,42,65,24,-2.8056942435602354,18
4746,41,15,99,8,-2.808167291861728,7
4747,36,32,1,16,-2.8095303452930676,16
4748,40,48,9,27,-2.81743847104381,21
4749,76,26,97,14,-2.8180456861896683,12
4750,48,14,68,7,-2.8206443314688054,7
4751,71,13,18,7,-2.821320109059585,6
4752,62,18,54,10,-2.824080555827825,8
4753,112,21,75,12,-2.824219405034082,9
4754,107,39,15,24,-2.8291612991129433,15
4755,86,61,114,32,-2.83079839430398,29
4756,81,23,53,13,-2.832269045840236,10
4757,35,11,39,6,-2.836154761931755,5
4758,28,104,86,58,-2.8374089851944664,46
4759,16,73,104,40,-2.838890783683991,33
4760,16,25,4,12,-2.8411046840521466,13
4761,39,33,95,18,-2.841495525954101,15
4762,72,31,86,17,-2.847358039373839,14
4763,77,17,23,9,-2.847874929157046,8
4764,33,13,97,7,-2.8486496222061612,6
4765,28,96,16,53,-2.854985092700266,43
4766,112,13,74,7,-2.8550316834984466,6
4767,94,15,88,7,-2.858803168647949,8
4768,28,25,69,13,-2.8619129564051375,12
4769,11,50,55,29,-2.865634885836894,21
4770,88,14,72,8,-2.866088260356641,6
4771,84,70,28,39,-2.8670003890442084,31
4772,63,23,46,11,-2.86724186989635,12
4773,15,30,49,15,-2.868522690959725,15
4774,17,10,88,4,-2.869337502995369,6
4775,68,69,88,38,-2.8695211003313763,31
4776,1,14,112,9,-2.8723250567679224,5
4777,2,10,108,6,-2.87346504815302,4
4778,43,17,12,10,-2.8740234479238596,7
4779,30,21,75,11,-2.8743282279457314,10
4780,77,14,106,7,-2.8755893681261617,7
4781,46,25,17,14,-2.875672610475698,11
4782,88,58,27,30,-2.8900429056834263,28
4783,71,34,30,18,-2.8915964337712703,16
4784,79,33,16,19,-2.9049583801159375,14
4785,9,19,62,10,-2.9069158954391585,9
4786,10,12,104,6,-2.911353003023708,6
4787,54,36,80,18,-2.91166309610947,18
4788,58,23,60,12,-2.91177122457859,11
4789,41,22,47,11,-2.9126189727076204,11
4790,33,10,37,6,-2.9157377490462273,4
4791,31,11,55,6,-2.9183781753906346,5
4792,9,17,109,8,-2.91854195196147,9
4793,47,10,29,6,-2.919983374996915,4
4794,106,19,102,9,-2.920725539256512,10
4795,62,14,1,7,-2.9215215839903967,7
4796,33,10,3,6,-2.927658221464772,4
4797,40,18,12,9,-2.9302897037093416,9
4798,28,21,33,10,-2.934003356051797,11
4799,94,20,78,11,-2.934032764236852,9
4800,86,16,66,9,-2.9349279516020914,7
4801,87,20,36,12,-2.935573250897671,8
4802,49,27,68,15,-2.9363199373933018,12
4803,65,27,83,14,-2.938404758323202,13
4804,1,18,9,8,-2.9438107743951827,10
4805,8,39,60,20,-2.9438347563437417,19
4806,46,18,71,9,-2.9448527741935377,9
4807,12,15,52,8,-2.948123132553489,7
4808,29,19,54,11,-2.9499144478753045,8
4809,3,33,15,18,-2.9522579457276623,15
4810,51,106,13,55,-2.956296787814829,51
4811,46,23,114,13,-2.963143531607223,10
4812,13,27,91,14,-2.9639468252756305,13
4813,57,18,25,10,-2.9649349505538742,8
4814,63,16,73,8,-2.966556049159883,8
4815,37,21,2,11,-2.969758011269449,10
4816,88,64,114,34,-2.9736929918128054,30
4817,4,32,36,19,-2.973906674035423,13
4818,106,36,84,18,-2.975473960825012,18
4819,1,13,46,6,-2.9771068452784513,7
4820,13,23,85,14,-2.985985548040523,9
4821,34,11,114,5,-2.9884829411181757,6
4822,95,19,76,10,-2.992871867745084,9
4823,90,47,86,27,-2.997206734082277,20
4824,27,56,39,32,-2.997546423490314,24
4825,69,11,4,6,-2.9994841766617113,5
4826,34,14,96,8,-3.001763014782561,6
4827,37,58,16,31,-3.002510719128323,27
4828,108,20,50,10,-3.006186687462408,10
4829,19,14,48,7,-3.00728846408068,7
4830,63,42,74,22,-3.0096162132471513,20
4831,39,43,9,22,-3.01214851454061,21
4832,88,29,47,15,-3.0208806441241465,14
4833,33,17,40,11,-3.0217035797006964,6
4834,114,10,89,5,-3.0269218224279837,5
4835,98,13,39,8,-3.033232316977357,5
4836,89,11,39,7,-3.0350694418956095,4
4837,65,39,25,23,-3.0368934823131153,16
4838,79,22,30,13,-3.038702569108576,9
4839,12,30,68,16,-3.041358769608476,14
4840,96,13,38,7,-3.042215232246171,6
4841,3,40,12,23,-3.0432320355913456,17
4842,55,45,7,26,-3.0547614693932803,19
4843,57,11,6,6,-3.056750466696465,5
4844,51,41,57,22,-3.0641529465856623,19
4845,25,18,71,10,-3.0644100067848146,8
4846,25,30,75,17,-3.0695517335408993,13
4847,60,29,19,15,-3.0741844930514644,14
4848,104,23,97,12,-3.0789791419269115,11
4849,62,16,55,9,-3.0797392954165557,7
4850,76,13,12,6,-3.082319725605144,7
4851,28,12,66,6,-3.0826665795427424,6
4852,37,59,107,32,-3.087858660035623,27
4853,50,17,93,10,-3.0892168464304066,7
4854,76,19,103,9,-3.0940274843843967,10
4855,27,17,6,9,-3.094787186521295,8
4856,109,10,85,7,-3.095406882310694,3
4857,87,20,6,11,-3.0972456748613655,9
4858,54,34,104,18,-3.0987784259955413,16
4859,91,10,64,6,-3.099347902087069,4
4860,74,16,88,10,-3.1000151762465453,6
4861,68,14,99,8,-3.100103615084475,6
4862,60,15,92,9,-3.1016290657385786,6
4863,77,38,86,21,-3.1019167430803822,17
4864,86,21,111,12,-3.1037611827633467,9
4865,30,23,20,12,-3.1046519258930347,11
4866,4,24,50,12,-3.110559237136967,12
4867,17,25,25,14,-3.1106502600539123,11
4868,80,11,36,6,-3.115857421175655,5
4869,48,36,28,20,-3.1189690871072235,16
4870,8,36,23,20,-3.120762784480779,16
4871,61,15,51,10,-3.1232056571511624,5
4872,19,55,30,31,-3.1254848448500048,24
4873,28,11,6,6,-3.131247568187587,5
4874,2,15,76,9,-3.1350168634931235,6
4875,9,23,114,15,-3.140025237540426,8
4876,45,12,112,6,-3.1460936650177436,6
4877,13,65,100,35,-3.1478251869099063,30
4878,23,23,75,11,-3.148733601092015,12
4879,76,18,3,10,-3.150422222688239,8
4880,7,51,104,28,-3.1582194180075027,23
4881,82,21,86,12,-3.1586560919846343,9
4882,4,19,75,11,-3.1591429263358264,8
4883,69,30,41,18,-3.1671568486745967,12
4884,113,15,86,9,-3.16969593297623,6
4885,60,25,106,15,-3.171261503808185,10
4886,47,34,16,19,-3.1778605747552735,15
4887,69,16,103,8,-3.1785957104061207,8
4888,50,21,100,12,-3.1824846398299695,9
4889,114,31,54,16,-3.1847921316014287,15
4890,58,10,11,6,-3.1884299720547142,4
4891,90,22,17,13,-3.190848422422067,9
4892,8,15,69,8,-3.1913004711052855,7
4893,13,11,52,6,-3.198313935058208,5
4894,39,41,36,23,-3.1998605067578247,18
4895,30,15,23,8,-3.2022910560317883,7
4896,17,28,106,17,-3.2039846830051175,11
4897,97,12,56,6,-3.20853124358707,6
4898,31,47,60,23,-3.209470727487928,24
4899,65,22,72,12,-3.2103844839596927,10
4900,97,19,50,11,-3.210625734622635,8
4901,74,16,17,9,-3.211770551027836,7
4902,102,28,76,16,-3.211945141016371,12
4903,80,10,100,6,-3.221630002984554,4
4904,12,21,19,10,-3.2219445095429284,11
4905,7,55,23,30,-3.22292830537617,25
4906,19,41,39,25,-3.22399187704774,16
4907,65,50,23,26,-3.2292420048113133,24
4908,97,14,3,7,-3.230803945654675,7
4909,36,49,107,26,-3.2348387046482574,23
4910,60,25,99,14,-3.23819445910271,11
4911,49,46,30,26,-3.239911352008885,20
4912,81,12,23,7,-3.240703587077,5
4913,16,83,60,45,-3.245223315992939,38
4914,96,10,64,6,-3.2470341038418864,4
4915,48,12,43,6,-3.2474165098505914,6
4916,15,38,100,21,-3.2528324504039166,17
4917,39,27,76,17,-3.2536053252622454,10
4918,25,47,114,27,-3.2540864225169717,20
4919,74,24,7,15,-3.2574931437928867,9
4920,67,13,114,7,-3.2746706512348394,6
4921,53,50,39,28,-3.2771617260881896,22
4922,3,25,8,12,-3.277389633331906,13
4923,78,31,68,17,-3.285372327961684,14
4924,35,15,55,8,-3.2899027901624853,7
4925,107,45,34,26,-3.2909922405162497,19
4926,79,17,76,10,-3.2930359935936764,7
4927,61,13,47,7,-3.3043540506366402,6
4928,64,21,114,12,-3.3046667254482798,9
4929,107,41,19,24,-3.3073590728366797,17
4930,96,14,41,9,-3.3088942892360294,5
4931,25,66,86,35,-3.3097455853588764,31
4932,75,31,60,17,-3.313915862803686,14
4933,84,16,97,10,-3.3164282058099315,6
4934,97,14,98,7,-3.3185319117606134,7
4935,38,23,60,12,-3.3201484252433597,11
4936,48,17,80,10,-3.335623053391129,7
4937,5,13,68,7,-3.3380294056441095,6
4938,98,20,54,11,-3.341408257498297,9
4939,11,42,13,24,-3.34278030791396,18
4940,20,19,15,11,-3.3455642497005824,8
4941,65,20,94,10,-3.3472699488499047,10
4942,20,10,83,5,-3.3478898251644154,5
4943,107,15,14,9,-3.3479962116917648,6
4944,106,17,14,10,-3.3600594128266157,7
4945,61,14,9,8,-3.362078776884604,6
4946,8,23,14,13,-3.3634201583462144,10
4947,97,25,54,13,-3.3648153427656795,12
4948,20,17,40,10,-3.3649339637959677,7
4949,57,27,69,16,-3.367166221655227,11
4950,28,56,13,30,-3.367189637590283,26
4951,107,31,91,18,-3.369239220639531,13
4952,100,22,37,13,-3.3718369789109683,9
4953,96,18,73,10,-3.3726024221333355,8
4954,11,23,72,12,-3.3761818275237743,11
4955,60,78,13,45,-3.3770875938219196,33
4956,39,40,64,22,-3.3772164918090852,18
4957,75,20,70,10,-3.3793498632006282,10
4958,3,48,39,25,-3.3807598414665545,23
4959,55,28,36,15,-3.38333657725735,13
4960,104,10,73,6,-3.3914910994647247,4
4961,28,13,4,7,-3.394082491248691,6
4962,19,44,49,24,-3.394696308295238,20
4963,7,35,43,21,-3.405692523929345,14
4964,19,24,76,14,-3.4114547768841037,10
4965,11,22,79,13,-3.411899322441765,9
4966,36,11,17,5,-3.4172736451567602,6
4967,78,18,28,9,-3.4177116588011063,9
4968,37,12,4,7,-3.4218717037755013,5
4969,50,57,87,30,-3.4276386978359663,27
4970,51,69,54,38,-3.4308531323018583,31
4971,27,52,7,28,-3.4308990471010476,24
4972,48,20,106,11,-3.4316235296616595,9
4973,81,11,78,5,-3.4320246992935277,6
4974,12,30,16,17,-3.4325288291725844,13
4975,65,17,81,10,-3.4470499311553464,7
4976,60,35,11,20,-3.4471724802633115,15
4977,46,63,86,37,-3.4473674168834245,26
4978,86,94,7,54,-3.44879121802912,40
4979,114,14,112,7,-3.452952980329055,7
4980,23,21,37,11,-3.4530437057487378,10
4981,27,27,76,16,-3.4531012420920075,11
4982,5,23,33,12,-3.4543275091771934,11
4983,16,15,52,8,-3.459524085791249,7
4984,5,60,74,32,-3.4699961467083478,28
4985,70,20,25,11,-3.484518115943742,9
4986,45,16,41,10,-3.485066668867454,6
4987,51,30,36,16,-3.4874600225025043,14
4988,36,13,62,7,-3.4895283270523745,6
4989,5,16,14,10,-3.4903696256491523,6
4990,54,10,6,5,-3.4921987314309866,5
4991,109,26,20,16,-3.4929177397438647,10
4992,114,36,97,20,-3.4948097299506924,16
4993,51,39,114,20,-3.4973322349486473,19
4994,108,13,37,7,-3.5019197237718496,6
4995,54,15,38,8,-3.502268170966973,7
4996,102,14,39,8,-3.5024293607442267,6
4997,109,19,37,11,-3.5038440546797935,8
4998,98,17,73,9,-3.5039598524288147,8
4999,109,27,25,15,-3.504136926234722,12
5000,23,16,74,9,-3.505315761927062,7
5001,27,32,8,17,-3.5152116177223616,15
5002,100,14,53,8,-3.519519789056672,6
5003,15,17,28,9,-3.5210057183007173,8
5004,98,19,27,10,-3.521955911173927,9
5005,57,11,17,7,-3.5231240907929307,4
5006,50,55,37,29,-3.5287986061002137,26
5007,25,17,93,9,-3.53003978897563,8
5008,8,24,62,14,-3.532603268082998,10
5009,107,62,30,35,-3.5341826082178893,27
5010,62,10,6,6,-3.5345556158920366,4
5011,84,26,85,16,-3.5349178606931724,10
5012,7,15,44,8,-3.535266020755458,7
5013,30,32,28,17,-3.5399264254738525,15
5014,36,65,40,37,-3.5400829247343593,28
5015,43,27,69,15,-3.543083442131467,12
5016,27,29,47,16,-3.543966431934924,13
5017,19,31,13,18,-3.544087166327382,13
5018,70,11,33,6,-3.545285037756224,5
5019,19,16,40,10,-3.545611871303118,6
5020,49,17,114,8,-3.548728211191125,9
5021,109,28,41,17,-3.548779347954399,11
5022,86,94,63,55,-3.549478365403399,39
5023,104,17,34,10,-3.55064687835478,7
5024,36,19,28,10,-3.554999615354129,9
5025,79,12,60,7,-3.555370933230573,5
5026,65,62,30,35,-3.5619176000989485,27
5027,7,28,6,13,-3.563185524233912,15
5028,84,13,62,7,-3.5672380956620353,6
5029,23,56,16,31,-3.5704087987012967,25
5030,43,19,25,12,-3.5730773529480713,7
5031,87,22,14,13,-3.5746572289058025,9
5032,86,38,91,21,-3.5760441594388466,17
5033,51,22,102,12,-3.5799509862134142,10
5034,5,62,88,33,-3.583030843412139,29
5035,11,18,14,11,-3.5868100547047623,7
5036,95,10,97,6,-3.5894324713347885,4
5037,11,22,7,13,-3.590907173314133,9
5038,5,61,104,33,-3.5931408944870395,28
5039,57,14,106,7,-3.59361898372693,7
5040,16,57,75,31,-3.59529020803502,26
5041,79,23,34,14,-3.5987779482770503,9
5042,32,24,86,13,-3.600337352350486,11
5043,88,36,1,19,-3.6124862498641357,17
5044,61,21,13,13,-3.6146533376867587,8
5045,79,15,112,8,-3.621796379179409,7
5046,28,26,80,14,-3.6230809501897747,12
5047,18,19,43,9,-3.6267699505365094,10
5048,5,51,55,29,-3.628046191114139,22
5049,100,22,72,13,-3.6290401350984696,9
5050,86,15,6,9,-3.637615954610378,6
5051,29,32,3,18,-3.640968061507456,14
5052,109,38,104,21,-3.642560155113917,17
5053,43,18,34,10,-3.6439583345872704,8
5054,70,10,14,5,-3.647042134114855,5
5055,23,13,9,7,-3.6475995665029,6
5056,65,50,74,27,-3.6492230502429246,23
5057,18,11,17,5,-3.651905683853183,6
5058,29,17,97,10,-3.6527966127132636,7
5059,20,11,62,6,-3.653244367006134,5
5060,32,21,107,11,-3.65469777615246,10
5061,71,10,90,5,-3.6561036030201173,5
5062,31,24,39,14,-3.6610558433956157,10
5063,87,134,86,71,-3.667174675816122,63
5064,85,20,28,11,-3.6675135147560156,9
5065,86,55,60,31,-3.667613524236148,24
5066,84,21,38,11,-3.6699802067032445,10
5067,49,13,89,7,-3.6780362206368418,6
5068,109,23,65,11,-3.6820630235649325,12
5069,78,24,72,12,-3.687490807799237,12
5070,38,16,80,8,-3.6957801142124267,8
5071,28,19,23,10,-3.6970356039584327,9
5072,11,28,48,16,-3.701141809786494,12
5073,5,62,16,37,-3.7016615680953464,25
5074,35,10,112,5,-3.704644012481239,5
5075,64,21,1,11,-3.7140968256416436,10
5076,5,21,15,13,-3.7147342263498166,8
5077,41,25,20,13,-3.722699653504377,12
5078,49,68,16,39,-3.7240847239461545,29
5079,20,52,87,28,-3.7251195086400495,24
5080,40,13,15,7,-3.72557831166786,6
5081,5,31,90,18,-3.72922813011693,13
5082,40,59,60,33,-3.7350164129782835,26
5083,55,84,13,47,-3.735224882055998,37
5084,4,13,1,8,-3.7360390878519705,5
5085,7,31,15,15,-3.741081293807919,16
5086,84,55,51,31,-3.742451182903001,24
5087,54,58,28,33,-3.742783353616919,25
5088,40,42,53,23,-3.7429391558119973,19
5089,107,13,52,8,-3.7535584759825276,5
5090,17,14,102,8,-3.765627490194505,6
5091,30,29,18,16,-3.7717933229839495,13
5092,51,87,88,45,-3.772351956328506,42
5093,9,27,55,16,-3.772633679119087,11
5094,17,21,87,12,-3.7733166042192905,9
5095,13,47,114,23,-3.7759149187311722,24
5096,93,10,7,5,-3.7802315490169547,5
5097,87,39,29,23,-3.782229354716841,16
5098,98,28,104,13,-3.783243181516934,15
5099,51,52,106,29,-3.7850976424308227,23
5100,37,24,57,13,-3.7883373383566443,11
5101,54,29,25,16,-3.7885203565536667,13
5102,50,25,90,14,-3.7900343777578587,11
5103,39,11,6,6,-3.796620754703812,5
5104,53,14,89,7,-3.799040779312777,7
5105,80,13,17,8,-3.803939831522535,5
5106,71,27,28,16,-3.8126316435493957,11
5107,5,16,110,9,-3.8138584796050905,7
5108,91,28,5,17,-3.814625093066518,11
5109,75,12,48,7,-3.8239435270874167,5
5110,3,11,4,6,-3.8250463920918425,5
5111,107,33,98,18,-3.826261245167428,15
5112,86,84,74,45,-3.8304380678874983,39
5113,54,45,11,25,-3.830761670343524,20
5114,46,13,38,8,-3.8338597693432206,5
5115,18,22,3,13,-3.8346712095468676,9
5116,34,22,65,13,-3.838809663446646,9
5117,12,11,47,6,-3.839015416153552,5
5118,31,23,18,12,-3.8430258307678686,11
5119,50,22,41,13,-3.845767300582984,9
5120,63,33,100,17,-3.8476705598955565,16
5121,49,37,76,21,-3.8482642836319476,16
5122,76,39,28,21,-3.8485126894088935,18
5123,17,17,85,10,-3.8507511089593,7
5124,107,50,40,30,-3.8570605527160122,20
5125,62,33,86,18,-3.857981546675875,15
5126,48,16,57,9,-3.858947382973919,7
5127,109,27,43,16,-3.867241547838043,11
5128,78,44,86,24,-3.867468382132847,20
5129,29,21,41,12,-3.868637237264429,9
5130,41,86,65,51,-3.8730812369047185,35
5131,112,22,3,11,-3.881829625852149,11
5132,5,17,40,9,-3.8914877974226956,8
5133,48,18,27,11,-3.8925796052199777,7
5134,54,25,1,14,-3.8929886538978145,11
5135,58,13,77,7,-3.8981506835692445,6
5136,3,44,107,23,-3.899807395774833,21
5137,63,30,55,16,-3.900377194965691,14
5138,64,29,75,16,-3.916000714039239,13
5139,87,24,83,13,-3.916710407315815,11
5140,62,51,16,31,-3.918066009623021,20
5141,2,28,5,16,-3.923277825320164,12
5142,20,15,18,9,-3.9303607040253326,6
5143,76,22,84,12,-3.9389733435046645,10
5144,54,31,9,17,-3.942845641758714,14
5145,40,11,6,6,-3.944267868023087,5
5146,43,19,35,10,-3.946831407739412,9
5147,2,23,16,13,-3.9485844823217353,10
5148,104,11,67,6,-3.9505697623954874,5
5149,91,15,9,8,-3.9508212932565088,7
5150,37,23,40,12,-3.9558411724945217,11
5151,84,21,10,12,-3.960254602065843,9
5152,96,15,78,9,-3.9616133541960523,6
5153,94,11,84,6,-3.9681566657444405,5
5154,65,60,8,33,-3.9715477971861413,27
5155,14,12,96,7,-3.975747798085742,5
5156,54,58,96,30,-3.9768276973257124,28
5157,76,10,83,6,-3.979171756100496,4
5158,97,18,60,9,-3.9792005525226384,9
5159,19,40,78,24,-3.986269843175626,16
5160,3,12,106,7,-3.9869286680549885,5
5161,87,16,45,9,-3.9869877249578156,7
5162,29,15,50,8,-3.9901096227477506,7
5163,65,85,51,48,-3.9909865262117235,37
5164,14,12,112,6,-3.9932359631148633,6
5165,112,16,104,9,-3.994340241273064,7
5166,100,18,9,11,-3.9953268600169216,7
5167,60,24,76,15,-4.000770681345001,9
5168,112,16,31,10,-4.001730552260444,6
5169,64,42,107,23,-4.007940956634882,19
5170,77,18,5,10,-4.010067732208504,8
5171,110,20,8,12,-4.013172679497397,8
5172,67,17,34,8,-4.015594495513434,9
5173,19,25,28,15,-4.019180575644085,10
5174,47,31,7,18,-4.025431088719286,13
5175,86,154,16,90,-4.027183016832997,64
5176,114,42,60,20,-4.029174933224297,22
5177,114,41,63,26,-4.0379729890543565,15
5178,43,10,1,5,-4.038976715758714,5
5179,69,12,84,7,-4.046782427990892,5
5180,51,58,8,32,-4.048019136901901,26
5181,40,10,32,5,-4.050021677419865,5
5182,20,10,14,6,-4.05196683725804,4
5183,39,11,56,5,-4.061429150921741,6
5184,95,10,43,6,-4.063398320607962,4
5185,38,12,20,8,-4.067291998076448,4
5186,73,19,65,11,-4.067312461469671,8
5187,31,68,7,38,-4.069172309295861,30
5188,46,21,95,12,-4.071848693893571,9
5189,109,48,16,28,-4.0745201581983626,20
5190,75,21,91,8,-4.084376386784757,13
5191,98,17,78,9,-4.084899624702052,8
5192,19,11,36,6,-4.08859021842168,5
5193,51,51,17,27,-4.088673144397256,24
5194,93,27,86,15,-4.0902499993060095,12
5195,8,15,111,8,-4.091375789332371,7
5196,35,24,20,14,-4.0987287220029165,10
5197,93,20,83,11,-4.100880722204596,9
5198,51,48,75,26,-4.10605342104463,22
5199,63,30,97,17,-4.107378727934816,13
5200,2,12,7,7,-4.115660194227728,5
5201,107,121,87,68,-4.1215288380102235,53
5202,41,35,60,18,-4.124791635334076,17
5203,53,57,18,31,-4.124925801617173,26
5204,50,15,83,7,-4.131296712002355,8
5205,106,51,107,28,-4.131711792879515,23
5206,30,13,74,7,-4.132114674773073,6
5207,20,11,71,7,-4.1364305573939655,4
5208,64,28,30,16,-4.139822872969586,12
5209,16,45,95,24,-4.139884598584294,21
5210,71,47,53,27,-4.141303557057989,20
5211,95,12,100,6,-4.142851413596654,6
5212,28,77,50,44,-4.143924434349461,33
5213,103,17,15,9,-4.148119256013829,8
5214,17,12,99,7,-4.148375833376952,5
5215,84,24,27,13,-4.156059221916358,11
5216,2,10,19,5,-4.15617878328422,5
5217,86,50,49,26,-4.160999894397799,24
5218,5,40,83,21,-4.163709904424498,19
5219,96,24,60,16,-4.164982345638217,8
5220,46,51,51,29,-4.174462162624302,22
5221,103,13,18,8,-4.1752141807255745,5
5222,25,27,23,15,-4.182190113226042,12
5223,43,11,93,6,-4.184906166012258,5
5224,23,22,64,12,-4.187137123111157,10
5225,1,36,13,22,-4.187998461115461,14
5226,38,39,107,23,-4.19085189067167,16
5227,103,12,112,7,-4.192929666832575,5
5228,29,26,51,14,-4.200611882951566,12
5229,3,18,103,9,-4.204198112236472,9
5230,36,56,65,32,-4.205692860728478,24
5231,48,10,52,6,-4.211289472665269,4
5232,84,19,43,10,-4.2146198508874155,9
5233,63,20,17,11,-4.217095300732271,9
5234,18,19,4,11,-4.220670692754496,8
5235,100,29,28,17,-4.221129674472951,12
5236,102,18,62,10,-4.2234688534060565,8
5237,44,11,71,6,-4.223524348839454,5
5238,38,21,9,12,-4.2241565966881796,9
5239,62,12,17,7,-4.2301807671986245,5
5240,107,59,41,36,-4.232356930880344,23
5241,104,11,29,6,-4.232469176091443,5
5242,65,32,49,18,-4.235437559418131,14
5243,58,14,12,8,-4.239755277925306,6
5244,87,31,71,17,-4.240167636343153,14
5245,71,44,16,26,-4.24180487871631,18
5246,34,14,106,7,-4.243674039664677,7
5247,72,10,6,5,-4.248570153213717,5
5248,104,62,86,35,-4.25024591812339,27
5249,87,29,108,16,-4.255919125935353,13
5250,106,55,37,29,-4.262507559544696,26
5251,49,20,50,11,-4.263153819097887,9
5252,19,47,100,27,-4.274343208098634,20
5253,15,20,114,11,-4.283176268910454,9
5254,52,15,30,9,-4.285939641259885,6
5255,55,45,37,24,-4.301001080588835,21
5256,53,27,106,14,-4.302319600135904,13
5257,78,29,100,17,-4.306504123439815,12
5258,109,45,88,27,-4.312126403910374,18
5259,17,23,97,13,-4.313428551304964,10
5260,88,53,11,31,-4.315288914266511,22
5261,40,22,4,12,-4.316643149060886,10
5262,77,15,112,10,-4.331879954372317,5
5263,41,19,95,11,-4.33214397979218,8
5264,22,12,60,7,-4.334241842742773,5
5265,3,29,11,17,-4.336087828492777,12
5266,13,40,12,26,-4.341371143569527,14
5267,65,29,70,18,-4.343984179663611,11
5268,6,16,65,9,-4.346168811124804,7
5269,83,11,19,6,-4.35939819270106,5
5270,71,31,64,19,-4.3594731378011655,12
5271,23,20,95,11,-4.361896262769259,9
5272,70,17,49,9,-4.364791676107705,8
5273,3,60,27,34,-4.366790070220602,26
5274,9,15,74,9,-4.367415226980933,6
5275,23,23,40,13,-4.368423326803304,10
5276,58,13,55,7,-4.3690044835062585,6
5277,72,17,50,10,-4.375655689739112,7
5278,25,33,87,18,-4.379098196808539,15
5279,54,10,99,6,-4.379722874612374,4
5280,5,35,76,20,-4.4006703577730075,15
5281,28,53,20,30,-4.401187083369335,23
5282,108,14,71,8,-4.402422140240555,6
5283,15,21,47,11,-4.413268254147364,10
5284,81,36,86,23,-4.413702097160574,13
5285,50,55,16,32,-4.41371963953955,23
5286,5,118,86,67,-4.4152564938780525,51
5287,64,24,50,13,-4.415510499418937,11
5288,53,64,7,36,-4.416213736910667,28
5289,70,30,84,17,-4.416286467774103,13
5290,107,82,88,48,-4.417922077161399,34
5291,23,17,29,9,-4.418393467914162,8
5292,13,30,99,17,-4.4209668288342625,13
5293,20,14,23,8,-4.427778675436007,6
5294,3,35,65,21,-4.429509708162627,14
5295,70,39,37,23,-4.433263990915908,16
5296,107,78,100,41,-4.436649878456105,37
5297,109,15,95,9,-4.44413143370079,6
5298,19,14,50,8,-4.445333605009821,6
5299,3,29,41,19,-4.44975974563974,10
5300,97,11,77,7,-4.454901155383995,4
5301,85,14,19,8,-4.456802611003387,6
5302,49,11,96,6,-4.460220810874953,5
5303,54,15,79,9,-4.4628144491387465,6
5304,32,18,37,10,-4.466542082918523,8
5305,11,47,51,28,-4.472212048209777,19
5306,94,11,108,6,-4.472725388082187,5
5307,25,31,96,17,-4.472832877552796,14
5308,103,18,72,10,-4.478916130706035,8
5309,64,46,7,25,-4.481240056988838,21
5310,71,44,75,27,-4.485645835804011,17
5311,41,43,87,24,-4.49381868653754,19
5312,39,21,58,12,-4.494576390875354,9
5313,60,47,55,26,-4.496007919155315,21
5314,46,68,13,40,-4.497540419141799,28
5315,8,28,64,17,-4.503057942170459,11
5316,54,64,63,37,-4.513765725874225,27
5317,93,16,20,8,-4.515352163146574,8
5318,112,18,49,10,-4.51791122222607,8
5319,50,23,74,13,-4.520207268757789,10
5320,28,44,55,26,-4.526943972884062,18
5321,55,10,52,6,-4.531437489197341,4
5322,75,23,106,12,-4.532198108241352,11
5323,28,29,93,18,-4.540056078542574,11
5324,15,18,99,11,-4.551461310618722,7
5325,46,15,83,8,-4.551826612706295,7
5326,87,40,95,22,-4.552785676720849,18
5327,23,15,70,8,-4.554568026577774,7
5328,5,18,43,10,-4.559277543830877,8
5329,15,17,62,9,-4.561003044831276,8
5330,104,16,99,8,-4.5627492392393005,8
5331,95,14,99,8,-4.572737764013049,6
5332,58,23,7,12,-4.5750345256693405,11
5333,65,16,99,9,-4.579704538683155,7
5334,37,15,9,8,-4.590013554185221,7
5335,54,26,78,15,-4.592600537057526,11
5336,96,32,50,18,-4.592653394244438,14
5337,78,45,13,26,-4.597389344309831,19
5338,58,11,27,6,-4.599497662673681,5
5339,39,18,80,10,-4.600479594629686,8
5340,60,19,108,11,-4.601423271346146,8
5341,18,15,38,8,-4.607415756411177,7
5342,96,21,13,12,-4.608058597276484,9
5343,37,40,75,25,-4.608119905928107,15
5344,77,31,49,19,-4.610744146535698,12
5345,57,11,74,6,-4.613445177041247,5
5346,68,20,85,13,-4.615895850726343,7
5347,40,10,72,6,-4.616108231770903,4
5348,19,26,62,16,-4.622905769372407,10
5349,109,44,51,28,-4.624306959512696,16
5350,88,37,100,22,-4.625717286575204,15
5351,89,13,65,7,-4.632113459581723,6
5352,91,16,102,9,-4.632859199025976,7
5353,110,15,106,8,-4.633960085739292,7
5354,25,22,60,12,-4.63628280649392,10
5355,69,11,80,6,-4.638884395252672,5
5356,96,39,63,24,-4.649023449526143,15
5357,1,16,15,10,-4.649350840919031,6
5358,79,13,27,7,-4.651583262533679,6
5359,47,15,25,8,-4.655390231832651,7
5360,23,54,107,30,-4.657221706463222,24
5361,87,13,89,8,-4.661119949921155,5
5362,98,26,11,14,-4.667493378770945,12
5363,92,10,75,6,-4.670779177266829,4
5364,39,51,40,30,-4.685059105758994,21
5365,38,27,88,17,-4.695779895234789,10
5366,88,73,65,44,-4.702916833614272,29
5367,106,13,111,9,-4.703726078810505,4
5368,37,22,41,13,-4.708031554461573,9
5369,46,23,20,15,-4.708713070266477,8
5370,45,11,30,7,-4.71768267651097,4
5371,31,32,75,17,-4.72198275034643,15
5372,104,34,41,18,-4.7268653056009,16
5373,108,13,25,8,-4.727424255422313,5
5374,107,46,76,29,-4.736244325803577,17
5375,7,107,16,60,-4.744562074788692,47
5376,77,16,25,9,-4.745845616411634,7
5377,50,23,7,13,-4.754905099968972,10
5378,87,40,18,23,-4.75669359062204,17
5379,62,14,106,8,-4.759729251582842,6
5380,84,28,13,17,-4.762106527456084,11
5381,94,16,55,9,-4.767452995148849,7
5382,98,15,18,7,-4.76828904567196,8
5383,31,15,12,8,-4.7706324645211815,7
5384,70,13,90,7,-4.771084444295364,6
5385,23,14,33,8,-4.772846471482117,6
5386,5,12,9,7,-4.777710715122406,5
5387,98,10,34,5,-4.779193341125504,5
5388,30,28,50,16,-4.780811288699289,12
5389,87,28,72,15,-4.78103232912852,13
5390,81,25,15,14,-4.7836577803432645,11
5391,10,12,5,6,-4.788462999241516,6
5392,89,10,26,6,-4.7934486550169115,4
5393,20,13,52,8,-4.795236183864798,5
5394,25,11,111,6,-4.797175922879401,5
5395,88,14,34,8,-4.799596567728281,6
5396,97,22,41,12,-4.799957538599525,10
5397,96,22,75,15,-4.801381492311929,7
5398,12,16,1,9,-4.804302234326604,7
5399,68,14,89,8,-4.8060770512882325,6
5400,16,75,30,45,-4.810756321281797,30
5401,63,34,104,19,-4.811269466320188,15
5402,79,23,13,14,-4.81127521378253,9
5403,85,11,74,6,-4.8123880044938,5
5404,65,112,16,64,-4.817496389223385,48
5405,54,15,14,10,-4.820525855929134,5
5406,25,19,31,10,-4.823839301099769,9
5407,65,25,90,13,-4.825235861891515,12
5408,67,15,8,9,-4.831909846155587,6
5409,64,20,83,11,-4.840996077098241,9
5410,83,17,39,10,-4.845386042652685,7
5411,96,22,39,14,-4.8469385601006945,8
5412,94,31,30,17,-4.848071493453302,14
5413,60,34,78,19,-4.850344284158851,15
5414,32,12,97,7,-4.851459349576825,5
5415,114,11,77,6,-4.854209160918305,5
5416,88,46,23,28,-4.856004139813015,18
5417,107,38,58,23,-4.857008495705356,15
5418,112,31,100,17,-4.858414274039207,14
5419,3,24,81,14,-4.860040341211916,10
5420,51,33,49,19,-4.860731289374452,14
5421,89,10,5,7,-4.8624656409017435,3
5422,64,10,95,5,-4.863376640358333,5
5423,1,11,29,7,-4.866934575588786,4
5424,57,26,88,14,-4.87081224887015,12
5425,87,42,23,25,-4.879954184264544,17
5426,79,20,63,12,-4.882182316485546,8
5427,95,11,69,7,-4.882909765417964,4
5428,18,12,94,7,-4.884425557504233,5
5429,72,12,20,7,-4.886775559464282,5
5430,108,12,29,7,-4.887109798889699,5
5431,46,11,27,7,-4.887638683251712,4
5432,101,10,39,6,-4.889741278103361,4
5433,77,43,13,25,-4.906794574928388,18
5434,28,12,38,6,-4.907164394244709,6
5435,29,11,18,7,-4.9072911901611125,4
5436,30,13,47,6,-4.910819083779561,7
5437,15,13,34,8,-4.917498933434509,5
5438,106,56,74,32,-4.924754963776781,24
5439,63,17,108,10,-4.925158043652064,7
5440,36,40,86,23,-4.92743325124,17
5441,103,10,104,5,-4.929333969571576,5
5442,85,17,63,9,-4.93137224468223,8
5443,51,72,100,38,-4.940002025939465,34
5444,37,26,98,15,-4.940519420053042,11
5445,71,11,49,6,-4.9409457894604065,5
5446,32,14,28,8,-4.942148577857081,6
5447,78,15,40,10,-4.942465399220725,5
5448,81,23,39,14,-4.943832581007462,9
5449,106,29,80,17,-4.946009667025367,12
5450,68,19,56,10,-4.94813216675333,9
5451,100,12,20,7,-4.94868435190728,5
5452,41,33,64,20,-4.951397157092097,13
5453,16,38,97,21,-4.9536962755291185,17
5454,64,10,85,6,-4.962701184974941,4
5455,90,23,96,14,-4.963939687748074,9
5456,114,21,27,12,-4.967571693509976,9
5457,23,11,98,6,-4.969965161139004,5
5458,44,10,80,5,-4.973541413806903,5
5459,86,73,37,41,-4.980857284592115,32
5460,55,34,80,18,-4.9879675297352755,16
5461,94,19,63,11,-4.988953899876627,8
5462,31,23,50,13,-4.991999785997779,10
5463,77,26,3,14,-4.9989738181650925,12
5464,96,23,51,13,-5.001175453325252,10
5465,106,41,7,21,-5.003800212982271,20
5466,34,25,100,13,-5.004456878240623,12
5467,5,26,93,16,-5.004460526821323,10
5468,83,13,102,8,-5.005327574584489,5
5469,72,24,85,15,-5.005644721261359,9
5470,43,35,39,19,-5.006459842543771,16
5471,94,17,112,11,-5.010192110959226,6
5472,63,12,93,7,-5.011120266810433,5
5473,18,19,55,10,-5.012210431301632,9
5474,51,30,108,17,-5.016985241457157,13
5475,60,50,30,32,-5.01777904981637,18
5476,38,20,109,13,-5.020675554109466,7
5477,86,25,47,15,-5.026594655071246,10
5478,34,12,112,7,-5.029259987635679,5
5479,93,26,74,14,-5.031462008142044,12
5480,91,16,40,9,-5.034652795604084,7
5481,108,18,30,11,-5.041583987630236,7
5482,8,34,34,20,-5.045872609442448,14
5483,2,23,20,13,-5.04811788923968,10
5484,75,20,95,12,-5.050260152484929,8
5485,35,23,16,14,-5.053981282073501,9
5486,55,27,100,14,-5.057275002393836,13
5487,10,16,7,9,-5.060407065651965,7
5488,61,10,41,6,-5.060781095904458,4
5489,100,38,104,22,-5.075921827905519,16
5490,64,23,3,13,-5.079848362911417,10
5491,20,10,32,7,-5.082163415292113,3
5492,30,28,15,16,-5.083664216760197,12
5493,5,15,34,10,-5.091205514677906,5
5494,39,18,69,10,-5.092034225030051,8
5495,30,24,34,14,-5.093231704876005,10
5496,33,14,49,9,-5.095253781724573,5
5497,8,100,16,59,-5.098937538254701,41
5498,1,10,30,6,-5.107240382060614,4
5499,76,10,64,5,-5.126258276838511,5
5500,103,17,78,12,-5.128778719706272,5
5501,12,20,103,10,-5.129139372345028,10
5502,33,14,64,9,-5.132334361355243,5
5503,58,30,40,16,-5.133397385337805,14
5504,77,25,107,14,-5.133888332698847,11
5505,3,21,36,13,-5.136055944816982,8
5506,8,17,72,9,-5.1378199606498285,8
5507,71,15,70,8,-5.140933357571855,7
5508,49,48,27,28,-5.1421479817942535,20
5509,70,17,13,10,-5.142156998200086,7
5510,97,13,11,7,-5.1491543911628765,6
5511,9,24,106,14,-5.150083731218857,10
5512,60,57,39,32,-5.152802282703841,25
5513,28,16,35,8,-5.153123660542294,8
5514,5,12,67,7,-5.159840528973079,5
5515,96,29,65,16,-5.165027076154164,13
5516,54,11,31,6,-5.168002033532433,5
5517,32,19,11,10,-5.169600921182679,9
5518,48,12,91,6,-5.179665478095682,6
5519,97,17,75,10,-5.1834390154874335,7
5520,103,11,89,6,-5.18386462486891,5
5521,71,10,6,6,-5.193692278292731,4
5522,113,13,40,8,-5.1937263926866155,5
5523,80,18,104,10,-5.194103195079235,8
5524,39,25,46,12,-5.196853389468726,13
5525,49,27,78,15,-5.198224201350137,12
5526,43,21,63,12,-5.207688448634705,9
5527,109,22,50,13,-5.207842202449347,9
5528,91,12,33,6,-5.213867650447786,6
5529,81,17,19,10,-5.2181130875891135,7
5530,86,20,10,11,-5.2191524654968555,9
5531,88,101,7,58,-5.220134457500585,43
5532,106,54,54,29,-5.222938310920246,25
5533,39,23,92,12,-5.223931097826435,11
5534,5,11,35,6,-5.226534281744123,5
5535,107,60,75,39,-5.231874163862644,21
5536,25,21,91,12,-5.236778929543696,9
5537,77,23,78,13,-5.23845431348766,10
5538,40,26,25,15,-5.242222631716464,11
5539,31,11,35,6,-5.255104723881266,5
5540,100,80,16,48,-5.259335703188094,32
5541,35,29,107,18,-5.259758635892076,11
5542,1,11,34,8,-5.259854618241466,3
5543,102,26,11,14,-5.269694308768166,12
5544,6,20,88,12,-5.272285617199486,8
5545,62,23,13,13,-5.279557581763116,10
5546,109,13,62,6,-5.284405260681897,7
5547,92,12,28,8,-5.284547759707863,4
5548,86,21,99,13,-5.291638236148404,8
5549,8,17,43,9,-5.29262224723472,8
5550,15,53,57,30,-5.293604507571547,23
5551,53,13,57,7,-5.295668988217709,6
5552,81,14,77,8,-5.30360249712173,6
5553,87,19,73,13,-5.303982369774458,6
5554,47,13,58,8,-5.305481766967035,5
5555,61,15,86,9,-5.314125600249347,6
5556,19,19,38,13,-5.315551758815004,6
5557,34,21,12,12,-5.315921719029712,9
5558,3,40,7,24,-5.315954351050264,16
5559,90,36,54,21,-5.31608911225222,15
5560,51,33,5,21,-5.328986421528186,12
5561,102,14,97,9,-5.335160623731833,5
5562,53,53,68,31,-5.342360173932807,22
5563,50,18,78,11,-5.342630350789609,7
5564,48,22,13,13,-5.345621103460161,9
5565,49,31,17,16,-5.351365626248913,15
5566,96,12,15,7,-5.353611172107386,5
5567,97,35,7,19,-5.356987360153852,16
5568,39,36,84,20,-5.36967448681498,16
5569,18,25,15,15,-5.370261713586335,10
5570,29,20,76,10,-5.371211242445575,10
5571,103,16,65,10,-5.377768524309902,6
5572,109,22,100,14,-5.379853421224187,8
5573,68,38,54,23,-5.382447112107092,15
5574,87,42,48,26,-5.383765877890527,16
5575,106,14,6,8,-5.390411966564588,6
5576,33,20,8,12,-5.397787705463005,8
5577,58,11,4,7,-5.405037105567137,4
5578,106,26,2,15,-5.41401262665605,11
5579,27,51,100,29,-5.416295940725653,22
5580,25,38,104,21,-5.422383455319622,17
5581,69,13,42,7,-5.432900919803655,6
5582,68,29,71,18,-5.43565333686224,11
5583,20,50,65,31,-5.436416455030898,19
5584,37,38,13,22,-5.4444858267423255,16
5585,38,19,8,11,-5.455715550555012,8
5586,50,13,57,8,-5.460704285123109,5
5587,74,13,31,8,-5.4682993706513905,5
5588,17,31,28,18,-5.468605078583842,13
5589,98,14,57,8,-5.474149624282838,6
5590,25,22,100,12,-5.476003695191376,10
5591,54,46,13,27,-5.479487703639157,19
5592,15,15,108,9,-5.486650476336331,6
5593,55,27,111,16,-5.492663797248299,11
5594,102,10,67,6,-5.497246561771854,4
5595,69,28,58,15,-5.500786187625181,13
5596,111,10,5,6,-5.501968622126494,4
5597,40,13,2,8,-5.504797437287728,5
5598,109,13,32,7,-5.508051897308614,6
5599,38,32,39,19,-5.509418569416409,13
5600,81,10,80,5,-5.509744831821594,5
5601,83,19,95,12,-5.510188596504651,7
5602,65,23,45,12,-5.510611418282088,11
5603,84,10,89,5,-5.518590211576736,5
5604,77,15,74,9,-5.523098396212754,6
5605,102,11,64,7,-5.525256448935211,4
5606,85,11,8,7,-5.538404103047143,4
5607,70,11,44,6,-5.543204446478318,5
5608,75,42,18,24,-5.546579166688548,18
5609,84,18,25,11,-5.546687618128967,7
5610,31,53,36,30,-5.548564460468655,23
5611,25,41,8,25,-5.550067480025429,16
5612,54,16,69,9,-5.552096999235808,7
5613,46,44,8,24,-5.55305372609631,20
5614,65,86,104,49,-5.554661796165203,37
5615,4,11,46,6,-5.556221874645653,5
5616,95,30,13,17,-5.5569838085167085,13
5617,95,10,31,6,-5.5581891593402775,4
5618,20,63,107,36,-5.562332766197244,27
5619,88,98,86,57,-5.562390170991595,41
5620,9,11,72,6,-5.567587328744072,5
5621,38,23,7,13,-5.5754388810337625,10
5622,44,22,20,13,-5.576158683247873,9
5623,86,38,69,22,-5.5778024324397695,16
5624,96,38,20,23,-5.591064360306497,15
5625,64,17,80,9,-5.593698551425533,8
5626,86,88,11,51,-5.601840851498305,37
5627,10,11,23,6,-5.611414438981724,5
5628,98,16,102,9,-5.616900846312716,7
5629,91,26,68,14,-5.619466372772095,12
5630,50,26,95,15,-5.619957219349119,11
5631,5,10,19,6,-5.623378775596125,4
5632,20,16,78,9,-5.629467930549494,7
5633,86,43,64,25,-5.632716173751322,18
5634,46,16,109,9,-5.636528034552761,7
5635,51,47,78,25,-5.638766096914631,22
5636,104,18,62,12,-5.643310295152116,6
5637,38,13,108,8,-5.644414418783651,5
5638,19,37,29,23,-5.646461013632089,14
5639,97,13,39,8,-5.649731064357224,5
5640,97,10,4,6,-5.649870700339141,4
5641,16,44,20,28,-5.6538868890789145,16
5642,75,31,46,18,-5.654705399493309,13
5643,2,13,30,7,-5.655225265692612,6
5644,88,36,25,23,-5.660869431868404,13
5645,84,37,16,22,-5.660913981238356,15
5646,82,11,54,7,-5.664278302313933,4
5647,99,31,16,18,-5.665818337043018,13
5648,25,10,94,5,-5.671887186214522,5
5649,19,55,87,33,-5.685217473862323,22
5650,95,10,102,6,-5.685319962340827,4
5651,114,17,76,11,-5.686109810518632,6
5652,40,21,35,13,-5.68914021357686,8
5653,32,10,70,5,-5.69247937209622,5
5654,62,17,53,10,-5.701449545318571,7
5655,72,23,54,14,-5.711828677342122,9
5656,12,16,69,8,-5.715951067980106,8
5657,9,11,93,7,-5.723540166631908,4
5658,51,26,25,15,-5.726135112848953,11
5659,87,75,8,44,-5.726611414139773,31
5660,9,14,45,9,-5.7278535004589894,5
5661,54,40,55,22,-5.729162102948166,18
5662,47,31,107,18,-5.730039668040248,13
5663,64,50,13,27,-5.733384315133941,23
5664,87,37,94,21,-5.733861435476388,16
5665,106,42,25,26,-5.737688222420903,16
5666,57,22,103,13,-5.739096182156349,9
5667,114,25,100,15,-5.743860264273012,10
5668,18,25,50,14,-5.74537053291684,11
5669,77,12,36,7,-5.751140829309575,5
5670,19,34,11,21,-5.756316664639485,13
5671,53,13,58,6,-5.756559382638675,7
5672,63,32,64,18,-5.757572899301189,14
5673,68,15,80,9,-5.759836210772854,6
5674,49,43,87,23,-5.762852743279542,20
5675,54,10,61,6,-5.763750710129662,4
5676,87,25,58,15,-5.7682346867020975,10
5677,60,45,23,27,-5.772794691627651,18
5678,50,18,15,11,-5.776077652807675,7
5679,81,16,104,8,-5.786821230718971,8
5680,9,21,17,12,-5.788074839959892,9
5681,48,21,34,12,-5.788285695597516,9
5682,11,19,62,11,-5.78936924763006,8
5683,17,21,11,12,-5.800640520347569,9
5684,31,19,91,12,-5.801858258461764,7
5685,106,11,10,8,-5.803672894932926,3
5686,37,65,87,38,-5.805092251858705,27
5687,98,19,8,12,-5.806615359942181,7
5688,109,20,73,12,-5.807578339260897,8
5689,20,13,79,8,-5.810117746469003,5
5690,75,56,86,31,-5.819454003755878,25
5691,103,32,86,20,-5.822946833329546,12
5692,93,37,8,21,-5.824171473230354,16
5693,25,49,13,27,-5.82760144771215,22
5694,13,40,63,23,-5.83698160270361,17
5695,57,34,8,21,-5.8373147484651255,13
5696,66,13,88,8,-5.8387523732132625,5
5697,49,29,54,17,-5.8414712309316155,12
5698,93,23,16,12,-5.842811946264205,11
5699,69,40,13,24,-5.843363292908417,16
5700,14,17,65,9,-5.850273562995321,8
5701,79,12,80,6,-5.851472407179259,6
5702,93,16,75,9,-5.854064268882732,7
5703,51,52,104,33,-5.856995324327739,19
5704,112,21,7,13,-5.863389950487477,8
5705,7,17,34,10,-5.863504951401842,7
5706,8,31,18,20,-5.865710785121708,11
5707,95,36,54,20,-5.865979569344116,16
5708,98,18,55,11,-5.870446924304781,7
5709,109,18,94,10,-5.873110590864873,8
5710,91,19,51,12,-5.873980399232273,7
5711,31,12,28,7,-5.876337878232255,5
5712,36,12,46,7,-5.882094180819337,5
5713,74,22,102,13,-5.882481039476397,9
5714,108,17,75,10,-5.885506345854971,7
5715,57,15,10,10,-5.887280827061498,5
5716,43,16,17,9,-5.888801333071097,7
5717,3,11,37,6,-5.889738338475403,5
5718,40,52,65,30,-5.891062339928423,22
5719,68,15,101,10,-5.891939886749792,5
5720,9,45,75,27,-5.89399328159944,18
5721,98,10,38,6,-5.899897776783364,4
5722,3,18,54,10,-5.900167075724966,8
5723,110,22,37,12,-5.913666685850415,10
5724,80,15,90,10,-5.9152161026884,5
5725,88,84,54,50,-5.915269494128592,34
5726,7,23,78,12,-5.919551023484507,11
5727,60,18,61,10,-5.9227502194184884,8
5728,114,20,73,12,-5.924435121305102,8
5729,104,26,53,15,-5.936620222245529,11
5730,17,48,16,31,-5.94023234098231,17
5731,53,15,28,9,-5.94574436463327,6
5732,65,56,27,34,-5.9505220277082325,22
5733,10,12,97,6,-5.9508315819177,6
5734,50,46,104,28,-5.958647190439791,18
5735,29,34,39,18,-5.9660900499545715,16
5736,40,18,97,11,-5.9669184161403885,7
5737,81,16,47,10,-5.967835030110961,6
5738,8,30,78,18,-5.971195592839113,12
5739,18,20,64,12,-5.974775055211903,8
5740,3,52,16,32,-5.976983247695231,20
5741,109,13,71,8,-5.977466642753509,5
5742,72,15,30,9,-5.981031131976351,6
5743,37,17,94,10,-5.9815536162143665,7
5744,97,28,87,18,-5.983886061129735,10
5745,86,57,27,34,-5.991658190462793,23
5746,31,25,114,14,-5.991876520395491,11
5747,29,18,28,10,-5.99194760387537,8
5748,87,62,68,37,-5.999176916704002,25
5749,54,21,94,12,-6.000772945562414,9
5750,63,26,57,14,-6.001123193099421,12
5751,5,47,106,29,-6.005839560090041,18
5752,9,51,65,31,-6.006217714596816,20
5753,104,69,107,41,-6.010771127855346,28
5754,53,37,16,23,-6.0109581007292086,14
5755,35,18,27,11,-6.016767935838181,7
5756,48,15,29,9,-6.020141509256064,6
5757,107,132,16,82,-6.020709478551167,50
5758,68,10,26,6,-6.030745942778485,4
5759,98,24,7,15,-6.033686003781979,9
5760,55,41,104,24,-6.036207114699969,17
5761,63,62,8,35,-6.040704829296192,27
5762,51,30,62,18,-6.046321991251016,12
5763,18,24,63,15,-6.046455003215185,9
5764,68,22,20,12,-6.050979140814712,10
5765,28,22,41,13,-6.053005216366935,9
5766,84,22,98,14,-6.061006275589921,8
5767,77,22,55,13,-6.070240499873465,9
5768,90,11,3,6,-6.078153120016463,5
5769,102,13,23,7,-6.080684731147932,6
5770,15,33,60,19,-6.08275874538289,14
5771,84,26,9,15,-6.089357364465301,11
5772,108,14,96,8,-6.092516088942799,6
5773,47,11,54,6,-6.095812400128515,5
5774,69,16,62,9,-6.098141811871047,7
5775,15,12,84,7,-6.098921486728437,5
5776,76,30,98,18,-6.108080609901334,12
5777,7,12,90,7,-6.108519045195328,5
5778,48,13,10,8,-6.11091450287738,5
5779,66,24,107,14,-6.11591039623151,10
5780,31,13,81,9,-6.117159791325402,4
5781,66,18,63,11,-6.119936177330313,7
5782,48,17,76,11,-6.130488708954145,6
5783,43,15,23,9,-6.148918923918837,6
5784,74,24,73,15,-6.15033234594065,9
5785,68,48,114,28,-6.151577271829131,20
5786,7,32,100,19,-6.153012622391108,13
5787,81,11,50,6,-6.158903696641054,5
5788,100,25,23,15,-6.1602001909122555,10
5789,28,58,104,34,-6.1611678298334525,24
5790,36,47,13,29,-6.167141158071527,18
5791,93,10,80,5,-6.175234905241022,5
5792,28,17,47,10,-6.182374184386464,7
5793,40,73,13,42,-6.184837754544506,31
5794,63,21,90,12,-6.196182582339524,9
5795,87,39,76,24,-6.196326349442491,15
5796,2,28,63,16,-6.200018491851488,12
5797,70,28,74,15,-6.203999405338757,13
5798,71,30,50,17,-6.204695227712774,13
5799,88,26,108,16,-6.206778138596414,10
5800,84,15,35,9,-6.209299301194261,6
5801,70,24,114,15,-6.214622620602995,9
5802,70,37,28,22,-6.2149266559981875,15
5803,94,10,95,5,-6.229015093991729,5
5804,5,48,114,28,-6.237633533478719,20
5805,63,49,37,30,-6.239339617220504,19
5806,57,15,38,8,-6.244977724558426,7
5807,46,10,48,6,-6.2577441282220505,4
5808,55,65,107,38,-6.262965189618901,27
5809,95,12,15,7,-6.265255655621165,5
5810,103,17,43,11,-6.266249297468395,6
5811,5,45,20,28,-6.270373633442779,17
5812,70,24,55,14,-6.2726471619319275,10
5813,4,21,86,13,-6.279484499549702,8
5814,93,14,29,8,-6.281843189307092,6
5815,4,15,12,10,-6.285579029533404,5
5816,68,68,40,42,-6.288399173895761,26
5817,84,18,100,12,-6.292769168431846,6
5818,102,36,28,21,-6.294379170221608,15
5819,97,55,86,32,-6.29556894674749,23
5820,53,48,107,29,-6.300738049492765,19
5821,50,19,3,11,-6.302491398681792,8
5822,60,35,49,21,-6.302798279430961,14
5823,107,41,48,24,-6.323493383217477,17
5824,51,37,77,21,-6.3237027482982455,16
5825,55,12,89,7,-6.33577587353113,5
5826,7,34,28,21,-6.339260574445828,13
5827,91,16,15,8,-6.341064031534599,8
5828,9,43,28,24,-6.342362216975378,19
5829,75,15,15,10,-6.343731652265016,5
5830,96,17,85,12,-6.345069391274803,5
5831,27,13,92,7,-6.356396578041118,6
5832,46,24,7,16,-6.3620461131037525,8
5833,37,10,56,6,-6.367440662879469,4
5834,102,15,33,9,-6.371524301983967,6
5835,17,18,72,11,-6.374145428769874,7
5836,98,20,70,13,-6.375551069484688,7
5837,27,16,28,11,-6.382931621067466,5
5838,96,13,33,6,-6.392035038140804,7
5839,48,38,86,23,-6.392497095701154,15
5840,70,62,54,37,-6.3937515742988325,25
5841,49,12,79,8,-6.395374558799645,4
5842,37,20,80,12,-6.401050818487375,8
5843,55,21,48,13,-6.406579400537664,8
5844,54,18,91,10,-6.414686940093469,8
5845,65,38,64,22,-6.415105269042927,16
5846,62,20,7,12,-6.416308867276496,8
5847,68,23,29,14,-6.416741070326833,9
5848,23,10,61,6,-6.419517618014349,4
5849,86,48,41,30,-6.421498587390495,18
5850,48,28,84,17,-6.421668889523295,11
5851,80,23,96,14,-6.423400971659432,9
5852,100,21,75,11,-6.42687784088126,10
5853,74,15,89,9,-6.429670108852098,6
5854,94,18,69,11,-6.4324341241447325,7
5855,15,29,29,17,-6.442607839265635,12
5856,19,25,41,16,-6.446423665891768,9
5857,87,40,78,24,-6.450776166412693,16
5858,33,16,68,10,-6.451134609706935,6
5859,54,28,93,18,-6.453790444084363,10
5860,91,20,8,12,-6.453847873736635,8
5861,10,15,11,9,-6.454288934219355,6
5862,15,12,35,6,-6.4672967653015005,6
5863,68,11,98,7,-6.46992769597506,4
5864,77,10,80,6,-6.477746915706978,4
5865,87,62,100,35,-6.484057869538875,27
5866,76,28,112,16,-6.4984423567384235,12
5867,76,25,13,15,-6.503302760367722,10
5868,55,29,74,17,-6.503619546467792,12
5869,65,66,55,39,-6.5120252706716855,27
5870,66,20,60,13,-6.515171561917174,7
5871,12,16,98,10,-6.517291711023471,6
5872,87,84,13,52,-6.521909690525374,32
5873,49,12,95,8,-6.522771930281714,4
5874,64,16,44,10,-6.52641817446092,6
5875,38,12,102,9,-6.529266346603467,3
5876,80,13,91,8,-6.531108694088667,5
5877,34,14,94,8,-6.531647534575399,6
5878,13,48,81,30,-6.534046463710119,18
5879,77,30,39,17,-6.543255167179637,13
5880,112,16,58,9,-6.5464579572728105,7
5881,23,32,106,17,-6.549055396089183,15
5882,41,28,23,17,-6.550829980754915,11
5883,65,15,85,9,-6.556919781757102,6
5884,97,26,55,16,-6.559887224901373,10
5885,19,22,64,15,-6.560999233342088,7
5886,30,15,112,10,-6.562692428407155,5
5887,91,15,74,9,-6.5630560139016625,6
5888,49,24,34,14,-6.563193871261935,10
5889,63,31,75,18,-6.570041946714361,13
5890,69,29,78,17,-6.570244276121928,12
5891,114,26,53,15,-6.571088082289223,11
5892,57,28,84,15,-6.577348977317856,13
5893,101,11,27,7,-6.582303845846215,4
5894,73,29,86,16,-6.584732384148774,13
5895,3,33,49,19,-6.592008597219499,14
5896,90,14,41,8,-6.596764805214359,6
5897,13,16,73,10,-6.598047492921338,6
5898,13,52,71,30,-6.60226683262218,22
5899,43,20,64,12,-6.605345215745443,8
5900,93,13,30,8,-6.605367379129465,5
5901,35,25,11,15,-6.6098986532599575,10
5902,29,15,70,8,-6.61208942766715,7
5903,64,18,70,12,-6.615054052504195,6
5904,77,12,102,7,-6.618078815941925,5
5905,5,48,25,29,-6.626414170343123,19
5906,51,102,39,61,-6.628453471772385,41
5907,63,29,98,17,-6.629039814212707,12
5908,13,43,47,26,-6.6302542913878515,17
5909,37,22,39,13,-6.6321566948630455,9
5910,65,30,4,18,-6.635600395573754,12
5911,71,16,74,9,-6.635644376222863,7
5912,51,51,76,32,-6.6431414983377675,19
5913,5,26,32,16,-6.647447060451904,10
5914,37,19,71,11,-6.653996053488668,8
5915,71,11,83,6,-6.6562053803338666,5
5916,80,13,19,8,-6.657036501175087,5
5917,54,20,85,13,-6.664179187550934,7
5918,88,15,14,9,-6.66936824683007,6
5919,86,34,34,20,-6.674360500745735,14
5920,68,31,23,17,-6.676959480055372,14
5921,3,35,30,23,-6.678994379061112,12
5922,31,38,64,23,-6.680717740842573,15
5923,23,25,63,16,-6.701335055503617,9
5924,74,15,83,8,-6.7032980304888605,7
5925,51,115,86,66,-6.7054276981334295,49
5926,97,35,28,22,-6.716635909782018,13
5927,94,13,103,7,-6.717236128190118,6
5928,55,32,30,20,-6.725062001131896,12
5929,103,21,39,12,-6.7260659335959305,9
5930,96,38,74,24,-6.731828732252366,14
5931,69,20,15,13,-6.736896270525394,7
5932,80,13,41,8,-6.741244434437033,5
5933,19,16,104,10,-6.74217179249715,6
5934,74,23,100,14,-6.742923050259366,9
5935,68,13,45,8,-6.747691137383074,5
5936,71,10,94,6,-6.748460655059326,4
5937,109,27,63,15,-6.749986635160675,12
5938,50,17,33,10,-6.750798742645289,7
5939,88,43,39,26,-6.751316626963761,17
5940,63,64,51,36,-6.75372645182253,28
5941,29,43,65,26,-6.767708276680646,17
5942,17,18,103,12,-6.777134032154199,6
5943,30,15,17,8,-6.779357915144956,7
5944,42,10,8,5,-6.780541784776636,5
5945,57,20,97,12,-6.781237277284942,8
5946,108,15,79,10,-6.783855393965386,5
5947,87,29,80,18,-6.78798453778918,11
5948,38,14,2,8,-6.79244823778732,6
5949,100,15,47,9,-6.79657524504294,6
5950,49,16,28,9,-6.801284823553006,7
5951,108,14,28,8,-6.806119384401873,6
5952,28,21,14,14,-6.807027415542907,7
5953,102,22,50,12,-6.809919414830618,10
5954,4,13,56,7,-6.8162735158796925,6
5955,18,14,49,9,-6.821290318156632,5
5956,31,69,68,41,-6.821634358561019,28
5957,106,25,95,16,-6.830338155584791,9
5958,29,15,20,9,-6.832826874702709,6
5959,47,28,75,19,-6.839491111976111,9
5960,51,99,7,62,-6.849475435937795,37
5961,68,36,11,21,-6.855439241001142,15
5962,4,43,60,24,-6.864343045215707,19
5963,69,19,29,11,-6.870269758663408,8
5964,38,12,34,8,-6.871444823359393,4
5965,91,43,16,28,-6.876030290903078,15
5966,76,30,65,20,-6.878261201466497,10
5967,99,15,106,10,-6.882359612487443,5
5968,112,17,18,11,-6.8872676099947565,6
5969,67,13,88,9,-6.891493842154362,4
5970,14,16,39,9,-6.892280896151707,7
5971,8,32,68,19,-6.897514212007413,13
5972,68,21,58,13,-6.9046526848664955,8
5973,40,39,87,22,-6.915208460636838,17
5974,87,118,16,72,-6.930604317212722,46
5975,96,83,86,51,-6.93405772836464,32
5976,88,12,99,7,-6.939131232028662,5
5977,58,16,49,9,-6.942973037040067,7
5978,50,33,60,18,-6.944865376684981,15
5979,52,24,86,15,-6.945114778958062,9
5980,88,20,58,12,-6.951724289335951,8
5981,51,25,4,16,-6.952578906103848,9
5982,55,30,109,16,-6.952801077513015,14
5983,50,19,91,12,-6.959059467736709,7
5984,104,18,32,12,-6.959225086389552,6
5985,39,15,111,9,-6.9608600117118025,6
5986,87,22,102,14,-6.961827622477074,8
5987,36,34,16,21,-6.9623095532486765,13
5988,97,23,18,14,-6.9651635757198616,9
5989,47,14,23,9,-6.976037054038962,5
5990,43,22,57,15,-6.979538883847616,7
5991,6,12,15,8,-6.9844847610743175,4
5992,30,30,53,18,-6.98498975026545,12
5993,55,20,17,11,-6.987444025974708,9
5994,13,24,111,13,-6.9889422498925144,11
5995,5,15,62,9,-6.992708759597398,6
5996,87,21,4,14,-6.993636995986404,7
5997,37,26,30,17,-6.9952716221417335,9
5998,37,18,89,9,-7.006041314616402,9
5999,69,13,40,9,-7.006717860168273,4
6000,102,26,100,17,-7.010528546414988,9
6001,92,16,51,9,-7.0168491500307955,7
6002,53,27,87,15,-7.022639512769472,12
6003,40,15,95,9,-7.026458120737084,6
6004,43,10,80,6,-7.031005677454653,4
6005,27,19,37,12,-7.034792767414977,7
6006,60,18,94,11,-7.0351599724686675,7
6007,114,11,72,6,-7.039741382461145,5
6008,57,26,3,16,-7.046184284491375,10
6009,36,18,99,12,-7.061516094995867,6
6010,25,50,37,29,-7.070541112352608,21
6011,53,10,85,7,-7.078145746437185,3
6012,12,15,63,8,-7.082818499870269,7
6013,3,27,104,17,-7.08628040850776,10
6014,55,21,27,14,-7.087211713998168,7
6015,38,26,63,18,-7.091217263422915,8
6016,45,10,1,6,-7.100044646871245,4
6017,54,32,100,20,-7.1062650526850275,12
6018,55,51,40,32,-7.109300201154281,19
6019,106,64,13,39,-7.112707704477981,25
6020,7,33,45,20,-7.1141476412284765,13
6021,83,30,86,20,-7.11486297608935,10
6022,35,10,57,7,-7.121001943594234,3
6023,107,12,67,8,-7.124134838046413,4
6024,77,21,72,12,-7.125122343869388,9
6025,93,12,13,7,-7.127658172301537,5
6026,63,77,16,47,-7.128365700865015,30
6027,58,14,30,9,-7.134101849433167,5
6028,15,39,27,22,-7.136849333340006,17
6029,78,13,33,8,-7.142209395263028,5
6030,69,12,111,7,-7.144443379259749,5
6031,51,26,97,17,-7.145200913148903,9
6032,37,14,29,8,-7.147246302868524,6
6033,103,29,27,18,-7.1483638951641275,11
6034,3,25,114,16,-7.152889180930057,9
6035,60,23,17,14,-7.159951280063793,9
6036,14,14,86,8,-7.166696838482465,6
6037,57,19,114,12,-7.1681797791764685,7
6038,61,13,30,8,-7.169715355965246,5
6039,112,16,36,10,-7.175574629533444,6
6040,29,24,98,15,-7.180316216962129,9
6041,88,50,63,32,-7.181466866993262,18
6042,43,15,112,9,-7.1893251112725824,6
6043,95,14,14,9,-7.1971223272437035,5
6044,78,20,15,11,-7.2046295834224425,9
6045,15,17,12,10,-7.205252182553482,7
6046,93,14,98,8,-7.212314028509714,6
6047,90,15,30,9,-7.212567303813307,6
6048,88,129,16,80,-7.215072234032144,49
6049,46,49,16,31,-7.21524117201606,18
6050,12,31,78,21,-7.222144018862552,10
6051,30,16,114,9,-7.223280031087748,7
6052,40,27,114,18,-7.240772461331045,9
6053,5,14,31,9,-7.246607645789557,5
6054,3,32,19,19,-7.248295900826971,13
6055,8,42,13,26,-7.249552270590034,16
6056,103,26,11,17,-7.251690186306058,9
6057,96,12,69,8,-7.252755690648866,4
6058,89,16,51,10,-7.254363659794546,6
6059,81,19,75,12,-7.259552889264537,7
6060,48,14,100,8,-7.263809625362945,6
6061,98,17,20,11,-7.267496359610289,6
6062,70,16,110,10,-7.267896542251019,6
6063,96,10,62,7,-7.268496266352457,3
6064,68,20,55,13,-7.2739791513354835,7
6065,17,18,23,11,-7.286484354574565,7
6066,54,18,2,12,-7.287492324178091,6
6067,40,31,43,18,-7.287691070183644,13
6068,98,27,5,16,-7.2988387616369135,11
6069,3,28,78,16,-7.304787220480848,12
6070,5,42,70,25,-7.323141246130925,17
6071,88,30,62,18,-7.323841783087015,12
6072,38,30,16,21,-7.324586483454913,9
6073,2,16,75,9,-7.332326563651876,7
6074,34,24,78,14,-7.336336560215487,10
6075,11,19,75,11,-7.336654356306241,8
6076,104,41,40,26,-7.342291894534158,15
6077,114,18,23,12,-7.3449426375970175,6
6078,8,45,109,26,-7.345721442245666,19
6079,33,16,25,11,-7.365926272964513,5
6080,80,14,31,10,-7.367135464628979,4
6081,88,12,56,7,-7.371104573008601,5
6082,71,10,73,6,-7.37323406519455,4
6083,23,48,13,27,-7.373546879981892,21
6084,81,19,71,12,-7.374213709282576,7
6085,92,15,16,11,-7.376894869640721,4
6086,56,22,7,13,-7.387479337914442,9
6087,28,15,10,10,-7.394064388880875,5
6088,49,71,39,45,-7.394965855903047,26
6089,76,14,75,8,-7.401272000460671,6
6090,94,11,20,7,-7.404911652749632,4
6091,20,30,70,19,-7.408681007686707,11
6092,41,34,36,18,-7.412500474371832,16
6093,5,18,73,11,-7.416873021801379,7
6094,62,17,30,10,-7.428902113557478,7
6095,16,24,6,13,-7.439865172191105,11
6096,71,12,11,7,-7.444969376445685,5
6097,70,12,100,7,-7.458777129644962,5
6098,80,11,27,7,-7.461746767808682,4
6099,53,12,45,7,-7.463487107897498,5
6100,39,18,110,12,-7.4641114165704305,6
6101,65,25,18,15,-7.4673190946756405,10
6102,36,14,70,8,-7.476080415111225,6
6103,74,19,34,13,-7.479438239426344,6
6104,76,15,71,8,-7.4875920550169335,7
6105,109,21,7,13,-7.49374057253885,8
6106,93,10,64,5,-7.507177747442427,5
6107,61,16,107,9,-7.509321940652875,7
6108,38,12,62,8,-7.514124412933273,4
6109,47,11,85,8,-7.514718359567318,3
6110,17,39,86,22,-7.514722263451874,17
6111,66,17,65,11,-7.515278237298981,6
6112,31,11,6,6,-7.520489323813347,5
6113,78,49,27,32,-7.520666840665304,17
6114,17,17,41,11,-7.526219064648916,6
6115,55,11,6,8,-7.526848268362221,3
6116,7,16,33,9,-7.5321884826380465,7
6117,55,22,34,13,-7.534603126846269,9
6118,46,10,85,7,-7.538229298143683,3
6119,55,74,16,47,-7.540678563620174,27
6120,76,18,34,10,-7.561119825945017,8
6121,49,23,75,14,-7.565086245339056,9
6122,112,31,53,17,-7.574348903828082,14
6123,77,25,12,15,-7.576465102864338,10
6124,43,22,49,14,-7.580081398941197,8
6125,39,100,16,61,-7.584140410281978,39
6126,85,12,3,6,-7.5842525005471515,6
6127,114,31,28,18,-7.584853881328922,13
6128,36,10,72,6,-7.585561627806541,4
6129,84,18,103,10,-7.589982363677433,8
6130,36,20,18,12,-7.594902878501233,8
6131,77,27,41,18,-7.59954783990565,9
6132,69,32,60,18,-7.6138451240077565,14
6133,27,14,71,9,-7.620974472293361,5
6134,61,11,69,8,-7.63321647110431,3
6135,3,28,28,17,-7.638630473496032,11
6136,5,29,97,19,-7.6394183021151285,10
6137,60,11,70,7,-7.646435749026205,4
6138,31,13,33,7,-7.647223417443057,6
6139,60,39,104,27,-7.655966632440938,12
6140,66,11,104,8,-7.658809119364056,3
6141,112,29,27,18,-7.661494705671576,11
6142,60,14,72,9,-7.664629407768881,5
6143,96,24,37,14,-7.665844925696508,10
6144,38,29,37,18,-7.668156637885104,11
6145,9,38,8,21,-7.6727541362269935,17
6146,102,18,30,10,-7.681071626833282,8
6147,12,38,100,23,-7.682762116528131,15
6148,11,32,5,20,-7.687442157533872,12
6149,68,39,76,27,-7.690297930054157,12
6150,7,25,111,15,-7.690323425771979,10
6151,1,28,86,17,-7.696680317913665,11
6152,68,61,75,39,-7.698232004910779,22
6153,86,42,98,25,-7.705613124334453,17
6154,96,21,114,13,-7.708209589747937,8
6155,27,29,72,17,-7.712316498929214,12
6156,104,17,78,11,-7.72449974280056,6
6157,57,37,11,21,-7.727829388644563,16
6158,101,14,16,9,-7.729447625525019,5
6159,62,35,107,20,-7.732225326199554,15
6160,29,18,46,9,-7.738693511487552,9
6161,84,11,44,6,-7.74146437073986,5
6162,111,10,30,7,-7.744421754490768,3
6163,68,29,28,19,-7.748993038967355,10
6164,51,19,111,12,-7.750696049131197,7
6165,11,38,100,24,-7.7524005573637345,14
6166,30,12,98,7,-7.753603265737282,5
6167,73,11,53,7,-7.756297558195459,4
6168,114,14,92,10,-7.774797164908201,4
6169,49,46,107,29,-7.77551908328081,17
6170,81,18,114,10,-7.77743951670038,8
6171,76,40,16,22,-7.786506155237845,18
6172,111,10,47,6,-7.786638633209638,4
6173,31,31,107,16,-7.788469010128701,15
6174,78,11,108,7,-7.797957113003344,4
6175,110,12,114,8,-7.800316810979699,4
6176,46,46,25,27,-7.8204011950255445,19
6177,108,14,54,10,-7.821734358546889,4
6178,52,10,15,6,-7.828284164082511,4
6179,17,22,5,15,-7.829641724195978,7
6180,43,58,13,33,-7.834617919431733,25
6181,93,16,70,10,-7.834949393241651,6
6182,9,50,16,33,-7.836196702611143,17
6183,1,20,114,13,-7.837742070296789,7
6184,66,13,11,7,-7.856337586346076,6
6185,89,12,29,7,-7.857776153945498,5
6186,91,26,106,17,-7.859341034872009,9
6187,35,12,44,7,-7.859665557157527,5
6188,2,30,28,19,-7.862984699152352,11
6189,90,25,114,15,-7.8701656835045455,10
6190,77,35,27,22,-7.8745216976485,13
6191,40,34,54,21,-7.877426017050995,13
6192,94,18,3,11,-7.8995884826671166,7
6193,29,16,17,9,-7.89967630532443,7
6194,90,14,53,9,-7.9010322992925905,5
6195,30,30,29,19,-7.902898306652615,11
6196,31,11,78,6,-7.904414780494012,5
6197,38,13,71,9,-7.906029048659732,4
6198,82,10,88,6,-7.912578083642501,4
6199,98,20,108,12,-7.913100401728397,8
6200,33,13,30,9,-7.913395188124868,4
6201,38,25,30,17,-7.923368604045865,8
6202,13,48,30,30,-7.92615309985384,18
6203,71,19,98,12,-7.940784287039028,7
6204,86,46,43,29,-7.944824738230936,17
6205,66,15,87,9,-7.946121045220587,6
6206,76,59,86,36,-7.950570859260316,23
6207,34,15,102,10,-7.962391346680716,5
6208,39,21,23,13,-7.963088024258928,8
6209,50,44,75,29,-7.963443352466475,15
6210,61,10,58,6,-7.964357976226594,4
6211,86,69,100,41,-7.971641299719466,28
6212,68,20,34,12,-7.97804478331916,8
6213,94,35,27,22,-7.986020548938502,13
6214,84,28,5,17,-7.986435375626319,11
6215,3,19,20,12,-7.987586080022353,7
6216,3,24,72,14,-7.988593694419689,10
6217,40,16,98,9,-7.993416961646093,7
6218,96,19,102,12,-7.995631160966492,7
6219,87,30,34,19,-7.997798450633533,11
6220,81,18,41,12,-8.009042710590085,6
6221,98,31,91,19,-8.010154956050261,12
6222,5,28,65,17,-8.01209130053563,11
6223,9,11,35,6,-8.012816785902416,5
6224,52,12,63,7,-8.01519600341839,5
6225,12,17,74,11,-8.01561317270324,6
6226,18,18,100,10,-8.035989461751754,8
6227,48,15,98,10,-8.040930745507076,5
6228,84,36,20,25,-8.048616703285953,11
6229,69,45,16,29,-8.054291070790876,16
6230,46,15,19,9,-8.056646218005667,6
6231,68,29,97,18,-8.0623155896758,11
6232,70,18,50,10,-8.072010588554928,8
6233,97,16,110,10,-8.077466293642962,6
6234,9,43,87,26,-8.078706607204955,17
6235,32,17,8,10,-8.079749532998788,7
6236,4,17,43,10,-8.083539648296876,7
6237,51,14,73,9,-8.097743889322738,5
6238,77,17,17,10,-8.106011789729994,7
6239,111,11,81,8,-8.120062859865858,3
6240,98,12,9,7,-8.123745049728663,5
6241,110,11,20,7,-8.125291114928709,4
6242,55,36,50,21,-8.131693382626928,15
6243,102,24,107,14,-8.132228988483364,10
6244,107,14,56,8,-8.14241374429404,6
6245,112,10,4,6,-8.145974306589785,4
6246,38,18,12,11,-8.148426278473254,7
6247,20,17,33,11,-8.15792468553464,6
6248,64,15,62,8,-8.16208391087894,7
6249,87,53,7,34,-8.18693322227242,19
6250,40,16,92,10,-8.191919233506125,6
6251,39,25,74,15,-8.195535087876934,10
6252,51,42,64,26,-8.201880887276834,16
6253,40,14,112,8,-8.221202026655064,6
6254,70,35,87,20,-8.222879447071525,15
6255,71,10,99,6,-8.224966300288866,4
6256,7,31,37,19,-8.226042864777217,12
6257,106,21,69,13,-8.230262561693126,8
6258,1,18,75,12,-8.241769187322507,6
6259,76,10,93,6,-8.25053412937542,4
6260,15,29,8,17,-8.254756555500954,12
6261,14,12,37,7,-8.266467835075428,5
6262,45,20,60,12,-8.270932074255702,8
6263,91,18,41,12,-8.276671952774398,6
6264,79,14,15,8,-8.279617988476957,6
6265,106,31,90,21,-8.283845461248367,10
6266,58,10,109,6,-8.291034573977958,4
6267,56,17,86,11,-8.300855291965847,6
6268,63,13,92,7,-8.301235837359338,6
6269,109,13,91,8,-8.302894097359493,5
6270,109,23,74,15,-8.306575916019817,8
6271,46,43,37,29,-8.306667442353499,14
6272,51,20,79,11,-8.309517555811905,9
6273,9,15,25,10,-8.323455878342044,5
6274,108,14,76,9,-8.33452707348594,5
6275,109,54,54,35,-8.336552490351867,19
6276,96,25,48,16,-8.343995751105185,9
6277,102,32,65,21,-8.353467426988889,11
6278,31,33,41,21,-8.353957395244581,12
6279,5,22,7,14,-8.357081514884822,8
6280,94,28,39,17,-8.363460408949937,11
6281,25,45,7,29,-8.372806618348298,16
6282,13,29,58,20,-8.381428024864281,9
6283,108,19,19,12,-8.381442328055746,7
6284,68,25,62,15,-8.382615098007266,10
6285,34,21,29,12,-8.399162943605289,9
6286,67,14,109,7,-8.410228891959633,7
6287,103,23,13,16,-8.418538595487915,7
6288,102,12,41,8,-8.421036787338002,4
6289,90,19,73,12,-8.42410199186246,7
6290,103,15,88,9,-8.430464226549896,6
6291,114,20,55,13,-8.432483182241098,7
6292,70,24,96,13,-8.43741799102626,11
6293,60,33,100,21,-8.438543952400131,12
6294,41,24,8,16,-8.446748885751395,8
6295,96,14,95,9,-8.450373982592186,5
6296,94,22,76,15,-8.458632259785002,7
6297,12,23,53,14,-8.460797624804181,9
6298,106,16,12,11,-8.461406597257817,5
6299,20,37,63,22,-8.464473402081476,15
6300,112,26,39,16,-8.464674026518868,10
6301,48,20,50,13,-8.466418162124782,7
6302,19,28,103,17,-8.46904787700572,11
6303,51,24,34,15,-8.469910228480797,9
6304,66,11,30,8,-8.470012652510327,3
6305,85,14,55,9,-8.476039600481299,5
6306,70,11,15,6,-8.484143116693572,5
6307,58,27,16,17,-8.488429747726556,10
6308,69,19,104,13,-8.491359963005362,6
6309,40,28,64,18,-8.496071624321132,10
6310,45,10,91,6,-8.504304930616431,4
6311,8,35,95,21,-8.511725721270736,14
6312,64,25,55,17,-8.512933226534457,8
6313,52,11,50,6,-8.515472572504802,5
6314,9,22,20,14,-8.515923532058862,8
6315,69,22,81,13,-8.51799786685539,9
6316,61,20,53,14,-8.524850655507475,6
6317,63,11,110,7,-8.534985747455591,4
6318,65,13,91,8,-8.541931736396268,5
6319,35,12,94,7,-8.545638882275085,5
6320,67,15,16,10,-8.550473387804702,5
6321,2,11,94,7,-8.550586885180524,4
6322,36,11,78,7,-8.552435160203325,4
6323,71,13,91,8,-8.567246551132914,5
6324,107,25,111,14,-8.570266784296766,11
6325,93,10,49,6,-8.572163796775678,4
6326,76,24,100,14,-8.57272751966319,10
6327,104,22,9,14,-8.574493523715214,8
6328,55,23,95,15,-8.575006509864881,8
6329,77,18,53,11,-8.57678025133704,7
6330,107,34,2,22,-8.596357154255273,12
6331,6,23,44,16,-8.597523681350717,7
6332,6,22,13,14,-8.600067561462975,8
6333,14,22,16,14,-8.606971231031414,8
6334,15,10,58,7,-8.609651553934281,3
6335,72,13,76,9,-8.643851121564204,4
6336,8,28,73,17,-8.656865963639591,11
6337,58,12,70,8,-8.66252309250944,4
6338,54,11,53,7,-8.670288326383611,4
6339,31,12,19,8,-8.676840084796208,4
6340,68,67,39,41,-8.679610428054557,26
6341,20,41,39,24,-8.683414479878408,17
6342,77,13,46,8,-8.692557302357292,5
6343,3,16,38,10,-8.700552917920668,6
6344,62,23,28,14,-8.703867920620004,9
6345,49,28,98,18,-8.706969661782534,10
6346,43,44,107,28,-8.708997727097913,16
6347,86,15,45,9,-8.710518828201984,6
6348,3,27,40,18,-8.719928293728282,9
6349,17,22,4,15,-8.727735068009611,7
6350,46,26,57,16,-8.73890097930274,10
6351,32,11,65,7,-8.739314169667134,4
6352,11,20,49,13,-8.744249175882365,7
6353,106,14,38,7,-8.745019433529976,7
6354,39,53,30,32,-8.747392409319964,21
6355,52,16,28,10,-8.757305556361812,6
6356,84,34,8,22,-8.76285424467774,12
6357,84,37,74,21,-8.764103490564016,16
6358,88,42,15,29,-8.764269632154088,13
6359,1,27,16,19,-8.777340054296332,8
6360,99,14,77,10,-8.784719144285264,4
6361,107,11,26,7,-8.789963547813732,4
6362,46,12,6,7,-8.79137101803374,5
6363,19,18,63,12,-8.792724982250471,6
6364,47,21,11,14,-8.793803106813352,7
6365,38,19,11,12,-8.800255391920867,7
6366,42,10,106,7,-8.802546839644405,3
6367,47,18,36,12,-8.810892372607714,6
6368,19,19,84,12,-8.81339664085273,7
6369,77,22,63,15,-8.819997532642512,7
6370,36,19,63,12,-8.822881427312195,7
6371,9,26,76,17,-8.828926017071298,9
6372,15,12,89,7,-8.830075201869482,5
6373,107,40,12,27,-8.830240406285608,13
6374,29,31,100,19,-8.841937017793759,12
6375,87,15,32,10,-8.844155029434871,5
6376,93,47,65,28,-8.847119413638655,19
6377,51,16,35,10,-8.849945437990394,6
6378,12,15,6,8,-8.87368712650089,7
6379,98,12,112,8,-8.873991556640123,4
6380,53,11,49,7,-8.876928289416249,4
6381,107,24,45,15,-8.882581208643296,9
6382,13,23,90,15,-8.883764352926047,8
6383,97,12,69,8,-8.888377862411462,4
6384,27,77,16,49,-8.892060221661591,28
6385,87,65,27,41,-8.893120352605743,24
6386,12,32,94,19,-8.90023153026558,13
6387,10,15,63,10,-8.910939208335906,5
6388,43,38,100,23,-8.917383841964034,15
6389,25,19,110,13,-8.91770167255822,6
6390,88,10,26,6,-8.919527282390273,4
6391,29,29,84,18,-8.921575167609983,11
6392,98,15,3,8,-8.926309600802394,7
6393,29,22,49,14,-8.92665983569728,8
6394,60,49,27,33,-8.928785554550485,16
6395,31,12,73,8,-8.93891957013575,4
6396,74,26,51,18,-8.938947542412071,8
6397,70,11,73,6,-8.941351293720283,5
6398,91,33,87,22,-8.944507965742197,11
6399,48,14,69,8,-8.947708246863764,6
6400,39,45,18,29,-8.951686778360688,16
6401,41,34,11,23,-8.953991407123155,11
6402,81,14,11,9,-8.967824856070829,5
6403,53,27,27,18,-8.968048711845618,9
6404,114,20,47,12,-8.969382880850311,8
6405,103,19,34,13,-8.970243702574697,6
6406,36,18,97,11,-8.970668153566258,7
6407,81,10,48,7,-8.989696104511102,3
6408,80,15,78,10,-8.990142670025016,5
6409,72,10,38,6,-8.999506480702252,4
6410,65,25,1,15,-9.00217902882169,10
6411,5,64,8,40,-9.002251377410767,24
6412,50,19,85,12,-9.007921978503544,7
6413,88,30,30,18,-9.008031571554385,12
6414,36,15,5,9,-9.008614310253616,6
6415,39,25,91,16,-9.014113578195186,9
6416,45,16,35,9,-9.040031591861498,7
6417,86,29,44,19,-9.073857704921483,10
6418,55,14,49,9,-9.07453979611351,5
6419,107,39,80,26,-9.074881524481428,13
6420,40,16,57,10,-9.07504759076948,6
6421,3,21,53,14,-9.076818822513886,7
6422,75,12,94,8,-9.08090116606965,4
6423,45,11,58,7,-9.091525705777384,4
6424,49,20,72,13,-9.109802917699248,7
6425,31,15,109,10,-9.113887572404181,5
6426,17,11,92,7,-9.114563540800479,4
6427,2,13,57,8,-9.119959996501732,5
6428,112,23,28,15,-9.120223564016392,8
6429,5,11,1,7,-9.143641454097294,4
6430,106,25,39,15,-9.155969378752738,10
6431,5,43,50,26,-9.15604936984071,17
6432,10,14,76,9,-9.15717818444399,5
6433,63,21,62,13,-9.161474645821354,8
6434,64,36,16,24,-9.166098638825638,12
6435,72,14,63,10,-9.168022793278993,4
6436,29,22,112,14,-9.17461030773198,8
6437,38,14,53,9,-9.179468731240128,5
6438,87,48,43,31,-9.179610719744838,17
6439,58,19,54,11,-9.183988111852093,8
6440,91,14,23,8,-9.188824217195526,6
6441,18,31,68,20,-9.190826393650623,11
6442,63,16,81,10,-9.193429569946275,6
6443,114,21,95,13,-9.195016624238175,8
6444,41,10,79,6,-9.204704069079497,4
6445,90,11,93,7,-9.204947446014167,4
6446,109,22,68,15,-9.205767765094535,7
6447,69,16,70,11,-9.22734622840158,5
6448,100,10,93,7,-9.229250964204907,3
6449,20,23,91,14,-9.233435902067155,9
6450,62,12,18,8,-9.234800982158575,4
6451,53,15,78,9,-9.245467105519944,6
6452,93,27,87,17,-9.265524424049662,10
6453,84,23,104,14,-9.266746412193928,9
6454,94,17,114,10,-9.267018335328505,7
6455,27,30,54,19,-9.269071237772646,11
6456,60,26,47,17,-9.272798561110864,9
6457,40,24,62,13,-9.275726600058688,11
6458,17,11,12,7,-9.294611804735958,4
6459,74,10,49,6,-9.302425288754321,4
6460,38,10,45,7,-9.31109379184883,3
6461,9,30,18,20,-9.325317307118524,10
6462,84,10,77,7,-9.326879307665173,3
6463,81,13,54,8,-9.33569894630605,5
6464,87,20,1,12,-9.344990956449259,8
6465,28,12,26,8,-9.352858082446945,4
6466,12,19,28,13,-9.36472715251189,6
6467,12,34,60,19,-9.373381073655496,15
6468,4,16,27,10,-9.378715415982098,6
6469,38,12,103,9,-9.379557577066373,3
6470,54,14,73,9,-9.382932635383147,5
6471,16,25,81,16,-9.384174025613891,9
6472,103,26,107,17,-9.385277654742342,9
6473,36,11,109,8,-9.390936468630551,3
6474,38,16,27,11,-9.401601002215303,5
6475,56,13,16,9,-9.403965360554952,4
6476,2,15,13,9,-9.422510080465477,6
6477,63,11,32,7,-9.44232166344675,4
6478,9,22,11,14,-9.452997859790166,8
6479,57,16,23,10,-9.474501256774843,6
6480,98,22,13,15,-9.474726692398676,7
6481,5,29,75,17,-9.487135559909316,12
6482,99,22,37,15,-9.502759058160704,7
6483,51,35,15,22,-9.503627084553731,13
6484,2,13,114,8,-9.509158562417845,5
6485,69,13,33,8,-9.51115802646404,5
6486,36,17,8,11,-9.51236026695053,6
6487,25,32,20,21,-9.520523686179047,11
6488,31,22,1,13,-9.525804060927038,9
6489,97,11,92,6,-9.525917165548371,5
6490,75,11,20,7,-9.527707505687728,4
6491,94,14,9,8,-9.535806051453793,6
6492,107,25,33,15,-9.539564483245073,10
6493,89,14,48,11,-9.53986772534915,3
6494,3,17,17,10,-9.55033737225928,7
6495,18,51,16,34,-9.558301530146911,17
6496,13,23,26,16,-9.562123129591571,7
6497,31,28,27,16,-9.569633624787402,12
6498,37,18,49,11,-9.571164342243119,7
6499,7,20,73,12,-9.582485903794176,8
6500,43,21,54,13,-9.585604342831406,8
6501,31,10,92,6,-9.586105290347549,4
6502,108,19,48,13,-9.586410616395145,6
6503,53,13,8,9,-9.596286006275319,4
6504,10,15,16,10,-9.607669865815328,5
6505,104,11,72,7,-9.607945163400757,4
6506,84,18,83,11,-9.609473734372155,7
6507,8,14,99,8,-9.611065592860319,6
6508,15,26,43,17,-9.619130376922648,9
6509,77,32,30,21,-9.6218312337316,11
6510,109,17,70,11,-9.623350653501724,6
6511,53,23,41,15,-9.631953807885303,8
6512,8,40,75,27,-9.637059553855455,13
6513,114,10,22,5,-9.649313306364826,5
6514,46,41,74,27,-9.651769490532573,14
6515,88,11,21,7,-9.65721273441522,4
6516,71,12,100,8,-9.660687520316314,4
6517,60,47,64,32,-9.661747726131635,15
6518,65,18,79,11,-9.675692837298339,7
6519,112,22,88,14,-9.681832903230308,8
6520,114,34,8,23,-9.699231858321156,11
6521,48,10,2,7,-9.702269151070572,3
6522,111,18,28,12,-9.712251206209237,6
6523,96,48,16,34,-9.712671053609277,14
6524,8,15,52,10,-9.715026692600484,5
6525,37,12,78,8,-9.719307443467276,4
6526,31,19,43,9,-9.72085277355369,10
6527,13,35,108,23,-9.73762618587381,12
6528,84,52,63,32,-9.747162233837335,20
6529,38,10,49,7,-9.749746841362613,3
6530,53,14,15,9,-9.75938988218119,5
6531,51,30,95,21,-9.770011754426973,9
6532,83,24,37,15,-9.78372636697842,9
6533,35,27,76,17,-9.787487717233065,10
6534,93,10,62,6,-9.798162399200411,4
6535,62,16,114,10,-9.799890996069497,6
6536,109,21,53,14,-9.80472277411344,7
6537,70,10,111,6,-9.807746966138032,4
6538,18,24,106,16,-9.811498602513076,8
6539,79,18,104,11,-9.811537818194267,7
6540,48,40,63,26,-9.811551158222231,14
6541,17,24,40,16,-9.815776001763272,8
6542,109,40,11,27,-9.818197495918092,13
6543,109,12,81,8,-9.819741316945185,4
6544,19,24,72,16,-9.81989282907299,8
6545,57,13,54,10,-9.824315369895022,3
6546,69,17,47,11,-9.824856595944091,6
6547,96,26,7,18,-9.825450759982106,8
6548,109,19,75,13,-9.83076635543319,6
6549,47,17,9,11,-9.833363334347133,6
6550,98,10,53,6,-9.839111782848333,4
6551,3,10,74,7,-9.841517466916367,3
6552,33,26,51,19,-9.853114112635913,7
6553,31,32,9,21,-9.853659783790295,11
6554,71,15,17,9,-9.87407872077162,6
6555,16,20,110,13,-9.893450419413215,7
6556,83,14,11,10,-9.896151919094919,4
6557,3,58,13,39,-9.902674814214107,19
6558,68,21,103,13,-9.904114100948451,8
6559,60,34,54,23,-9.913747967452045,11
6560,70,18,30,11,-9.913973705469942,7
6561,57,11,1,7,-9.916035104284749,4
6562,2,10,95,7,-9.920312629990494,3
6563,29,15,75,9,-9.923300198268766,6
6564,103,17,49,10,-9.92709926919869,7
6565,102,14,29,10,-9.929141879190583,4
6566,90,14,46,9,-9.960134782518509,5
6567,61,15,6,10,-9.976861344972216,5
6568,12,16,114,9,-9.985343546707199,7
6569,65,25,95,16,-9.987438820754926,9
6570,71,23,104,14,-10.004145398382484,9
6571,29,18,64,13,-10.005731422414543,5
6572,63,19,111,12,-10.01291034850113,7
6573,57,19,76,13,-10.02019313359368,6
6574,75,39,28,26,-10.021801272184058,13
6575,84,27,30,19,-10.023299208241367,8
6576,72,21,28,14,-10.026127135244147,7
6577,107,13,110,9,-10.034721322746929,4
6578,3,10,70,7,-10.036631807498473,3
6579,30,15,80,10,-10.043035385271976,5
6580,19,21,34,14,-10.046525413696886,7
6581,38,10,44,7,-10.048373138060265,3
6582,10,16,107,10,-10.056408787562024,6
6583,40,18,73,12,-10.060776256522114,6
6584,83,23,13,15,-10.067954696106945,8
6585,69,37,49,22,-10.076509248182438,15
6586,49,16,40,10,-10.077718304922938,6
6587,54,21,71,13,-10.113144202991709,8
6588,36,36,53,25,-10.114732824687984,11
6589,29,11,74,7,-10.117149758840515,4
6590,114,12,78,7,-10.123963867745248,5
6591,31,37,53,23,-10.136338371296794,14
6592,23,11,96,7,-10.143008283174428,4
6593,68,16,92,11,-10.147306838487292,5
6594,9,12,6,7,-10.175309866966636,5
6595,48,14,90,9,-10.193948361787585,5
6596,33,13,71,9,-10.195530501937558,4
6597,49,23,41,15,-10.197367127109926,8
6598,2,15,98,9,-10.19860338932166,6
6599,37,42,97,28,-10.199316810918765,14
6600,104,19,90,12,-10.205908373136614,7
6601,31,17,30,10,-10.214096274935347,7
6602,48,10,97,6,-10.221233545434696,4
6603,79,12,75,8,-10.235318929578343,4
6604,106,16,67,10,-10.25216143423421,6
6605,76,33,23,21,-10.259651294452182,12
6606,3,16,47,11,-10.263621577333433,5
6607,68,22,72,15,-10.275897741373278,7
6608,112,24,60,16,-10.282975838759189,8
6609,109,30,30,21,-10.285519935967157,9
6610,76,39,63,27,-10.294441268951953,12
6611,13,11,101,8,-10.296727071239353,3
6612,28,37,74,24,-10.332746781815512,13
6613,54,48,37,32,-10.345446907641223,16
6614,102,16,40,10,-10.346146758066931,6
6615,27,15,17,9,-10.354549099588292,6
6616,7,10,94,7,-10.355621654064777,3
6617,12,24,104,16,-10.358875950961007,8
6618,88,39,50,25,-10.36486098410092,14
6619,18,49,13,32,-10.36629502959634,17
6620,69,24,63,16,-10.366973166191586,8
6621,91,36,63,25,-10.368824470659426,11
6622,55,16,15,12,-10.370537288257989,4
6623,68,14,108,9,-10.37834742902957,5
6624,93,16,106,10,-10.37915501513517,6
6625,19,16,18,11,-10.389246220506255,5
6626,29,35,60,22,-10.420897470065029,13
6627,39,16,44,10,-10.434810009571386,6
6628,46,15,78,9,-10.43532016213296,6
6629,9,17,43,10,-10.43571876790201,7
6630,112,28,64,20,-10.456743108722609,8
6631,49,14,94,10,-10.474432971630808,4
6632,9,27,64,19,-10.495957554452962,8
6633,88,44,53,30,-10.519286458480718,14
6634,36,27,27,17,-10.52334959933135,10
6635,97,19,71,13,-10.523533962196904,6
6636,68,19,50,11,-10.535408083030939,8
6637,79,13,19,8,-10.549815768045507,5
6638,40,17,28,10,-10.551622113062642,7
6639,12,11,20,7,-10.562633058497607,4
6640,9,15,95,9,-10.569002592922947,6
6641,75,26,104,17,-10.574353916694225,9
6642,91,31,7,22,-10.609100286101581,9
6643,103,13,28,9,-10.609246701939707,4
6644,103,11,48,8,-10.609852030111927,3
6645,3,10,80,6,-10.612199935723584,4
6646,33,17,63,11,-10.66390349401416,6
6647,77,20,98,14,-10.67353135151257,6
6648,36,13,43,8,-10.71355202500855,5
6649,111,11,54,8,-10.714143810197234,3
6650,17,22,53,15,-10.723383781136485,7
6651,11,10,23,7,-10.736120462067522,3
6652,91,12,11,9,-10.737589094202365,3
6653,60,19,5,13,-10.737943337535816,6
6654,108,14,106,10,-10.746780907865295,4
6655,7,11,59,8,-10.771239818059202,3
6656,19,45,27,31,-10.77128036768826,14
6657,19,25,7,18,-10.77597719817787,7
6658,91,25,55,18,-10.791612827626555,7
6659,75,12,85,9,-10.804683773311504,3
6660,81,17,106,10,-10.816681182916206,7
6661,65,26,38,16,-10.834638706827015,10
6662,13,22,44,15,-10.852020262338174,7
6663,67,17,86,11,-10.856458271232293,6
6664,81,33,51,21,-10.882761671799566,12
6665,106,13,79,9,-10.885501834452416,4
6666,9,22,48,15,-10.894666127588817,7
6667,28,48,63,33,-10.937243385325445,15
6668,86,28,29,19,-10.944229389007262,9
6669,20,40,50,27,-10.968930608298043,13
6670,88,19,102,14,-10.972125082564366,5
6671,97,25,13,16,-10.985857531237668,9
6672,107,49,57,32,-10.985936793318812,17
6673,110,20,51,14,-11.00014817045874,6
6674,71,13,15,9,-11.00914391321025,4
6675,92,14,41,9,-11.016394202336146,5
6676,66,13,7,8,-11.03456679955437,5
6677,104,25,49,17,-11.041712547533374,8
6678,84,10,47,7,-11.043789003229907,3
6679,32,17,16,11,-11.045561391190382,6
6680,114,12,32,8,-11.045874107216173,4
6681,1,39,55,27,-11.047135752371084,12
6682,11,11,99,7,-11.04788337752713,4
6683,109,44,107,30,-11.051110030102842,14
6684,89,21,41,15,-11.09646589284071,6
6685,66,11,78,7,-11.09651688512087,4
6686,57,23,79,15,-11.100381889906581,8
6687,32,13,74,9,-11.101664191982367,4
6688,94,17,62,11,-11.117470705270842,6
6689,70,15,46,10,-11.123543654837011,5
6690,1,13,78,9,-11.156578268103178,4
6691,1,11,89,7,-11.209011069389929,4
6692,46,12,100,8,-11.210309669403339,4
6693,3,15,25,10,-11.214634960222725,5
6694,96,20,46,12,-11.223825219116964,8
6695,39,12,45,7,-11.230688824941204,5
6696,68,25,25,17,-11.235607083018877,8
6697,70,11,83,6,-11.265042422069474,5
6698,7,52,75,35,-11.274663385996204,17
6699,65,50,100,34,-11.275226832418381,16
6700,55,14,2,9,-11.27681615957405,5
6701,27,11,111,8,-11.279710088837584,3
6702,61,10,75,6,-11.283854363299358,4
6703,5,10,80,7,-11.295210617596888,3
6704,91,13,69,8,-11.30407928014614,5
6705,20,12,64,9,-11.331308462604776,3
6706,44,15,104,10,-11.332078649569059,5
6707,112,11,108,7,-11.335603356831967,4
6708,102,15,75,11,-11.35790237245839,4
6709,78,28,39,19,-11.374922957505097,9
6710,91,17,43,12,-11.378756439291882,5
6711,57,22,65,15,-11.3825342300458,7
6712,106,66,16,46,-11.389696810454694,20
6713,38,11,4,8,-11.395009854616482,3
6714,75,10,73,5,-11.395199340418813,5
6715,54,39,75,25,-11.408133317564461,14
6716,18,17,47,12,-11.411676107822023,5
6717,12,26,41,18,-11.414617123719315,8
6718,86,38,102,26,-11.442450297093961,12
6719,49,35,100,23,-11.456244824909795,12
6720,106,41,114,27,-11.462749893343949,14
6721,15,14,48,9,-11.482791416530661,5
6722,34,14,18,10,-11.48294101232062,4
6723,37,12,68,8,-11.49658369134707,4
6724,75,14,98,9,-11.49709370731316,5
6725,18,10,108,7,-11.508388616511892,3
6726,65,11,35,8,-11.518581403700487,3
6727,76,20,7,12,-11.52245661748586,8
6728,81,15,7,9,-11.525413070422038,6
6729,7,12,110,7,-11.526061320417648,5
6730,84,12,18,8,-11.52667869126048,4
6731,109,15,93,10,-11.535822563792802,5
6732,41,30,100,20,-11.550572113391238,10
6733,46,14,53,9,-11.556347535591735,5
6734,3,13,108,9,-11.562059375800658,4
6735,87,13,21,9,-11.56318091799384,4
6736,71,10,111,7,-11.563837134119526,3
6737,104,16,36,10,-11.564722196156032,6
6738,104,12,93,8,-11.57701291373734,4
6739,39,15,90,10,-11.577976501423597,5
6740,70,23,11,16,-11.609570033059047,7
6741,1,14,37,9,-11.6272926254772,5
6742,38,17,75,13,-11.628826987325251,4
6743,110,10,11,8,-11.637838089699006,2
6744,40,12,100,8,-11.638460148115913,4
6745,114,32,87,20,-11.64317239381751,12
6746,83,17,107,12,-11.64452174042024,5
6747,23,15,72,10,-11.667454901588142,5
6748,81,10,8,7,-11.678569579324545,3
6749,28,23,34,16,-11.682170467841415,7
6750,96,13,91,9,-11.69285419312405,4
6751,43,25,55,19,-11.714024478286158,6
6752,69,12,34,10,-11.742698738008174,2
6753,102,17,63,11,-11.747209471298389,6
6754,103,10,58,7,-11.772908526311582,3
6755,62,10,112,7,-11.78047192200998,3
6756,54,10,44,7,-11.791894285038762,3
6757,40,21,8,15,-11.79192140237277,6
6758,91,10,53,7,-11.811611902058752,3
6759,77,31,104,21,-11.812621663747162,10
6760,109,11,92,8,-11.825872450184745,3
6761,64,10,74,6,-11.828764368523546,4
6762,86,17,92,11,-11.833574375075663,6
6763,12,11,79,7,-11.866943529008417,4
6764,60,30,91,19,-11.867580664385896,11
6765,62,12,43,8,-11.874169648552916,4
6766,102,11,43,7,-11.887502689329436,4
6767,31,18,98,11,-11.908816140421925,7
6768,77,17,71,12,-11.915487518479782,5
6769,49,19,48,14,-11.919274877330183,5
6770,65,46,114,30,-11.938229846486394,16
6771,57,27,70,17,-11.940546365796532,10
6772,81,13,28,9,-11.947384191502275,4
6773,18,27,95,18,-11.951490678023534,9
6774,77,15,37,10,-11.967604181160285,5
6775,55,18,102,12,-11.98386619497443,6
6776,19,17,17,12,-11.9971982095889,5
6777,39,22,108,14,-11.99851415989162,8
6778,77,25,43,17,-12.004670640929955,8
6779,5,32,102,21,-12.011851390558958,11
6780,81,29,87,18,-12.015356959966109,11
6781,89,15,63,11,-12.017404575838292,4
6782,104,12,1,8,-12.02010829271743,4
6783,28,14,43,9,-12.028046594555397,5
6784,46,20,30,14,-12.044164698044927,6
6785,89,10,10,7,-12.05123505380701,3
6786,63,18,1,11,-12.054495717242014,7
6787,62,22,74,15,-12.061308273026555,7
6788,23,22,49,15,-12.076835461637529,7
6789,35,11,8,8,-12.093356369533678,3
6790,43,23,30,17,-12.09351277368479,6
6791,4,10,15,6,-12.124220843420797,4
6792,109,19,57,13,-12.12921132196382,6
6793,37,14,34,10,-12.135815020075322,4
6794,96,40,11,27,-12.14102850879166,13
6795,70,22,2,14,-12.153236389251049,8
6796,41,23,111,15,-12.165817300484488,8
6797,23,21,55,13,-12.170945018647474,8
6798,99,21,107,14,-12.174640608684577,7
6799,35,11,75,8,-12.188091693345983,3
6800,92,10,49,6,-12.189632873694912,4
6801,84,35,11,24,-12.18991190656385,11
6802,11,15,2,10,-12.196157085843714,5
6803,109,15,72,11,-12.199392565133762,4
6804,13,11,42,8,-12.203174115394763,3
6805,106,11,78,8,-12.210243252742742,3
6806,91,22,30,16,-12.212093275229307,6
6807,37,19,64,13,-12.216856507558592,6
6808,43,19,75,14,-12.224767647713703,5
6809,60,22,74,14,-12.23030247671151,8
6810,29,11,58,8,-12.250932195859463,3
6811,39,10,32,7,-12.259008757767623,3
6812,88,19,73,13,-12.262693289910837,6
6813,60,18,37,11,-12.263894360602315,7
6814,39,21,109,15,-12.264003725130953,6
6815,95,12,29,8,-12.273663594494513,4
6816,81,15,40,11,-12.276802562895192,4
6817,18,15,69,10,-12.281407888329312,5
6818,69,16,72,11,-12.28889492591065,5
6819,77,30,100,21,-12.29767742568246,9
6820,88,18,98,13,-12.300728896947142,5
6821,96,29,98,20,-12.30166544531649,9
6822,94,34,13,23,-12.315280597409899,11
6823,89,10,78,7,-12.322206367086613,3
6824,41,14,34,9,-12.338786367505541,5
6825,87,32,98,23,-12.344093153312015,9
6826,97,12,67,9,-12.353467827440639,3
6827,12,14,75,9,-12.356839423121738,5
6828,109,10,35,7,-12.407562430544193,3
6829,50,17,36,10,-12.423703215189777,7
6830,58,27,65,18,-12.431650709075077,9
6831,37,14,18,10,-12.438833593443574,4
6832,88,88,13,62,-12.460305993563065,26
6833,87,30,79,22,-12.466071130940083,8
6834,92,15,64,8,-12.492372460791035,7
6835,11,33,104,23,-12.522578417808797,10
6836,71,18,41,13,-12.557773267008857,5
6837,35,12,3,8,-12.563400964105028,4
6838,38,14,100,11,-12.572962429479658,3
6839,9,32,15,19,-12.592578406206986,13
6840,51,21,2,13,-12.595923969105383,8
6841,102,12,15,9,-12.597866884640938,3
6842,108,24,53,15,-12.606603502458741,9
6843,48,20,74,12,-12.617131151527767,8
6844,85,20,39,13,-12.618845399489867,7
6845,57,23,7,14,-12.666461617234948,9
6846,5,15,48,11,-12.675358072710559,4
6847,31,13,104,8,-12.681964820727016,5
6848,63,40,80,28,-12.682443988429268,12
6849,31,76,13,51,-12.705633823012965,25
6850,106,24,46,15,-12.725492516069494,9
6851,106,14,33,10,-12.736963404825655,4
6852,37,44,11,30,-12.738426249160876,14
6853,36,10,95,7,-12.746346244298937,3
6854,1,15,100,10,-12.750379039232417,5
6855,16,12,26,8,-12.76532683036784,4
6856,51,21,80,14,-12.779249811641696,7
6857,3,31,84,20,-12.781771350844402,11
6858,25,15,49,10,-12.785517383168525,5
6859,11,14,108,10,-12.798974196396985,4
6860,76,11,1,7,-12.827717897490281,4
6861,27,35,104,24,-12.83724877330016,11
6862,103,13,50,9,-12.862167277055057,4
6863,19,30,51,22,-12.868592174220957,8
6864,74,11,15,8,-12.870326474022038,3
6865,57,24,34,17,-12.872133630873053,7
6866,65,21,2,16,-12.890027578518191,5
6867,109,19,17,13,-12.911257852793483,6
6868,47,14,78,9,-12.914558187890036,5
6869,76,16,74,10,-12.94370107525992,6
6870,85,11,41,7,-12.952472883327006,4
6871,106,19,98,13,-12.95487415033694,6
6872,84,10,92,6,-12.962976398847763,4
6873,94,17,85,12,-12.99160031268738,5
6874,35,14,63,9,-12.998216518752985,5
6875,12,14,9,10,-13.029002866437166,4
6876,47,14,55,9,-13.036465008068175,5
6877,72,13,57,11,-13.071458888669092,2
6878,103,31,100,21,-13.109980501741745,10
6879,57,15,75,11,-13.125107209592635,4
6880,37,28,95,21,-13.149042342745602,7
6881,54,18,36,12,-13.21774479827317,6
6882,64,15,109,9,-13.229745561488967,6
6883,57,19,94,13,-13.247205639863786,6
6884,11,23,95,17,-13.263288005084231,6
6885,99,12,7,8,-13.27451726078842,4
6886,46,43,104,29,-13.294982678813746,14
6887,106,19,64,13,-13.295192075566398,6
6888,1,14,8,10,-13.305141225086524,4
6889,88,20,80,13,-13.305539707805673,7
6890,19,17,9,12,-13.318120114033066,5
6891,18,16,11,11,-13.321280125838722,5
6892,9,13,108,8,-13.341841222661904,5
6893,32,11,55,7,-13.363639630093914,4
6894,48,14,17,9,-13.364907872446567,5
6895,35,12,104,8,-13.369677424437173,4
6896,103,14,109,9,-13.379278679742844,5
6897,48,11,62,7,-13.383804058498162,4
6898,84,15,71,11,-13.41321574412034,4
6899,45,10,27,7,-13.421070416218559,3
6900,112,11,91,8,-13.423237527272493,3
6901,53,15,75,10,-13.423496737137015,5
6902,68,16,61,11,-13.424919545398382,5
6903,89,14,19,10,-13.426371568520794,4
6904,70,13,34,9,-13.426554854854936,4
6905,32,12,25,7,-13.427877456338669,5
6906,109,27,15,21,-13.433613800365606,6
6907,45,15,23,11,-13.436468047997261,4
6908,53,19,43,14,-13.438033142991662,5
6909,35,15,36,11,-13.440272285829968,4
6910,51,24,94,17,-13.451133934243908,7
6911,69,24,27,16,-13.483104419153626,8
6912,108,12,84,9,-13.488009207908556,3
6913,63,32,30,22,-13.498171962188781,10
6914,112,13,55,10,-13.49840576791747,3
6915,29,27,13,18,-13.513958263485303,9
6916,78,21,76,16,-13.52214163403542,5
6917,6,10,80,7,-13.522871173076236,3
6918,12,15,30,11,-13.545717330650541,4
6919,84,19,41,13,-13.556150264603872,6
6920,60,18,103,13,-13.575363139165225,5
6921,27,13,22,9,-13.578238998395374,4
6922,60,18,34,13,-13.644836415292458,5
6923,108,12,8,9,-13.645968521702336,3
6924,25,10,92,7,-13.698642336458672,3
6925,5,28,57,20,-13.702708831126639,8
6926,95,10,34,7,-13.704508911135058,3
6927,31,25,63,18,-13.714594813504084,7
6928,27,10,97,6,-13.735152835550474,4
6929,88,37,95,26,-13.752013257016607,11
6930,57,17,62,13,-13.757275808574354,4
6931,85,11,87,8,-13.78530468452242,3
6932,112,11,97,9,-13.794615799527316,2
6933,112,14,38,11,-13.819485047030156,3
6934,112,18,47,12,-13.820833793363406,6
6935,103,17,55,13,-13.826956770005324,4
6936,57,12,47,8,-13.842676334165546,4
6937,109,35,27,23,-13.847267092001198,12
6938,72,18,39,13,-13.872487814202467,5
6939,50,19,53,13,-13.883151416746285,6
6940,83,21,16,15,-13.895144807658395,6
6941,3,31,63,24,-13.905152866710317,7
6942,112,10,25,7,-13.919292260310073,3
6943,112,11,37,8,-13.937736127059292,3
6944,20,14,60,10,-13.939926452860888,4
6945,69,19,75,14,-13.942304484906572,5
6946,71,24,40,17,-13.948125771645662,7
6947,109,29,114,22,-13.96133653890183,7
6948,75,12,111,8,-13.97228180941997,4
6949,9,31,41,22,-13.990507643067815,9
6950,41,11,6,7,-13.99218654178206,4
6951,77,29,40,21,-14.048771071022594,8
6952,68,31,100,21,-14.067965798054429,10
6953,9,10,90,7,-14.073147353965513,3
6954,66,13,58,10,-14.087865353684418,3
6955,3,32,100,23,-14.177671200718624,9
6956,75,10,72,7,-14.207053385683185,3
6957,46,18,50,12,-14.208875687593247,6
6958,7,17,61,11,-14.217702740281519,6
6959,48,13,72,8,-14.22664791418154,5
6960,17,11,83,7,-14.269615650014424,4
6961,18,15,23,10,-14.275894417804937,5
6962,112,10,48,8,-14.307464286387088,2
6963,102,11,46,8,-14.307494713152066,3
6964,57,12,31,8,-14.310689026630854,4
6965,86,25,26,19,-14.322036756570215,6
6966,10,10,54,7,-14.334784055636703,3
6967,83,10,40,8,-14.347262135245899,2
6968,81,15,100,10,-14.382694095158197,5
6969,90,16,20,11,-14.40477443227544,5
6970,70,26,108,19,-14.427393649276276,7
6971,14,11,80,7,-14.43534539519452,4
6972,77,24,8,17,-14.435582202481529,7
6973,35,13,97,10,-14.444551731599498,3
6974,5,12,44,9,-14.447481002517359,3
6975,2,10,73,7,-14.457830254043131,3
6976,25,12,34,9,-14.468789684868277,3
6977,109,18,12,13,-14.482637172197814,5
6978,38,23,104,16,-14.499014536690481,7
6979,97,15,38,11,-14.531013843539451,4
6980,49,15,47,12,-14.532787825231312,3
6981,50,19,80,15,-14.554439051919097,4
6982,20,18,34,14,-14.557800978959815,4
6983,99,12,50,8,-14.581629542155008,4
6984,66,10,39,7,-14.612542929328725,3
6985,19,16,55,11,-14.68778354720052,5
6986,78,19,17,13,-14.709203332504178,6
6987,83,19,114,14,-14.712530964906863,5
6988,77,28,7,20,-14.72949510503469,8
6989,31,10,100,7,-14.730848989291468,3
6990,48,15,78,11,-14.736137197437776,4
6991,102,11,90,6,-14.739148726840867,5
6992,106,14,32,11,-14.741977351969272,3
6993,89,19,27,14,-14.746406878256861,5
6994,25,26,11,20,-14.778705544740388,6
6995,89,11,7,8,-14.785043291363074,3
6996,35,11,102,7,-14.787485364380142,4
6997,77,19,15,14,-14.819984931970575,5
6998,88,18,111,14,-14.89137809160146,4
6999,91,14,76,11,-14.966787278347377,3
7000,44,10,49,7,-14.992301775479174,3
7001,49,14,80,9,-14.993186389789676,5
7002,22,12,13,9,-14.994671319317483,3
7003,75,10,45,8,-15.003649946946844,2
7004,99,18,25,13,-15.014737107768294,5
7005,81,18,49,12,-15.043369514696261,6
7006,93,10,38,6,-15.046407356806787,4
7007,50,19,77,15,-15.082093464135088,4
7008,29,10,71,8,-15.143188317628589,2
7009,54,31,48,22,-15.152035020388912,9
7010,77,11,54,10,-15.154916790692537,1
7011,94,44,16,33,-15.20885505708528,11
7012,46,14,93,11,-15.25112664035686,3
7013,94,12,104,9,-15.272338655973261,3
7014,2,15,100,10,-15.363858490781979,5
7015,62,16,12,11,-15.366878044727521,5
7016,18,11,5,8,-15.389394006883379,3
7017,107,25,73,17,-15.46067272069853,8
7018,39,12,2,9,-15.473797666414953,3
7019,84,23,112,17,-15.486639525748986,6
7020,31,15,69,10,-15.502962092044207,5
7021,104,20,64,15,-15.51526416011922,5
7022,66,12,13,9,-15.520614540867863,3
7023,5,21,23,16,-15.554175057753401,5
7024,90,10,100,8,-15.596895375105717,2
7025,45,14,4,10,-15.600891470448106,4
7026,69,10,23,8,-15.603167423944381,2
7027,85,11,106,8,-15.605731963514023,3
7028,97,13,90,9,-15.621888085765935,4
7029,97,12,14,10,-15.664913845649805,2
7030,51,23,72,16,-15.686011493569213,7
7031,112,14,15,10,-15.700949053545523,4
7032,51,20,45,15,-15.703190735785377,5
7033,80,13,75,10,-15.718052052365538,3
7034,35,12,80,9,-15.72406211872363,3
7035,96,16,93,12,-15.733194627661215,4
7036,94,13,17,9,-15.746212612138288,4
7037,28,13,110,9,-15.755425369009838,4
7038,17,22,95,17,-15.802621580377183,5
7039,41,12,15,9,-15.833444649300676,3
7040,28,29,90,22,-15.880089586771646,7
7041,70,13,80,11,-15.901333417895945,2
7042,76,11,80,8,-15.945303671637879,3
7043,90,11,57,8,-15.975273202140913,3
7044,9,31,53,23,-16.014655893145633,8
7045,37,14,15,11,-16.033544043199246,3
7046,29,15,72,11,-16.0438299277562,4
7047,5,18,41,12,-16.050377082501452,6
7048,112,15,71,11,-16.116875921028463,4
7049,46,13,98,9,-16.12835125202737,4
7050,58,25,86,19,-16.26853319646311,6
7051,80,12,34,10,-16.269229317512288,2
7052,33,16,65,12,-16.286121361101067,4
7053,85,18,30,13,-16.304609608829036,5
7054,98,17,109,13,-16.306862994782453,4
7055,14,12,25,10,-16.337614979675553,2
7056,2,19,104,13,-16.352388003055772,6
7057,57,22,100,16,-16.352929528191847,6
7058,83,13,27,11,-16.368092522641103,2
7059,43,11,110,8,-16.376498956572302,3
7060,40,10,29,8,-16.378294184390825,2
7061,63,14,14,10,-16.386711509096077,4
7062,43,13,45,9,-16.39462685745925,4
7063,103,13,74,10,-16.40982303219032,3
7064,39,19,99,15,-16.42872930905631,4
7065,38,15,87,11,-16.440170970047014,4
7066,37,11,19,9,-16.4401797639671,2
7067,55,15,14,12,-16.464885141480416,3
7068,87,10,61,7,-16.482333693393578,3
7069,31,46,16,34,-16.494251500601976,12
7070,64,10,66,8,-16.526342406123636,2
7071,79,12,17,9,-16.52858758988839,3
7072,68,22,95,18,-16.55020486315604,4
7073,109,15,19,11,-16.588566849406615,4
7074,36,10,101,8,-16.627946704419486,2
7075,94,13,48,10,-16.653883625052597,3
7076,69,23,53,17,-16.676579450904736,6
7077,112,28,78,21,-16.67914983172849,7
7078,71,15,95,10,-16.726754189945986,5
7079,83,13,23,10,-16.74470008954982,3
7080,41,20,30,15,-16.767826748629858,5
7081,46,14,18,11,-16.84517490405338,3
7082,29,27,88,20,-16.85204786067182,7
7083,10,12,37,8,-16.87706142806293,4
7084,10,12,13,9,-16.892767460419815,3
7085,41,10,22,8,-16.895138763704843,2
7086,57,18,29,14,-16.901122362734938,4
7087,46,12,43,9,-16.90387334173946,3
7088,112,19,20,15,-16.964936240764278,4
7089,31,10,38,6,-16.97274158238423,4
7090,102,11,48,9,-16.984312347736424,2
7091,37,13,73,9,-17.03246334806977,4
7092,1,14,18,11,-17.058153705270215,3
7093,9,29,27,21,-17.072056537621446,8
7094,2,11,60,8,-17.116843000088547,3
7095,60,17,102,12,-17.171392721318526,5
7096,5,22,27,16,-17.186967099907655,6
7097,106,10,35,7,-17.31905115685177,3
7098,76,15,15,11,-17.413278847676434,4
7099,35,10,60,7,-17.418126947264813,3
7100,29,10,80,8,-17.45720022045759,2
7101,77,39,16,30,-17.459530597353453,9
7102,29,18,109,12,-17.571930830154635,6
7103,83,11,110,9,-17.575104905290953,2
7104,70,12,48,9,-17.60881542858036,3
7105,67,10,20,8,-17.672455088050597,2
7106,62,18,78,14,-17.687600407036527,4
7107,3,11,5,7,-17.694163901939536,4
7108,51,23,90,18,-17.7178788097309,5
7109,55,12,44,9,-17.771847163193577,3
7110,15,10,85,8,-17.788004047228643,2
7111,5,18,30,15,-17.810533055025342,3
7112,35,13,48,10,-17.821530991658577,3
7113,88,17,32,13,-17.824594134673823,4
7114,114,11,111,8,-17.846918134233796,3
7115,41,10,35,7,-17.84884882348167,3
7116,30,15,95,11,-17.919901608832802,4
7117,76,21,54,16,-18.08934803214948,5
7118,54,10,67,8,-18.121548101252504,2
7119,12,14,55,11,-18.17466355866916,3
7120,43,12,81,9,-18.327617727929393,3
7121,6,11,19,8,-18.33570620434032,3
7122,13,20,80,14,-18.33580484931627,6
7123,54,12,34,10,-18.362976743969604,2
7124,35,17,87,12,-18.4649770696095,5
7125,31,15,106,11,-18.52908676481623,4
7126,12,10,45,8,-18.65380711999512,2
7127,57,16,112,12,-18.74164060463068,4
7128,28,17,99,13,-18.75458480836917,4
7129,102,12,27,10,-18.772173343475483,2
7130,33,20,55,16,-18.82593244000092,4
7131,97,12,34,9,-18.83120290818016,3
7132,4,13,98,11,-18.93649850914462,2
7133,106,11,89,7,-18.95338953455918,4
7134,106,10,92,8,-19.04169077246869,2
7135,18,14,99,11,-19.290873438644518,3
7136,36,19,30,17,-19.305297671687285,2
7137,29,11,114,8,-19.42881288570476,3
7138,6,11,30,9,-19.605882514870544,2
7139,5,11,64,9,-19.69819687485363,2
7140,31,11,15,8,-19.73878794252568,3
7141,32,12,95,10,-19.760326388824463,2
7142,38,10,94,8,-19.793182522248042,2
7143,97,13,73,9,-19.966763707753138,4
7144,54,17,4,15,-19.99443539185139,2
7145,89,12,76,10,-20.057237370983124,2
7146,89,10,57,8,-20.153446064878874,2
7147,84,12,7,10,-20.16090095994254,2
7148,68,38,112,30,-20.16144061217486,8
7149,103,10,75,9,-20.24199150509897,1
7150,12,10,26,8,-20.37973185640995,2
7151,10,11,30,9,-20.38962047667116,2
7152,94,23,81,17,-20.517798479805748,6
7153,108,13,114,10,-20.766174427392745,3
7154,3,18,48,14,-20.77461856356065,4
7155,68,11,90,9,-20.78795619801594,2
7156,3,17,75,14,-20.897191698320935,3
7157,10,14,112,11,-21.021770709139744,3
7158,10,16,51,13,-21.051824036569297,3
7159,112,16,80,12,-21.108795407964617,4
7160,31,11,76,10,-21.157211826935978,1
7161,51,11,101,9,-21.226620175614496,2
7162,4,13,25,11,-21.420042602463127,2
7163,4,15,41,10,-21.48059017391386,5
7164,34,11,64,9,-21.53865059177988,2
7165,62,12,34,10,-21.778436974548594,2
7166,31,12,62,9,-21.79094106777599,3
7167,89,15,11,13,-21.994738492227253,2
7168,97,12,91,10,-22.175648770183784,2
7169,1,10,3,8,-22.670516239418713,2
7170,91,18,104,17,-22.937436859705542,1
7171,57,14,26,11,-23.006782602638854,3
7172,8,11,4,10,-23.17790508365148,1
7173,77,19,75,16,-23.52836570307736,3
7174,38,13,55,11,-23.805883695964802,2
7175,42,11,104,10,-24.55480599508646,1
7176,33,11,100,10,-25.460296177649866,1
7177,106,10,49,9,-25.68163240192886,1
7178,38,10,69,9,-27.69592076147955,1
7179,61,10,98,10,-28.32332956610249,0
7180,23,13,90,12,-28.362481429909806,1
7181,90,10,109,10,-29.2714816942141,0
7182,37,11,44,11,-29.88349889925713,0
7183,102,17,112,16,-31.59305348177514,1
